,LIMIT_BAL,80%,match 100,MatchA,Match J,Match JUN,MatchM,default,STAT_AUG,BILL_JUL,PAID_AUG,Bal_AUG,STAT_JUL,BILL_JUN,PAID_JUL,Bal_JUL,STAT_JUN,BILL_MAY,PAID_JUN,Bal_JUN,STAT_MAY,BILL_APR,PAID_MAY,Bal_MAY
0,50000,40000,1,1,1,1,1,1,0,92309,2784,89525,0,93880,2603,91277,0,99418,10000,89418,0,101392,3164,98228
1,30000,24000,0,0,0,0,0,0,0,19273,2000,17273,0,16469,2000,14469,0,14670,417,14253,0,11214,1500,9714
2,260000,208000,0,0,0,0,0,0,0,101721,4132,97589,0,76699,3410,73289,0,56738,2600,54138,0,39134,1800,37334
3,200000,160000,0,0,0,0,0,0,0,26988,2000,24988,0,25237,600,24637,0,22131,3000,19131,0,13774,4000,9774
4,50000,40000,0,0,0,0,0,0,0,16342,1278,15064,0,17653,1589,16064,0,17697,633,17064,0,18068,656,17412
5,150000,120000,0,0,0,0,0,0,0,24134,1699,22435,0,24635,1200,23435,0,29032,5000,24032,0,29766,1214,28552
6,400000,320000,0,0,0,0,0,1,-2,330,330,0,-2,330,330,0,-2,330,330,0,-2,330,330,0
7,360000,288000,0,0,0,0,0,0,-1,1340,1340,0,-1,1650,1650,0,-1,4350,4350,0,-2,4792,4792,0
8,160000,128000,0,0,0,0,0,0,2,400,0,400,2,0,0,0,2,20818,20818,0,-1,20818,0,20818
9,500000,400000,0,0,0,0,0,0,-1,367979,368199,-220,-1,294969,6486,288483,0,189612,234,189378,0,128459,90,128369
10,70000,56000,0,1,0,0,0,0,0,67533,1751,65782,0,28653,969,27684,0,29253,1004,28249,0,26185,938,25247
11,20000,16000,0,0,0,0,0,0,-2,0,0,0,-2,0,0,0,-2,0,0,0,-2,0,0,0
12,230000,184000,0,0,0,0,0,0,0,44477,2353,42124,0,39998,5000,34998,0,23278,0,23278,0,27775,8000,19775
13,200000,160000,0,0,0,0,0,1,-1,10323,3014,7309,0,8440,1027,7413,0,4963,2022,2941,0,10222,10017,205
14,140000,112000,0,0,0,0,0,0,0,44739,2027,42712,0,43455,1800,41655,0,43980,1600,42380,0,44614,1750,42864
15,50000,40000,0,0,0,0,0,0,2,30935,1663,29272,0,14010,1544,12466,0,19110,5500,13610,0,19500,390,19110
16,70000,56000,0,0,0,0,0,0,0,29314,1773,27541,0,28844,1181,27663,0,29443,1215,28228,0,30101,1297,28804
17,200000,160000,0,0,0,0,0,1,-1,0,0,0,-1,0,0,0,-2,0,0,0,-2,0,0,0
18,320000,256000,0,0,0,0,0,0,-1,7809,7935,-126,-1,5238,5238,0,-1,8594,8594,0,-1,3743,3743,0
19,20000,16000,0,1,0,1,1,0,0,18578,2000,16578,0,17989,2000,15989,0,19533,2000,17533,0,20039,831,19208
20,120000,96000,0,0,0,0,0,1,2,27570,600,26970,2,28318,1500,26818,2,29217,1500,27717,2,28598,0,28598
21,20000,16000,0,0,1,1,1,0,0,16686,1000,15686,2,17406,1000,16406,0,18123,1000,17123,0,19680,1864,17816
22,500000,400000,0,1,1,1,1,1,3,499936,0,499936,2,505507,14000,491507,0,484612,16500,468112,0,419643,16000,403643
23,10000,8000,0,0,0,1,1,1,2,7996,1290,6706,0,9004,1298,7706,0,9180,474,8706,0,9371,487,8884
24,150000,120000,0,0,0,0,0,0,-1,16719,16732,-13,-1,8568,8593,-25,-1,797,799,-2,-2,1158,1161,-3
25,80000,64000,0,0,0,0,0,0,2,8109,4500,3609,2,7849,21,7828,2,0,0,0,2,0,0,0
26,360000,288000,0,0,0,0,0,0,-2,430,436,-6,-2,1982,1991,-9,-2,211250,211250,0,-1,215670,7762,207908
27,320000,256000,0,0,0,0,0,0,0,201913,9000,192913,0,103278,6000,97278,0,62891,3000,59891,0,64948,3000,61948
28,50000,40000,0,1,1,1,1,0,0,51057,2004,49053,0,49496,1900,47596,0,50688,2001,48687,0,50517,2200,48317
29,200000,160000,0,0,0,0,0,0,0,116545,4500,112045,0,120396,5800,114596,0,121486,4500,116986,0,121518,5000,116518
30,20000,16000,0,0,0,0,0,0,-1,0,0,0,-1,597,597,0,-1,0,0,0,-1,4740,4740,0
31,30000,24000,0,0,0,0,0,0,-1,390,390,0,-1,780,780,0,-1,390,0,390,0,390,390,0
32,140000,112000,0,0,0,0,0,0,-1,0,0,0,-2,0,0,0,-2,0,0,0,-2,0,0,0
33,390000,312000,0,0,0,0,0,0,-2,6548,6548,0,-2,8976,8976,0,-2,909,909,0,-2,17682,17682,0
34,200000,160000,0,0,0,0,0,1,-1,726,726,0,-1,726,0,726,0,495,495,0,-1,1402,1562,-160
35,180000,144000,0,0,0,0,0,0,-2,21645,21849,-204,-2,5800,5829,-29,-2,24283,24404,-121,-2,11545,11602,-57
36,150000,120000,0,0,0,0,0,0,2,1430,1430,0,-1,810,810,0,-1,786,786,0,-1,447,447,0
37,60000,48000,0,1,1,1,1,0,0,57920,2269,55651,0,58064,2277,55787,0,55928,2002,53926,0,57108,2081,55027
38,200000,160000,0,1,1,0,0,0,0,181617,6900,174717,0,181994,7022,174972,0,150013,5300,144713,0,150283,5368,144915
39,190000,152000,0,0,0,0,0,0,0,110000,10000,100000,0,115674,5674,110000,0,121313,11313,110000,0,15538,5538,10000
40,10000,8000,0,0,1,1,1,1,0,8939,1159,7780,0,9533,1140,8393,0,9692,692,9000,0,9829,829,9000
41,50000,40000,0,0,0,0,0,0,0,16383,1303,15080,0,17837,1757,16080,0,15791,711,15080,0,15988,600,15388
42,210000,168000,0,0,0,0,0,0,0,59658,2753,56905,0,60466,2400,58066,0,61593,2255,59338,0,65163,4767,60396
43,50000,40000,0,1,1,0,0,0,0,46836,2500,44336,0,48635,3000,45635,0,19373,1500,17873,0,20129,2000,18129
44,50000,40000,0,1,1,0,0,0,0,48265,1967,46298,0,43451,1400,42051,0,19790,396,19394,0,17790,0,17790
45,140000,112000,0,1,0,0,0,0,0,137477,6405,131072,0,110865,4819,106046,0,69217,3091,66126,0,48018,2477,45541
46,220000,176000,0,0,0,0,0,1,2,325,0,325,2,950,950,0,-1,475,0,475,2,325,325,0
47,90000,72000,0,0,0,0,0,1,0,7097,2500,4597,0,6624,2397,4227,0,6806,2150,4656,0,6266,709,5557
48,50000,40000,0,0,0,0,0,1,0,27199,1500,25699,0,18810,1400,17410,0,18487,1000,17487,0,18874,684,18190
49,400000,320000,0,0,0,0,0,0,0,194509,8000,186509,0,199284,8000,191284,0,203502,7500,196002,0,195769,9000,186769
50,110000,88000,0,0,0,0,0,0,0,87889,5009,82880,0,61123,4000,57123,0,59395,3027,56368,0,52189,3000,49189
51,20000,16000,0,1,1,0,0,0,0,19633,1750,17883,0,18347,1000,17347,0,9347,1000,8347,0,0,0,0
52,30000,24000,0,0,0,0,0,0,0,13052,3345,9707,0,0,0,0,0,0,0,0,-2,0,0,0
53,30000,24000,0,0,0,0,0,0,-2,0,0,0,-2,295,295,0,-2,-5,5,-10,-2,-5,0,-5
54,230000,184000,0,0,0,0,0,1,-2,0,0,0,-2,0,0,0,-2,0,0,0,-2,0,0,0
55,160000,128000,0,0,0,0,0,1,-1,1097,0,1097,2,772,0,772,0,447,0,447,0,797,1000,-203
56,200000,160000,0,0,0,0,0,1,-2,0,0,0,-2,0,0,0,-2,0,0,0,-2,0,0,0
57,20000,16000,0,0,0,0,0,0,0,0,0,0,0,0,0,0,-2,0,0,0,-2,0,0,0
58,160000,128000,0,0,0,0,0,0,-1,9244,6152,3092,0,8344,1000,7344,0,5607,1401,4206,0,1289,0,1289
59,160000,128000,0,0,0,0,0,0,0,25254,1000,24254,0,10740,10740,0,-1,50207,50207,0,-1,10298,10298,0
60,140000,112000,0,0,0,0,0,0,0,16025,16025,0,-1,24616,24616,0,-1,19458,1000,18458,0,20047,1000,19047
61,120000,96000,1,1,1,1,1,0,0,131281,4500,126781,2,128594,4260,124334,0,117561,4595,112966,0,116732,4311,112421
62,180000,144000,0,1,1,1,1,0,0,173685,11080,162605,0,179213,10000,169213,0,182271,10000,172271,0,156029,7000,149029
63,60000,48000,0,0,0,0,0,0,0,40870,1668,39202,0,39703,1609,38094,0,38600,1506,37094,0,40230,2379,37851
64,360000,288000,0,0,0,0,0,1,-1,7508,7545,-37,-1,434,502,-68,-1,2139,2205,-66,-1,993,5,988
65,100000,80000,0,0,0,0,0,1,2,61749,2500,59249,2,65130,5000,60130,2,63816,0,63816,3,65011,2400,62611
66,100000,80000,0,1,1,0,0,0,0,102252,17023,85229,0,89009,8942,80067,0,79853,86950,-7097,-1,80970,33000,47970
67,100000,80000,0,0,0,0,0,0,2,1647,1647,0,-1,3348,3348,0,-1,1458,1458,0,-1,1458,1458,0
68,200000,160000,0,0,0,0,0,0,-1,1000,1000,0,-1,0,0,0,-1,1275,1275,0,-1,543,543,0
69,210000,168000,0,0,0,0,0,0,0,101951,15011,86940,0,96329,10000,86329,0,84224,10000,74224,0,81570,5000,76570
70,230000,184000,0,0,0,0,0,0,0,35448,0,35448,2,36551,2000,34551,0,37460,1500,35960,0,38831,2000,36831
71,520000,416000,0,0,0,0,0,0,2,37238,0,37238,2,36293,20000,16293,0,55826,40000,15826,0,34989,0,34989
72,210000,168000,0,0,0,0,0,0,-2,850,850,0,-2,2340,2340,0,-2,2380,2380,0,-2,2694,2694,0
73,500000,400000,0,0,0,0,0,1,2,0,0,0,-2,0,0,0,-2,0,0,0,-2,0,0,0
74,220000,176000,0,0,0,0,0,1,-2,416,832,-416,-2,416,416,0,-2,416,416,0,-2,416,416,0
75,400000,320000,0,0,0,0,0,0,0,0,0,0,-2,53826,53826,0,-1,55061,1642,53419,0,71541,20000,51541
76,90000,72000,0,0,0,0,0,0,0,42142,3611,38531,0,35349,199,35150,2,29790,208,29582,0,26414,0,26414
77,360000,288000,0,0,0,0,0,0,-1,740,740,0,-1,871,871,0,-1,1980,1980,0,-1,0,0,0
78,50000,40000,0,0,0,0,0,0,0,37779,1900,35879,0,28424,1500,26924,0,29133,1194,27939,0,27509,1000,26509
79,60000,48000,0,0,0,0,0,0,0,20261,3000,17261,0,22832,3000,19832,0,24234,2000,22234,0,24928,2000,22928
80,50000,40000,0,0,0,0,0,0,0,12549,2000,10549,0,16995,5000,11995,0,17490,778,16712,0,18253,1200,17053
81,200000,160000,0,0,0,0,0,0,-1,1209,2712,-1503,-1,0,0,0,-1,1440,1440,0,-1,0,0,0
82,60000,48000,0,0,0,0,0,1,0,44291,3042,41249,0,41241,1433,39808,0,29534,1012,28522,0,29297,1029,28268
83,200000,160000,0,0,0,0,0,0,-1,3308,3324,-16,-1,481,483,-2,-1,-19,0,-19,-1,3821,3840,-19
84,260000,208000,0,0,0,0,0,0,0,16986,2000,14986,0,17700,1000,16700,0,19401,2000,17401,0,21067,2000,19067
85,110000,88000,0,0,0,0,0,1,2,450,0,450,2,450,0,450,3,450,0,450,3,300,0,300
86,240000,192000,0,0,0,0,0,0,-1,68105,68116,-11,-1,95615,30800,64815,0,123931,30000,93931,0,151559,30000,121559
87,200000,160000,0,0,0,0,0,0,0,4963,1155,3808,0,5418,1000,4418,0,5131,103,5028,0,5741,1000,4741
88,120000,96000,0,0,0,0,1,0,0,96290,4371,91919,0,97913,4425,93488,0,102959,7900,95059,0,104872,4000,100872
89,500000,400000,0,0,0,0,0,0,-1,23804,113935,-90131,-1,92715,108041,-15326,-1,6655,33,6622,0,3966,3984,-18
90,100000,80000,0,0,1,1,1,1,2,83945,7400,76545,2,81702,0,81702,2,83232,3000,80232,0,84947,3100,81847
91,80000,64000,0,0,0,0,0,0,0,0,0,0,0,0,0,0,-2,0,0,0,-2,0,0,0
92,120000,96000,0,0,0,0,0,0,0,225,225,0,-1,3550,3550,0,-1,3550,0,3550,0,3550,0,3550
93,160000,128000,0,0,0,0,0,0,0,101479,101505,-26,-1,101454,3600,97854,0,102861,3700,99161,0,103921,3800,100121
94,60000,48000,0,0,0,0,0,0,-1,0,0,0,-1,785,785,0,-1,0,0,0,-1,0,0,0
95,390000,312000,0,0,0,0,0,0,-1,31192,1397,29795,0,13859,347,13512,0,10078,250,9828,0,4635,145,4490
96,90000,72000,0,1,1,1,1,0,0,83204,3200,80004,0,81645,3000,78645,0,84629,5000,79629,0,87981,5000,82981
97,120000,96000,0,1,1,1,1,0,2,112056,4100,107956,2,112819,4087,108732,2,111298,400,110898,2,113290,4000,109290
98,520000,416000,0,0,0,0,0,0,0,25689,8011,17678,0,146903,151509,-4606,-1,150656,50263,100393,0,132050,59491,72559
99,450000,360000,0,0,0,0,0,0,-1,6665,6665,0,-1,0,0,0,-1,0,0,0,-2,0,0,0
100,20000,16000,0,1,0,0,0,0,0,19413,3000,16413,0,14871,0,14871,2,15478,1000,14478,0,16068,1000,15068
101,50000,40000,0,0,0,0,0,0,0,20791,1351,19440,0,22104,1664,20440,0,22237,797,21440,0,22703,825,21878
102,180000,144000,0,0,0,0,0,0,0,68650,2500,66150,0,67895,3000,64895,0,68442,2500,65942,0,70131,3000,67131
103,60000,48000,0,0,0,0,0,0,0,29306,2000,27306,0,27800,1748,26052,0,27552,1500,26052,0,29545,2600,26945
104,200000,160000,0,0,0,0,0,0,-2,-10,0,-10,-2,4115,4125,-10,-2,1315,1315,0,-2,0,0,0
105,110000,88000,0,0,0,0,0,0,2,75794,4000,71794,0,76947,3000,73947,0,79105,3000,76105,0,72344,10000,62344
106,200000,160000,0,0,0,0,0,1,-2,0,0,0,-2,0,0,0,-2,0,0,0,-2,0,0,0
107,140000,112000,0,1,0,0,0,0,0,136377,4744,131633,0,106241,4546,101695,0,96986,3672,93314,0,94665,3602,91063
108,150000,120000,0,0,0,0,0,0,0,14648,1500,13148,0,12115,1600,10515,0,12613,1000,11613,0,15225,3000,12225
109,120000,96000,0,0,0,0,0,1,2,66450,3000,63450,2,67373,2600,64773,2,68186,2500,65686,2,68959,2000,66959
110,260000,208000,0,0,0,0,0,0,0,22099,8000,14099,0,18985,1000,17985,0,19662,1000,18662,0,22274,5000,17274
111,80000,64000,0,1,1,1,1,0,0,82116,3750,78366,0,80299,3520,76779,0,81416,3069,78347,0,81617,3271,78346
112,430000,344000,0,0,0,0,0,0,-2,2250,2250,0,-2,3004,3004,0,-2,1074,1074,0,-2,1623,1623,0
113,100000,80000,0,0,0,0,0,0,-1,1635,5635,-4000,-1,884,884,0,-1,0,0,0,-1,0,0,0
114,400000,320000,0,0,0,0,0,0,0,92336,3565,88771,0,91816,2731,89085,0,57477,10031,47446,0,66203,16027,50176
115,110000,88000,0,0,0,0,1,0,-1,2161,2161,0,-1,1719,1719,0,-1,107591,107591,0,-1,107940,5000,102940
116,610000,488000,0,0,0,0,0,0,0,3428,4017,-589,-1,6384,6434,-50,-1,65809,68290,-2481,-1,62950,2045,60905
117,50000,40000,0,0,0,0,0,0,0,20895,2000,18895,0,11241,1000,10241,0,-861,0,-861,0,38040,39500,-1460
118,170000,136000,0,0,0,0,0,0,0,46870,1900,44970,0,43584,2014,41570,0,34760,2500,32260,0,35467,2000,33467
119,190000,152000,0,0,0,0,0,0,0,5029,1300,3729,0,6494,2000,4494,0,678,678,0,-1,11928,11514,414
120,400000,320000,0,0,0,0,0,0,2,0,0,0,2,3378,3378,0,-2,0,0,0,-2,590,590,0
121,50000,40000,0,0,0,0,0,0,0,21940,1400,20540,0,20718,1200,19518,0,24048,5000,19048,0,5017,5017,0
122,320000,256000,0,0,0,0,0,0,-2,2849,2849,0,-2,1060,1060,0,-2,3667,3667,0,-2,1627,1627,0
123,290000,232000,0,1,1,1,1,0,0,267792,11800,255992,0,273208,11500,261708,0,277225,10000,267225,0,284010,11000,273010
124,50000,40000,0,0,0,0,0,0,2,30266,0,30266,2,30897,2000,28897,2,30050,0,30050,2,24651,2000,22651
125,320000,256000,0,0,0,0,0,0,-2,10798,10832,-34,-2,9198,9244,-46,-2,2314,2325,-11,-2,14497,14568,-71
126,250000,200000,0,0,0,0,0,1,2,39814,2000,37814,0,34374,1871,32503,0,34768,1265,33503,0,38830,4643,34187
127,30000,24000,0,0,1,1,1,1,2,28721,5000,23721,2,31262,3300,27962,3,30217,0,30217,5,29158,0,29158
128,20000,16000,0,0,0,0,0,1,2,8198,0,8198,2,9752,1700,8052,2,9447,0,9447,2,10290,1000,9290
129,60000,48000,0,0,0,0,0,0,0,17638,1293,16345,0,17989,644,17345,0,18383,684,17699,0,21781,3721,18060
130,380000,304000,0,0,0,0,0,0,0,63052,13052,50000,0,0,0,0,0,1184,1184,0,-1,21852,21852,0
131,20000,16000,0,0,0,0,0,0,0,16470,800,15670,2,10195,1500,8695,0,11195,1000,10195,0,11995,800,11195
132,140000,112000,0,0,0,0,0,0,0,54636,2000,52636,0,51407,2059,49348,0,12016,1019,10997,0,60890,55317,5573
133,50000,40000,0,0,0,0,0,1,2,29778,1496,28282,0,30370,1088,29282,0,31003,1123,29880,0,32291,1800,30491
134,50000,40000,0,0,0,0,0,0,0,40205,2001,38204,0,43024,3520,39504,0,39908,0,39908,2,40731,2000,38731
135,50000,40000,0,0,0,0,0,0,-1,0,0,0,-1,1261,2522,-1261,-1,1261,1261,0,-1,1261,1261,0
136,110000,88000,0,0,0,0,0,0,0,78997,3300,75697,0,71276,2000,69276,0,68385,3000,65385,0,62475,2500,59975
137,70000,56000,0,1,1,1,1,1,2,63931,6672,57259,2,64585,2300,62285,2,66207,2800,63407,2,67577,2600,64977
138,300000,240000,0,0,0,0,0,0,-1,48163,48408,-245,-1,13461,13538,-77,-1,5121,5145,-24,-1,5663,5690,-27
139,280000,224000,1,1,0,0,0,0,0,296257,8034,288223,0,232,232,0,-1,-94,94,-188,-1,143864,145935,-2071
140,200000,160000,0,0,0,0,0,1,0,34228,14031,20197,0,26418,15021,11397,0,22196,15007,7189,0,15973,14004,1969
141,50000,40000,0,0,0,0,0,0,0,19833,3302,16531,0,24014,5000,19014,0,27429,6500,20929,0,29189,10000,19189
142,50000,40000,0,0,0,0,0,0,0,15472,1258,14214,0,15778,564,15214,0,16109,585,15524,0,16427,586,15841
143,140000,112000,0,0,0,0,0,0,0,41831,7000,34831,0,45893,8000,37893,0,10186,5000,5186,0,4887,0,4887
144,90000,72000,0,0,0,0,0,0,-1,669,669,0,-1,0,0,0,-1,400,400,0,-1,182,182,0
145,250000,200000,0,0,0,0,0,1,2,125721,4500,121221,2,122209,0,122209,2,126129,5954,120175,2,127847,3900,123947
146,150000,120000,0,0,0,0,0,0,-1,1062,1062,0,-1,0,0,0,-1,1810,1810,0,-1,0,0,0
147,30000,24000,0,1,1,1,1,1,2,27640,1400,26240,2,26897,0,26897,2,27949,1500,26449,2,29645,2300,27345
148,310000,248000,0,0,0,0,0,0,0,71403,2216,69187,0,69478,1879,67599,0,53786,1563,52223,0,52791,2000,50791
149,100000,80000,0,0,0,0,0,0,2,76434,2700,73734,2,74611,0,74611,2,79292,5900,73392,2,80945,3100,77845
150,210000,168000,0,0,0,0,0,0,-1,3853,3856,-3,-1,3942,3945,-3,-1,2338,2338,0,-1,1767,1767,0
151,200000,160000,0,0,0,0,0,0,0,34114,5351,28763,0,29982,200,29782,0,-18,0,-18,0,-18,0,-18
152,380000,304000,0,0,0,0,0,0,0,16678,3000,13678,0,16650,2000,14650,0,17380,2000,15380,0,17074,2000,15074
153,10000,8000,0,0,0,0,0,1,-1,3629,4011,-382,-1,6260,6260,0,-1,5990,120,5870,0,6520,2000,4520
154,290000,232000,0,0,0,0,0,0,0,3253,1000,2253,0,766,766,0,-1,168322,168342,-20,-1,169676,7000,162676
155,200000,160000,0,0,0,0,0,0,0,76593,14593,62000,0,93988,20150,73838,0,50292,0,50292,2,10510,5739,4771
156,200000,160000,0,0,0,0,0,0,0,143982,43982,100000,0,146700,5150,141550,0,149339,6000,143339,0,162121,15027,147094
157,160000,128000,0,0,0,0,0,0,0,7169,2000,5169,0,9036,2000,7036,0,8749,0,8749,2,9447,1000,8447
158,300000,240000,0,1,0,0,0,0,0,295855,11504,284351,0,201842,8500,193342,0,201309,8000,193309,0,200695,8000,192695
159,130000,104000,0,1,1,1,1,0,0,119553,5000,114553,0,116530,4214,112316,0,113962,4500,109462,0,113972,5000,108972
160,120000,96000,0,0,0,0,0,0,0,86478,2960,83518,0,81902,3833,78069,0,78616,2855,75761,0,80307,3000,77307
161,100000,80000,0,0,1,1,1,0,0,86016,7000,79016,0,87715,4000,83715,2,85411,0,85411,2,87870,4000,83870
162,210000,168000,0,0,0,0,0,0,0,163576,7000,156576,0,115854,4000,111854,0,111606,5000,106606,0,120885,105015,15870
163,200000,160000,0,0,1,0,0,0,-1,194779,100000,94779,0,194179,0,194179,0,164444,83277,81167,0,83277,0,83277
164,200000,160000,0,0,0,0,0,0,-1,2967,2996,-29,-1,0,0,0,-1,0,0,0,-2,0,0,0
165,310000,248000,0,0,0,0,0,0,0,44127,2500,41627,0,44782,2150,42632,0,2108,1000,1108,0,1983,2000,-17
166,100000,80000,0,0,0,0,0,0,0,70814,2687,68127,0,69786,2997,66789,0,68116,2147,65969,0,62652,2369,60283
167,130000,104000,0,0,0,0,0,0,0,59064,2188,56876,0,46825,2500,44325,0,46730,1122,45608,0,47775,1500,46275
168,360000,288000,0,0,0,0,0,1,-2,0,0,0,-2,0,0,0,-2,0,0,0,-2,0,0,0
169,270000,216000,0,0,0,0,0,0,-2,15332,3119,12213,-2,9094,9124,-30,-2,225604,225616,-12,-1,7443,7443,0
170,210000,168000,0,0,0,0,0,0,-2,1835,1835,0,-2,2396,2396,0,-2,0,0,0,-2,0,0,0
171,330000,264000,0,1,1,0,0,0,0,317997,10882,307115,0,274132,9902,264230,0,267622,10000,257622,0,261246,10000,251246
172,180000,144000,0,0,0,0,0,0,0,25600,5000,20600,0,0,0,0,0,0,0,0,-2,36565,36565,0
173,390000,312000,0,0,0,0,0,0,0,212726,7500,205226,0,210556,7228,203328,0,208317,7103,201214,0,205339,7214,198125
174,180000,144000,0,0,0,0,0,1,2,15009,0,15009,2,17752,3000,14752,2,17172,0,17172,2,18732,2000,16732
175,30000,24000,0,0,0,0,0,0,0,23582,1400,22182,2,21422,1000,20422,2,18302,700,17602,2,16527,1000,15527
176,200000,160000,0,0,0,0,0,0,-2,2005,2015,-10,-2,15776,15854,-78,-2,2696,2709,-13,-2,6147,6178,-31
177,10000,8000,0,1,1,1,0,0,2,8440,0,8440,2,9229,900,8329,2,8969,0,8969,2,8819,2000,6819
178,50000,40000,0,0,0,0,0,0,0,29457,1060,28397,0,9279,212,9067,0,888,888,0,-1,19947,19709,238
179,150000,120000,0,0,0,0,0,0,-2,9447,9460,-13,-1,4887,0,4887,2,11181,6702,4479,2,6692,16,6676
180,10000,8000,0,0,0,0,0,1,0,4883,1081,3802,0,5053,251,4802,0,5275,375,4900,0,0,0,0
181,50000,40000,0,0,0,0,0,1,0,7384,2095,5289,0,13479,500,12979,0,6734,1000,5734,0,6801,500,6301
182,360000,288000,0,0,0,0,0,0,-1,6385,6401,-16,-1,991,997,-6,-1,4632,4641,-9,-1,2014,2014,0
183,260000,208000,0,0,0,0,0,0,1,-15910,0,-15910,-2,-15910,0,-15910,-2,24090,40000,-15910,-1,13977,507,13470
184,80000,64000,0,1,1,1,1,0,0,82265,3000,79265,0,81974,3500,78474,0,81253,3200,78053,0,78343,3800,74543
185,500000,400000,0,0,0,0,0,0,-1,1000,1005,-5,-1,16639,16639,0,-1,7081,142,6939,0,0,0,0
186,10000,8000,0,1,0,0,0,0,2,10047,1006,9041,0,8775,1390,7385,0,8984,1000,7984,0,7628,1000,6628
187,430000,344000,0,0,0,0,0,0,-2,2539,2539,0,-2,2250,2250,0,-2,0,0,0,-2,2580,2580,0
188,260000,208000,0,0,0,0,0,0,-1,577,577,0,-1,0,0,0,-1,200,200,0,-1,0,0,0
189,20000,16000,0,0,1,0,0,0,0,17264,2000,15264,0,18325,1500,16825,0,15680,500,15180,0,0,0,0
190,90000,72000,0,0,0,0,0,0,0,44881,2325,42556,0,43906,1510,42396,0,43767,1199,42568,0,43619,2380,41239
191,50000,40000,0,0,0,0,0,0,0,21682,21282,400,0,20833,694,20139,0,20289,1000,19289,0,19380,700,18680
192,30000,24000,0,1,1,1,1,1,0,30398,3564,26834,0,29305,0,29305,2,29408,1174,28234,0,28699,1207,27492
193,340000,272000,0,0,0,0,0,0,0,83636,3136,80500,0,85282,3014,82268,0,87070,3123,83947,0,88828,3168,85660
194,150000,120000,0,0,0,0,0,1,-2,3420,3420,0,-2,2527,2612,-85,-2,0,0,0,-2,0,0,0
195,150000,120000,0,0,0,0,0,0,3,112968,8000,104968,4,117613,8000,109613,4,122161,8000,114161,5,129616,10000,119616
196,10000,8000,0,0,0,1,0,1,0,6224,0,6224,2,6347,227,6120,0,12856,239,12617,0,8078,3412,4666
197,550000,440000,0,1,0,1,0,1,0,535509,22863,512646,0,548020,167622,380398,0,530672,14000,516672,0,155083,4300,150783
198,50000,40000,0,0,0,0,0,0,0,39851,2156,37695,0,27258,1200,26058,0,27679,1010,26669,0,28619,1400,27219
199,140000,112000,0,0,0,0,1,1,2,113177,10970,102207,2,113622,3805,109817,2,116396,4747,111649,2,115826,1932,113894
200,50000,40000,0,0,0,0,0,1,0,7692,3200,4492,0,12048,0,12048,2,3750,2000,1750,0,95,95,0
201,100000,80000,0,1,0,0,0,0,0,83616,3098,80518,0,67825,5010,62815,0,66756,3038,63718,0,57075,4031,53044
202,300000,240000,0,0,0,0,0,0,0,125120,10048,115072,0,133997,20172,113825,0,118000,11034,106966,0,131067,20109,110958
203,80000,64000,0,0,0,0,0,1,-1,1965,1800,165,0,390,0,390,0,985,985,0,-1,370,0,370
204,400000,320000,0,0,0,0,0,0,-1,9885,9939,-54,-1,65207,65243,-36,-1,59247,1239,58008,0,53752,5366,48386
205,70000,56000,0,1,1,0,0,0,0,61652,2312,59340,0,62788,2237,60551,0,57325,2038,55287,0,53415,2000,51415
206,320000,256000,0,0,0,0,0,0,0,13917,1700,12217,0,12125,243,11882,0,0,0,0,0,0,0,0
207,400000,320000,0,0,0,0,0,0,-1,98214,53704,44510,0,84142,4142,80000,0,70732,5010,65722,0,68674,66676,1998
208,340000,272000,1,1,1,1,0,1,4,572677,0,572677,4,384060,0,384060,3,304508,1000,303508,2,247178,4320,242858
209,100000,80000,0,0,0,0,0,1,2,57778,1400,56378,2,59227,3000,56227,2,58151,0,58151,2,61966,4800,57166
210,80000,64000,0,0,0,0,0,1,0,23661,1500,22161,0,24678,1412,23266,0,25766,1500,24266,0,26351,1000,25351
211,160000,128000,0,0,0,0,0,0,-2,0,0,0,-2,0,0,0,-2,0,0,0,-2,0,0,0
212,30000,24000,0,0,0,0,0,1,2,22875,0,22875,2,24155,2000,22155,0,23739,1500,22239,0,22124,900,21224
213,10000,8000,0,0,0,0,0,0,2,8019,2000,6019,2,5819,1000,4819,2,5626,0,5626,2,5621,2000,3621
214,20000,16000,0,0,1,1,1,0,0,18920,3500,15420,0,18180,0,18180,2,19000,2000,17000,0,20000,1000,19000
215,140000,112000,0,1,1,1,1,0,0,134552,7000,127552,0,135151,5000,130151,0,136327,5200,131127,0,136647,5100,131547
216,20000,16000,0,1,1,1,1,1,0,21579,1675,19904,0,22231,1327,20904,0,22301,800,21501,0,21687,783,20904
217,80000,64000,0,0,0,0,0,1,0,1473,1000,473,0,48029,48029,0,-1,47525,2000,45525,0,47181,2000,45181
218,140000,112000,0,1,0,0,0,0,2,117392,3500,113892,2,111478,3500,107978,2,109353,3600,105753,2,97612,0,97612
219,50000,40000,0,1,1,0,0,0,0,47667,3687,43980,0,48119,5000,43119,0,8257,1000,7257,0,8037,309,7728
220,50000,40000,0,0,0,0,0,1,-2,0,0,0,-2,0,0,0,-2,0,0,0,-2,0,0,0
221,180000,144000,0,0,0,0,0,0,0,12621,5000,7621,0,17987,15000,2987,0,-99,0,-99,0,-99,0,-99
222,500000,400000,0,0,0,0,0,0,0,170225,10093,160132,0,170407,20031,150376,0,196150,60030,136120,0,167748,15008,152740
223,200000,160000,0,0,0,0,0,0,0,84398,3000,81398,0,88612,3000,85612,0,86159,3338,82821,0,89751,5000,84751
224,320000,256000,0,0,0,0,0,0,0,131816,6125,125691,0,120761,4001,116760,0,120375,4013,116362,0,120897,5000,115897
225,50000,40000,0,1,1,1,1,0,0,49009,1844,47165,0,49949,2200,47749,0,50479,2000,48479,0,50702,1800,48902
226,80000,64000,1,1,1,1,1,0,0,81833,0,81833,2,79673,3000,76673,0,79735,3100,76635,0,81271,3000,78271
227,220000,176000,0,0,0,0,0,0,0,140964,5198,135766,0,105353,6006,99347,0,100750,10362,90388,0,85261,5000,80261
228,310000,248000,0,0,0,0,0,0,0,178753,6650,172103,0,166942,6000,160942,0,140659,6000,134659,0,145379,7000,138379
229,170000,136000,0,1,0,0,0,0,0,170024,4000,166024,0,32898,3000,29898,0,34869,2500,32369,0,73932,5000,68932
230,360000,288000,0,0,0,0,0,0,-1,0,0,0,-1,0,0,0,-2,0,0,0,-2,0,0,0
231,280000,224000,0,0,0,0,0,1,-1,1699,1699,0,-1,0,0,0,-1,2722,2722,0,-1,0,0,0
232,50000,40000,0,0,0,0,0,0,-1,0,0,0,-1,261,261,0,-1,28606,46506,-17900,-1,24041,2000,22041
233,180000,144000,0,0,0,0,0,0,0,92245,3343,88902,0,94082,3366,90716,0,96050,3483,92567,0,97963,3507,94456
234,150000,120000,0,0,0,0,0,0,0,64293,4123,60170,0,58024,0,58024,2,59230,1304,57926,0,54638,1338,53300
235,150000,120000,0,0,0,0,0,0,0,82191,3000,79191,0,77262,3116,74146,0,49851,2500,47351,0,6666,5000,1666
236,50000,40000,0,1,1,1,1,1,3,48602,2001,46601,2,46289,499,45790,2,44837,2000,42837,2,44535,2000,42535
237,120000,96000,0,0,0,0,0,0,-2,6826,6826,0,-2,36830,36837,-7,-2,6280,6280,0,-2,150,150,0
238,50000,40000,0,0,0,0,0,0,0,29521,1472,28049,0,29876,1217,28659,0,30201,1347,28854,0,15611,558,15053
239,360000,288000,0,0,0,0,0,0,-1,2722,2738,-16,-1,2961,2969,-8,-1,2669,2677,-8,-1,2054,2060,-6
240,260000,208000,0,0,0,0,0,0,-1,3593,3601,-8,-1,5332,5348,-16,-1,1994,2802,-808,-1,5782,5801,-19
241,310000,248000,0,0,0,0,0,0,-1,2060,2060,0,-1,2004,2018,-14,-1,2503,2505,-2,-1,814,816,-2
242,50000,40000,0,1,1,1,1,0,0,48382,1790,46592,0,49392,1800,47592,0,50608,2000,48608,0,50722,1835,48887
243,150000,120000,0,0,0,0,0,0,0,80614,13013,67601,0,110343,64442,45901,0,64419,3000,61419,0,18536,2000,16536
244,30000,24000,0,0,0,0,0,0,0,11022,1488,9534,0,12032,1498,10534,0,12134,600,11534,0,12439,500,11939
245,180000,144000,0,0,0,0,0,0,-1,17380,17552,-172,-1,8329,8333,-4,-1,20406,20406,0,-1,9772,9772,0
246,200000,160000,0,0,0,0,0,0,-1,10274,10274,0,-1,4726,4726,0,-2,4484,4490,-6,-2,4745,4745,0
247,100000,80000,0,0,0,0,0,0,0,16138,2000,14138,0,17758,2000,15758,0,18774,2000,16774,0,20272,2000,18272
248,110000,88000,0,0,0,0,0,0,2,68044,0,68044,2,34059,10452,23607,0,20284,6475,13809,0,31179,51179,-20000
249,220000,176000,0,0,0,0,0,1,-2,0,0,0,-2,0,0,0,-2,0,0,0,-2,0,0,0
250,330000,264000,0,0,0,0,0,0,0,128212,3000,125212,0,79407,5000,74407,0,8875,8875,0,-1,49880,49880,0
251,130000,104000,0,0,0,0,0,0,-1,339,339,0,-1,339,339,0,-1,339,339,0,-1,339,339,0
252,100000,80000,0,1,1,1,1,0,0,99377,3654,95723,0,101577,3900,97677,0,99453,3729,95724,0,101879,4200,97679
253,30000,24000,0,1,1,1,1,0,2,30498,2000,28498,0,29713,1500,28213,0,29819,2000,27819,0,30342,1100,29242
254,80000,64000,0,0,0,0,0,0,0,58309,2500,55809,0,59217,3000,56217,0,59955,2500,57455,0,57100,3000,54100
255,80000,64000,0,1,1,1,1,1,0,73445,5850,67595,0,74645,3000,71645,2,73330,0,73330,2,78032,6103,71929
256,350000,280000,0,0,0,0,0,0,0,108299,30000,78299,0,103487,4000,99487,0,90880,4000,86880,0,84387,5000,79387
257,190000,152000,0,0,0,0,0,0,0,61892,2000,59892,0,191260,191260,0,-1,144062,6000,138062,-1,140871,0,140871
258,420000,336000,0,0,0,0,0,0,-1,31429,23040,8389,-1,22483,63,22420,2,16437,104,16333,2,-2474,23,-2497
259,100000,80000,0,0,0,0,0,0,0,40027,2500,37527,0,37735,3000,34735,0,35437,1597,33840,0,34155,2457,31698
260,210000,168000,0,0,0,0,0,0,0,40053,2000,38053,0,41084,2000,39084,0,42416,2000,40416,0,43707,2000,41707
261,110000,88000,0,0,0,0,0,0,0,46942,2100,44842,0,47935,2000,45935,0,49083,2000,47083,0,49603,2500,47103
262,290000,232000,0,0,0,0,0,1,0,10336,2000,8336,0,15127,5000,10127,0,19685,5000,14685,0,29275,10000,19275
263,220000,176000,0,0,0,1,0,1,-2,175771,6376,169395,-2,180794,7942,172852,-2,184650,8270,176380,-2,167856,170000,-2144
264,30000,24000,0,0,0,1,1,1,0,21616,0,21616,2,26695,5800,20895,2,25970,0,25970,2,26402,1000,25402
265,70000,56000,0,1,1,1,1,0,0,66782,0,66782,2,67266,2975,64291,0,66431,2505,63926,0,67046,2590,64456
266,230000,184000,0,0,0,0,0,0,-1,5537,5537,0,-1,1247,1259,-12,-1,0,0,0,-1,1000,1000,0
267,300000,240000,0,0,0,0,0,0,0,84870,3319,81551,0,69725,2210,67515,0,54744,1095,53649,0,9234,1594,7640
268,50000,40000,0,0,0,0,0,0,0,2895,1181,1714,0,2698,300,2398,0,2500,300,2200,0,2296,300,1996
269,180000,144000,0,0,0,0,0,0,0,9065,5000,4065,0,5016,1000,4016,0,5931,1000,4931,0,6826,1000,5826
270,100000,80000,0,0,0,0,0,1,0,70125,2092,68033,0,69856,2000,67856,0,69718,2127,67591,0,51365,1960,49405
271,200000,160000,0,0,0,0,0,0,0,26043,2000,24043,0,27497,2000,25497,0,29082,2000,27082,0,31647,3000,28647
272,310000,248000,0,0,0,0,0,0,0,127390,4600,122790,0,129886,4507,125379,0,130676,4027,126649,0,127738,4025,123713
273,120000,96000,0,0,0,0,0,0,0,87941,3185,84756,0,89737,3251,86486,0,95451,7200,88251,0,97379,3600,93779
274,200000,160000,0,0,0,0,0,0,-1,3539,3539,0,-1,5529,5529,0,-1,10332,10332,0,-1,6894,6894,0
275,340000,272000,0,0,0,0,0,0,0,156674,5000,151674,0,129651,23809,105842,0,126192,4136,122056,0,94722,3600,91122
276,140000,112000,0,0,0,0,0,1,-1,7983,7983,0,-1,3277,0,3277,2,2964,2964,0,-1,4791,4800,-9
277,320000,256000,0,0,0,0,0,0,-1,2987,3002,-15,-1,-13,0,-13,-1,2670,2683,-13,-1,-4,0,-4
278,90000,72000,0,0,0,0,0,0,0,56116,2500,53616,0,48430,52285,-3855,-1,49585,2000,47585,0,50443,2100,48343
279,30000,24000,0,0,1,1,1,0,0,27439,5000,22439,0,26708,0,26708,3,26141,0,26141,2,26823,1115,25708
280,30000,24000,0,1,1,1,1,0,0,27878,2000,25878,0,29103,2000,27103,0,29426,1100,28326,0,29907,1088,28819
281,200000,160000,0,0,0,0,0,0,-1,1662,1662,0,-1,2553,2553,0,-1,1977,1977,0,-1,3175,3175,0
282,230000,184000,0,0,0,0,0,0,-1,3648,1000,2648,0,6648,3000,3648,0,7982,4000,3982,0,9203,2000,7203
283,150000,120000,0,0,0,0,0,0,-2,3177,3182,-5,-2,49174,49174,0,-2,11823,11823,0,-2,669,669,0
284,100000,80000,0,0,0,0,0,1,-1,-73,0,-73,-2,-73,0,-73,-2,-73,0,-73,-2,-73,0,-73
285,140000,112000,0,0,0,0,0,0,0,26006,2000,24006,0,26771,1500,25271,0,28179,2000,26179,0,29746,2200,27546
286,220000,176000,0,0,0,0,0,0,0,25918,2000,23918,0,27479,2000,25479,0,28877,2000,26877,0,30237,2000,28237
287,50000,40000,0,0,0,0,0,1,2,-978,0,-978,2,978,1956,-978,-1,652,0,652,0,626,626,0
288,20000,16000,0,0,0,0,0,1,0,3064,2300,764,0,1587,2100,-513,-1,-193,0,-193,-1,3107,5000,-1893
289,300000,240000,0,0,0,0,0,0,-1,10195,10217,-22,-1,34010,34039,-29,-1,20854,20854,0,-1,64741,64741,0
290,20000,16000,0,0,0,1,0,1,0,15800,0,15800,2,16341,16741,-400,-1,16675,334,16341,0,0,0,0
291,290000,232000,0,0,0,0,0,0,-1,-1001,0,-1001,-2,3999,5000,-1001,-1,0,0,0,-1,4483,4483,0
292,500000,400000,0,0,0,0,0,0,0,392278,13691,378587,0,375931,12692,363239,0,364134,11883,352251,0,354019,11922,342097
293,300000,240000,0,0,0,0,0,1,2,5000,0,5000,2,5000,0,5000,2,5000,0,5000,2,5000,0,5000
294,360000,288000,0,0,0,0,0,1,2,0,0,0,-2,0,0,0,-2,0,0,0,-2,0,0,0
295,60000,48000,0,0,0,0,0,1,0,50324,3000,47324,0,58688,12000,46688,0,30099,30000,99,0,16810,12000,4810
296,70000,56000,0,0,0,0,0,1,0,34578,6000,28578,0,33723,0,33723,2,35156,2000,33156,0,37370,2784,34586
297,20000,16000,0,0,0,0,0,0,-2,0,0,0,-2,600,600,0,-1,5275,5275,0,-1,841,841,0
298,200000,160000,0,0,0,0,0,0,-1,1024,0,1024,2,990,990,0,-1,1000,10,990,0,0,0,0
299,160000,128000,0,0,0,0,0,0,0,89231,2993,86238,0,67134,2293,64841,0,55773,1838,53935,0,46485,1687,44798
300,500000,400000,0,0,0,0,0,0,0,24801,2090,22711,0,6288,6333,-45,-1,166251,178460,-12209,-1,162785,5506,157279
301,70000,56000,0,1,1,0,0,0,0,70737,2620,68117,0,70324,2641,67683,0,55291,2000,53291,0,56648,2250,54398
302,50000,40000,0,1,0,0,0,0,0,50556,3266,47290,0,12557,600,11957,0,9959,1672,8287,0,11361,20000,-8639
303,140000,112000,0,0,0,0,0,0,0,11225,0,11225,2,6688,310,6378,0,6908,400,6508,0,6438,0,6438
304,360000,288000,0,0,0,0,0,0,0,3381,3397,-16,-1,1151,1156,-5,-1,1155,1160,-5,-1,381,382,-1
305,50000,40000,0,1,1,0,0,0,0,50076,5000,45076,0,48995,2305,46690,0,19780,3000,16780,0,15102,559,14543
306,70000,56000,0,0,0,0,0,0,0,51424,5000,46424,0,45121,5000,40121,0,5515,5000,515,0,10424,5000,5424
307,10000,8000,0,0,1,1,0,0,0,9635,2000,7635,0,17622,176,17446,0,8991,360,8631,0,0,0,0
308,300000,240000,0,0,0,0,0,1,0,5475,1475,4000,0,13581,13581,0,-1,13930,349,13581,0,14000,14070,-70
309,350000,280000,0,0,0,0,0,1,0,32597,32597,0,-1,16666,1000,15666,0,16666,16666,0,-1,32809,32809,0
310,360000,288000,0,0,0,0,0,0,-1,47416,47427,-11,-1,48811,48846,-35,-1,193712,193712,0,-1,80601,80601,0
311,80000,64000,0,0,0,0,0,0,-1,21400,21000,400,0,21000,0,21000,0,21000,0,21000,0,0,0,0
312,80000,64000,0,0,0,0,0,0,0,27297,1775,25522,0,27969,1447,26522,0,29857,2335,27522,0,28872,0,28872
313,50000,40000,0,1,1,0,0,0,0,48052,2000,46052,0,49491,2295,47196,0,28618,1000,27618,0,29217,1048,28169
314,20000,16000,0,0,1,1,0,1,2,19092,5166,13926,0,19113,2963,16150,0,19483,833,18650,0,14523,812,13711
315,360000,288000,0,0,0,0,0,1,0,276310,11100,265210,0,196654,6992,189662,0,186281,7000,179281,0,177587,6372,171215
316,80000,64000,0,0,0,0,0,0,0,26400,1500,24900,0,27201,1201,26000,0,27363,1500,25863,0,-4000,2000,-6000
317,50000,40000,0,0,0,0,0,0,-2,1684,1794,-110,-1,3697,3697,0,-1,1397,1392,5,0,0,0,0
318,200000,160000,0,0,0,0,0,0,-1,2451,2451,0,-1,3043,3043,0,-1,1542,1542,0,-1,0,0,0
319,60000,48000,0,0,0,1,1,1,2,48669,2000,46669,2,49559,2000,47559,2,50608,2000,48608,2,51426,1806,49620
320,270000,216000,0,0,0,0,0,0,-2,0,0,0,-2,0,0,0,-2,0,0,0,-2,0,0,0
321,110000,88000,0,0,0,0,0,0,0,20400,1280,19120,0,20729,600,20129,0,21465,1005,20460,0,21740,709,21031
322,50000,40000,0,1,1,1,1,0,0,50895,2000,48895,2,48598,0,48598,2,47668,2200,45468,0,45400,2000,43400
323,30000,24000,0,0,0,0,0,1,0,18394,1342,17052,0,19560,1508,18052,0,13035,500,12535,0,13836,1000,12836
324,20000,16000,0,0,0,0,0,1,2,0,0,0,2,0,0,0,-2,0,0,0,-2,0,0,0
325,300000,240000,0,0,0,0,0,0,-2,8042,8351,-309,-2,7733,7733,0,-2,7733,7733,0,-2,7733,7733,0
326,50000,40000,0,0,0,0,0,0,0,30336,1200,29136,0,13378,268,13110,0,-1022,0,-1022,0,29857,31448,-1591
327,50000,40000,0,0,0,0,0,0,1,409,2931,-2522,-1,29148,30000,-852,-1,30270,5270,25000,0,22814,2814,20000
328,70000,56000,0,0,0,0,0,0,0,8398,2000,6398,0,8864,2000,6864,0,9301,2000,7301,0,10702,3000,7702
329,50000,40000,0,0,0,0,0,0,0,9709,1700,8009,0,9404,0,9404,2,10254,1000,9254,2,9940,0,9940
330,50000,40000,0,1,1,0,0,1,0,50076,2701,47375,0,50205,2220,47985,0,19985,1000,18985,0,20650,1050,19600
331,50000,40000,0,0,0,0,0,1,2,32332,2210,30122,0,34156,2190,31966,0,33360,1000,32360,2,25988,0,25988
332,50000,40000,0,0,0,0,0,0,0,18061,2000,16061,0,18955,1500,17455,0,19933,1300,18633,0,21605,2000,19605
333,60000,48000,0,0,0,0,0,0,2,20956,24419,-3463,-1,22462,2018,20444,0,21476,15000,6476,0,23164,2000,21164
334,20000,16000,0,0,0,0,0,1,0,14599,1300,13299,0,15650,1300,14350,0,15964,574,15390,0,17204,1500,15704
335,30000,24000,0,0,0,0,0,0,0,5547,5572,-25,-1,3312,3321,-9,-1,3145,3154,-9,-1,3022,3031,-9
336,20000,16000,0,0,0,0,0,1,2,11208,4500,6708,2,8818,0,8818,2,6704,1000,5704,0,7364,2000,5364
337,160000,128000,0,0,0,0,0,1,2,1395,1399,-4,-1,898,903,-5,-1,894,896,-2,-1,2198,2204,-6
338,60000,48000,0,0,0,0,1,0,2,47557,2100,45457,0,48464,2000,46464,0,49532,2000,47532,0,50552,2000,48552
339,30000,24000,0,0,0,0,0,0,0,0,0,0,0,0,0,0,-2,0,0,0,-2,0,0,0
340,180000,144000,0,0,0,0,0,0,-2,0,0,0,-2,0,0,0,-2,500,500,0,-2,2240,2240,0
341,570000,456000,0,0,0,0,0,0,0,36283,4880,31403,0,36502,3000,33502,0,37669,3000,34669,0,39102,3000,36102
342,360000,288000,0,0,0,0,0,0,-2,0,0,0,-2,0,0,0,-2,0,0,0,-2,0,0,0
343,120000,96000,0,0,0,0,0,0,0,40795,2562,38233,0,39938,1392,38546,0,40610,1442,39168,0,39397,1415,37982
344,50000,40000,0,0,0,0,1,0,0,-1618,809,-2427,0,-809,928,-1737,-1,46976,48659,-1683,-1,47618,1400,46218
345,120000,96000,0,0,0,0,0,0,2,78109,4000,74109,0,79198,2988,76210,0,80865,3100,77765,0,82859,3500,79359
346,150000,120000,0,0,0,0,0,1,-1,5887,5887,0,-1,3935,3935,0,-1,3935,3935,0,-1,3935,3935,0
347,150000,120000,0,0,0,0,0,0,-1,0,0,0,-1,41147,41147,0,-1,-3,0,-3,-1,-3,0,-3
348,210000,168000,0,0,0,0,0,0,-1,1939,1939,0,-1,1939,1939,0,-1,1939,1939,0,-1,1520,1520,0
349,160000,128000,0,0,0,0,0,0,-1,780,780,0,-1,390,0,390,0,390,390,0,-1,540,540,0
350,130000,104000,0,0,0,0,0,0,0,97006,4559,92447,0,60608,5000,55608,0,62065,5000,57065,0,60842,0,60842
351,200000,160000,0,0,0,0,0,0,0,0,0,0,0,0,0,0,-2,0,0,0,-2,0,0,0
352,220000,176000,0,0,0,0,1,0,0,178594,15000,163594,0,174330,0,174330,2,179525,8000,171525,0,184562,8000,176562
353,80000,64000,0,0,0,0,0,0,0,59873,2200,57673,0,61077,2200,58877,0,62394,2300,60094,0,63655,2300,61355
354,360000,288000,0,0,0,0,0,0,-1,3307,3307,0,-1,0,0,0,-1,380,380,0,-1,2566,2566,0
355,200000,160000,0,0,0,0,0,0,0,133236,70538,62698,0,6574,6634,-60,-1,2924,10,2914,0,-626,0,-626
356,20000,16000,1,1,1,1,1,1,0,25183,1500,23683,0,25961,1275,24686,0,27491,1805,25686,0,40106,2000,38106
357,50000,40000,0,0,0,0,0,1,0,0,0,0,-2,0,0,0,-2,0,0,0,-2,0,0,0
358,60000,48000,0,0,0,0,0,0,0,35875,1669,34206,0,36695,1805,34890,0,36837,1263,35574,0,37307,1439,35868
359,260000,208000,0,0,0,0,0,1,-1,1198,1198,0,-1,1198,1198,0,-1,1198,1198,0,-1,1198,1198,0
360,20000,16000,0,0,0,0,0,0,0,14426,0,14426,2,16471,2600,13871,2,15909,0,15909,2,17151,1500,15651
361,110000,88000,0,0,0,0,0,0,0,33143,0,33143,2,34157,1568,32589,0,34950,1361,33589,0,36175,1900,34275
362,180000,144000,0,0,0,0,0,0,-2,0,0,0,-2,0,0,0,-2,0,0,0,-2,0,0,0
363,100000,80000,0,0,0,0,0,0,2,49899,1831,48068,0,53407,4339,49068,0,51951,0,51951,2,53195,2083,51112
364,210000,168000,0,0,0,0,0,1,-1,21776,0,21776,2,9631,9631,0,-1,1561,1561,0,-1,1990,1990,0
365,110000,88000,0,0,1,1,1,0,2,92035,4200,87835,2,93231,3600,89631,2,94309,3500,90809,2,96258,3600,92658
366,330000,264000,0,0,0,0,0,1,0,248541,8001,240540,0,231534,7000,224534,0,230309,7000,223309,0,235992,8000,227992
367,230000,184000,0,0,0,0,0,0,0,122232,6000,116232,0,82007,3400,78607,0,80811,2500,78311,0,81914,2000,79914
368,90000,72000,0,1,1,0,0,0,0,90720,3700,87020,0,82735,3534,79201,0,50185,2000,48185,0,50563,1820,48743
369,210000,168000,0,0,0,0,0,0,-2,-632,632,-1264,-2,-632,0,-632,-2,-632,0,-632,-2,-632,0,-632
370,50000,40000,0,1,0,0,0,0,0,48351,2500,45851,0,28442,1500,26942,0,29481,1500,27981,0,30232,1256,28976
371,180000,144000,0,0,0,0,0,1,-2,0,0,0,-2,0,0,0,-2,0,0,0,-2,0,0,0
372,180000,144000,0,0,0,0,0,0,-2,521,521,0,-2,0,0,0,-2,0,0,0,-2,0,0,0
373,50000,40000,0,0,0,0,0,0,-2,0,0,0,-2,0,0,0,-2,0,0,0,-2,0,0,0
374,100000,80000,0,0,0,0,0,0,0,63520,3600,59920,0,64825,3000,61825,0,65725,2500,63225,0,67183,2600,64583
375,80000,64000,0,0,0,0,0,0,-2,300,300,0,-1,0,0,0,-1,0,0,0,-2,0,0,0
376,80000,64000,0,1,0,0,0,0,0,80238,3463,76775,0,50642,1600,49042,0,50533,1770,48763,0,50758,50000,758
377,470000,376000,0,0,0,0,0,0,0,162702,7566,155136,0,69923,3000,66923,0,29271,960,28311,0,29889,1000,28889
378,30000,24000,0,1,1,1,1,1,4,29740,0,29740,3,28736,0,28736,2,28336,0,28336,0,28336,0,28336
379,50000,40000,0,1,0,0,0,0,0,49611,1462,48149,0,2190,248,1942,0,19769,20787,-1018,-1,19335,21402,-2067
380,280000,224000,0,0,0,0,0,0,-2,1572,1586,-14,-2,2437,2444,-7,-2,1572,1586,-14,-2,1572,1579,-7
381,180000,144000,0,0,0,0,0,0,-1,0,0,0,-1,0,0,0,-2,0,0,0,-2,0,0,0
382,20000,16000,0,0,0,0,0,1,-2,-738,0,-738,-2,-1518,0,-1518,-2,-1518,0,-1518,-2,-1518,0,-1518
383,50000,40000,0,0,0,0,0,0,-1,8514,8514,0,-1,5797,0,5797,2,2413,0,2413,0,33353,33353,0
384,80000,64000,0,0,0,0,0,0,0,62321,13800,48521,0,43303,3557,39746,0,40866,1620,39246,0,40573,1520,39053
385,240000,192000,0,0,0,0,0,0,-1,1696,1200,496,-1,1437,0,1437,2,2714,1479,1235,2,2202,0,2202
386,270000,216000,0,0,0,0,0,0,0,0,0,0,-2,2786,2786,0,-1,4686,4686,0,-1,3184,0,3184
387,30000,24000,0,0,0,0,0,0,0,16341,1000,15341,0,7593,1000,6593,0,7828,235,7593,0,1366,1366,0
388,20000,16000,1,1,0,0,0,0,0,20650,0,20650,2,0,0,0,2,0,0,0,-2,0,0,0
389,330000,264000,0,1,1,1,1,0,2,301265,22200,279065,2,306752,12000,294752,2,313710,12000,301710,2,309446,978,308468
390,210000,168000,0,0,0,0,0,0,-1,1002,1002,0,-1,711,711,0,-1,420,420,0,-1,1572,1572,0
391,260000,208000,0,0,0,0,0,0,0,61641,2300,59341,0,60715,2200,58515,0,57116,2060,55056,0,58318,2119,56199
392,50000,40000,0,0,0,1,1,1,2,40582,2000,38582,2,41316,1700,39616,2,41998,1662,40336,2,42674,1493,41181
393,210000,168000,0,0,0,0,0,1,2,90687,2500,88187,2,91888,3900,87988,2,93852,3400,90452,2,95734,3400,92334
394,40000,32000,0,1,1,1,1,0,0,39380,2000,37380,0,41389,2938,38451,0,40628,0,40628,2,41389,3700,37689
395,80000,64000,0,0,0,0,0,0,-1,1975,1975,0,-1,672,672,0,-1,5112,5112,0,-1,3932,3932,0
396,50000,40000,0,0,0,0,0,0,0,26809,1609,25200,0,27809,1500,26309,0,29705,2305,27400,0,26856,0,26856
397,60000,48000,0,0,0,0,0,0,0,18486,0,18486,2,19077,3000,16077,2,18487,2,18485,2,18429,1000,17429
398,500000,400000,0,0,0,0,0,0,-2,0,0,0,-2,0,0,0,-2,0,0,0,-2,706,706,0
399,180000,144000,0,1,1,1,1,0,2,163620,6000,157620,2,165604,6100,159504,2,169075,6200,162875,2,172401,6200,166201
400,120000,96000,0,0,0,0,0,0,-1,10780,10780,0,-1,0,0,0,-1,12000,12000,0,-1,0,0,0
401,200000,160000,0,0,0,0,0,1,-2,-109,0,-109,-2,-109,0,-109,-2,-109,0,-109,-2,-109,0,-109
402,280000,224000,0,0,0,0,0,0,-1,393,393,0,-1,294,294,0,-1,223,223,0,-1,13635,13635,0
403,30000,24000,0,1,1,1,0,0,2,31002,2300,28702,2,29879,0,29879,2,29382,996,28386,0,23110,1000,22110
404,500000,400000,0,0,0,0,0,0,0,95607,3027,92580,0,95276,6024,89252,0,90310,3003,87307,0,91229,2334,88895
405,30000,24000,0,0,0,0,0,0,2,6353,1500,4853,2,7092,1000,6092,2,7972,1000,6972,2,7702,0,7702
406,390000,312000,0,0,0,0,0,0,-2,0,0,0,-2,0,0,0,-2,0,0,0,-2,4792,4792,0
407,280000,224000,0,0,0,0,0,0,-1,3516,3516,0,-1,2769,0,2769,0,0,0,0,0,0,0,0
408,20000,16000,0,1,1,1,1,0,2,17922,1287,16635,0,18201,2000,16201,0,18566,648,17918,0,19284,1000,18284
409,40000,32000,0,0,0,0,0,0,-1,17940,18220,-280,-1,31308,31319,-11,-1,12009,12009,0,-1,32846,33482,-636
410,210000,168000,0,0,0,0,0,0,0,88039,5030,83009,0,83304,10008,73296,0,77605,10017,67588,0,70260,10000,60260
411,390000,312000,0,0,0,0,0,0,-1,11914,11978,-64,-1,14503,14572,-69,-1,13407,13418,-11,-1,52830,42121,10709
412,210000,168000,0,0,0,0,0,1,-1,1828,1828,0,-1,0,0,0,-1,11854,11854,0,-1,30949,30288,661
413,130000,104000,0,0,0,0,0,0,0,70638,3001,67637,0,72955,3000,69955,0,74877,2500,72377,0,76334,2200,74134
414,430000,344000,0,1,1,1,1,0,0,409626,20015,389611,0,417113,18027,399086,0,363553,14015,349538,0,357476,13010,344466
415,290000,232000,0,0,0,0,0,0,-1,11101,11101,0,-1,21101,10000,11101,0,2833,2839,-6,0,4820,4826,-6
416,50000,40000,0,0,0,0,0,0,0,5116,1205,3911,0,4425,2000,2425,0,6353,2000,4353,0,15829,10000,5829
417,20000,16000,0,0,0,0,0,1,2,15428,2700,12728,2,14883,0,14883,2,15494,850,14644,0,16086,850,15236
418,20000,16000,0,0,0,0,0,0,2,6181,0,6181,2,6778,700,6078,2,6524,0,6524,2,8408,2000,6408
419,90000,72000,0,0,0,0,0,1,-1,0,0,0,-1,0,0,0,-2,1980,1980,0,-1,170,170,0
420,20000,16000,0,0,0,0,0,1,0,8231,2717,5514,0,2717,0,2717,2,4733,4733,0,-1,1099,1099,0
421,10000,8000,0,0,0,0,0,1,2,8623,2586,6037,2,5885,0,5885,2,4417,1000,3417,0,5190,1000,4190
422,150000,120000,0,0,0,0,0,0,-1,90787,91269,-482,-1,11232,56,11176,0,0,0,0,0,0,0,0
423,230000,184000,0,0,0,0,0,0,-2,0,0,0,-2,0,0,0,-2,0,0,0,-2,0,0,0
424,290000,232000,0,0,0,0,0,0,-1,1369,1369,0,-1,15010,15010,0,-1,3280,3280,0,-1,0,0,0
425,80000,64000,0,1,1,0,0,1,0,74954,5608,69346,0,79356,8000,71356,0,48981,1205,47776,0,46848,1500,45348
426,280000,224000,0,0,0,0,0,0,-1,182251,189570,-7319,-1,173922,6084,167838,0,160553,5798,154755,0,147124,4627,142497
427,140000,112000,0,0,0,0,0,0,0,13001,13001,0,-1,5818,5841,-23,-1,13506,13506,0,-1,487,487,0
428,50000,40000,0,0,0,0,0,0,-1,22214,22232,-18,-1,4985,4985,0,-1,6551,6551,0,-1,7117,5000,2117
429,230000,184000,0,0,0,0,0,1,0,12784,700,12084,2,12584,0,12584,0,0,0,0,0,0,0,0
430,50000,40000,0,1,0,0,0,0,0,47060,2000,45060,0,19171,1000,18171,0,18624,1000,17624,0,18923,1000,17923
431,160000,128000,0,0,0,0,0,1,0,2310,1000,1310,0,0,0,0,0,0,0,0,-2,351,351,0
432,180000,144000,0,0,0,0,0,0,-1,5719,5719,0,-1,0,0,0,-1,0,0,0,-2,7632,7632,0
433,50000,40000,0,1,0,0,0,1,0,43348,1461,41887,0,10122,1155,8967,0,9626,400,9226,0,9828,351,9477
434,200000,160000,0,0,0,0,0,0,-1,2234,2244,-10,-1,3678,3678,0,-1,32405,31996,409,0,30943,1097,29846
435,200000,160000,0,0,0,0,0,0,0,24718,7013,17705,0,25213,15000,10213,0,68126,10000,58126,0,9636,10000,-364
436,330000,264000,0,0,0,0,0,0,-1,0,0,0,-1,5882,5882,0,-1,5882,0,5882,0,1013,1013,0
437,30000,24000,0,0,0,0,1,0,0,13329,0,13329,2,7275,607,6668,0,26804,20000,6804,0,29362,3000,26362
438,30000,24000,0,0,1,1,1,0,0,25254,3000,22254,0,27099,3000,24099,0,30297,5000,25297,0,28817,0,28817
439,200000,160000,0,0,0,0,0,0,-1,2257,2000,257,0,43720,42000,1720,0,43968,1700,42268,0,45182,2000,43182
440,60000,48000,0,0,0,0,0,1,0,23720,1010,22710,0,1569,1569,0,-1,5580,5580,0,-1,2211,2211,0
441,80000,64000,0,0,0,1,1,1,0,63325,0,63325,2,67711,5487,62224,0,71984,5429,66555,0,73672,3000,70672
442,30000,24000,0,1,1,0,0,1,0,30326,1400,28926,0,28004,560,27444,0,26446,3000,23446,0,6411,1765,4646
443,200000,160000,0,0,0,0,0,0,0,98951,3585,95366,0,100914,3602,97312,0,103146,3848,99298,0,104993,3669,101324
444,230000,184000,0,0,0,0,0,0,-2,0,0,0,-2,0,0,0,-2,0,0,0,-2,136,136,0
445,210000,168000,0,0,0,0,0,0,-1,330,330,0,-1,330,330,0,-1,330,330,0,-1,330,330,0
446,20000,16000,0,0,0,0,0,1,-1,750,750,0,-1,0,0,0,-1,0,0,0,-2,0,0,0
447,200000,160000,0,0,0,0,0,0,-1,1280,1000,280,0,1675,1000,675,0,97,97,0,-1,138,138,0
448,390000,312000,0,0,0,0,0,0,0,35165,10529,24636,0,44543,10000,34543,0,45631,1773,43858,0,45793,2000,43793
449,30000,24000,0,0,0,0,0,0,0,20543,5000,15543,0,18180,8180,10000,0,7200,2200,5000,0,18183,18183,0
450,340000,272000,0,0,0,0,0,0,-1,59375,3000,56375,0,60216,2600,57616,0,59842,1000,58842,0,46882,1817,45065
451,130000,104000,0,0,0,0,0,0,0,0,0,0,-2,0,0,0,-2,0,0,0,-2,0,0,0
452,30000,24000,0,1,1,1,1,0,0,30286,3600,26686,0,29993,1390,28603,2,58134,0,58134,2,28910,1000,27910
453,20000,16000,0,1,1,1,1,1,2,17418,800,16618,2,17608,770,16838,2,17187,0,17187,2,17528,776,16752
454,420000,336000,0,0,0,0,0,0,-2,4829,4866,-37,-2,12181,12241,-60,-2,7597,7635,-38,-2,17772,17858,-86
455,50000,40000,0,0,0,0,0,0,-1,360,360,0,-1,360,360,0,-1,360,360,0,-1,360,360,0
456,500000,400000,0,0,0,0,0,0,0,81334,2114,79220,0,78637,1751,76886,0,36993,5132,31861,0,22089,22197,-108
457,30000,24000,0,1,1,1,1,0,2,26577,0,26577,2,28120,2000,26120,0,29659,2000,27659,0,30394,1200,29194
458,200000,160000,0,0,0,0,0,0,-1,316,316,0,-1,2681,2681,0,-1,3486,3486,0,-1,2296,2296,0
459,30000,24000,0,1,1,1,0,0,0,30263,2500,27763,0,29418,1200,28218,0,30275,1000,29275,0,0,0,0
460,500000,400000,0,0,0,0,0,0,0,27489,1231,26258,0,27053,1154,25899,0,-9,0,-9,0,14863,14872,-9
461,160000,128000,1,1,1,1,1,0,0,175363,6395,168968,0,172417,10000,162417,0,165800,6160,159640,0,158671,5772,152899
462,180000,144000,0,0,0,0,0,1,2,131176,0,131176,2,139976,11000,128976,2,138325,700,137625,2,146136,10300,135836
463,160000,128000,0,0,0,0,0,0,-2,550,550,0,-2,550,550,0,-2,550,550,0,-2,550,550,0
464,30000,24000,0,0,0,0,0,1,0,15525,1525,14000,0,0,0,0,0,0,0,0,-2,0,0,0
465,220000,176000,0,0,0,0,0,0,0,19270,1000,18270,0,1500,1500,0,-1,5520,5520,0,-1,0,0,0
466,180000,144000,0,0,0,0,0,0,0,20650,1074,19576,0,7751,2038,5713,0,1630,819,811,-1,0,0,0
467,250000,200000,0,0,0,0,0,0,-2,1738,1751,-13,-2,6706,6739,-33,-2,2391,2403,-12,-2,11082,11137,-55
468,180000,144000,0,0,0,0,0,0,-1,1316,1316,0,-1,325,0,325,0,1657,1657,0,-1,325,325,0
469,330000,264000,0,0,0,0,0,0,0,105594,0,105594,2,105896,3593,102303,0,106491,4100,102391,0,107289,15794,91495
470,280000,224000,0,0,0,0,0,0,-1,63729,64167,-438,-1,55664,1113,54551,0,31014,32000,-986,0,28903,578,28325
471,60000,48000,0,0,0,0,0,0,-1,26766,30000,-3234,-1,-1644,0,-1644,-1,6398,20009,-13611,-1,5556,10000,-4444
472,30000,24000,0,1,1,1,1,1,0,30646,3000,27646,0,29657,3000,26657,0,30232,3000,27232,0,28415,1083,27332
473,20000,16000,0,0,1,1,1,0,0,17258,1500,15758,0,18981,2000,16981,0,19496,800,18696,0,18594,800,17794
474,230000,184000,0,0,0,0,0,0,0,10722,2000,8722,0,11543,1000,10543,0,10058,0,10058,0,20158,10100,10058
475,10000,8000,0,0,0,0,0,1,2,390,390,0,-1,0,0,0,-1,780,780,0,-1,0,0,0
476,50000,40000,0,0,0,0,0,1,-1,780,0,780,2,0,0,0,2,0,0,0,-2,0,0,0
477,170000,136000,0,0,0,0,0,0,-1,2430,2430,0,-1,2430,2430,0,-1,2430,2430,0,-1,2430,2430,0
478,210000,168000,0,1,1,0,0,0,0,190867,20000,170867,0,195323,8000,187323,0,156651,10000,146651,0,135493,4416,131077
479,80000,64000,0,0,0,0,0,0,0,31756,3000,28756,2,30946,0,30946,2,31830,1700,30130,0,0,0,0
480,150000,120000,0,0,0,0,0,1,0,75782,2700,73082,0,76333,5000,71333,0,77956,2823,75133,0,77553,2865,74688
481,180000,144000,0,0,0,0,0,1,-1,2597,2604,-7,-1,998,1001,-3,-1,847,849,-2,-1,1912,1915,-3
482,450000,360000,0,0,0,0,0,0,2,9341,9511,-170,-1,2857,20,2837,2,83527,84000,-473,-1,0,0,0
483,60000,48000,0,0,0,0,0,0,0,49735,2500,47235,0,36840,2000,34840,0,30119,3000,27119,0,32446,3000,29446
484,120000,96000,0,0,0,0,0,1,-1,0,0,0,-2,0,0,0,-2,0,0,0,-2,0,0,0
485,20000,16000,0,1,0,1,0,0,0,18679,1150,17529,0,16264,467,15797,0,17119,1000,16119,0,10550,1200,9350
486,30000,24000,0,1,1,0,0,0,0,29352,1200,28152,0,29766,614,29152,0,19933,520,19413,0,10921,335,10586
487,100000,80000,0,1,1,1,1,1,2,102698,8200,94498,2,97997,0,97997,2,103384,8000,95384,2,97266,0,97266
488,180000,144000,0,0,0,0,0,0,0,60506,4000,56506,0,58458,4000,54458,0,60770,4000,56770,0,61628,4000,57628
489,60000,48000,0,0,0,0,0,0,2,24209,3000,21209,2,23524,0,23524,2,24491,1500,22991,0,25033,1100,23933
490,230000,184000,0,0,0,0,1,0,0,159930,5600,154330,0,141834,10753,131081,0,213408,100000,113408,0,222681,12823,209858
491,30000,24000,0,0,0,0,0,0,-1,2381,2781,-400,-1,2967,3067,-100,-1,1746,35,1711,0,780,780,0
492,330000,264000,0,1,0,0,0,0,0,334826,12780,322046,0,265256,9400,255856,0,264516,20000,244516,0,264079,9610,254469
493,140000,112000,0,1,0,0,0,0,0,138303,6302,132001,0,67695,3000,64695,0,69068,2500,66568,0,70512,2555,67957
494,190000,152000,0,0,0,0,0,0,-1,4251,4251,0,-1,0,0,0,-1,0,0,0,-2,6732,6732,0
495,110000,88000,0,0,0,0,0,0,-1,1867,1867,0,-1,36986,36986,0,-1,40053,5000,35053,0,41196,3000,38196
496,210000,168000,0,0,0,0,0,0,0,25810,1800,24010,0,27071,2000,25071,0,27817,1500,26317,0,28401,1031,27370
497,200000,160000,0,0,0,0,0,0,0,130376,5000,125376,0,133207,5000,128207,0,136159,5100,131059,0,138741,5000,133741
498,50000,40000,0,0,0,0,0,0,0,21021,1654,19367,0,22067,1700,20367,0,22896,1500,21396,0,23873,1500,22373
499,100000,80000,0,0,0,0,0,1,2,5607,0,5607,2,59265,59265,0,-1,62554,4100,58454,-1,55392,2500,52892
500,230000,184000,0,0,0,0,0,1,0,5567,3000,2567,0,2622,2000,622,0,5550,3000,2550,0,7446,2000,5446
501,20000,16000,0,0,0,0,0,1,2,7638,1000,6638,4,7388,0,7388,4,6991,0,6991,3,33327,27150,6177
502,80000,64000,0,0,0,0,0,0,0,14415,3000,11415,0,16177,2000,14177,0,16582,800,15782,2,16178,0,16178
503,380000,304000,0,0,0,0,0,0,0,60615,20012,40603,0,65016,10014,55002,0,69286,10048,59238,0,67455,10022,57433
504,200000,160000,0,0,0,0,0,0,0,15421,1246,14175,0,15728,553,15175,0,16057,572,15485,0,16398,597,15801
505,50000,40000,0,1,1,1,1,0,0,46228,1684,44544,0,46755,1601,45154,0,43686,2000,41686,0,44573,2000,42573
506,220000,176000,0,0,0,0,0,0,-2,4903,4927,-24,-2,9078,9123,-45,-2,3583,3587,-4,-2,4682,4698,-16
507,110000,88000,1,1,1,1,1,0,0,121030,5780,115250,0,119267,5000,114267,0,116142,4206,111936,0,113887,5000,108887
508,50000,40000,0,0,0,0,0,1,0,5701,5701,0,-1,0,0,0,-1,0,0,0,-2,0,0,0
509,140000,112000,0,0,0,0,0,0,-2,1264,1264,0,-2,0,0,0,-2,0,0,0,-2,1980,1980,0
510,260000,208000,0,1,1,1,1,0,0,250051,11065,238986,0,247271,9500,237771,0,250327,9000,241327,0,253355,9100,244255
511,500000,400000,0,0,0,0,0,0,-2,27610,27648,-38,-2,18133,25012,-6879,-2,2506,2506,0,-2,169233,169233,0
512,600000,480000,0,0,0,0,0,1,0,237135,10561,226574,0,241033,8629,232404,0,246081,8934,237147,0,250971,8984,241987
513,230000,184000,0,0,0,0,0,0,0,183268,6200,177068,0,186989,6237,180752,0,159345,7000,152345,0,162695,6000,156695
514,150000,120000,0,0,0,0,0,0,-1,15378,8200,7178,0,6832,0,6832,0,10164,8160,2004,0,0,0,0
515,10000,8000,0,0,0,0,0,1,-2,5235,5500,-265,-1,5007,0,5007,3,4779,0,4779,2,7680,3000,4680
516,50000,40000,0,0,0,0,0,0,0,25360,1431,23929,0,27929,3000,24929,0,27184,0,27184,2,27752,1155,26597
517,20000,16000,0,0,0,0,0,0,2,10179,2400,7779,2,9394,0,9394,2,11462,2458,9004,0,11410,2228,9182
518,150000,120000,0,0,0,0,0,0,0,1366,1366,0,-1,1388,1388,0,-1,3118,3118,0,-1,1148,1148,0
519,120000,96000,0,0,0,0,0,1,-2,0,0,0,-2,0,0,0,-2,0,0,0,-2,0,0,0
520,300000,240000,0,0,0,0,0,1,-1,1485,1485,0,-1,990,0,990,0,495,0,495,0,495,495,0
521,180000,144000,0,0,0,0,0,0,2,104317,4000,100317,0,106583,4000,102583,0,108811,4000,104811,0,111160,4100,107060
522,80000,64000,0,0,0,0,0,0,0,47892,2000,45892,0,49098,2000,47098,0,50152,2000,48152,0,51812,2500,49312
523,290000,232000,0,0,0,0,0,0,0,80890,3600,77290,0,81615,3000,78615,0,75661,3000,72661,0,77012,3000,74012
524,30000,24000,0,0,0,1,0,0,0,23804,1517,22287,0,25668,2381,23287,0,24887,0,24887,2,0,0,0
525,100000,80000,0,0,0,0,0,1,-2,0,0,0,-2,0,0,0,-2,0,0,0,-2,0,0,0
526,170000,136000,0,0,0,0,0,1,0,11507,11572,-65,-1,715,3282,-2567,-1,3282,3282,0,-1,715,0,715
527,100000,80000,0,1,1,0,0,0,0,89076,3400,85676,0,91143,3700,87443,0,77655,2800,74855,0,78518,2900,75618
528,80000,64000,0,0,0,1,1,0,0,64773,2961,61812,0,68073,5000,63073,0,69538,2700,66838,2,70841,2600,68241
529,170000,136000,0,1,1,0,0,0,0,172541,10000,162541,0,159546,8009,151537,0,137410,6000,131410,0,136680,30000,106680
530,30000,24000,0,0,0,0,0,0,0,17113,2000,15113,2,4818,0,4818,2,4818,0,4818,0,0,0,0
531,230000,184000,0,0,0,0,0,1,0,157345,5449,151896,0,155335,5339,149996,0,153427,5370,148057,0,150514,4435,146079
532,150000,120000,0,0,0,0,0,0,-1,4015,4026,-11,-1,3693,3704,-11,-1,7850,7873,-23,-1,2423,2429,-6
533,500000,400000,0,0,0,0,0,0,0,189136,8000,181136,0,172674,9000,163674,0,20253,791,19462,0,29576,10000,19576
534,30000,24000,0,0,0,0,0,1,2,17032,1000,16032,2,17448,1000,16448,0,18507,1500,17007,0,19046,1000,18046
535,200000,160000,0,0,0,0,0,0,2,-2,27,-29,2,-2,88,-90,-2,-90,0,-90,-2,-90,0,-90
536,360000,288000,0,0,0,0,0,0,0,250227,6850,243377,0,123146,4129,119017,0,101486,5000,96486,0,93700,2790,90910
537,210000,168000,0,0,0,0,0,0,0,68579,3000,65579,0,70036,2600,67436,0,71706,2800,68906,0,73162,2800,70362
538,20000,16000,1,1,1,1,0,0,0,23623,1400,22223,0,19600,2500,17100,0,20100,500,19600,0,0,0,0
539,220000,176000,0,0,0,0,0,0,0,69651,2913,66738,0,68255,2435,65820,0,61183,2300,58883,0,60982,2378,58604
540,180000,144000,0,0,0,0,0,0,-1,416,416,0,-1,416,416,0,-1,416,416,0,-1,416,416,0
541,220000,176000,0,0,0,0,0,0,0,175378,6921,168457,0,178367,6858,171509,0,177657,6219,171438,0,180346,6409,173937
542,250000,200000,0,0,0,0,0,0,-2,2942,2942,0,-2,1054,1057,-3,-2,1708,1708,0,-2,3014,3014,0
543,300000,240000,0,0,0,0,0,0,-1,843,843,0,-1,0,0,0,-2,444,444,0,-2,0,0,0
544,100000,80000,0,0,0,0,0,0,-2,-4,0,-4,-2,-4,0,-4,-2,-4,0,-4,-2,-4,0,-4
545,450000,360000,0,0,0,0,0,0,0,10920,10973,-53,-1,8072,8112,-40,-1,22809,22923,-114,-1,12415,12476,-61
546,50000,40000,0,1,1,1,1,0,2,48162,2000,46162,2,48576,1523,47053,2,43700,200,43500,2,44853,2000,42853
547,320000,256000,0,0,0,0,0,0,-1,192,0,192,2,2518,2518,0,-1,255,255,0,-1,1945,1945,0
548,90000,72000,0,0,0,0,0,0,0,10953,3000,7953,0,11155,3000,8155,0,15210,5000,10210,0,19425,6000,13425
549,180000,144000,0,0,0,0,0,0,-1,100,0,100,2,300,300,0,-1,200,0,200,0,499,399,100
550,260000,208000,0,0,0,0,0,0,-1,188,188,0,-1,188,188,0,-1,194,194,0,-1,188,188,0
551,230000,184000,0,0,0,0,0,0,0,2439,3000,-561,-1,5185,6000,-815,-1,9893,5000,4893,0,11567,2000,9567
552,40000,32000,0,0,0,0,0,0,0,17431,1207,16224,0,15031,301,14730,0,10600,212,10388,0,5315,5315,0
553,30000,24000,1,1,1,1,1,0,2,32515,1634,30881,0,28499,796,27703,0,29133,865,28268,0,29988,1143,28845
554,70000,56000,0,0,0,0,0,0,0,32128,1804,30324,0,27265,1100,26165,0,27133,1005,26128,0,26234,1504,24730
555,50000,40000,0,0,0,0,0,0,2,18265,1000,17265,2,20455,2500,17955,2,19986,0,19986,2,21747,2100,19647
556,50000,40000,0,0,0,0,0,0,0,23867,1500,22367,0,25464,2000,23464,0,27348,2620,24728,0,26774,0,26774
557,200000,160000,0,0,0,0,0,0,-1,3002,3017,-15,-1,1715,1720,-5,-1,2604,2611,-7,-1,-1,0,-1
558,340000,272000,0,0,0,0,0,0,-2,-20,0,-20,-2,4016,4036,-20,-2,6209,6254,-45,-2,2081,2091,-10
559,50000,40000,0,0,0,0,0,1,2,25473,1200,24273,2,25857,1100,24757,2,26298,1000,25298,2,25725,0,25725
560,140000,112000,0,1,0,0,0,0,0,124689,5000,119689,0,105447,5000,100447,0,106704,5000,101704,0,97725,5000,92725
561,320000,256000,0,1,1,1,1,0,0,314201,12868,301333,0,319204,11721,307483,0,325758,12000,313758,0,319898,13000,306898
562,30000,24000,0,0,0,0,0,0,0,25591,2041,23550,0,16337,2001,14336,0,19690,4004,15686,0,19986,2006,17980
563,80000,64000,0,0,0,0,0,0,0,32883,1397,31486,0,29425,5000,24425,0,30117,1300,28817,0,30492,1400,29092
564,160000,128000,0,0,0,0,0,0,0,21323,1533,19790,0,18933,1000,17933,0,12763,255,12508,0,0,0,0
565,160000,128000,0,0,0,0,0,1,-1,380,380,0,-1,776,776,0,-1,1172,1172,0,-1,380,380,0
566,100000,80000,0,1,1,1,1,1,0,101421,4000,97421,0,101111,3602,97509,0,101384,3719,97665,0,101358,3700,97658
567,80000,64000,0,0,0,0,0,1,2,7311,1266,6045,0,7303,258,7045,0,7456,267,7189,0,7605,269,7336
568,150000,120000,0,1,0,0,0,0,0,139520,5500,134020,0,99814,4500,95314,0,100810,3500,97310,0,103233,4000,99233
569,240000,192000,0,0,0,0,0,0,2,150022,7000,143022,0,151787,5000,146787,0,154922,5000,149922,0,159113,6000,153113
570,400000,320000,0,0,0,0,0,1,-2,4991,5002,-11,-2,466,504,-38,-2,-1381,499,-1880,-2,3122,5056,-1934
571,80000,64000,0,0,0,0,0,0,0,61969,4000,57969,0,40457,3000,37457,0,42875,3000,39875,0,44724,4000,40724
572,320000,256000,0,0,0,0,0,0,0,28695,5018,23677,0,19370,1000,18370,0,10155,3000,7155,0,3788,0,3788
573,360000,288000,0,0,0,0,0,0,0,1004,1004,0,-1,1004,1004,0,-1,646,646,0,-1,3508,3508,0
574,20000,16000,0,0,0,0,0,1,2,14127,4211,9916,2,14598,1000,13598,2,14069,0,14069,2,14690,1000,13690
575,170000,136000,0,0,0,0,0,0,0,7360,1000,6360,0,2437,2437,0,0,2881,3103,-222,-2,2659,2659,0
576,360000,288000,0,0,0,0,0,0,-2,196,196,0,-1,2855,2855,0,-1,0,0,0,-1,463,463,0
577,210000,168000,0,0,0,0,0,0,-2,0,0,0,-2,0,0,0,-2,0,0,0,-2,0,0,0
578,80000,64000,0,0,0,0,0,1,2,21660,0,21660,2,22055,1000,21055,0,22603,1000,21603,0,23133,1000,22133
579,200000,160000,0,0,0,0,0,0,-1,-3,0,-3,-1,-3,0,-3,-2,-3,0,-3,-2,-3,0,-3
580,90000,72000,0,0,0,0,0,0,0,17316,1500,15816,0,18026,1000,17026,0,18559,824,17735,0,19097,1000,18097
581,30000,24000,0,0,0,0,0,0,0,6290,1108,5182,0,4440,1000,3440,0,4531,91,4440,0,1300,26,1274
582,500000,400000,0,0,0,0,0,0,-1,27243,27398,-155,-1,2487,3104,-617,-1,6269,6300,-31,-1,10744,10797,-53
583,10000,8000,0,0,0,0,0,1,2,2400,0,2400,7,2400,0,2400,7,2400,0,2400,7,2400,0,2400
584,200000,160000,0,0,0,0,0,0,-1,29705,29705,0,-1,25854,25854,0,-1,510,510,0,-1,1470,1470,0
585,260000,208000,0,0,0,0,0,0,-1,352,400,-48,-1,364,400,-36,-1,376,400,-24,-1,388,400,-12
586,130000,104000,0,1,0,0,0,1,2,135259,18259,117000,0,95956,3456,92500,0,97770,3770,94000,0,92206,3706,88500
587,30000,24000,0,0,1,1,1,1,2,26346,3401,22945,2,26920,1300,25620,2,26194,0,26194,2,27854,2400,25454
588,150000,120000,0,0,0,0,0,1,0,55705,0,55705,2,57210,2100,55110,2,57084,222,56862,2,13194,1000,12194
589,150000,120000,0,0,0,0,0,1,-1,44476,44476,0,-1,18547,18547,0,-1,32581,17000,15581,0,95780,95780,0
590,100000,80000,0,1,1,0,0,0,0,100415,3232,97183,0,102666,3275,99391,0,63913,2290,61623,0,65246,2365,62881
591,150000,120000,0,0,0,0,0,0,0,28119,1867,26252,0,100540,92920,7620,0,88865,3578,85287,0,88526,3000,85526
592,50000,40000,0,0,0,0,0,0,0,24059,1500,22559,0,24658,1000,23658,0,25212,1100,24112,0,25642,1000,24642
593,360000,288000,0,0,0,0,0,0,-2,0,0,0,-2,0,0,0,-2,0,0,0,-2,0,0,0
594,130000,104000,0,0,0,0,0,0,-1,722,729,-7,-1,4399,4399,0,-1,0,0,0,-1,0,0,0
595,220000,176000,0,0,0,0,0,0,0,160032,5759,154273,0,162303,5938,156365,0,164700,6200,158500,0,166756,6009,160747
596,190000,152000,0,0,0,0,0,0,-1,8032,8034,-2,-1,30,0,30,-1,240,600,-360,-1,540,690,-150
597,170000,136000,0,0,0,0,0,1,-1,100,100,0,-1,1608,1608,0,-1,1800,1800,0,-1,897,897,0
598,120000,96000,0,0,0,0,0,0,-1,-7809,380,-8189,-1,120680,131062,-10382,-1,63530,2000,61530,0,63552,3000,60552
599,210000,168000,0,0,0,0,0,0,0,82549,4600,77949,0,89170,9086,80084,0,56683,0,56683,2,10496,1000,9496
600,360000,288000,0,0,0,0,0,1,2,2500,0,2500,2,2500,0,2500,2,0,0,0,2,0,0,0
601,310000,248000,0,0,0,0,0,0,-2,-7,0,-7,-2,-7,0,-7,-2,1440,1447,-7,-2,3079,3094,-15
602,230000,184000,0,0,0,0,0,0,-1,7234,7247,-13,-1,824,828,-4,-1,4690,4713,-23,-2,1408,1415,-7
603,130000,104000,0,0,0,0,0,0,2,47113,0,47113,2,48218,1700,46518,0,49408,1800,47608,0,50648,2000,48648
604,320000,256000,0,0,0,0,0,1,-2,0,0,0,-2,0,0,0,-2,700,700,0,-2,860,860,0
605,50000,40000,0,0,0,0,0,0,0,13368,1500,11868,0,14142,1000,13142,0,14911,1000,13911,0,15660,1000,14660
606,50000,40000,0,1,1,1,1,1,0,51125,5300,45825,0,50497,2000,48497,0,50544,2000,48544,0,50555,2000,48555
607,80000,64000,0,0,0,0,0,0,-1,22120,3200,18920,0,21365,1200,20165,0,20967,1000,19967,0,48250,29000,19250
608,160000,128000,0,0,0,0,0,0,0,17243,2000,15243,0,18478,2000,16478,0,3541,300,3241,0,6459,6459,0
609,50000,40000,0,1,1,0,0,0,0,47626,1606,46020,0,45227,1198,44029,0,29436,1196,28240,0,10363,343,10020
610,100000,80000,0,0,0,0,0,1,-2,0,0,0,-2,0,0,0,-2,0,0,0,-2,0,0,0
611,200000,160000,0,0,0,0,1,0,0,157776,5769,152007,0,160520,5411,155109,0,163878,5603,158275,0,167872,6367,161505
612,90000,72000,0,0,0,0,0,0,0,371,11336,-10965,0,385,1501,-1116,-2,13273,13278,-5,-1,20971,10022,10949
613,330000,264000,0,0,0,0,0,0,0,78274,4000,74274,0,80102,8000,72102,0,60729,10000,50729,0,56411,15000,41411
614,190000,152000,0,0,0,0,0,1,0,119290,5000,114290,0,99767,3815,95952,0,101761,3614,98147,0,105150,5000,100150
615,60000,48000,0,1,0,0,0,0,0,59295,3057,56238,0,19212,700,18512,0,19232,700,18532,0,19218,682,18536
616,140000,112000,0,0,0,0,0,0,0,8717,1500,7217,0,9046,1000,8046,0,9369,1000,8369,0,10165,1500,8665
617,300000,240000,0,0,0,0,0,1,2,2500,0,2500,2,0,0,0,2,0,0,0,-2,0,0,0
618,550000,440000,0,0,0,0,0,0,-2,256321,6016,250305,-2,19753,19753,0,-2,464,464,0,-2,8199,8199,0
619,50000,40000,1,1,1,1,1,0,0,58108,2200,55908,0,55774,2000,53774,0,53589,1967,51622,0,51345,2002,49343
620,230000,184000,0,0,0,0,0,1,-2,0,0,0,-2,0,0,0,-2,0,0,0,-2,0,0,0
621,50000,40000,0,0,0,0,0,0,-2,0,0,0,-2,0,0,0,-2,0,0,0,-2,0,0,0
622,200000,160000,0,0,0,0,0,0,-1,8627,9003,-376,-1,1530,1530,0,-1,-200,0,-200,-1,-200,0,-200
623,50000,40000,0,0,0,0,0,1,2,20544,2101,18443,2,17210,0,17210,2,15754,2201,13553,0,10860,1000,9860
624,150000,120000,0,0,0,0,0,0,0,14101,4000,10101,0,17523,4000,13523,0,18914,2000,16914,0,28516,10000,18516
625,100000,80000,0,0,0,0,0,0,0,54883,2088,52795,0,55383,1511,53872,0,36095,1124,34971,0,31322,1053,30269
626,300000,240000,0,0,0,0,0,0,-1,111665,3000,108665,0,14325,14325,0,-1,11416,0,11416,0,10523,0,10523
627,50000,40000,0,0,0,0,0,0,0,13063,2000,11063,0,25224,2000,23224,0,14197,2000,12197,0,13872,2000,11872
628,260000,208000,0,0,0,0,0,0,0,175869,7000,168869,0,180891,8000,172891,0,184952,7032,177920,0,182328,13603,168725
629,360000,288000,0,0,0,0,0,0,-1,14190,8500,5690,0,16328,4000,12328,0,17383,1700,15683,0,17194,371,16823
630,160000,128000,0,0,0,0,0,0,0,40537,1972,38565,0,41030,1465,39565,0,41891,1519,40372,0,43196,2000,41196
631,130000,104000,0,0,0,0,0,0,0,84822,3107,81715,0,85970,5003,80967,0,86644,3203,83441,0,87576,3456,84120
632,120000,96000,0,0,0,0,0,1,0,47023,5000,42023,0,53576,8000,45576,0,57529,5000,52529,0,61392,5000,56392
633,110000,88000,0,0,0,0,0,0,-2,0,0,0,-2,3007,3007,0,-1,857,857,0,-1,55973,100000,-44027
634,140000,112000,0,0,0,0,0,1,0,53578,3500,50078,0,49288,2000,47288,0,43870,2500,41370,0,44854,1800,43054
635,50000,40000,0,0,0,0,0,0,0,36114,2000,34114,0,23706,3005,20701,0,20166,700,19466,0,19930,1000,18930
636,270000,216000,0,0,0,0,0,0,-1,3564,3568,-4,-1,1280,1280,0,-1,1898,1898,0,-1,0,0,0
637,30000,24000,0,0,0,0,0,0,-2,0,0,0,-2,0,0,0,-2,0,0,0,-2,0,0,0
638,400000,320000,0,0,0,0,0,1,0,222085,120018,102067,0,223350,10071,213279,0,213831,8037,205794,0,210563,8018,202545
639,500000,400000,0,0,0,0,0,0,0,212134,50000,162134,0,201014,10012,191002,0,222520,50000,172520,0,208271,10000,198271
640,320000,256000,0,0,0,0,0,0,0,16784,3394,13390,0,9558,2100,7458,0,11022,1580,9442,0,11953,1016,10937
641,330000,264000,0,0,0,0,0,0,-1,2368,2368,0,-1,3368,1000,2368,0,1377,190,1187,0,0,0,0
642,50000,40000,0,0,0,0,0,0,0,26566,6207,20359,0,9866,1465,8401,0,5386,2200,3186,0,5651,1000,4651
643,260000,208000,0,0,0,0,0,0,-2,2000,2020,-20,-1,0,0,0,-1,0,0,0,-2,0,0,0
644,330000,264000,0,0,0,0,0,1,-2,0,0,0,-2,0,0,0,-2,0,0,0,-2,0,0,0
645,170000,136000,0,0,0,0,0,0,0,23602,1500,22102,0,16633,1007,15626,0,0,0,0,0,51269,51269,0
646,50000,40000,0,1,0,0,0,0,0,47995,2027,45968,0,40226,2204,38022,0,27828,996,26832,0,28411,1031,27380
647,30000,24000,0,0,0,0,0,0,2,5509,0,5509,2,6260,1000,5260,0,7654,1500,6154,0,8522,1000,7522
648,200000,160000,0,0,0,0,0,0,0,21543,2000,19543,0,22765,1500,21265,0,23374,1200,22174,0,24134,1200,22934
649,180000,144000,0,0,0,0,0,1,-2,0,0,0,-2,0,0,0,-2,0,0,0,-2,0,0,0
650,230000,184000,0,0,0,0,0,0,0,150,150,0,-1,150,0,150,2,921,921,0,-1,771,0,771
651,20000,16000,0,0,0,1,1,0,0,16350,2000,14350,0,17322,2000,15322,0,18319,2000,16319,0,19297,2000,17297
652,210000,168000,0,0,0,0,0,0,-2,4160,4160,0,-2,2540,2540,0,-2,1055,1055,0,-2,0,0,0
653,360000,288000,0,0,0,0,0,0,-2,0,0,0,-2,0,0,0,-2,0,0,0,-2,0,0,0
654,150000,120000,0,0,0,0,0,0,-2,0,0,0,-2,900,900,0,-1,0,0,0,-1,583,583,0
655,70000,56000,0,0,0,0,0,1,2,51060,0,51060,2,54200,4600,49600,2,52734,0,52734,2,55903,4200,51703
656,150000,120000,0,0,0,0,0,0,-1,819,0,819,2,2145,2145,0,-1,17000,17000,0,-1,23698,23698,0
657,50000,40000,0,0,0,0,0,0,-1,2946,4419,-1473,-1,1473,0,1473,0,1473,1473,0,-1,1473,1473,0
658,110000,88000,0,0,0,0,0,0,0,30454,2500,27954,0,33100,3000,30100,0,34727,2000,32727,0,36823,2500,34323
659,310000,248000,0,0,0,0,0,0,0,34608,1562,33046,0,21262,1118,20144,0,11944,1139,10805,0,-2571,2195,-4766
660,170000,136000,0,0,0,0,0,1,0,136552,19078,117474,0,132655,0,132655,2,134140,5000,129140,0,115892,5000,110892
661,140000,112000,0,1,1,1,1,0,0,134472,4800,129672,0,130129,4659,125470,0,133031,5000,128031,0,136919,6100,130819
662,50000,40000,0,0,0,0,0,1,0,28928,2000,26928,0,29475,1300,28175,0,29579,1200,28379,0,30445,1500,28945
663,180000,144000,0,0,0,0,0,0,-2,0,0,0,-2,0,0,0,-2,0,0,0,-2,0,0,0
664,10000,8000,0,1,1,1,1,1,0,9479,1136,8343,0,9669,326,9343,0,9978,444,9534,0,9928,199,9729
665,20000,16000,0,0,0,0,0,1,0,0,0,0,-2,0,0,0,-2,0,0,0,-2,0,0,0
666,240000,192000,0,1,0,0,1,0,0,232686,7400,225286,0,195509,6500,189009,0,198861,7000,191861,0,202057,7000,195057
667,280000,224000,0,0,0,0,0,0,-1,-21,0,-21,-1,-21,0,-21,-2,15237,15258,-21,-1,7345,36,7309
668,70000,56000,0,0,0,0,0,0,0,17349,2000,15349,0,14654,4000,10654,0,23808,10000,13808,0,24852,2000,22852
669,210000,168000,0,0,0,0,0,0,-2,0,0,0,-2,0,0,0,-2,0,0,0,-2,0,0,0
670,130000,104000,0,0,0,0,0,0,-1,5000,5000,0,-1,1500,1500,0,-1,0,0,0,-1,390,390,0
671,90000,72000,0,0,0,0,0,1,2,66605,3324,63281,0,63795,5380,58415,0,61061,0,61061,2,54646,2000,52646
672,180000,144000,0,0,0,0,0,0,0,124730,5966,118764,0,120423,4250,116173,0,113901,4200,109701,0,114077,4200,109877
673,480000,384000,0,0,0,0,0,0,0,56776,1708,55068,0,37484,1292,36192,0,37906,1010,36896,0,18387,772,17615
674,20000,16000,0,1,1,1,0,1,0,19411,1500,17911,0,20209,1257,18952,0,19880,456,19424,0,4341,149,4192
675,320000,256000,0,0,0,0,0,0,0,913,1116,-203,-1,5356,5384,-28,-1,58545,58837,-292,-1,7357,7393,-36
676,180000,144000,0,0,0,0,0,0,0,132054,35206,96848,0,115551,40600,74951,0,109539,5000,104539,0,108837,10000,98837
677,50000,40000,0,0,0,0,0,0,-1,6561,6561,0,-1,5091,102,4989,0,353,353,0,-1,26864,27000,-136
678,50000,40000,0,0,0,0,0,0,2,33489,3041,30448,2,18968,0,18968,3,15611,3,15608,2,19304,5700,13604
679,160000,128000,0,1,0,0,0,0,0,137027,5000,132027,0,70845,1417,69428,0,0,0,0,0,0,0,0
680,200000,160000,0,0,0,0,0,0,-2,0,0,0,-2,0,0,0,-2,0,0,0,-2,2206,2206,0
681,20000,16000,0,0,0,0,0,0,0,14340,1600,12740,0,15301,1500,13801,0,14916,0,14916,2,15515,1000,14515
682,150000,120000,0,0,0,0,0,0,2,1402,0,1402,2,3244,3244,0,-1,-13,0,-13,-1,-13,0,-13
683,80000,64000,0,0,0,0,0,1,0,58715,1389,57326,0,39389,889,38500,0,12012,900,11112,0,2900,58,2842
684,30000,24000,0,0,0,0,0,0,0,11581,2000,9581,0,12580,1500,11080,0,13716,1500,12216,0,14828,1500,13328
685,100000,80000,1,1,1,0,0,0,0,105282,5088,100194,0,83616,3098,80518,0,67825,5010,62815,0,66756,3038,63718
686,460000,368000,0,0,0,0,0,1,2,268463,9737,258726,0,273066,9060,264006,0,278594,9200,269394,0,284423,9480,274943
687,50000,40000,0,1,1,1,1,0,0,47360,2500,44860,0,48296,2000,46296,0,47790,2000,45790,0,49045,2069,46976
688,140000,112000,0,0,0,0,0,1,-1,978,0,978,2,652,0,652,0,326,0,326,0,1052,1052,0
689,250000,200000,0,0,0,0,0,1,-1,2617,2617,0,-1,1817,0,1817,0,975,0,975,0,1141,1141,0
690,50000,40000,0,1,1,1,1,0,0,46920,2100,44820,0,47864,2000,45864,0,50856,3900,46956,0,48390,0,48390
691,20000,16000,0,1,1,1,1,0,3,19376,0,19376,2,20295,1400,18895,0,19505,390,19115,0,19964,459,19505
692,200000,160000,0,0,0,0,0,1,-2,1111,3000,-1889,-1,1111,0,1111,0,-29,0,-29,0,-3789,0,-3789
693,30000,24000,0,0,0,0,0,0,3,10903,1149,9754,2,10533,101,10432,2,10132,348,9784,0,10343,359,9984
694,200000,160000,0,0,0,0,0,0,0,87537,3683,83854,0,67974,2947,65027,0,35003,1253,33750,0,35736,1297,34439
695,260000,208000,0,0,0,0,0,0,0,63074,7100,55974,0,262317,200140,62177,0,201344,6500,194844,0,191829,6000,185829
696,20000,16000,0,0,0,0,0,1,2,1650,0,1650,2,1650,0,1650,4,1650,0,1650,4,1650,0,1650
697,500000,400000,0,0,0,0,0,1,-1,30592,30594,-2,-1,154167,150843,3324,-1,13410,163881,-150471,-1,25426,25426,0
698,110000,88000,0,0,0,0,0,0,0,27012,2000,25012,0,27762,1500,26262,0,32126,5000,27126,0,37779,6400,31379
699,80000,64000,0,0,0,0,0,0,0,33185,3199,29986,0,28600,914,27686,0,29101,850,28251,0,28939,2055,26884
700,230000,184000,0,0,0,0,0,1,2,13135,1064,12071,0,10596,423,10173,0,9218,313,8905,0,5068,1000,4068
701,360000,288000,0,0,0,0,0,1,-1,5043,5043,0,-1,333,333,0,-1,0,0,0,-1,333,333,0
702,220000,176000,0,0,0,0,0,0,-2,0,0,0,-2,0,0,0,-2,5889,5889,0,-1,300,300,0
703,160000,128000,0,1,1,1,1,0,0,165587,7600,157987,0,161950,6100,155850,0,161680,5900,155780,0,164031,6300,157731
704,180000,144000,0,0,0,0,0,0,-1,2599,2800,-201,-1,0,0,0,-1,2311,2311,0,-1,2194,2542,-348
705,240000,192000,0,0,0,0,0,0,-1,28395,28473,-78,-1,24582,12069,12513,0,10715,21,10694,0,9346,2978,6368
706,130000,104000,0,0,0,0,0,0,-1,1261,1261,0,-1,1411,1411,0,-1,930,930,0,-1,390,0,390
707,170000,136000,0,0,0,0,0,0,0,14549,2000,12549,0,10849,1000,9849,0,12509,2000,10509,0,64218,52292,11926
708,50000,40000,0,0,0,0,0,0,0,41493,1614,39879,0,19129,700,18429,0,20561,1745,18816,0,20083,0,20083
709,150000,120000,0,0,0,0,0,0,0,62844,2803,60041,0,61785,2019,59766,0,61136,2060,59076,0,57287,2098,55189
710,30000,24000,0,0,0,0,0,1,2,4845,3048,1797,2,3048,0,3048,2,8314,8314,0,-1,5080,0,5080
711,140000,112000,0,1,1,0,0,1,0,120847,4505,116342,0,121040,4100,116940,0,107310,3800,103510,0,105958,4000,101958
712,150000,120000,0,0,0,0,1,1,2,116491,4225,112266,0,118839,4282,114557,0,126102,9207,116895,0,123914,0,123914
713,200000,160000,0,0,0,0,0,0,0,106808,13590,93218,0,115702,12356,103346,0,122236,12500,109736,0,134013,14013,120000
714,80000,64000,0,0,0,0,0,0,-2,0,0,0,-2,0,0,0,-2,0,0,0,-2,0,0,0
715,50000,40000,0,0,0,0,0,0,0,12946,8000,4946,0,20650,8000,12650,0,20650,20650,0,-1,2529,2529,0
716,50000,40000,0,0,0,0,0,0,-1,-721,710,-1431,-1,-710,268,-978,-1,29114,45171,-16057,-1,27154,1036,26118
717,80000,64000,0,0,0,0,0,0,0,27006,1550,25456,0,23705,1244,22461,0,18275,751,17524,0,18104,612,17492
718,140000,112000,0,0,0,0,0,1,0,69529,3021,66508,0,70804,5012,65792,0,70781,5112,65669,0,66735,3000,63735
719,240000,192000,0,0,0,0,0,0,-1,858,3,855,2,1048,1054,-6,-1,2695,2695,0,-1,0,0,0
720,200000,160000,0,0,0,0,0,0,2,148438,6700,141738,0,143121,5500,137621,0,141466,6000,135466,0,128846,9800,119046
721,30000,24000,0,0,0,0,0,0,0,9436,1313,8123,0,10123,1000,9123,0,10335,375,9960,0,10691,528,10163
722,20000,16000,0,0,0,0,0,0,-2,0,0,0,-2,0,0,0,-2,0,0,0,-2,0,0,0
723,170000,136000,0,0,0,0,0,1,2,17711,1500,16211,2,17131,0,17131,2,18197,1500,16697,2,18748,1000,17748
724,260000,208000,0,0,0,0,0,0,0,24119,24145,-26,-1,16887,16900,-13,-1,149104,150241,-1137,-1,127342,5285,122057
725,270000,216000,0,0,0,0,0,0,0,13533,1533,12000,0,14391,1391,13000,0,15255,1255,14000,0,16273,1273,15000
726,260000,208000,0,0,0,0,0,0,-1,526,526,0,-1,452,452,0,-2,397,397,0,-2,485,485,0
727,220000,176000,0,0,0,0,0,0,0,14856,14469,387,0,35705,35278,427,0,25649,4647,21002,0,5018,19,4999
728,70000,56000,0,1,0,0,0,0,0,62750,2231,60519,0,53600,1800,51800,0,45215,1700,43515,0,46486,2000,44486
729,50000,40000,0,0,0,0,0,0,0,31071,1400,29671,0,30258,1500,28758,0,29579,1200,28379,0,28396,1500,26896
730,20000,16000,0,1,1,1,1,0,0,19413,2401,17012,0,19704,900,18804,0,19563,709,18854,0,20391,1548,18843
731,200000,160000,0,0,0,0,0,0,-1,0,0,0,-1,0,0,0,-2,0,0,0,-2,0,0,0
732,80000,64000,0,0,0,0,0,1,2,47595,2000,45595,2,48312,1800,46512,2,49392,2000,47392,2,50426,2000,48426
733,200000,160000,0,0,0,0,0,0,-2,1312,1325,-13,-2,0,0,0,-2,0,0,0,-2,0,0,0
734,80000,64000,0,0,0,0,0,0,0,25181,2150,23031,0,5187,1000,4187,0,5524,2500,3024,0,5529,1000,4529
735,230000,184000,0,0,0,0,0,0,-1,0,0,0,-1,0,0,0,-2,0,0,0,-2,0,0,0
736,180000,144000,0,0,0,0,0,0,2,22627,1500,21127,0,23306,1000,22306,0,22780,1000,21780,0,20890,1000,19890
737,410000,328000,0,0,0,0,0,0,0,25865,15014,10851,0,21619,5034,16585,0,19336,10006,9330,0,1433,1433,0
738,70000,56000,0,1,1,1,0,1,0,63806,3500,60306,0,126005,2154,123851,0,66451,7800,58651,0,20200,555,19645
739,280000,224000,0,0,0,0,0,0,-1,920,390,530,2,390,390,0,2,7531,7531,0,-1,1240,1240,0
740,260000,208000,0,0,0,0,0,1,-2,4052,4052,0,-2,977,977,0,-2,977,977,0,-2,452,452,0
741,80000,64000,0,0,0,0,0,0,-1,1260,352,908,2,0,0,0,2,0,0,0,-2,16640,16640,0
742,280000,224000,0,0,0,0,0,0,2,1179,1179,0,-1,1714,1714,0,-1,2875,1290,1585,0,1047,1047,0
743,250000,200000,0,0,0,0,0,1,-1,7014,7014,0,-1,1581,1581,0,-1,36022,36022,0,-1,34011,10000,24011
744,430000,344000,0,0,0,0,0,0,-1,33490,35000,-1510,-1,30636,30636,0,-1,30240,30241,-1,-1,0,0,0
745,180000,144000,0,0,0,0,0,0,0,133758,3521,130237,0,80055,5000,75055,0,69672,5000,64672,0,33194,5004,28190
746,120000,96000,0,1,1,1,1,1,0,121408,9496,111912,0,119070,4252,114818,0,121696,4535,117161,0,119138,4304,114834
747,210000,168000,0,0,0,0,0,0,0,139089,6507,132582,0,140488,5200,135288,0,143649,5500,138149,0,146834,5500,141334
748,140000,112000,0,0,0,0,1,0,2,114448,3500,110948,2,114653,4500,110153,2,115720,4000,111720,2,116690,4000,112690
749,580000,464000,0,0,0,0,0,0,-2,1758,1758,0,-1,2886,2014,872,0,3733,3793,-60,-1,3040,7,3033
750,90000,72000,0,0,0,0,0,0,0,64528,2300,62228,0,65815,2281,63534,0,67350,2519,64831,0,68605,2451,66154
751,160000,128000,0,0,0,0,0,0,-1,3342,1000,2342,0,171,171,0,-1,1770,1770,0,-1,837,837,0
752,200000,160000,0,0,0,0,0,0,0,154234,7048,147186,0,143953,5016,138937,0,147834,10294,137540,0,147373,5136,142237
753,90000,72000,0,1,1,1,1,0,0,87187,4000,83187,0,86669,3200,83469,0,90391,6700,83691,0,87207,0,87207
754,20000,16000,0,1,0,0,1,0,4,16253,0,16253,3,15695,0,15695,2,16832,1400,15432,2,16420,0,16420
755,150000,120000,0,0,0,0,0,0,0,32220,1300,30920,0,33247,1300,31947,0,34164,1200,32964,0,34878,1200,33678
756,50000,40000,0,0,0,0,0,0,-2,0,0,0,-2,24415,24415,0,-1,25305,1295,24010,0,25775,1275,24500
757,50000,40000,0,0,0,0,0,0,-1,33604,1599,32005,0,25303,1200,24103,0,17841,0,17841,0,6980,0,6980
758,20000,16000,0,0,1,1,1,1,0,17452,1577,15875,2,16879,0,16879,2,17059,757,16302,0,17263,628,16635
759,140000,112000,0,0,0,0,0,1,0,99736,9064,90672,0,80445,4009,76436,0,81005,5014,75991,0,79387,5011,74376
760,150000,120000,0,0,0,0,0,0,-2,65330,65676,-346,-1,20333,20368,-35,-1,8433,25,8408,0,10332,10363,-31
761,60000,48000,0,0,0,1,1,1,2,46663,5000,41663,0,49877,4000,45877,0,50734,1800,48934,2,49764,0,49764
762,240000,192000,0,0,0,0,0,0,-2,0,0,0,-2,0,0,0,-2,0,0,0,-2,0,0,0
763,60000,48000,1,1,0,0,0,0,0,61183,146,61037,2,29052,1500,27552,0,29087,1200,27887,0,27296,1500,25796
764,70000,56000,0,0,0,0,0,0,0,21351,2000,19351,0,19837,3000,16837,0,19273,4000,15273,0,13900,10000,3900
765,120000,96000,0,0,0,0,0,1,-1,2558,2558,0,-1,2577,2577,0,-1,249,0,249,0,1976,1976,0
766,50000,40000,0,0,0,0,0,1,0,40892,1880,39012,0,41612,1650,39962,0,18825,10000,8825,0,18019,1000,17019
767,210000,168000,0,0,0,0,0,0,0,73664,30003,43661,0,38405,1000,37405,0,38395,38395,0,-1,5062,5062,0
768,420000,336000,0,0,0,0,0,1,-2,0,0,0,-2,0,0,0,-2,0,0,0,-2,0,0,0
769,80000,64000,0,0,0,0,0,0,0,59515,5000,54515,0,48444,4000,44444,0,44372,4851,39521,0,45412,3000,42412
770,100000,80000,1,1,1,1,1,0,0,113939,5600,108339,0,111079,5500,105579,0,107257,4500,102757,0,105377,5000,100377
771,230000,184000,0,0,0,0,0,0,-1,2886,2886,0,-1,1443,0,1443,0,1443,1443,0,-1,1443,1443,0
772,30000,24000,0,0,0,0,0,1,2,23921,0,23921,4,23259,0,23259,3,22369,0,22369,2,23408,1800,21608
773,100000,80000,0,0,0,0,0,0,0,4419,0,4419,2,2946,0,2946,0,1473,0,1473,0,3230,3230,0
774,150000,120000,0,0,0,0,0,0,0,1207,2306,-1099,-1,1617,2610,-993,-1,0,0,0,-1,620,620,0
775,60000,48000,0,0,0,0,0,0,-1,694,694,0,-1,694,694,0,-1,694,694,0,-1,28948,28948,0
776,150000,120000,0,0,0,0,0,0,-1,316,316,0,-1,0,0,0,-1,782,1098,-316,-1,316,0,316
777,50000,40000,0,0,0,0,0,1,0,35245,3100,32145,0,27520,1723,25797,0,25928,1100,24828,0,26470,1111,25359
778,100000,80000,0,0,0,0,0,1,2,67965,14130,53835,0,73871,7065,66806,0,79707,7065,72642,0,85433,7065,78368
779,20000,16000,0,0,0,0,0,0,0,-280,0,-280,0,-280,0,-280,-2,-280,390,-670,-2,-670,0,-670
780,170000,136000,0,1,1,1,1,1,2,154850,8000,146850,2,150893,0,150893,2,165924,19172,146752,2,163176,0,163176
781,130000,104000,0,0,0,0,0,0,0,63421,3000,60421,0,60269,3000,57269,0,59984,3000,56984,0,27126,1000,26126
782,80000,64000,1,1,0,0,0,1,0,84848,2983,81865,0,63373,1501,61872,0,20324,5000,15324,0,23749,5000,18749
783,100000,80000,0,0,0,0,1,0,-2,1991,1991,0,-1,1991,0,1991,2,93536,93536,0,-1,95373,3500,91873
784,150000,120000,0,0,0,0,0,0,0,41515,2636,38879,0,43879,3000,40879,0,44446,1528,42918,0,45394,1600,43794
785,50000,40000,0,1,1,0,0,0,0,48063,2181,45882,0,48667,2175,46492,0,17875,773,17102,0,17699,638,17061
786,230000,184000,0,0,0,0,0,0,0,16190,1068,15122,0,11849,306,11543,0,11826,457,11369,0,6248,348,5900
787,160000,128000,0,0,0,0,0,0,0,3291,1000,2291,0,1623,32,1591,0,905,905,0,-1,0,0,0
788,80000,64000,0,1,1,0,0,0,0,70656,2671,67985,0,72290,3308,68982,0,390,390,0,-1,390,390,0
789,20000,16000,0,1,0,0,0,1,2,18113,1003,17110,2,14885,1300,13585,0,14975,900,14075,0,15311,700,14611
790,260000,208000,0,0,0,0,0,0,0,33379,33393,-14,-1,35877,6094,29783,0,21946,3530,18416,0,32150,12357,19793
791,110000,88000,0,0,0,0,0,0,0,82407,3786,78621,0,70562,2666,67896,0,70982,2900,68082,0,71609,3100,68509
792,70000,56000,0,0,0,0,0,0,0,49864,1744,48120,0,48481,2001,46480,0,46946,2000,44946,0,47958,1800,46158
793,30000,24000,0,0,0,1,1,0,-2,-4220,0,-4220,-2,30821,35821,-5000,-1,30071,0,30071,3,28767,0,28767
794,290000,232000,0,0,0,0,0,0,-2,208769,8001,200768,-2,213085,8037,205048,-2,211829,10074,201755,-2,96532,5010,91522
795,110000,88000,0,0,0,0,0,0,-1,3290,3290,0,-1,3089,0,3089,2,3601,563,3038,0,3396,296,3100
796,420000,336000,0,0,0,0,0,0,-1,12230,12290,-60,-1,13682,13749,-67,-1,1695,1706,-11,-1,712,714,-2
797,230000,184000,0,0,0,0,0,0,-1,1741,1741,0,-1,16594,33188,-16594,-1,18261,20000,-1739,-1,18333,19000,-667
798,260000,208000,0,1,0,0,0,0,0,257628,11710,245918,0,161545,7503,154042,0,0,0,0,0,0,0,0
799,320000,256000,0,0,0,0,0,0,-2,3342,3343,-1,-2,11970,11973,-3,-2,9700,9700,0,-2,38473,38473,0
800,90000,72000,0,1,0,0,0,0,0,91308,5000,86308,0,53991,4300,49691,0,56032,2800,53232,0,51010,2800,48210
801,20000,16000,0,0,0,0,0,0,-1,10067,10200,-133,-1,10144,540,9604,0,10400,600,9800,0,0,1000,-1000
802,490000,392000,0,0,0,0,0,0,-2,3180,3182,-2,-2,7715,7779,-64,-2,6507,6517,-10,-2,3424,3434,-10
803,80000,64000,0,0,0,0,0,0,0,49611,4000,45611,0,50496,2000,48496,2,51543,2000,49543,2,50563,0,50563
804,30000,24000,0,0,0,0,0,1,0,16390,1500,14890,0,17717,1600,16117,0,19420,2000,17420,0,18970,0,18970
805,120000,96000,0,0,0,0,0,1,0,20805,3000,17805,0,18271,0,18271,2,18128,961,17167,0,16405,2000,14405
806,150000,120000,0,0,0,0,0,0,-2,2580,2580,0,-2,0,0,0,-2,0,0,0,-2,0,0,0
807,100000,80000,0,0,0,0,0,0,-2,-78,0,-78,-2,-78,0,-78,-2,-78,0,-78,-2,-78,0,-78
808,100000,80000,0,0,0,0,0,0,0,58083,3503,54580,0,88344,59000,29344,0,49443,1600,47843,0,23159,1000,22159
809,50000,40000,0,0,0,0,0,1,2,34806,1300,33506,2,35433,1500,33933,2,36216,1500,34716,2,36969,1500,35469
810,200000,160000,0,0,0,0,0,0,0,50290,1762,48528,0,49771,1827,47944,0,92192,53248,38944,0,90772,3293,87479
811,30000,24000,0,1,1,1,1,1,-1,29093,3300,25793,-1,28319,0,28319,2,29064,1200,27864,0,28658,1100,27558
812,60000,48000,0,1,1,0,0,1,0,62254,3100,59154,0,59586,2000,57586,0,33190,1111,32079,0,32243,1122,31121
813,80000,64000,0,0,0,0,0,0,-1,390,390,0,-1,390,390,0,-1,390,390,0,-1,390,390,0
814,260000,208000,0,1,0,0,0,1,2,261518,7700,253818,0,194791,6000,188791,0,198894,6130,192764,0,197564,7500,190064
815,220000,176000,0,0,0,0,0,0,-1,0,0,0,-1,0,0,0,-2,0,0,0,-2,0,0,0
816,160000,128000,0,0,0,0,0,1,-1,26808,26808,0,-2,0,0,0,-2,0,0,0,-2,0,0,0
817,80000,64000,0,0,0,0,0,0,0,30297,2000,28297,0,30633,2000,28633,0,31190,1312,29878,0,30905,3200,27705
818,50000,40000,0,1,0,0,0,0,0,50071,2000,48071,0,10104,1000,9104,0,9208,500,8708,0,10075,1000,9075
819,160000,128000,1,1,0,0,0,0,0,272419,9368,263051,0,0,0,0,0,0,0,0,-2,0,0,0
820,420000,336000,1,1,1,1,1,1,2,428712,0,428712,2,425345,16100,409245,0,354852,13000,341852,0,353113,14064,339049
821,150000,120000,0,0,0,0,0,0,0,103528,5300,98228,0,105623,5300,100323,0,106583,4200,102383,0,108909,4200,104709
822,90000,72000,0,1,0,0,0,1,0,80720,3328,77392,0,69788,2100,67688,0,63868,2542,61326,0,40136,3000,37136
823,50000,40000,0,0,0,0,0,0,0,16670,1138,15532,0,8433,302,8131,0,8609,312,8297,0,8783,317,8466
824,90000,72000,0,0,0,0,0,0,2,390,390,0,-1,390,1950,-1560,-1,1848,1848,0,-1,930,1710,-780
825,50000,40000,0,0,0,0,0,0,0,15726,5000,10726,0,1148,1148,0,-1,0,0,0,-1,0,0,0
826,180000,144000,0,0,0,0,0,0,0,18193,5000,13193,0,18652,3000,15652,0,14545,2000,12545,0,18545,2000,16545
827,70000,56000,0,1,1,1,1,0,0,69514,3000,66514,0,69312,3100,66212,0,69412,3000,66412,0,68692,3000,65692
828,140000,112000,0,0,0,0,0,0,0,101362,7010,94352,0,87420,2359,85061,0,88774,7617,81157,0,81869,2760,79109
829,140000,112000,0,0,0,0,0,0,0,84235,4010,80225,0,82432,3800,78632,0,81465,3200,78265,0,83160,3100,80060
830,210000,168000,0,0,0,0,0,1,2,167095,16,167079,2,161573,6800,154773,0,122362,3800,118562,0,116243,5134,111109
831,90000,72000,0,0,0,0,0,1,2,32789,2900,29889,2,31641,0,31641,2,29240,2500,26740,2,28306,0,28306
832,30000,24000,0,0,0,0,0,0,2,428,0,428,2,428,428,0,-1,13749,13749,0,-1,659,659,0
833,500000,400000,0,0,0,0,0,0,-2,3581,3587,-6,-1,18855,18860,-5,-1,6783,146,6637,0,5921,5923,-2
834,80000,64000,0,1,0,0,0,0,0,76022,2229,73793,0,58897,1900,56997,0,54512,4000,50512,0,51937,5000,46937
835,100000,80000,0,0,0,0,0,0,0,30160,0,30160,2,22934,1600,21334,0,21876,1000,20876,0,22910,2800,20110
836,80000,64000,0,0,0,0,0,1,2,26823,3000,23823,0,29157,2780,26377,0,28389,0,28389,2,29036,1100,27936
837,20000,16000,0,1,1,0,0,1,0,20023,1500,18523,0,19625,500,19125,0,15188,500,14688,0,0,0,0
838,170000,136000,0,0,0,0,0,1,0,-1,0,-1,0,192,193,-1,-1,0,0,0,-1,397,397,0
839,120000,96000,0,0,0,0,0,0,0,41583,0,41583,2,42736,2000,40736,0,43806,1600,42206,0,44623,1500,43123
840,10000,8000,0,0,0,0,0,1,2,1050,0,1050,2,1050,0,1050,3,1050,0,1050,3,1050,0,1050
841,30000,24000,0,1,1,1,1,0,0,27000,0,27000,2,27382,1100,26282,0,26876,1000,25876,0,28351,2300,26051
842,30000,24000,0,1,1,1,1,0,2,29112,1800,27312,0,29555,1200,28355,0,28536,1083,27453,0,29252,1200,28052
843,160000,128000,0,0,0,0,0,0,-1,9121,9128,-7,-1,2412,2412,0,-1,2271,2271,0,-1,2187,2187,0
844,180000,144000,0,0,0,0,0,0,0,57466,2100,55366,0,58609,2100,56509,0,59828,2163,57665,0,59842,1000,58842
845,120000,96000,1,1,0,0,0,1,0,150952,3400,147552,0,77639,6000,71639,0,79966,3200,76766,0,61248,4000,57248
846,20000,16000,0,1,1,1,1,0,0,20196,1400,18796,0,19777,2000,17777,0,20130,3000,17130,0,19350,1000,18350
847,180000,144000,0,0,0,0,0,0,-2,3837,3842,-5,-2,5760,5760,0,-2,0,0,0,-2,925,925,0
848,110000,88000,0,0,0,0,0,1,2,59518,4803,54715,2,57964,0,57964,2,66995,10000,56995,2,65762,0,65762
849,20000,16000,0,0,0,0,0,1,0,5075,1318,3757,0,5979,1183,4796,0,6796,1000,5796,0,6463,0,6463
850,140000,112000,0,0,0,0,0,1,3,106947,4000,102947,2,107690,4000,103690,2,109821,4000,105821,2,107893,0,107893
851,280000,224000,0,0,0,0,0,0,-2,-8,0,-8,-2,-8,0,-8,-2,1680,1688,-8,-2,0,0,0
852,30000,24000,0,1,1,1,1,0,2,29827,0,29827,2,28661,4455,24206,0,28608,1047,27561,0,30647,2500,28147
853,200000,160000,0,0,0,0,0,1,-2,23344,1400,21944,-2,23627,1110,22517,-2,3977,1000,2977,-2,1100,0,1100
854,180000,144000,0,0,0,0,0,1,-2,1829,1829,0,-2,-200,998,-1198,-2,0,200,-200,-2,4208,4208,0
855,180000,144000,0,1,1,0,0,0,0,177813,8431,169382,0,178907,6845,172062,0,139825,4465,135360,0,118621,4287,114334
856,290000,232000,0,0,0,0,0,0,-1,316,316,0,-1,316,316,0,-1,316,316,0,-1,297,297,0
857,150000,120000,0,0,0,0,0,0,-2,0,0,0,-2,0,0,0,-2,0,0,0,-2,0,0,0
858,50000,40000,0,0,0,0,0,1,2,18209,1000,17209,2,18595,1000,17595,2,20323,2000,18323,2,19218,0,19218
859,50000,40000,0,1,0,0,0,0,0,49345,1305,48040,0,20238,1201,19037,0,18646,663,17983,0,19034,684,18350
860,10000,8000,0,1,1,1,1,0,0,9821,1300,8521,0,9495,350,9145,0,9469,500,8969,0,10191,1650,8541
861,150000,120000,0,0,0,0,0,0,-2,0,0,0,-2,0,0,0,-2,0,0,0,-2,302,302,0
862,460000,368000,0,0,0,0,0,1,-1,-13,0,-13,-1,2641,2654,-13,-1,-10,0,-10,-1,22535,22545,-10
863,250000,200000,0,0,0,0,0,0,0,138084,6399,131685,0,100574,5000,95574,0,40066,2000,38066,0,38765,1615,37150
864,80000,64000,0,1,1,1,1,0,0,71918,3310,68608,0,71534,2200,69334,0,73344,2400,70944,0,75218,2500,72718
865,20000,16000,0,0,0,1,1,0,0,16472,1600,14872,0,18087,2200,15887,0,17499,0,17499,2,17868,650,17218
866,60000,48000,0,0,0,0,0,0,0,28017,4022,23995,0,25011,1500,23511,0,28143,3500,24643,0,24712,1000,23712
867,120000,96000,0,0,0,0,0,0,-2,369,369,0,-1,0,55,-55,-1,7490,7490,0,-1,941,941,0
868,130000,104000,0,1,1,1,1,0,0,133834,7000,126834,0,132336,7000,125336,0,132614,6000,126614,0,132208,5500,126708
869,200000,160000,0,0,0,0,0,1,0,11773,1201,10572,0,12784,1212,11572,0,13039,467,12572,0,13314,485,12829
870,50000,40000,0,0,0,0,0,1,2,21864,3008,18856,2,21215,0,21215,2,23494,2638,20856,2,22978,0,22978
871,420000,336000,0,0,0,0,0,0,0,4889,4913,-24,-1,14373,14415,-42,-1,12881,6930,5951,0,3690,709,2981
872,150000,120000,0,1,1,1,1,0,0,140019,5000,135019,0,143237,5000,138237,0,140658,5000,135658,0,143344,5000,138344
873,360000,288000,0,0,0,0,0,0,0,256974,12649,244325,0,241226,8916,232310,0,241673,7725,233948,0,233157,8900,224257
874,290000,232000,0,0,0,0,0,0,0,99370,3530,95840,0,84836,3019,81817,0,82168,2818,79350,0,80299,3000,77299
875,230000,184000,0,1,0,0,0,0,0,229229,25000,204229,0,143168,10000,133168,0,145270,5000,140270,0,141874,5000,136874
876,130000,104000,0,0,0,0,0,0,0,88214,3200,85014,0,90167,3403,86764,0,90682,3300,87382,0,92672,3500,89172
877,230000,184000,0,0,0,0,0,0,-1,711,711,0,-1,711,711,0,-1,711,711,0,-1,291,291,0
878,450000,360000,0,0,0,0,0,0,-1,0,0,0,-1,2481,2481,0,-1,13716,13716,0,-1,19584,7100,12484
879,250000,200000,0,0,0,0,0,1,-1,1400,1400,0,-1,79181,79181,0,-1,29172,10000,19172,0,14816,0,14816
880,300000,240000,0,0,0,0,0,0,0,16022,6191,9831,0,10880,10892,-12,-1,2558,2558,0,-1,2324,2332,-8
881,20000,16000,0,0,1,1,1,0,0,17948,2500,15448,0,18647,1000,17647,0,19193,846,18347,0,19721,1000,18721
882,20000,16000,0,0,0,0,0,0,-2,-1,0,-1,-2,494,495,-1,-2,2284,2290,-6,-2,490,491,-1
883,120000,96000,0,1,0,0,0,0,0,118774,3740,115034,0,91369,3215,88154,0,88015,3300,84715,0,88087,3405,84682
884,160000,128000,0,1,1,1,1,1,2,151842,12000,139842,2,147962,0,147962,2,156921,11500,145421,2,159416,5811,153605
885,510000,408000,0,0,0,0,0,0,0,107686,20094,87592,0,103776,5000,98776,0,87265,5001,82264,0,36739,25365,11374
886,150000,120000,0,0,0,0,0,0,0,-18,0,-18,0,-18,0,-18,-2,-18,0,-18,-2,-18,0,-18
887,50000,40000,0,0,0,0,0,0,0,35242,1600,33642,0,34776,1600,33176,0,35497,1300,34197,0,36325,1400,34925
888,290000,232000,0,0,0,0,0,0,0,102628,6039,96589,0,100000,4000,96000,0,92238,4000,88238,0,90447,4000,86447
889,20000,16000,0,0,0,0,0,1,0,14337,1500,12837,0,15596,1500,14096,0,15204,0,15204,2,17149,2200,14949
890,450000,360000,0,0,0,0,0,0,-2,0,0,0,-2,0,0,0,-2,0,0,0,-2,0,0,0
891,300000,240000,0,0,0,0,0,0,-1,0,0,0,-2,0,0,0,-2,0,0,0,-2,0,0,0
892,30000,24000,0,0,0,0,0,1,0,18246,3200,15046,0,17660,0,17660,2,17768,700,17068,0,18151,670,17481
893,500000,400000,0,0,0,0,0,1,0,44157,10004,34153,0,48322,5178,43144,0,21593,1047,20546,0,13866,2019,11847
894,200000,160000,0,0,0,0,0,0,0,80906,5000,75906,0,82088,4000,78088,0,81564,3000,78564,0,87241,9000,78241
895,50000,40000,0,1,0,0,0,0,0,48400,2520,45880,0,29781,1000,28781,0,30082,1100,28982,0,26609,1000,25609
896,80000,64000,0,0,0,0,0,0,2,2072,5572,-3500,-1,1752,1752,0,-1,1876,2000,-124,-1,1876,1876,0
897,430000,344000,0,0,0,0,0,0,0,90604,3200,87404,0,91200,3185,88015,0,92134,3500,88634,0,92834,3500,89334
898,150000,120000,0,0,0,0,0,0,-2,1276,1282,-6,-2,4830,4854,-24,-2,10251,10251,0,-1,5706,0,5706
899,30000,24000,0,0,0,0,0,0,-1,1152,1152,0,-1,780,780,0,-1,2678,2678,0,-1,1225,1544,-319
900,490000,392000,0,0,0,0,0,1,-1,4657,4657,0,-1,3398,3398,0,-1,1476,1476,0,-1,1602,1602,0
901,120000,96000,0,0,0,0,0,0,2,4782,0,4782,2,6041,1500,4541,0,6784,1000,5784,0,6826,300,6526
902,100000,80000,0,1,1,1,0,0,0,94407,0,94407,2,95124,2951,92173,0,96354,2300,94054,0,64168,7174,56994
903,20000,16000,0,0,0,0,0,0,0,9369,2002,7367,0,5873,3098,2775,0,5990,215,5775,0,6231,338,5893
904,200000,160000,0,0,0,0,0,1,-1,2337,0,2337,2,1904,1904,0,-1,548,0,548,0,1403,1403,0
905,20000,16000,0,0,0,0,0,0,0,14372,2600,11772,0,15619,1500,14119,0,16376,1000,15376,0,16738,1000,15738
906,380000,304000,0,0,0,0,0,0,0,177842,50434,127408,0,120027,7132,112895,0,97256,11068,86188,0,108213,20050,88163
907,10000,8000,0,0,0,0,0,0,-1,3096,3098,-2,-1,3400,3400,0,-1,4522,4522,0,-1,-240,0,-240
908,70000,56000,0,0,0,0,0,0,0,23968,1500,22468,0,25559,2000,23559,0,26134,1000,25134,0,26715,1000,25715
909,400000,320000,0,0,0,0,0,0,-1,1617,1617,0,-1,875,875,0,-1,917,917,0,-1,5434,5434,0
910,210000,168000,0,0,0,0,0,1,-2,0,0,0,-2,0,0,0,-2,0,0,0,-2,0,0,0
911,200000,160000,0,0,0,0,0,0,-1,10599,10599,0,-1,13865,13865,0,-1,6177,0,6177,0,5519,5519,0
912,630000,504000,0,0,0,0,0,0,0,1207,1207,0,0,2632,2632,0,-1,8654,8654,0,-1,0,0,0
913,210000,168000,0,0,0,0,0,0,-1,3638,3638,0,-1,7489,7489,0,-1,2684,2684,0,-1,9448,9448,0
914,200000,160000,0,0,0,0,0,1,-2,0,0,0,-2,347,347,0,-1,197,0,197,2,2917,2720,197
915,140000,112000,0,0,0,0,0,0,-1,2549,2549,0,-1,151,151,0,-1,0,0,0,-1,574,574,0
916,90000,72000,0,1,1,1,1,0,0,91504,4100,87404,0,91706,3900,87806,0,91801,4000,87801,0,91753,3700,88053
917,100000,80000,0,0,0,0,0,0,0,0,0,0,-2,0,0,0,-2,0,0,0,-2,16708,16708,0
918,200000,160000,0,0,0,0,0,0,0,53862,2569,51293,0,37056,793,36263,0,19790,49,19741,0,20842,15085,5757
919,30000,24000,0,1,1,1,1,1,2,30128,1980,28148,2,30548,1200,29348,2,31326,1400,29926,2,30688,0,30688
920,550000,440000,0,0,0,0,0,1,0,318029,14407,303622,0,91903,3512,88391,0,91010,3506,87504,0,70045,2512,67533
921,100000,80000,0,1,1,1,1,0,2,94009,8000,86009,2,95577,4000,91577,2,93145,0,93145,2,95489,4000,91489
922,30000,24000,0,1,1,1,0,1,0,28067,1500,26567,0,28334,1000,27334,0,28984,800,28184,0,14769,728,14041
923,400000,320000,0,0,0,0,0,0,-1,426,426,0,-1,27926,27926,0,-1,0,27500,-27500,-1,430,430,0
924,50000,40000,0,0,0,0,0,0,-1,390,390,0,-1,2300,4300,-2000,-1,1910,0,1910,0,780,0,780
925,230000,184000,0,0,0,0,0,0,-2,3000,3000,0,-1,1800,1800,0,-1,29387,29387,0,-1,22980,1200,21780
926,50000,40000,0,0,0,0,0,0,2,23091,2000,21091,0,10202,500,9702,0,10476,1200,9276,0,10161,0,10161
927,400000,320000,0,0,0,0,0,0,-1,566,285,281,-1,21373,22240,-867,-1,16663,4200,12463,0,7873,905,6968
928,20000,16000,0,0,0,0,0,0,-1,-2,0,-2,-1,221,223,-2,-1,0,0,0,-1,0,0,0
929,200000,160000,0,0,0,0,0,0,-2,7289,7289,0,-2,0,0,0,-2,0,0,0,-2,2376,2376,0
930,20000,16000,0,0,1,1,1,1,0,17968,3000,14968,0,17382,0,17382,2,18094,1000,17094,0,19399,1600,17799
931,40000,32000,0,0,0,0,0,0,2,21057,0,21057,2,20746,1000,19746,0,20613,1062,19551,0,867,1600,-733
932,20000,16000,0,0,0,0,0,0,0,0,0,0,0,0,0,0,-2,0,0,0,-2,0,0,0
933,200000,160000,0,0,0,0,0,0,0,47100,1903,45197,0,27112,10033,17079,0,21220,949,20271,0,15719,10078,5641
934,50000,40000,0,0,0,0,0,0,-1,581,581,0,-1,581,581,0,-1,581,581,0,-1,581,581,0
935,150000,120000,0,0,0,0,0,1,-2,0,0,0,-2,0,0,0,-2,0,0,0,-2,0,0,0
936,50000,40000,0,1,1,0,0,0,0,47104,2500,44604,0,48205,1401,46804,0,17555,0,17555,0,7809,3000,4809
937,280000,224000,0,0,0,0,0,0,-1,695,695,0,-1,10639,10639,0,-1,13158,3158,10000,0,768,768,0
938,50000,40000,0,0,0,0,0,1,0,0,0,0,0,0,0,0,-2,0,0,0,-2,0,0,0
939,20000,16000,0,0,0,0,0,0,-1,0,19837,-19837,-1,0,0,0,-2,0,15846,-15846,-2,0,2000,-2000
940,50000,40000,0,1,1,0,0,0,0,49149,1518,47631,0,44073,1414,42659,0,40260,1432,38828,0,30222,1300,28922
941,310000,248000,0,0,0,0,0,0,-1,0,0,0,-2,0,0,0,-2,0,0,0,-2,0,0,0
942,60000,48000,0,0,0,0,0,0,0,38344,1590,36754,0,37311,1500,35811,0,37428,1354,36074,0,38187,1377,36810
943,200000,160000,0,0,0,0,0,0,-2,8795,8795,0,-2,13676,13676,0,-2,-1282,1282,-2564,-2,-1282,0,-1282
944,500000,400000,0,0,0,0,0,0,-1,2031,5262,-3231,-1,2593,3023,-430,-1,45858,45868,-10,-1,161299,130586,30713
945,50000,40000,0,0,0,0,0,1,2,16215,4200,12015,0,20490,4700,15790,0,19990,0,19990,2,0,0,0
946,50000,40000,0,0,0,0,0,1,2,18134,2500,15634,2,17622,0,17622,2,19249,2000,17249,2,14259,0,14259
947,30000,24000,0,1,1,1,1,0,0,26286,1838,24448,0,26458,1400,25058,0,26668,1000,25668,0,28195,2342,25853
948,390000,312000,0,0,0,0,0,0,0,64171,4000,60171,0,58767,2100,56667,0,54224,2000,52224,0,51667,3000,48667
949,80000,64000,0,0,0,0,0,0,0,0,0,0,0,0,0,0,-2,0,0,0,-2,0,0,0
950,110000,88000,1,1,1,1,1,1,2,126200,5000,121200,2,130540,8000,122540,2,127114,0,127114,2,111429,5000,106429
951,50000,40000,0,0,0,0,0,0,0,20497,1582,18915,0,19465,811,18654,0,18474,700,17774,0,20096,2318,17778
952,140000,112000,0,0,0,0,0,1,2,31809,1600,30209,0,34374,3100,31274,0,33522,0,33522,2,34481,1500,32981
953,50000,40000,0,1,0,0,0,1,0,49564,1500,48064,0,21002,1500,19502,0,20230,2000,18230,0,19462,1700,17762
954,40000,32000,0,0,0,0,0,1,0,19606,3000,16606,0,21272,2000,19272,0,22923,2000,20923,0,24539,2000,22539
955,270000,216000,0,0,0,0,0,0,0,5061,2000,3061,0,5500,1000,4500,0,116681,116681,0,-1,119553,5000,114553
956,20000,16000,0,0,0,0,0,0,0,15640,1260,14380,0,15950,570,15380,0,16130,436,15694,0,17011,1150,15861
957,130000,104000,0,0,0,0,0,0,-1,604,604,0,-1,700,700,0,-1,0,0,0,-1,1440,1440,0
958,290000,232000,0,0,0,0,0,0,-2,0,0,0,-2,0,0,0,-2,0,0,0,-2,0,0,0
959,200000,160000,0,0,0,0,0,0,-1,15093,15093,0,-1,0,0,0,-1,0,0,0,-2,0,0,0
960,120000,96000,0,0,0,0,0,0,-2,0,0,0,-2,0,0,0,-2,0,0,0,-2,0,0,0
961,50000,40000,0,0,0,1,1,0,0,44880,5000,39880,0,45122,8000,37122,0,49518,5000,44518,0,50389,10000,40389
962,150000,120000,0,0,0,0,0,1,2,17491,1329,16162,0,24882,7720,17162,0,25229,1051,24178,2,24688,0,24688
963,50000,40000,0,1,0,0,0,0,0,46689,1785,44904,0,8261,296,7965,0,8434,306,8128,0,8738,444,8294
964,150000,120000,0,1,0,0,0,1,0,147474,3000,144474,0,7474,120000,-112526,-1,8173,823,7350,0,87500,80000,7500
965,230000,184000,0,0,0,0,0,0,-2,0,0,0,-2,0,0,0,-2,2533,2533,0,-1,0,0,0
966,180000,144000,0,0,0,0,0,0,-2,0,0,0,-2,0,0,0,-2,0,0,0,-2,0,0,0
967,200000,160000,0,0,0,0,0,0,-1,9212,9236,-24,-1,2529,2529,0,-1,1036,0,1036,0,4430,4430,0
968,250000,200000,0,0,0,0,0,1,-2,0,0,0,-2,0,0,0,-2,0,0,0,-2,0,0,0
969,50000,40000,0,0,0,0,0,0,0,28202,2000,26202,0,30727,3000,27727,0,30098,0,30098,2,32580,3000,29580
970,80000,64000,0,0,0,0,0,1,-1,390,390,0,-1,390,390,0,-1,390,390,0,-1,390,390,0
971,130000,104000,0,0,0,0,0,1,2,25144,2000,23144,0,23235,1000,22235,0,13277,700,12577,0,13895,1000,12895
972,280000,224000,0,0,0,0,0,0,-1,2783,2783,0,-1,2001,0,2001,0,-339,0,-339,0,-1180,0,-1180
973,50000,40000,1,1,1,0,0,0,0,81308,1640,79668,0,41463,1449,40014,0,40045,1454,38591,0,40845,1466,39379
974,180000,144000,0,0,0,0,0,0,-1,644,644,0,-1,29944,29944,0,-1,644,644,0,-1,264,264,0
975,420000,336000,0,0,0,0,0,0,-2,2950,2965,-15,-2,17827,18048,-221,-2,23711,23831,-120,-2,63784,64101,-317
976,110000,88000,0,1,1,1,1,0,0,107172,5369,101803,0,107629,4003,103626,0,106628,3806,102822,0,106903,4050,102853
977,320000,256000,0,0,0,0,0,0,-1,76755,7001,69754,-1,74838,21,74817,2,72402,3012,69390,0,71847,3015,68832
978,20000,16000,0,1,1,0,0,0,0,21148,1500,19648,0,17767,1035,16732,0,2692,54,2638,0,-956,24056,-25012
979,400000,320000,0,0,0,0,0,0,-1,3944,10,3934,2,87146,87170,-24,-1,90818,10013,80805,0,96316,10008,86308
980,80000,64000,0,0,0,0,0,0,0,44275,2000,42275,0,42029,1500,40529,0,33838,1500,32338,0,29757,2000,27757
981,20000,16000,0,0,1,1,1,1,2,18200,3000,15200,2,17613,0,17613,2,18371,1200,17171,0,19865,1800,18065
982,20000,16000,0,0,0,0,0,0,2,948,948,0,-1,632,0,632,0,316,0,316,0,1096,1096,0
983,50000,40000,0,0,0,0,0,0,0,15251,8000,7251,0,12159,9400,2759,0,9581,1000,8581,0,15222,6000,9222
984,190000,152000,0,0,0,0,0,1,-1,16500,16500,0,-1,0,0,0,-1,26854,26854,0,-1,554,500,54
985,180000,144000,0,0,0,0,0,1,2,8469,8510,-41,-1,6591,5244,1347,0,5244,2174,3070,0,2174,0,2174
986,70000,56000,0,0,0,0,0,0,0,57625,2311,55314,0,45675,1622,44053,0,46236,1674,44562,0,46758,1677,45081
987,330000,264000,0,0,0,0,0,0,-2,20992,21060,-68,-2,681,681,0,-2,0,0,0,-2,5180,5180,0
988,290000,232000,0,0,0,0,0,0,-1,22149,22149,0,-1,23737,20000,3737,0,13449,3449,10000,0,17963,7000,10963
989,150000,120000,0,0,0,0,0,0,2,25195,3500,21695,2,24497,0,24497,2,24791,1000,23791,0,25462,1071,24391
990,480000,384000,0,0,0,0,0,0,-1,8313,8351,-38,-1,25714,25753,-39,-1,25710,14012,11698,0,20110,10021,10089
991,240000,192000,0,0,0,0,0,0,0,135075,6004,129071,0,134705,3000,131705,0,143883,10500,133383,0,145643,4000,141643
992,390000,312000,0,0,0,0,0,0,0,68855,3181,65674,0,-1391,895,-2286,0,249742,253009,-3267,-1,253914,10009,243905
993,80000,64000,0,0,0,0,0,0,-2,0,0,0,-2,0,0,0,-2,0,0,0,-2,0,0,0
994,60000,48000,0,0,0,0,0,1,0,32091,1791,30300,0,32792,2378,30414,0,31277,0,31277,2,29512,1092,28420
995,130000,104000,0,0,0,0,0,1,-1,-2,2,-4,-1,935,937,-2,-2,4985,4990,-5,-1,1212,1215,-3
996,420000,336000,0,0,0,0,0,0,0,15189,2005,13184,0,13787,5000,8787,0,9199,2000,7199,0,4405,1000,3405
997,200000,160000,0,0,0,0,0,0,0,30212,1503,28709,0,26302,5000,21302,0,20465,3000,17465,0,12460,1000,11460
998,100000,80000,0,0,0,0,0,0,-2,0,0,0,-2,0,0,0,-2,60,60,0,-1,210,300,-90
999,510000,408000,0,0,0,0,0,0,-1,3700,1000,2700,0,0,0,0,0,0,0,0,-2,102097,102097,0
1000,230000,184000,0,0,0,0,0,0,0,13348,1500,11848,0,14620,1500,13120,0,15877,1500,14377,0,16611,1000,15611
1001,180000,144000,0,0,0,0,0,1,-2,11021,11021,0,-2,16883,16883,0,-2,150,150,0,-2,4661,4661,0
1002,180000,144000,0,0,1,1,0,1,0,146529,6000,140529,0,151106,7000,144106,0,153900,6900,147000,0,0,0,0
1003,50000,40000,0,1,1,1,1,0,0,43407,0,43407,2,44382,2000,42382,0,45672,2000,43672,0,46758,2000,44758
1004,200000,160000,0,0,0,0,0,0,-2,441,441,0,-2,653,653,0,-2,500,500,0,-2,600,600,0
1005,360000,288000,0,0,0,0,0,0,-1,396,396,0,-1,396,396,0,-1,396,396,0,-1,846,846,0
1006,90000,72000,0,0,0,0,0,0,0,17566,1266,16300,0,8718,1048,7670,0,6432,1032,5400,0,2655,1655,1000
1007,190000,152000,0,0,0,0,0,0,-1,105265,50000,55265,0,126905,26905,100000,0,150953,30000,120953,0,153223,7000,146223
1008,260000,208000,0,0,0,0,0,0,0,64075,2048,62027,0,63922,2129,61793,0,60089,1660,58429,0,53326,1568,51758
1009,70000,56000,0,1,0,0,0,0,0,68976,3290,65686,0,49145,1706,47439,0,49688,1759,47929,0,47780,1729,46051
1010,30000,24000,0,1,1,0,0,0,0,29697,0,29697,2,29760,1000,28760,0,21061,421,20640,0,1894,1894,0
1011,140000,112000,0,0,0,0,0,0,-1,1633,1000,633,0,1666,33,1633,0,1700,34,1666,0,0,0,0
1012,490000,392000,0,0,0,0,0,0,0,2310,2324,-14,-1,48409,25053,23356,-1,296319,280695,15624,0,181627,17398,164229
1013,240000,192000,1,1,1,1,0,0,0,243589,30,243559,2,204754,7046,197708,0,201426,7023,194403,0,198736,10005,188731
1014,290000,232000,0,0,0,0,0,0,-1,1750,1750,0,-1,19117,19117,0,-1,12693,400,12293,0,28468,2000,26468
1015,50000,40000,0,0,0,0,0,0,2,6747,1200,5547,0,7859,1200,6659,0,7464,1200,6264,0,7199,0,7199
1016,360000,288000,0,0,0,0,0,0,-1,-15,0,-15,-1,3041,3056,-15,-1,21801,21910,-109,-1,3837,3856,-19
1017,20000,16000,0,0,0,1,0,0,0,16168,900,15268,2,16268,500,15768,0,16600,332,16268,0,0,2000,-2000
1018,180000,144000,0,0,0,0,0,0,0,26743,1000,25743,0,28943,2200,26743,0,30943,2000,28943,0,0,0,0
1019,280000,224000,0,0,0,0,0,1,0,30079,30000,79,0,13139,14000,-861,-1,13989,1000,12989,0,15559,16000,-441
1020,370000,296000,0,0,0,0,0,0,0,200761,8300,192461,0,125646,5000,120646,0,111185,4600,106585,0,45816,10000,35816
1021,80000,64000,0,0,0,0,0,0,-1,390,390,0,-1,390,390,0,-1,390,390,0,-1,390,390,0
1022,150000,120000,0,0,0,0,0,0,-2,0,0,0,-2,0,0,0,-2,650,650,0,-2,1430,1430,0
1023,350000,280000,0,0,0,0,0,0,-2,0,0,0,-2,0,0,0,-2,8631,8631,0,-2,277,277,0
1024,300000,240000,0,0,0,0,0,0,0,139649,5800,133849,0,104245,5000,99245,0,56788,2200,54588,0,57920,2200,55720
1025,10000,8000,0,1,1,1,1,0,0,9590,1150,8440,0,9782,335,9447,0,9986,346,9640,0,9173,336,8837
1026,20000,16000,0,1,0,0,0,0,0,17972,1211,16761,0,16592,1500,15092,0,15369,1300,14069,0,16247,1500,14747
1027,60000,48000,0,0,0,0,0,0,2,31018,1500,29518,2,32193,2000,30193,0,34213,2700,31513,0,35002,1500,33502
1028,30000,24000,0,0,0,0,0,1,2,15002,2955,12047,2,13914,0,13914,2,11093,436,10657,0,9508,423,9085
1029,80000,64000,0,0,0,0,0,0,-1,0,0,0,-2,0,0,0,-2,0,0,0,-2,0,0,0
1030,100000,80000,0,1,1,0,0,0,0,93209,0,93209,2,89813,3501,86312,0,55359,3021,52338,0,32227,5011,27216
1031,150000,120000,0,0,0,0,0,0,0,45976,1765,44211,0,46890,1679,45211,0,47873,1739,46134,0,48833,1757,47076
1032,140000,112000,0,0,0,0,0,1,-2,12174,12174,0,-2,3961,3961,0,-2,3070,3070,0,-2,2306,2306,0
1033,270000,216000,0,0,0,0,0,0,0,23021,1719,21302,0,17934,1200,16734,0,13650,1000,12650,0,12864,2000,10864
1034,20000,16000,0,1,1,1,1,0,0,18181,1450,16731,0,19331,1600,17731,0,19113,382,18731,0,17996,383,17613
1035,120000,96000,0,0,0,0,0,1,-2,2382,2382,0,-1,0,0,0,-1,0,0,0,-2,0,0,0
1036,60000,48000,0,0,0,0,0,0,0,28465,1425,27040,0,31040,3000,28040,0,29827,0,29827,2,28254,955,27299
1037,80000,64000,0,0,0,0,0,0,-2,8140,8179,-39,-2,7258,7285,-27,-2,20171,20171,0,-2,5483,5483,0
1038,160000,128000,0,0,0,0,0,0,0,127848,3592,124256,0,96066,7317,88749,0,93974,2312,91662,0,40170,1637,38533
1039,40000,32000,0,1,1,1,1,0,0,40543,2000,38543,0,39943,2000,37943,0,38895,1400,37495,0,37726,1300,36426
1040,50000,40000,0,1,1,1,1,0,0,45559,3259,42300,0,46164,1754,44410,0,46685,1665,45020,0,47272,1723,45549
1041,270000,216000,0,0,0,0,0,0,-1,43615,43000,615,0,33336,1740,31596,0,36045,16045,20000,0,28725,2000,26725
1042,80000,64000,0,0,0,0,0,1,2,58276,2400,55876,0,60102,3000,57102,0,61423,2500,58923,0,72197,11576,60621
1043,210000,168000,0,0,0,0,0,0,-1,0,0,0,-2,0,0,0,-2,1243,1243,0,-1,0,0,0
1044,500000,400000,0,1,1,0,0,0,0,436858,12000,424858,0,432945,15236,417709,0,338417,98363,240054,0,318436,11000,307436
1045,360000,288000,0,0,0,0,0,1,-1,2274,0,2274,2,0,0,0,2,0,0,0,-2,0,0,0
1046,170000,136000,0,0,0,0,0,0,-2,0,0,0,-2,0,0,0,-2,150,150,0,-1,167,167,0
1047,120000,96000,0,0,0,0,0,1,0,72188,10000,62188,0,42840,4000,38840,0,19860,5000,14860,0,390,390,0
1048,70000,56000,0,0,0,0,0,0,0,35757,21000,14757,0,27906,2000,25906,0,25731,687,25044,0,21430,1500,19930
1049,500000,400000,0,0,0,0,0,0,0,352868,14500,338368,0,353297,13000,340297,0,377371,13000,364371,0,365278,15000,350278
1050,80000,64000,0,0,0,0,0,0,0,29425,1700,27725,0,29990,1169,28821,0,29153,1044,28109,0,19863,717,19146
1051,120000,96000,0,0,0,0,0,1,-1,1131,1131,0,-1,441,441,0,-1,441,441,0,-1,441,441,0
1052,260000,208000,0,1,1,1,1,0,0,244115,9001,235114,0,248831,9061,239770,0,263528,19155,244373,0,258973,1,258972
1053,190000,152000,0,0,0,0,0,0,0,66984,2458,64526,0,67864,2411,65453,0,68156,2405,65751,0,67958,2595,65363
1054,100000,80000,0,1,1,1,1,1,2,85536,5000,80536,2,90018,6800,83218,2,91151,3500,87651,3,89429,0,89429
1055,100000,80000,0,0,0,0,0,0,-1,7702,1000,6702,0,1550,1558,-8,-1,12079,12079,0,-1,35920,35920,0
1056,400000,320000,0,0,0,0,0,0,0,190256,44776,145480,0,89128,1502,87626,0,39276,2026,37250,0,23440,1015,22425
1057,320000,256000,0,0,0,0,0,1,-1,0,0,0,-2,0,0,0,-2,0,0,0,-2,0,0,0
1058,80000,64000,0,0,0,0,0,0,0,22145,3000,19145,0,33675,18000,15675,0,3047,3047,0,-1,77511,77511,0
1059,30000,24000,0,0,0,0,0,0,3,15274,0,15274,2,17018,2000,15018,2,16608,0,16608,2,18020,2000,16020
1060,20000,16000,0,0,0,0,0,0,-1,6050,6050,0,-1,3100,3100,0,-1,0,0,0,-1,0,0,0
1061,330000,264000,0,0,0,0,0,0,0,125969,6000,119969,0,127044,3614,123430,0,127027,4000,123027,0,129945,4000,125945
1062,390000,312000,0,0,0,0,0,0,0,38679,1647,37032,0,39689,1657,38032,0,40472,1440,39032,0,41320,1496,39824
1063,230000,184000,0,0,0,0,0,0,-1,56729,56729,0,-1,-1310,0,-1310,-1,6734,8044,-1310,-1,87161,87161,0
1064,710000,568000,0,0,0,0,0,0,0,34854,3696,31158,0,35774,1616,34158,0,35524,3024,32500,0,35047,5011,30036
1065,60000,48000,0,1,0,0,0,1,0,49907,1879,48028,0,44057,1500,42557,0,27510,1000,26510,0,28086,1019,27067
1066,150000,120000,0,0,0,0,0,0,-1,0,0,0,-1,863,863,0,-1,863,0,863,0,0,0,0
1067,40000,32000,0,0,0,0,0,0,0,14873,1500,13373,0,15624,1000,14624,0,15972,600,15372,0,16308,600,15708
1068,40000,32000,0,0,0,0,0,0,0,13600,1000,12600,0,0,0,0,0,44024,22373,21651,-1,18697,680,18017
1069,260000,208000,1,1,1,1,1,0,0,282092,9000,273092,2,255409,0,255409,2,257913,9394,248519,0,262004,9628,252376
1070,360000,288000,0,0,0,0,0,0,0,64277,2017,62260,0,32727,305,32422,0,13004,1240,11764,0,0,0,0
1071,200000,160000,0,0,0,0,0,0,-1,7973,23,7950,2,6202,6228,-26,-1,8549,8574,-25,-1,6251,6269,-18
1072,30000,24000,0,1,1,1,1,0,0,29138,2002,27136,0,28852,1503,27349,0,28487,2006,26481,0,27788,2005,25783
1073,260000,208000,0,0,0,0,0,0,0,52263,1826,50437,0,52261,1971,50290,0,52140,2000,50140,0,52615,2500,50115
1074,180000,144000,0,0,0,0,0,1,0,36882,4626,32256,0,34000,0,34000,2,34798,1500,33298,0,35488,1419,34069
1075,70000,56000,0,0,0,0,0,0,0,43705,1740,41965,0,45965,3000,42965,0,46900,1700,45200,0,47884,1739,46145
1076,60000,48000,0,1,1,1,1,0,0,59631,2133,57498,0,58105,2050,56055,0,57194,2191,55003,0,60650,5300,55350
1077,80000,64000,0,0,0,0,0,0,-1,1667,1667,0,-1,2146,2146,0,-1,1073,0,1073,0,2761,2761,0
1078,180000,144000,0,0,0,0,0,0,-1,6566,6500,66,0,6905,1000,5905,0,7385,1000,6385,0,7847,1000,6847
1079,300000,240000,0,0,0,0,0,0,0,221737,8705,213032,0,224774,8500,216274,0,182544,6820,175724,0,92014,2700,89314
1080,290000,232000,0,0,0,0,0,1,0,35181,1707,33474,0,28847,1800,27047,0,28131,0,28131,0,3016,0,3016
1081,30000,24000,0,1,0,0,1,0,-1,29325,0,29325,2,21449,0,21449,0,29709,29709,0,-1,29086,0,29086
1082,220000,176000,0,0,0,0,0,0,-2,1379,1385,-6,-2,-1,0,-1,-2,272,273,-1,-2,1628,1636,-8
1083,130000,104000,0,1,1,0,0,0,0,125733,6103,119630,0,118394,4823,113571,0,96230,4000,92230,0,98583,4000,94583
1084,200000,160000,0,0,0,0,0,0,0,41265,2626,38639,0,49072,9412,39660,0,11314,500,10814,0,11816,1000,10816
1085,130000,104000,0,0,0,0,0,0,-2,3955,3981,-26,-2,0,0,0,-2,708,708,0,-2,2773,2773,0
1086,220000,176000,0,0,0,0,0,0,0,126415,6047,120368,0,127447,4622,122825,0,129983,4652,125331,0,132727,4838,127889
1087,50000,40000,0,1,1,0,0,0,0,47066,1817,45249,0,44367,2000,42367,0,27496,1500,25996,0,27677,1001,26676
1088,280000,224000,0,0,0,0,0,0,-2,8971,9059,-88,-2,5747,5787,-40,-2,11927,11985,-58,-2,40170,40370,-200
1089,60000,48000,0,0,0,0,0,0,0,47023,2469,44554,0,57554,25000,32554,0,27412,1200,26212,0,27829,1008,26821
1090,70000,56000,0,0,0,0,0,0,0,28311,5000,23311,0,24094,3011,21083,0,21317,1500,19817,0,9736,1000,8736
1091,140000,112000,0,0,0,0,0,0,0,39811,2000,37811,0,41133,2000,39133,0,41730,2000,39730,0,42026,2000,40026
1092,20000,16000,0,1,1,1,1,0,0,18712,1400,17312,0,19682,1300,18382,0,18384,1000,17384,0,18768,680,18088
1093,130000,104000,0,0,0,0,0,0,-1,6712,6730,-18,-1,-884,900,-1784,-1,-6332,5448,-11780,-2,-9333,0,-9333
1094,340000,272000,0,0,0,0,0,0,-2,15018,15047,-29,-2,12062,12064,-2,-2,3894,3894,0,-2,7957,7957,0
1095,20000,16000,0,0,0,0,0,0,0,-1953,18047,-20000,-2,5985,7985,-2000,-1,6893,1000,5893,0,8273,2000,6273
1096,220000,176000,0,0,0,0,0,1,3,1090,0,1090,2,1090,0,1090,0,1090,0,1090,0,0,0,0
1097,280000,224000,0,0,0,0,0,0,-1,696,696,0,-1,696,696,0,-1,1392,1392,0,-1,696,0,696
1098,160000,128000,0,0,1,1,1,1,2,138289,13000,125289,2,134773,200,134573,2,142913,10500,132413,2,146003,5600,140403
1099,210000,168000,0,0,0,0,0,0,0,136428,6815,129613,0,54058,1800,52258,0,55398,2000,53398,0,56698,2000,54698
1100,50000,40000,0,0,0,0,0,0,0,20142,1315,18827,0,19920,703,19217,0,19722,723,18999,0,20437,1050,19387
1101,500000,400000,0,0,0,0,0,0,-1,390,0,390,2,0,0,0,2,3280,3280,0,-1,2500,0,2500
1102,280000,224000,0,0,0,0,0,1,2,170775,6000,164775,2,166749,5,166744,2,168739,5858,162881,0,166757,5741,161016
1103,300000,240000,0,0,0,0,0,1,-2,3572,3589,-17,-2,195,195,0,-2,209,210,-1,-2,990,994,-4
1104,300000,240000,0,0,0,0,0,0,-1,10000,2050,7950,0,0,0,0,0,0,0,0,-2,0,0,0
1105,200000,160000,0,0,0,0,0,0,0,6282,6282,0,-1,5906,5911,-5,-1,8787,6000,2787,0,14988,10000,4988
1106,40000,32000,0,1,1,1,1,0,0,34887,2000,32887,0,35607,1600,34007,0,36514,1500,35014,0,37921,2000,35921
1107,70000,56000,0,0,0,0,0,1,2,33632,0,33632,2,35747,3000,32747,0,38981,4000,34981,0,43331,5000,38331
1108,210000,168000,0,0,0,0,0,0,-1,0,0,0,-2,806,806,0,-1,1945,1945,0,-1,0,0,0
1109,380000,304000,0,0,0,0,0,0,-1,1299,1300,-1,-1,0,0,0,-1,0,0,0,-2,0,0,0
1110,50000,40000,0,0,0,0,0,0,-1,13876,13876,0,-1,13789,276,13513,0,725,725,0,0,0,0,0
1111,90000,72000,0,0,0,0,0,0,0,22265,2000,20265,0,30504,10004,20500,0,26909,1010,25899,0,25685,2000,23685
1112,60000,48000,0,0,0,0,0,0,2,9502,2000,7502,2,9217,0,9217,4,9722,800,8922,3,9291,0,9291
1113,10000,8000,0,1,0,1,1,0,2,9828,1133,8695,0,8637,1144,7493,0,8808,315,8493,0,8995,329,8666
1114,30000,24000,0,0,0,0,0,1,2,13909,1500,12409,2,13394,0,13394,3,13036,0,13036,2,15019,2200,12819
1115,50000,40000,0,1,0,0,0,0,0,49257,2316,46941,0,19641,690,18951,0,20053,715,19338,0,19613,718,18895
1116,50000,40000,0,0,0,0,0,1,2,35917,0,35917,2,26946,1036,25910,0,22458,817,21641,0,23569,1486,22083
1117,420000,336000,0,1,0,0,0,0,0,368259,15581,352678,0,344875,13000,331875,0,338552,12000,326552,0,345971,13000,332971
1118,50000,40000,0,0,0,0,0,1,2,28415,0,28415,2,18459,640,17819,0,16077,660,15417,0,12428,296,12132
1119,170000,136000,0,0,0,0,0,0,0,30544,2500,28044,0,30477,780,29697,0,2609,1100,1509,0,1359,400,959
1120,70000,56000,0,0,0,0,0,0,0,33333,2000,31333,0,34344,1600,32744,0,35032,1215,33817,0,35807,1300,34507
1121,120000,96000,0,0,0,0,0,0,0,6865,3147,3718,0,8209,12000,-3791,-1,4825,4000,825,0,4322,5000,-678
1122,30000,24000,0,0,0,0,0,0,2,16800,0,16800,2,16600,0,16600,0,11959,11959,0,-1,12957,1200,11757
1123,70000,56000,0,0,0,0,0,0,0,4540,4540,0,-1,39994,39994,0,-1,6844,6850,-6,-1,12308,10000,2308
1124,250000,200000,0,0,0,0,0,0,-2,390,390,0,-2,8042,8042,0,-1,16014,16014,0,-1,5607,5607,0
1125,280000,224000,0,0,0,0,0,1,2,2292,2292,0,-1,1153,1153,0,-1,607,0,607,2,3076,3076,0
1126,300000,240000,0,0,0,0,0,0,0,224062,9500,214562,0,212480,7500,204980,0,202148,6914,195234,0,186955,6100,180855
1127,80000,64000,0,0,0,0,0,0,-1,1393,1393,0,-1,1627,1627,0,-1,5189,5189,0,-1,10747,10747,0
1128,10000,8000,0,1,1,1,1,0,0,9474,1158,8316,0,9716,400,9316,0,9960,400,9560,0,10188,400,9788
1129,50000,40000,0,0,0,0,0,0,0,41150,2190,38960,0,30405,1100,29305,0,30671,1271,29400,0,30664,1264,29400
1130,110000,88000,0,0,0,0,0,0,0,76273,10000,66273,0,76409,3500,72909,0,76166,3000,73166,0,76384,3000,73384
1131,200000,160000,0,1,1,1,1,1,0,181089,8100,172989,0,183180,6600,176580,0,192223,12000,180223,0,189681,0,189681
1132,640000,512000,0,0,0,0,0,0,0,118372,30291,88081,0,33929,41,33888,0,79807,70128,9679,0,19552,19576,-24
1133,50000,40000,0,0,0,0,0,1,0,14777,1605,13172,0,12404,2000,10404,0,10777,500,10277,0,16597,6000,10597
1134,50000,40000,0,1,0,0,0,1,0,46368,3000,43368,0,2443,1000,1443,0,6251,6000,251,0,357,400,-43
1135,90000,72000,0,0,1,0,0,0,0,46678,1997,44681,0,85156,1995,83161,0,43269,1686,41583,0,44181,1749,42432
1136,180000,144000,0,0,0,0,1,0,0,132269,4900,127369,0,144990,15000,129990,0,152632,10000,142632,0,155935,6000,149935
1137,240000,192000,0,0,0,0,0,0,-2,0,0,0,-2,0,0,0,-2,0,0,0,-2,0,0,0
1138,30000,24000,0,1,1,1,1,1,2,28741,200,28541,2,30467,2492,27975,2,29858,0,29858,2,28898,580,28318
1139,80000,64000,0,0,0,0,0,0,0,52595,0,52595,2,56709,5000,51709,2,55201,0,55201,2,69270,15000,54270
1140,280000,224000,0,0,0,0,0,0,0,217637,8888,208749,0,177535,8006,169529,0,178337,6406,171931,0,180885,6606,174279
1141,180000,144000,0,0,0,0,0,1,0,124500,4371,120129,0,111430,3849,107581,0,98182,3405,94777,0,84598,2887,81711
1142,420000,336000,0,0,0,0,0,0,-2,0,0,0,-2,0,0,0,-2,0,0,0,-2,0,0,0
1143,80000,64000,0,0,0,0,0,0,0,0,0,0,0,0,0,0,-2,0,0,0,-2,0,0,0
1144,60000,48000,0,0,0,0,0,0,2,43153,3406,39747,2,43845,1700,42145,2,44795,1800,42995,2,45710,1800,43910
1145,20000,16000,0,0,0,0,0,0,0,9124,2000,7124,0,12915,10000,2915,0,4305,500,3805,0,18495,16000,2495
1146,30000,24000,0,0,0,0,0,1,2,15545,0,15545,2,16557,1275,15282,0,16857,575,16282,0,18121,1539,16582
1147,240000,192000,0,0,0,0,0,1,-1,291,291,0,-1,291,291,0,-1,291,291,0,-1,291,291,0
1148,210000,168000,0,0,0,0,0,0,0,56023,2931,53092,0,57137,2045,55092,0,58333,2117,56216,0,59373,2010,57363
1149,500000,400000,0,0,0,0,0,0,-2,0,0,0,-2,0,0,0,-2,0,0,0,-2,0,0,0
1150,450000,360000,0,0,0,0,0,0,-1,53938,55367,-1429,-1,14602,15174,-572,-1,18065,10528,7537,0,19239,10037,9202
1151,160000,128000,0,0,0,0,0,1,-1,326,326,0,-1,652,652,0,-1,326,0,326,0,476,476,0
1152,150000,120000,0,0,0,0,0,0,-1,10830,10830,0,-1,2501,2501,0,-1,4461,4461,0,-1,1240,1240,0
1153,100000,80000,0,0,0,0,0,1,0,81815,2986,78829,0,78927,2807,76120,0,77418,2686,74732,0,74657,2767,71890
1154,230000,184000,0,0,0,0,0,0,0,11864,2000,9864,0,10004,5000,5004,0,62349,65349,-3000,-1,52791,2000,50791
1155,10000,8000,0,0,0,0,0,0,0,511,511,0,-1,7696,7696,0,-1,8696,1000,7696,0,7660,0,7660
1156,280000,224000,0,0,0,0,0,0,0,39379,1304,38075,0,13409,1000,12409,0,40854,29485,11369,0,2930,2930,0
1157,150000,120000,0,0,0,0,0,1,0,110722,4100,106622,0,98874,4000,94874,0,65258,2675,62583,0,58027,2500,55527
1158,240000,192000,0,0,0,0,0,0,0,68907,3000,65907,0,70164,3000,67164,0,70672,2509,68163,0,69581,3000,66581
1159,110000,88000,0,0,0,0,0,1,-2,176,176,0,-2,-150,0,-150,-2,150,952,-802,-2,952,952,0
1160,160000,128000,0,1,1,1,1,1,2,135146,5000,130146,2,136520,5100,131420,2,139432,5252,134180,2,141971,5000,136971
1161,50000,40000,0,0,0,0,0,0,-1,0,0,0,-2,0,0,0,-2,0,0,0,-2,0,0,0
1162,30000,24000,0,1,1,0,0,0,0,29885,1650,28235,0,30188,950,29238,0,21647,800,20847,0,22087,800,21287
1163,100000,80000,0,0,0,0,0,1,0,12183,2000,10183,0,13670,2000,11670,0,15129,2000,13129,0,15732,1000,14732
1164,360000,288000,0,0,0,0,0,0,-1,0,0,0,-1,0,0,0,-2,0,0,0,-2,6232,6232,0
1165,150000,120000,0,0,0,0,0,0,-1,2162,2162,0,-1,0,0,0,-1,5085,5085,0,-1,2887,2887,0
1166,260000,208000,0,0,0,0,0,0,0,137558,5000,132558,0,140455,5184,135271,0,144032,6000,138032,0,146615,5026,141589
1167,70000,56000,0,1,1,1,1,0,0,69217,4000,65217,0,69327,3200,66127,0,68582,3000,65582,0,68677,3000,65677
1168,270000,216000,0,0,0,0,0,0,-1,608,608,0,-1,494,494,0,-1,315,315,0,-1,0,0,0
1169,130000,104000,0,0,0,0,0,1,-1,582,582,0,-1,291,0,291,0,441,441,0,-1,441,441,0
1170,80000,64000,0,0,0,0,0,0,-2,120,360,-240,-2,0,0,0,-2,0,0,0,-2,0,0,0
1171,480000,384000,0,0,0,0,0,0,-1,0,0,0,-1,0,0,0,-2,4415,4415,0,-1,1978,0,1978
1172,140000,112000,0,0,0,0,0,0,0,59862,10027,49835,0,42040,5008,37032,0,32591,5013,27578,0,21090,5008,16082
1173,200000,160000,0,0,0,0,0,0,0,96064,5000,91064,0,103511,9054,94457,0,100951,0,100951,2,103364,4200,99164
1174,230000,184000,0,0,0,0,0,0,2,17295,1200,16095,0,18335,3000,15335,0,9320,0,9320,2,1858,254,1604
1175,50000,40000,0,0,0,0,0,0,0,32218,1647,30571,0,20650,1050,19600,0,0,0,0,0,0,0,0
1176,60000,48000,0,0,0,0,0,0,0,10816,1003,9813,0,6956,0,6956,0,2489,1050,1439,0,0,0,0
1177,180000,144000,0,0,0,0,0,1,2,0,0,0,2,0,0,0,-2,1378,1704,-326,-1,978,0,978
1178,200000,160000,0,1,1,1,1,0,0,196787,7100,189687,0,194632,7100,187532,0,198839,7400,191439,0,196550,7200,189350
1179,290000,232000,0,0,0,0,0,1,0,10005,0,10005,2,10838,1000,9838,0,11663,1000,10663,0,13301,2000,11301
1180,50000,40000,0,1,1,1,1,1,2,51921,2500,49421,2,50767,0,50767,2,48488,1721,46767,0,49503,1782,47721
1181,210000,168000,0,0,0,0,0,0,0,90651,3381,87270,0,85295,3400,81895,0,80416,2684,77732,0,76946,2744,74202
1182,50000,40000,0,0,0,0,0,0,2,20767,1500,19267,2,20136,0,20136,2,21802,2000,19802,2,21315,0,21315
1183,310000,248000,0,0,0,0,0,0,-1,26863,26863,0,-1,7443,7443,0,-1,4221,0,4221,0,8172,8172,0
1184,120000,96000,0,1,0,0,0,0,2,115804,6781,109023,2,92542,0,92542,2,83581,5550,78031,2,61650,0,61650
1185,70000,56000,0,0,0,0,0,0,0,0,0,0,-2,0,0,0,-2,0,0,0,-2,0,0,0
1186,200000,160000,0,0,0,0,0,1,-2,0,0,0,-2,0,0,0,-2,0,0,0,-2,0,0,0
1187,440000,352000,0,0,0,0,0,0,-1,850,850,0,-1,10799,10819,-20,-1,746,746,0,-1,600,600,0
1188,30000,24000,0,0,0,0,0,1,0,20306,0,20306,2,20965,1000,19965,0,21625,1000,20625,0,22055,790,21265
1189,30000,24000,0,0,0,0,0,0,-1,390,390,0,-1,1438,1438,0,-1,719,0,719,0,1588,1588,0
1190,500000,400000,0,0,0,0,0,0,0,78031,3500,74531,0,78946,2818,76128,0,76689,2743,73946,0,77968,3000,74968
1191,80000,64000,0,0,0,0,0,0,-1,5114,5114,0,-1,0,0,0,-1,0,0,0,-2,0,0,0
1192,210000,168000,0,0,0,0,0,0,0,0,0,0,0,0,0,0,-2,0,0,0,-2,0,0,0
1193,240000,192000,0,1,1,0,0,1,0,230690,8300,222390,0,213633,7200,206433,0,176135,6200,169935,0,179027,6550,172477
1194,80000,64000,0,0,1,1,1,1,0,82215,20412,61803,0,80422,0,80422,2,78284,3000,75284,0,77270,3000,74270
1195,230000,184000,0,0,0,0,0,0,-1,476,0,476,2,3157,3157,0,-1,340,0,340,0,769,769,0
1196,20000,16000,0,0,0,0,0,0,0,16803,2004,14799,0,16525,1500,15025,0,16185,1500,14685,0,-2623,0,-2623
1197,90000,72000,0,0,0,0,0,1,-1,390,0,390,2,780,780,0,-1,390,0,390,0,780,780,0
1198,380000,304000,0,0,0,0,0,0,-1,188,188,0,-1,2172,2172,0,-1,5173,5173,0,-1,5446,5446,0
1199,390000,312000,0,0,0,0,0,1,-2,0,0,0,-2,0,0,0,-2,0,0,0,-2,0,0,0
1200,100000,80000,0,0,0,0,0,0,2,0,0,0,-2,0,0,0,-2,0,0,0,-2,-150953,0,-150953
1201,200000,160000,0,0,0,0,0,0,-2,12840,12848,-8,-2,3950,3950,0,-2,7688,7690,-2,-2,2241,2241,0
1202,140000,112000,0,1,1,0,0,0,0,123491,5000,118491,0,118886,5000,113886,0,117059,7500,109559,0,117405,7000,110405
1203,180000,144000,0,0,0,0,0,0,0,95955,3500,92455,0,98354,4000,94354,0,105327,8600,96727,0,107500,4000,103500
1204,130000,104000,0,1,1,0,0,0,0,110317,4000,106317,0,108099,3863,104236,0,106028,3831,102197,0,104253,4136,100117
1205,100000,80000,0,0,0,0,0,0,0,33077,5024,28053,0,43593,43593,0,-1,40782,1700,39082,0,37949,1500,36449
1206,50000,40000,0,0,0,0,0,0,-2,0,0,0,-2,0,0,0,-2,0,0,0,-2,0,0,0
1207,330000,264000,0,0,0,0,0,0,-1,18585,18585,0,-2,13835,13835,0,-2,45476,45476,0,-2,25125,25125,0
1208,240000,192000,0,0,0,0,0,0,0,6809,4015,2794,0,29324,25000,4324,0,30924,2000,28924,0,35770,5000,30770
1209,70000,56000,0,1,0,0,0,1,0,69970,2563,67407,0,57118,1568,55550,0,27510,970,26540,0,27176,1000,26176
1210,100000,80000,0,1,1,0,0,0,0,93409,4700,88709,0,95056,4500,90556,0,75688,3000,72688,0,77330,2900,74430
1211,70000,56000,0,0,0,0,0,0,0,8670,1400,7270,0,9764,1400,8364,0,9954,500,9454,0,10144,500,9644
1212,180000,144000,0,1,1,1,1,0,0,168208,6117,162091,0,171667,6268,165399,0,175219,6445,168774,0,173597,6379,167218
1213,70000,56000,0,0,0,0,0,0,-2,5173,69900,-64727,-1,6345,1262,5083,0,7083,1000,6083,0,8961,2000,6961
1214,190000,152000,0,0,0,0,0,0,-2,6101,6101,0,-1,4803,4803,0,-1,5039,5039,0,-1,0,0,0
1215,50000,40000,0,0,0,0,0,0,-2,-1,0,-1,-2,-1,0,-1,-2,349,350,-1,-1,350,351,-1
1216,20000,16000,0,0,0,0,0,1,-1,780,780,0,-1,390,0,390,0,390,390,0,-1,0,0,0
1217,80000,64000,0,0,0,0,0,1,0,9821,5098,4723,0,600,600,0,-1,53900,53900,0,-1,55000,1100,53900
1218,110000,88000,0,0,0,0,0,0,0,26351,2000,24351,0,26996,2000,24996,0,27754,1500,26254,0,28597,2000,26597
1219,350000,280000,0,0,0,0,0,0,-2,162651,164395,-1744,-2,13514,49,13465,-2,36306,36491,-185,-1,14974,15049,-75
1220,320000,256000,0,0,0,0,0,0,0,72029,2568,69461,0,72849,2570,70279,0,74374,2661,71713,0,74610,2781,71829
1221,260000,208000,0,0,0,0,0,0,0,51524,2000,49524,0,52681,2000,50681,0,53852,2000,51852,0,55967,3000,52967
1222,80000,64000,0,0,0,0,0,0,0,23352,1700,21652,0,23301,1000,22301,0,23900,1500,22400,0,24965,2000,22965
1223,120000,96000,0,0,0,0,0,1,0,28999,3000,25999,0,30064,2000,28064,0,33732,5000,28732,0,5992,0,5992
1224,80000,64000,0,1,1,1,1,1,2,73690,4000,69690,3,71908,0,71908,3,76294,5700,70594,2,74788,0,74788
1225,180000,144000,0,0,0,0,0,0,-2,6980,6980,0,-2,10628,10628,0,-2,9920,9920,0,-2,6205,6205,0
1226,210000,168000,0,0,0,0,0,0,0,50486,5000,45486,0,54019,5000,49019,0,58091,5000,53091,0,61630,4500,57130
1227,360000,288000,0,0,0,0,0,0,-2,1064,1064,0,-2,530,530,0,-2,822,822,0,-2,2222,2222,0
1228,20000,16000,0,0,0,0,1,0,0,15025,1200,13825,0,16504,2000,14504,0,17950,2000,15950,0,19558,2000,17558
1229,90000,72000,1,1,1,1,1,0,2,92860,2400,90460,2,88533,1000,87533,2,90942,4000,86942,0,88813,3600,85213
1230,30000,24000,0,1,1,0,0,0,0,30050,2002,28048,0,29797,1025,28772,0,18464,1230,17234,0,12235,1042,11193
1231,30000,24000,0,0,0,0,0,0,-1,0,0,0,-1,504,504,0,-1,279,300,-21,-1,254,500,-246
1232,30000,24000,0,1,1,1,1,0,0,28316,1790,26526,0,28966,1440,27526,0,29542,1016,28526,0,30163,1055,29108
1233,100000,80000,0,1,1,1,1,0,0,87189,4000,83189,0,89539,4100,85439,0,91258,4000,87258,0,93343,3241,90102
1234,410000,328000,0,0,0,0,0,0,-1,4054,4204,-150,-1,3830,0,3830,2,3160,3160,0,-1,49828,49828,0
1235,390000,312000,0,0,0,0,0,0,-2,0,0,0,-2,0,0,0,-2,0,0,0,-2,5112,5112,0
1236,30000,24000,0,0,0,0,0,0,2,21045,1500,19545,0,24681,4000,20681,0,23985,0,23985,2,25099,1500,23599
1237,50000,40000,0,0,0,0,0,0,0,0,0,0,-2,0,0,0,-2,0,1500,-1500,-2,0,0,0
1238,200000,160000,0,0,0,0,0,0,-1,8971,8981,-10,-1,8509,8525,-16,-1,29645,29713,-68,-1,7300,7305,-5
1239,200000,160000,0,0,0,0,0,0,-1,780,780,0,-1,390,390,0,-1,0,0,0,-1,390,390,0
1240,140000,112000,0,0,0,0,0,0,-1,2677,2698,-21,-1,2985,6069,-3084,-1,3739,3889,-150,-1,1242,1242,0
1241,200000,160000,0,0,0,0,0,1,-2,35063,35063,0,-1,0,16720,-16720,-1,0,0,0,-2,5799,5799,0
1242,200000,160000,0,0,0,0,0,0,0,117248,5571,111677,0,104889,5221,99668,0,103668,4001,99667,0,105467,4001,101466
1243,240000,192000,0,0,0,0,0,0,0,178840,10000,168840,0,186168,10000,176168,0,166745,10000,156745,0,165582,5000,160582
1244,80000,64000,0,0,0,0,0,0,0,4136,2000,2136,0,0,0,0,0,0,0,0,-2,150,150,0
1245,460000,368000,0,0,0,0,0,0,0,16712,1714,14998,0,15635,1000,14635,0,6965,1000,5965,0,7107,142,6965
1246,100000,80000,0,1,1,1,1,1,2,96674,3800,92874,2,97983,3800,94183,2,102803,7300,95503,2,100960,0,100960
1247,420000,336000,0,0,0,0,0,0,0,232028,11020,221008,0,233055,10238,222817,0,191518,10022,181496,0,192313,7000,185313
1248,160000,128000,0,0,0,0,0,0,0,0,0,0,-2,0,0,0,-2,0,0,0,-2,0,0,0
1249,230000,184000,0,0,0,0,0,0,0,20010,1067,18943,0,0,0,0,0,104160,104160,0,-1,0,0,0
1250,470000,376000,0,0,0,0,0,1,0,54551,4005,50546,0,14363,2021,12342,0,97440,97441,-1,-1,90717,5001,85716
1251,160000,128000,0,0,0,0,0,0,-1,1443,1443,0,-1,1443,1443,0,-1,1443,1443,0,-1,1443,1443,0
1252,210000,168000,0,0,0,0,0,0,-1,1000,1000,0,-1,15385,15385,0,-1,20302,5302,15000,0,25112,5112,20000
1253,360000,288000,0,0,0,0,0,0,-1,21715,21823,-108,-1,5064,5089,-25,-1,9147,9192,-45,-1,6068,6098,-30
1254,60000,48000,0,0,0,0,0,1,2,18619,1500,17119,0,19636,1328,18308,0,20326,1018,19308,0,21534,1687,19847
1255,180000,144000,0,1,1,0,0,0,0,182709,6792,175917,0,149997,5490,144507,0,142612,5156,137456,0,140493,5232,135261
1256,360000,288000,0,0,0,0,0,0,0,52950,3053,49897,0,44625,3122,41503,0,21906,1030,20876,0,16190,610,15580
1257,220000,176000,0,0,0,0,0,0,0,0,0,0,0,0,0,0,-2,0,0,0,-2,0,0,0
1258,250000,200000,0,0,0,0,0,0,0,3645,2000,1645,0,3090,1000,2090,0,3700,1000,2700,0,1190,0,1190
1259,440000,352000,0,0,0,0,0,0,0,4012,1084,2928,0,821,821,0,-1,821,821,0,-1,821,821,0
1260,390000,312000,0,0,0,0,0,0,0,204333,8000,196333,0,201825,7500,194325,0,199355,7500,191855,0,197036,7500,189536
1261,30000,24000,0,0,0,0,0,1,-2,0,0,0,-2,0,0,0,-2,0,0,0,-2,0,0,0
1262,50000,40000,0,1,1,1,1,0,0,48395,2760,45635,0,49604,2750,46854,0,48397,1507,46890,0,49847,2000,47847
1263,110000,88000,0,1,1,0,0,0,0,110768,5000,105768,2,110480,5060,105420,0,48708,2000,46708,0,47060,3000,44060
1264,150000,120000,0,0,0,0,0,0,0,28901,1650,27251,0,27587,2000,25587,0,25531,2000,23531,0,26586,3000,23586
1265,50000,40000,0,0,0,0,0,0,2,35929,2180,33749,0,0,0,0,0,0,0,0,-2,0,0,0
1266,70000,56000,0,0,0,0,0,0,0,34689,1881,32808,0,35700,1892,33808,0,36252,1444,34808,0,37008,1490,35518
1267,120000,96000,0,0,0,0,0,0,0,61181,3000,58181,0,52187,2000,50187,0,49327,2000,47327,0,41096,1500,39596
1268,240000,192000,0,0,0,0,0,0,0,47026,1923,45103,0,45827,1682,44145,0,39527,2000,37527,0,40868,2000,38868
1269,50000,40000,0,0,0,0,0,0,0,23168,21578,1590,0,20245,1310,18935,0,20251,706,19545,0,19970,806,19164
1270,50000,40000,0,0,0,0,0,0,0,10745,9537,1208,0,9994,5000,4994,0,16829,10000,6829,0,13051,5000,8051
1271,200000,160000,0,0,0,0,0,1,-1,660,0,660,2,1320,1320,0,-1,1320,1320,0,-1,1710,1710,0
1272,150000,120000,0,0,0,0,0,1,0,19902,7000,12902,0,23068,3500,19568,0,26184,3500,22684,0,25615,0,25615
1273,20000,16000,0,0,0,0,0,0,-1,780,0,780,2,1560,0,1560,0,780,0,780,0,0,0,0
1274,240000,192000,0,0,0,0,0,0,0,20496,10000,10496,0,15296,5000,10296,0,24332,15000,9332,0,23896,15000,8896
1275,80000,64000,0,1,0,0,0,0,0,79897,3900,75997,0,27950,1200,26750,0,28579,1230,27349,0,29138,1230,27908
1276,160000,128000,0,0,0,0,0,0,0,124438,5810,118628,0,112113,4591,107522,0,96459,3524,92935,0,93449,3542,89907
1277,130000,104000,0,0,0,0,0,0,-1,17055,17055,0,-1,14693,575,14118,0,14855,449,14406,0,14817,1000,13817
1278,100000,80000,0,0,0,0,0,0,0,48162,2102,46060,0,48806,1746,47060,0,49910,1890,48020,0,51400,2400,49000
1279,100000,80000,0,0,0,0,0,0,0,29395,1000,28395,2,28895,0,28895,2,105,1000,-895,-1,955,1000,-45
1280,20000,16000,0,1,0,0,0,0,2,19857,1200,18657,0,15422,0,15422,0,19279,9537,9742,0,9537,0,9537
1281,110000,88000,0,0,0,0,0,0,0,50526,20000,30526,0,51816,3000,48816,0,34262,3000,31262,0,23366,3000,20366
1282,180000,144000,0,0,0,0,0,0,0,105945,4400,101545,0,111065,10000,101065,0,122028,12900,109128,0,125069,5000,120069
1283,340000,272000,0,0,0,0,0,1,-2,0,0,0,-2,0,0,0,-2,0,0,0,-2,0,0,0
1284,300000,240000,0,0,0,0,0,1,-2,0,0,0,-2,0,0,0,-2,0,0,0,-2,0,0,0
1285,50000,40000,1,1,0,0,0,0,0,64104,2500,61604,0,33406,1985,31421,0,34104,1163,32941,0,34869,1256,33613
1286,80000,64000,0,0,0,0,0,1,0,45240,2500,42740,0,43967,2000,41967,0,45302,2000,43302,0,49646,5012,44634
1287,400000,320000,0,0,0,0,0,0,-1,18182,2600,15582,-1,12205,24,12181,2,941,1000,-59,-1,6346,7053,-707
1288,50000,40000,0,0,0,0,0,0,0,17523,1617,15906,0,18467,1561,16906,0,17865,759,17106,0,18234,779,17455
1289,70000,56000,0,0,0,0,0,0,-1,19,19,0,-1,-254,0,-254,-1,-527,0,-527,-2,1096,1896,-800
1290,100000,80000,0,0,0,0,0,0,0,19664,1407,18257,0,16407,328,16079,0,15068,935,14133,0,40794,42000,-1206
1291,150000,120000,0,0,0,0,0,1,-2,0,0,0,-2,0,0,0,-2,0,0,0,-2,0,0,0
1292,50000,40000,0,0,0,0,0,0,-1,47225,49325,-2100,-1,16483,3001,13482,0,9343,1882,7461,0,9693,500,9193
1293,50000,40000,0,0,0,0,0,1,2,4991,300,4691,2,4461,200,4261,0,2561,0,2561,0,0,0,0
1294,30000,24000,0,0,0,0,0,0,0,24564,2000,22564,0,25823,2000,23823,0,26269,2500,23769,0,26335,3000,23335
1295,50000,40000,0,1,1,0,0,0,0,46798,2298,44500,0,47647,2100,45547,0,40500,2500,38000,0,41921,1921,40000
1296,120000,96000,0,0,0,0,0,0,0,21930,1700,20230,0,22165,1500,20665,0,20502,700,19802,0,19030,1000,18030
1297,150000,120000,0,0,0,0,0,0,0,13086,1500,11586,0,13086,1500,11586,0,3555,1000,2555,0,0,0,0
1298,50000,40000,0,0,0,0,0,0,4,18687,0,18687,3,17956,0,17956,2,17710,354,17356,0,18710,1000,17710
1299,360000,288000,0,0,0,0,0,1,-2,0,0,0,-2,0,0,0,-2,0,0,0,-2,0,0,0
1300,400000,320000,0,0,0,0,0,0,-1,79259,10000,69259,0,87413,10009,77404,0,92269,8000,84269,0,100973,10000,90973
1301,260000,208000,0,0,0,0,0,0,0,142380,5046,137334,0,141746,4573,137173,0,112938,4000,108938,0,110346,3800,106546
1302,180000,144000,0,0,0,0,0,0,-1,92,92,0,-1,603,603,0,-1,1760,1760,0,-1,826,826,0
1303,460000,368000,0,0,0,0,0,0,0,35415,1000,34415,0,0,0,0,-2,1619,1619,0,-1,3795,3795,0
1304,70000,56000,0,0,1,1,1,0,0,63341,10000,53341,0,64694,3000,61694,0,67905,5000,62905,0,59383,3000,56383
1305,50000,40000,0,0,0,0,0,1,-1,390,390,0,-1,390,390,0,-1,390,390,0,-1,390,390,0
1306,440000,352000,0,0,0,0,0,1,-1,775,1,774,2,775,776,-1,-1,925,926,-1,-1,775,776,-1
1307,210000,168000,0,0,0,0,0,0,-2,-2,0,-2,-2,560,562,-2,-2,6190,6196,-6,-2,243,243,0
1308,100000,80000,0,0,0,0,0,1,2,5836,1000,4836,0,6746,2000,4746,0,7889,3323,4566,0,0,0,0
1309,60000,48000,0,1,1,0,0,0,0,57138,2285,54853,0,51026,1429,49597,0,24213,169,24044,0,5295,426,4869
1310,120000,96000,0,0,0,0,0,1,-2,0,0,0,-2,0,0,0,-2,0,0,0,-2,0,0,0
1311,360000,288000,0,0,0,0,0,0,0,12148,12163,-15,-1,12885,3787,9098,0,12994,714,12280,0,15320,5369,9951
1312,500000,400000,0,0,0,0,0,0,-1,229,229,0,-1,3377,3377,0,-1,441,441,0,-1,24116,24116,0
1313,360000,288000,0,0,0,0,0,0,-2,38645,38722,-77,-2,5235,5235,0,-2,4710,4710,0,-2,6392,6392,0
1314,50000,40000,0,1,1,0,0,0,0,46604,2005,44599,0,47982,2383,45599,0,29667,1068,28599,0,30449,1266,29183
1315,260000,208000,0,0,0,0,0,0,0,100606,4523,96083,0,93022,3154,89868,0,61746,2025,59721,0,47819,1709,46110
1316,50000,40000,0,0,0,0,0,0,0,20197,1348,18849,0,19528,1257,18271,0,19520,639,18881,0,17420,622,16798
1317,230000,184000,0,0,0,0,0,0,2,10507,1000,9507,0,6742,135,6607,0,4387,4387,0,-1,1670,1670,0
1318,260000,208000,1,1,1,0,0,1,0,297313,6633,290680,0,276948,6889,270059,0,2378,1025,1353,0,-2709,2047,-4756
1319,20000,16000,0,0,0,0,0,1,0,15524,3006,12518,0,14807,3506,11301,0,13667,3500,10167,0,16271,7011,9260
1320,90000,72000,0,0,0,0,0,0,0,20840,1339,19501,0,21023,1638,19385,0,20776,890,19886,0,21055,763,20292
1321,50000,40000,0,0,0,0,0,0,0,780,780,0,-1,390,0,390,0,850,850,0,-1,18460,18000,460
1322,50000,40000,0,0,0,0,0,0,2,27213,1500,25713,0,28521,1771,26750,0,28458,1500,26958,0,29053,1053,28000
1323,50000,40000,0,1,1,1,1,1,2,42891,0,42891,3,43582,1700,41882,2,44561,2000,42561,2,45592,1900,43692
1324,300000,240000,0,0,0,0,0,0,0,11671,2012,9659,0,12888,3902,8986,0,17915,7924,9991,0,18923,2932,15991
1325,200000,160000,0,0,0,0,0,0,-1,4271,4271,0,-1,3696,3696,0,-1,0,0,0,-1,2099,2099,0
1326,50000,40000,0,0,0,0,0,0,-1,12372,12534,-162,-1,14029,14031,-2,-1,14298,14298,0,-1,16496,16496,0
1327,160000,128000,0,0,0,0,0,0,0,61292,2000,59292,0,16623,15000,1623,0,33393,33000,393,0,34220,3000,31220
1328,40000,32000,0,0,0,0,0,1,2,9895,1000,8895,2,11420,2000,9420,0,12723,1500,11223,0,14360,2000,12360
1329,240000,192000,0,0,0,0,0,0,0,161691,8200,153491,0,165177,9009,156168,0,132478,5000,127478,0,138979,10500,128479
1330,20000,16000,0,0,0,0,0,1,2,5989,2266,3723,2,5761,38,5723,2,0,0,0,2,0,0,0
1331,210000,168000,0,0,0,0,0,1,0,21482,2000,19482,0,23118,2000,21118,0,23437,1000,22437,0,24900,2000,22900
1332,20000,16000,0,0,0,0,0,1,-1,3503,3010,493,-1,4809,6000,-1191,-1,5732,1000,4732,0,8632,3000,5632
1333,270000,216000,0,0,0,0,0,0,-1,3679,1522,2157,0,4065,4065,0,-1,3975,4056,-81,-1,8195,81,8114
1334,20000,16000,0,0,0,0,0,1,-2,0,0,0,-2,0,0,0,-2,0,0,0,-2,0,0,0
1335,250000,200000,0,0,0,0,0,0,-1,4559,4563,-4,-1,3110,24,3086,0,0,0,0,0,664,664,0
1336,150000,120000,0,0,0,0,0,0,-1,508,509,-1,-1,9634,9636,-2,-1,3822,3822,0,-1,1769,1779,-10
1337,80000,64000,0,0,0,0,0,0,-1,2290,2290,0,-1,1459,1459,0,-1,6764,6764,0,-1,7601,7601,0
1338,360000,288000,0,0,0,0,0,0,-1,4371,4377,-6,-1,6365,6400,-35,-1,2987,3002,-15,-1,2979,2994,-15
1339,60000,48000,0,0,0,0,0,0,0,9754,4457,5297,0,7795,37,7758,2,8258,500,7758,2,8370,300,8070
1340,100000,80000,0,0,0,0,0,1,2,24541,0,24541,2,27304,3100,24204,2,26669,0,26669,3,26172,0,26172
1341,80000,64000,0,1,1,1,1,1,2,79384,3500,75884,2,77519,0,77519,2,82607,7000,75607,2,81158,0,81158
1342,50000,40000,0,0,0,0,0,0,0,12274,2000,10274,0,11780,0,11780,2,14578,3000,11578,0,18309,4000,14309
1343,80000,64000,0,0,0,0,0,1,3,52059,2100,49959,2,47912,0,47912,2,48646,1800,46846,0,49341,2000,47341
1344,40000,32000,0,0,0,0,0,0,0,16390,2000,14390,0,9891,3538,6353,0,9594,0,9594,2,9798,500,9298
1345,80000,64000,0,0,0,0,0,0,-1,500,765,-265,-1,0,0,0,-1,0,0,0,-2,0,0,0
1346,80000,64000,0,0,0,0,0,0,0,317,450,-133,-1,401,500,-99,-1,34985,35000,-15,-1,37004,3000,34004
1347,160000,128000,0,0,0,0,0,1,0,39847,1940,37907,0,39114,1400,37714,0,39935,1451,38484,0,41269,2000,39269
1348,30000,24000,0,0,0,0,0,1,2,1650,0,1650,2,1650,0,1650,4,1650,0,1650,4,1650,0,1650
1349,240000,192000,0,1,1,1,0,0,0,226399,10000,216399,0,203561,7100,196461,0,205730,7500,198230,0,199631,7990,191641
1350,300000,240000,0,0,0,0,0,0,2,25945,1380,24565,0,22318,753,21565,0,18636,630,18006,0,15374,1000,14374
1351,70000,56000,0,1,1,0,0,0,0,71230,3098,68132,0,68655,2811,65844,0,41679,1281,40398,0,29887,1069,28818
1352,120000,96000,0,0,0,0,0,0,0,61042,2407,58635,0,61253,1421,59832,0,57695,0,57695,0,2530,0,2530
1353,150000,120000,0,0,0,0,0,0,-1,14517,14517,0,-1,1870,0,1870,0,3495,3495,0,-1,0,0,0
1354,120000,96000,0,0,0,0,0,0,-1,2402,2500,-98,-1,18700,38098,-19398,-1,9900,5000,4900,0,0,0,0
1355,220000,176000,0,0,0,0,0,0,-1,5602,5602,0,-1,769,769,0,-1,5595,5595,0,-1,2538,2538,0
1356,280000,224000,0,0,0,0,0,0,-1,1485,1492,-7,-1,5727,5727,0,-1,1247,1247,0,-1,2037,2037,0
1357,10000,8000,0,1,1,1,1,1,4,9244,0,9244,3,8949,0,8949,2,9137,480,8657,0,9177,340,8837
1358,100000,80000,0,0,0,0,0,0,0,26333,7009,19324,0,28110,1777,26333,0,2226,2000,226,0,0,0,0
1359,20000,16000,0,0,0,0,0,0,-2,0,0,0,-2,0,0,0,-2,0,0,0,-2,790,790,0
1360,110000,88000,0,0,0,0,0,0,0,4296,1054,3242,0,5043,1000,4043,0,5194,1000,4194,0,6110,1000,5110
1361,50000,40000,0,0,0,0,0,1,2,8643,1200,7443,0,7382,0,7382,0,1975,0,1975,0,50514,49800,714
1362,20000,16000,0,0,0,0,0,0,-1,0,0,0,-1,0,0,0,-2,0,0,0,-2,0,0,0
1363,220000,176000,0,0,0,0,0,1,2,162360,6000,156360,2,134989,6000,128989,0,124915,4000,120915,0,84959,2852,82107
1364,170000,136000,0,0,0,0,0,0,-1,3866,3866,0,-1,14894,14894,0,-1,6833,137,6696,0,6972,139,6833
1365,100000,80000,0,0,0,0,0,0,0,9777,2000,7777,0,10026,1000,9026,0,9657,504,9153,0,9279,1000,8279
1366,100000,80000,0,0,0,0,0,1,0,49380,1500,47880,0,29152,1500,27652,0,28832,1500,27332,0,29949,1500,28449
1367,60000,48000,0,0,0,0,0,0,0,38840,2000,36840,0,31965,1812,30153,0,30297,1037,29260,0,29814,1218,28596
1368,110000,88000,0,1,1,1,1,0,0,105089,6000,99089,0,107164,6000,101164,0,105988,4000,101988,0,108617,5000,103617
1369,240000,192000,0,1,1,1,1,0,2,242629,10949,231680,0,239438,9419,230019,0,203445,7461,195984,0,203585,7601,195984
1370,80000,64000,0,0,0,0,0,1,2,20471,1700,18771,2,20638,800,19838,2,21003,1000,20003,2,20529,0,20529
1371,90000,72000,0,0,0,0,0,0,0,32037,1357,30680,0,14589,1037,13552,0,10237,243,9994,0,10066,244,9822
1372,150000,120000,0,1,1,1,1,0,0,147235,6900,140335,0,147997,6690,141307,0,145405,5300,140105,0,146502,5500,141002
1373,50000,40000,0,1,1,1,1,0,0,46153,1700,44453,0,45572,1585,43987,0,45412,2000,43412,0,44985,2000,42985
1374,360000,288000,0,0,0,0,0,0,-1,42791,42887,-96,-1,31830,31839,-9,-1,30693,30693,0,-1,596,3,593
1375,150000,120000,0,0,0,0,0,0,-1,291,291,0,-1,285,285,0,-1,2085,2091,-6,-1,8669,8695,-26
1376,80000,64000,1,1,1,0,0,1,2,80495,0,80495,2,78027,2350,75677,0,30052,1048,29004,0,30373,1077,29296
1377,300000,240000,0,0,0,0,0,0,0,15196,5000,10196,0,19406,5000,14406,0,23260,4000,19260,0,15423,5000,10423
1378,100000,80000,0,0,0,0,0,1,0,101565,81565,20000,0,82087,2625,79462,0,81201,3931,77270,0,77928,2900,75028
1379,20000,16000,0,1,1,0,0,0,2,18918,1251,17667,0,19323,656,18667,0,13180,13180,0,-1,5200,5200,0
1380,50000,40000,0,0,0,0,0,0,0,49263,50045,-782,-1,29063,992,28071,0,26644,1000,25644,0,27201,1000,26201
1381,320000,256000,0,0,0,0,0,0,0,58124,20000,38124,0,70717,20000,50717,0,78149,15000,63149,0,70379,40000,30379
1382,440000,352000,0,0,0,0,0,0,-2,0,0,0,-2,17297,17297,0,-1,0,0,0,-1,13497,13497,0
1383,180000,144000,0,0,0,0,0,0,-2,2329,2329,0,-2,1778,1778,0,-2,2510,2514,-4,-2,184,184,0
1384,50000,40000,0,0,0,0,0,1,0,23670,1000,22670,2,22994,0,22994,2,23473,1000,22473,0,23932,1000,22932
1385,50000,40000,0,1,1,0,0,0,0,50951,2210,48741,0,50818,3300,47518,0,40453,1910,38543,0,37862,1530,36332
1386,210000,168000,0,0,0,0,0,0,0,135173,5005,130168,0,124843,8500,116343,0,125294,4392,120902,0,104545,4000,100545
1387,150000,120000,0,1,1,1,1,0,0,129099,0,129099,2,136717,11300,125417,2,133030,0,133030,2,141193,10500,130693
1388,30000,24000,0,0,0,0,0,0,2,15038,2905,12133,2,14502,0,14502,2,15501,1386,14115,2,15105,0,15105
1389,500000,400000,0,0,0,0,0,0,0,60927,30007,30920,0,76088,30000,46088,0,110294,50000,60294,0,108964,5000,103964
1390,50000,40000,0,0,0,0,0,0,0,9799,1500,8299,0,10054,400,9654,0,9736,344,9392,0,9955,371,9584
1391,20000,16000,0,0,0,1,0,0,0,14371,1100,13271,2,17963,4100,13863,2,17185,6,17179,2,16638,2000,14638
1392,50000,40000,0,1,0,0,0,0,0,45320,2500,42820,0,38446,2000,36446,0,36748,2000,34748,0,36827,1465,35362
1393,200000,160000,0,0,0,0,0,1,-2,24753,24891,-138,-2,123439,125171,-1732,-2,132269,17816,114453,-2,129224,26269,102955
1394,520000,416000,0,0,0,0,0,0,-2,385425,415552,-30127,-1,387189,14000,373189,0,395445,14005,381440,0,402289,14000,388289
1395,500000,400000,0,0,0,0,0,0,-2,0,0,0,-2,0,0,0,-2,1981,1981,0,-1,1700,1700,0
1396,210000,168000,0,0,0,0,0,0,-1,855,0,855,2,855,0,855,0,855,0,855,0,599,599,0
1397,30000,24000,0,0,0,1,0,1,2,23908,1200,22708,2,24815,1600,23215,2,24133,0,24133,3,25087,1500,23587
1398,360000,288000,0,0,0,0,0,0,2,0,0,0,2,0,0,0,-2,0,0,0,-2,0,0,0
1399,10000,8000,0,0,0,0,0,1,2,2400,0,2400,7,2400,0,2400,7,2400,0,2400,7,2400,0,2400
1400,130000,104000,0,0,0,0,0,1,-2,0,0,0,-2,0,0,0,-2,0,0,0,-2,0,0,0
1401,150000,120000,0,1,1,1,1,0,2,142475,5200,137275,2,143966,5300,138666,2,146736,5200,141536,2,149697,5500,144197
1402,70000,56000,0,0,0,0,0,1,2,49734,2100,47634,0,50361,1950,48411,0,49185,1900,47285,0,47245,2219,45026
1403,200000,160000,0,0,0,0,0,0,0,152447,5354,147093,0,119730,4363,115367,0,122537,4816,117721,0,109504,4381,105123
1404,160000,128000,0,0,0,0,0,0,0,129619,5000,124619,0,116388,4156,112232,0,114022,4500,109522,0,111743,4500,107243
1405,10000,8000,0,0,1,1,1,0,0,9363,1400,7963,0,9559,500,9059,0,9855,600,9255,0,10042,500,9542
1406,200000,160000,0,0,0,0,0,1,-2,1081,1093,-12,-2,1884,1893,-9,-2,2089,2097,-8,-2,7097,7132,-35
1407,160000,128000,0,0,0,0,0,0,0,0,0,0,0,0,0,0,-2,0,0,0,-2,0,0,0
1408,160000,128000,0,0,0,0,0,0,-1,0,0,0,-1,362,362,0,-1,9464,9102,362,0,6087,0,6087
1409,420000,336000,0,0,0,0,0,0,0,278407,10200,268207,0,284777,11000,273777,0,301438,21500,279938,0,308571,12000,296571
1410,300000,240000,0,0,0,0,0,0,0,1974,1983,-9,-1,17648,17652,-4,-1,36732,36183,549,0,1000,1002,-2
1411,140000,112000,0,0,0,0,0,0,-1,8808,1000,7808,0,27319,27329,-10,-1,19278,386,18892,0,11505,1000,10505
1412,500000,400000,0,0,0,0,0,0,-1,84087,75207,8880,0,50058,5100,44958,0,35036,5089,29947,-2,4757,118,4639
1413,50000,40000,0,0,0,0,0,0,2,7737,4019,3718,0,3406,2500,906,0,1470,0,1470,0,1500,30,1470
1414,10000,8000,0,0,0,1,1,0,0,7902,1302,6600,0,9166,1566,7600,0,8885,0,8885,2,9185,429,8756
1415,230000,184000,0,1,1,0,1,1,0,225070,12000,213070,0,227528,9100,218428,0,121751,4600,117151,0,219354,4200,215154
1416,50000,40000,0,0,0,0,0,0,0,0,0,0,0,0,0,0,-2,0,0,0,-2,0,0,0
1417,150000,120000,0,0,0,0,0,0,0,96253,11700,84553,0,93562,0,93562,2,96510,5000,91510,0,63417,2500,60917
1418,230000,184000,0,0,0,0,0,0,-1,4006,4091,-85,-1,411,411,0,-1,1511,1511,0,-1,1334,1334,0
1419,120000,96000,0,0,0,0,0,1,-2,0,0,0,-2,0,0,0,-2,0,0,0,-2,0,0,0
1420,100000,80000,0,0,0,0,0,1,-2,390,390,0,-2,780,780,0,-2,0,0,0,-2,599,599,0
1421,40000,32000,0,1,1,1,1,1,2,34205,0,34205,2,39361,6000,33361,2,35125,0,35125,2,35890,2000,33890
1422,140000,112000,0,0,0,0,0,0,0,3776,3776,0,-1,3776,3776,0,-1,4173,4173,0,-1,4287,1000,3287
1423,50000,40000,0,0,0,0,0,0,0,35458,1321,34137,0,19778,687,19091,0,19929,705,19224,0,19790,811,18979
1424,10000,8000,0,0,1,1,1,0,0,8704,1145,7559,0,8877,318,8559,0,9063,329,8734,0,9318,406,8912
1425,250000,200000,0,0,0,0,0,0,0,63561,3000,60561,0,59696,3000,56696,0,56875,3000,53875,0,55512,3000,52512
1426,80000,64000,0,0,0,0,0,1,0,5976,1106,4870,0,5812,1060,4752,0,4788,154,4634,0,3758,147,3611
1427,250000,200000,0,0,0,0,0,1,-1,390,390,0,-1,1130,1130,0,-1,1683,1683,0,-1,2587,2587,0
1428,380000,304000,0,0,0,0,0,0,0,191343,10000,181343,0,184267,10000,174267,0,172328,20000,152328,0,230031,95000,135031
1429,50000,40000,0,0,0,0,0,0,0,36535,1430,35105,0,32428,1000,31428,0,15313,1000,14313,0,16057,1000,15057
1430,360000,288000,0,0,0,0,0,0,-2,860,860,0,-1,246,246,0,-1,-46,0,-46,-1,-46,0,-46
1431,500000,400000,0,0,0,0,0,0,0,141177,4721,136456,0,130352,3854,126498,0,126422,3622,122800,0,113148,3433,109715
1432,130000,104000,0,0,0,0,0,0,0,44362,1800,42562,0,43359,1659,41700,0,39010,1200,37810,0,36546,1150,35396
1433,180000,144000,0,0,0,0,0,0,2,54485,4,54481,2,59415,8000,51415,2,57110,387,56723,2,19339,0,19339
1434,30000,24000,0,0,1,1,1,1,0,24689,1440,23249,0,28809,4560,24249,0,30052,2001,28051,2,29057,1,29056
1435,430000,344000,0,0,0,0,0,0,-1,15718,15783,-65,-1,7370,52,7318,2,4423,4445,-22,-1,2544,2556,-12
1436,310000,248000,0,1,1,1,1,0,2,308878,2100,306778,2,314524,22053,292471,2,308637,10654,297983,2,283200,0,283200
1437,110000,88000,0,0,0,0,0,1,0,45766,2000,43766,0,46864,2000,44864,0,50935,5000,45935,0,49538,2023,47515
1438,360000,288000,0,0,0,0,0,0,-1,14407,14430,-23,-1,6820,6820,0,-1,10099,10099,0,-1,7806,7806,0
1439,320000,256000,0,0,0,0,0,0,0,118294,12000,106294,0,119014,6700,112314,0,120567,5000,115567,0,128642,10000,118642
1440,180000,144000,0,0,0,0,0,0,0,29973,22119,7854,0,42347,17012,25335,0,-53,0,-53,0,10653,10706,-53
1441,50000,40000,0,0,0,0,0,1,-1,672,672,0,-1,-108,0,-108,-1,2830,2938,-108,-1,0,0,0
1442,200000,160000,0,0,0,0,0,0,-1,1662,1662,0,-1,14490,14987,-497,-1,34902,34902,0,-1,390,390,0
1443,100000,80000,0,0,0,0,0,0,0,31119,1777,29342,0,58653,29103,29550,0,59477,2283,57194,0,60695,2334,58361
1444,380000,304000,0,0,0,0,0,0,-1,9645,9683,-38,-1,11865,11916,-51,-1,13133,13191,-58,-1,4702,4717,-15
1445,440000,352000,0,0,0,0,0,0,0,182617,12538,170079,0,166031,5047,160984,0,148157,10522,137635,0,142034,6082,135952
1446,130000,104000,0,0,0,0,0,1,-1,1354,1354,0,-1,0,0,0,-1,0,0,0,-2,2699,2699,0
1447,200000,160000,0,0,0,0,0,0,0,7151,5019,2132,0,9641,5013,4628,0,14927,10007,4920,0,17345,5006,12339
1448,150000,120000,0,0,0,0,0,0,0,0,0,0,0,0,0,0,-2,0,0,0,-2,0,0,0
1449,100000,80000,0,1,0,0,0,0,0,86981,3065,83916,0,81522,2892,78630,0,81171,2936,78235,0,79766,3000,76766
1450,50000,40000,0,1,1,1,1,0,0,46985,0,46985,2,50484,4600,45884,2,50404,1000,49404,3,50241,2000,48241
1451,90000,72000,0,0,0,0,0,0,-1,696,696,0,-1,546,546,0,-1,846,996,-150,-1,846,846,0
1452,50000,40000,0,0,0,0,0,0,0,36360,1423,34937,0,29123,1020,28103,0,28809,1050,27759,0,29263,1503,27760
1453,20000,16000,0,1,1,1,0,0,3,19583,0,19583,2,19575,392,19183,0,16624,332,16292,0,0,0,0
1454,50000,40000,0,0,0,0,0,0,-1,36631,36671,-40,-1,29150,583,28567,0,0,0,0,0,0,0,0
1455,450000,360000,0,0,0,0,0,1,0,100429,3003,97426,0,77069,10000,67069,0,63851,11000,52851,0,36877,3000,33877
1456,500000,400000,0,0,0,0,0,0,-1,51072,52090,-1018,-1,77094,78372,-1278,-1,77669,78949,-1280,-1,42059,42985,-926
1457,80000,64000,0,0,0,0,0,0,0,35933,1533,34400,0,30605,1038,29567,0,25189,852,24337,0,19766,765,19001
1458,250000,200000,0,0,0,0,0,0,0,48162,10025,38137,0,48803,10074,38729,0,41207,10049,31158,0,34792,10076,24716
1459,200000,160000,0,0,0,0,0,0,-1,887,887,0,-1,1462,1462,0,-1,15195,15195,0,-1,17933,17933,0
1460,50000,40000,0,0,0,0,0,0,0,0,0,0,-2,0,0,0,-2,0,0,0,-2,0,0,0
1461,200000,160000,0,0,0,0,0,0,-1,0,0,0,-1,0,0,0,-2,506,506,0,-1,4408,4408,0
1462,100000,80000,0,0,0,0,0,0,0,0,0,0,0,0,0,0,-2,0,0,0,-2,0,0,0
1463,230000,184000,0,0,0,0,0,1,-2,162,162,0,-2,-868,0,-868,-2,-868,0,-868,-2,-868,0,-868
1464,230000,184000,0,0,0,0,0,0,-1,0,0,0,-2,0,0,0,-2,0,0,0,-2,0,0,0
1465,500000,400000,0,0,0,0,0,0,-2,62622,62646,-24,-2,166818,166853,-35,-2,78909,79331,-422,-2,40268,40268,0
1466,360000,288000,0,0,0,0,0,0,-1,8660,8660,0,-1,10013,1510,8503,0,-24,0,-24,0,-24,0,-24
1467,240000,192000,0,0,0,0,0,0,-2,913,913,0,-2,0,0,0,-2,0,0,0,-2,0,0,0
1468,200000,160000,0,0,0,0,0,0,-1,390,390,0,-1,3672,3672,0,-1,390,390,0,-1,390,390,0
1469,40000,32000,0,0,0,0,0,1,-1,1531,1531,0,-1,1017,0,1017,0,506,0,506,0,499,499,0
1470,20000,16000,0,0,0,0,0,1,0,14810,2100,12710,0,15267,1000,14267,2,15714,1000,14714,0,16308,1000,15308
1471,180000,144000,0,0,0,0,0,1,-1,0,0,0,-1,0,0,0,-2,0,0,0,-2,0,0,0
1472,50000,40000,0,0,0,0,0,0,-1,1447,1447,0,-1,1261,1261,0,-1,1261,1261,0,-1,1261,1261,0
1473,80000,64000,0,1,0,1,0,0,0,80896,2545,78351,0,53052,2100,50952,0,91667,1700,89967,0,47160,3374,43786
1474,460000,368000,0,0,0,0,0,0,-1,21494,23664,-2170,-1,12657,12659,-2,-1,5739,5752,-13,-1,10184,10192,-8
1475,140000,112000,0,0,0,0,0,0,-2,0,0,0,-2,0,0,0,-2,0,0,0,-2,0,0,0
1476,30000,24000,0,1,1,1,1,1,2,30670,2074,28596,2,29856,0,29856,2,30584,2304,28280,2,27883,0,27883
1477,240000,192000,0,0,0,0,0,0,-2,0,0,0,-2,0,0,0,-2,0,0,0,-2,0,0,0
1478,210000,168000,0,0,0,0,0,0,0,165356,7000,158356,0,116351,10079,106272,0,95854,4500,91354,0,91173,3532,87641
1479,260000,208000,0,0,0,0,0,0,-2,0,0,0,-2,8500,8500,0,-1,2890,2890,0,-1,210,210,0
1480,380000,304000,0,0,0,0,0,0,-1,15157,15233,-76,-1,11147,11202,-55,-1,12483,12493,-10,-1,13680,13748,-68
1481,30000,24000,0,0,0,0,0,0,0,17210,3300,13910,0,16636,0,16636,2,17908,1548,16360,2,17482,0,17482
1482,180000,144000,0,0,0,0,0,1,2,316,316,0,-1,316,316,0,-1,316,316,0,-1,316,316,0
1483,120000,96000,0,0,0,0,0,1,-2,0,0,0,-2,0,0,0,-2,0,0,0,-2,0,0,0
1484,30000,24000,0,0,0,0,0,1,2,17838,3141,14697,2,17272,0,17272,2,18131,1434,16697,2,17711,0,17711
1485,500000,400000,0,0,0,0,0,0,-2,293,293,0,-2,0,0,0,-2,0,0,0,-2,259,259,0
1486,50000,40000,0,1,1,0,0,0,0,48543,3000,45543,0,46366,3019,43347,0,9076,3000,6076,0,9812,1000,8812
1487,10000,8000,0,1,1,1,1,0,5,9565,0,9565,4,9265,0,9265,3,11951,3000,8951,2,12189,1000,11189
1488,470000,376000,0,0,0,0,0,0,0,220728,10018,210710,0,198425,10000,188425,0,182826,10000,172826,0,130586,4771,125815
1489,180000,144000,0,0,0,0,0,0,0,67722,4000,63722,0,70970,5000,65970,0,72670,3000,69670,0,76444,5000,71444
1490,300000,240000,1,1,1,1,1,1,5,302869,0,302869,4,306395,10000,296395,3,311256,10000,301256,2,305413,0,305413
1491,360000,288000,0,0,0,0,0,0,-1,10000,10000,0,-1,10000,10000,0,-1,18335,18335,0,-1,18889,18889,0
1492,100000,80000,0,0,0,0,0,0,0,66147,2556,63591,0,64691,2802,61889,0,49332,1786,47546,0,50366,1850,48516
1493,100000,80000,0,0,0,0,0,0,0,390,390,0,-1,390,390,0,-1,390,390,0,-1,390,390,0
1494,400000,320000,0,0,0,0,0,0,-2,-3,1000,-1003,-2,8067,8070,-3,-2,1154,1154,0,-2,2061,2061,0
1495,120000,96000,0,0,0,0,0,0,0,22922,1382,21540,0,23376,836,22540,0,23866,866,23000,0,24339,870,23469
1496,350000,280000,0,0,0,0,0,0,-1,-22,0,-22,-1,-22,0,-22,-2,-22,0,-22,-2,4532,4554,-22
1497,10000,8000,0,1,1,1,1,0,2,9706,1300,8406,0,10406,1000,9406,0,10109,0,10109,2,10057,1000,9057
1498,50000,40000,0,0,0,0,0,0,0,4785,1079,3706,0,5031,325,4706,0,5134,332,4802,0,5138,238,4900
1499,100000,80000,0,0,0,0,0,1,0,53034,5000,48034,0,53568,2000,51568,2,54563,2000,52563,2,56013,2500,53513
1500,250000,200000,0,0,0,0,0,1,-1,4482,4482,0,-1,43546,43676,-130,-1,38051,38166,-115,-1,576,576,0
1501,310000,248000,0,0,0,0,0,0,-2,360,360,0,-2,360,360,0,-2,360,360,0,-2,360,360,0
1502,140000,112000,0,0,0,0,0,1,2,1690,1690,0,-1,0,0,0,-1,1690,1690,0,-1,0,0,0
1503,300000,240000,0,0,0,0,0,0,-2,0,0,0,-2,0,0,0,-2,0,0,0,-2,0,0,0
1504,50000,40000,0,0,0,0,0,0,0,35553,1842,33711,0,23711,1000,22711,0,25975,1928,24047,0,900,900,0
1505,50000,40000,0,0,0,0,0,0,0,32197,10000,22197,0,12595,3000,9595,0,13445,1000,12445,0,13803,1500,12303
1506,150000,120000,0,0,0,0,0,0,0,20885,2500,18385,0,21738,1500,20238,2,22080,1000,21080,0,23558,2000,21558
1507,20000,16000,0,0,0,0,0,0,0,14534,1242,13292,0,9662,1020,8642,0,8091,2000,6091,0,0,0,0
1508,360000,288000,0,0,0,0,0,0,0,16250,1123,15127,0,13600,500,13100,0,12640,640,12000,0,0,0,0
1509,390000,312000,0,0,0,0,0,0,-1,1790,1790,0,-1,7957,7957,0,-1,3044,3044,0,-1,27603,27603,0
1510,200000,160000,0,1,1,1,1,1,2,177684,8000,169684,2,180259,7000,173259,2,183704,6500,177204,2,186507,6000,180507
1511,50000,40000,1,1,0,0,0,0,0,60513,2500,58013,0,18712,1000,17712,0,17015,1000,16015,0,20284,5000,15284
1512,160000,128000,0,0,0,0,0,0,-1,6468,1000,5468,0,6600,132,6468,0,0,0,0,0,0,0,0
1513,50000,40000,0,1,1,0,0,0,0,50643,2000,48643,0,48123,2000,46123,0,18092,2000,16092,0,28728,11041,17687
1514,90000,72000,0,0,0,0,0,0,0,63069,2518,60551,0,62643,2514,60129,0,59265,2100,57165,0,59046,2500,56546
1515,300000,240000,0,0,0,0,0,1,0,88446,5000,83446,0,76244,2500,73744,0,67747,2500,65247,0,70389,3500,66889
1516,130000,104000,0,0,0,0,0,0,2,390,0,390,2,390,390,0,-1,1080,1080,0,-1,540,0,540
1517,10000,8000,0,0,0,0,0,1,-1,0,0,0,-1,0,0,0,-2,0,0,0,-2,0,0,0
1518,50000,40000,0,1,0,0,0,1,0,49675,4406,45269,0,30929,1061,29868,0,30078,1073,29005,0,29170,1046,28124
1519,210000,168000,0,0,0,0,0,0,0,30089,3027,27062,0,30400,10018,20382,0,24236,6,24230,0,22002,66,21936
1520,60000,48000,0,0,0,0,0,0,0,27113,11279,15834,0,19582,1960,17622,0,19109,1000,18109,0,17236,633,16603
1521,200000,160000,0,0,0,0,0,0,-2,0,0,0,-2,445,445,0,-2,2309,2332,-23,-2,-10,10,-20
1522,130000,104000,0,0,0,0,0,0,0,102151,4000,98151,0,90917,3250,87667,0,92729,3231,89498,0,93359,3324,90035
1523,260000,208000,0,0,0,0,0,0,0,180660,6501,174159,0,179052,6005,173047,0,177072,5805,171267,0,175285,5909,169376
1524,20000,16000,0,1,1,1,1,1,3,17137,0,17137,2,19830,3000,16830,2,19240,0,19240,3,18419,0,18419
1525,80000,64000,0,0,0,0,0,0,-2,2939,2939,0,-2,3627,3627,0,-2,3868,3991,-123,-2,2193,2299,-106
1526,360000,288000,0,0,0,0,0,1,-2,0,0,0,-2,0,0,0,-2,0,0,0,-2,0,0,0
1527,150000,120000,0,0,0,0,0,0,0,96548,4500,92048,0,87085,5000,82085,0,52323,2000,50323,0,51260,1700,49560
1528,50000,40000,0,1,1,1,1,0,0,50085,1733,48352,0,50686,1724,48962,0,46805,1684,45121,0,47220,2058,45162
1529,30000,24000,0,0,0,0,0,0,0,-2,0,-2,-2,-2,0,-2,-2,708,710,-2,-2,940,1042,-102
1530,100000,80000,0,0,0,0,0,0,0,56677,2055,54622,0,58237,2500,55737,0,59643,2500,57143,0,63275,4800,58475
1531,190000,152000,0,0,0,0,0,1,0,43487,13487,30000,0,34904,1414,33490,0,108419,40710,67709,0,75455,43406,32049
1532,120000,96000,0,0,0,0,0,0,-1,5463,5479,-16,-1,10912,10929,-17,-1,5228,24,5204,0,9769,9769,0
1533,30000,24000,0,1,1,1,1,0,0,29377,1752,27625,0,29625,1000,28625,0,30134,2257,27877,0,28716,0,28716
1534,120000,96000,0,1,1,0,0,0,0,104694,5502,99192,0,103058,4204,98854,0,71095,3017,68078,0,47379,2005,45374
1535,210000,168000,0,0,0,0,0,0,-1,4571,4584,-13,-1,3265,3274,-9,-1,8623,8648,-25,-1,5907,5924,-17
1536,150000,120000,0,0,0,0,0,0,0,1860,1860,0,-1,1535,0,1535,0,0,0,0,0,0,0,0
1537,80000,64000,0,0,0,0,0,0,0,62223,2036,60187,0,26400,1500,24900,0,27201,1201,26000,0,27363,1500,25863
1538,360000,288000,0,0,0,0,0,1,-1,498,498,0,-1,498,498,0,-1,498,498,0,-1,498,498,0
1539,50000,40000,0,0,0,0,0,1,0,4766,1114,3652,0,5652,1000,4652,0,5772,120,5652,0,4392,0,4392
1540,160000,128000,0,1,0,0,0,0,0,145978,6632,139346,0,41600,1910,39690,0,2500,2500,0,-1,2500,2500,0
1541,80000,64000,0,0,0,0,0,1,-1,2071,2071,0,-1,2036,150,1886,2,840,0,840,2,1081,931,150
1542,390000,312000,0,0,0,0,0,0,0,15216,15224,-8,-1,16659,16659,0,-1,35241,35241,0,-1,14216,14216,0
1543,250000,200000,0,0,0,0,0,0,0,24326,1298,23028,0,13198,1000,12198,0,6686,134,6552,0,9423,9423,0
1544,50000,40000,0,0,0,0,0,0,0,35147,2126,33021,0,12236,415,11821,0,11013,401,10612,0,11388,559,10829
1545,170000,136000,0,0,0,0,0,0,0,23264,1000,22264,0,12346,375,11971,0,28910,18785,10125,0,13837,757,13080
1546,100000,80000,0,1,1,1,1,1,0,85103,3100,82003,0,86802,3100,83702,0,88912,3500,85412,0,90400,3500,86900
1547,20000,16000,0,0,0,0,0,0,0,9936,1546,8390,0,10790,1400,9390,0,230,390,-160,-1,-160,73,-233
1548,210000,168000,0,0,0,0,0,0,0,84043,4000,80043,0,88508,7000,81508,0,85802,0,85802,2,85280,3500,81780
1549,150000,120000,0,0,0,0,0,0,0,3096,3107,-11,-1,-1076,0,-1076,-1,0,10382,-10382,-2,0,0,0
1550,20000,16000,0,1,0,0,0,1,0,20285,1418,18867,0,16530,2011,14519,0,0,0,0,0,0,0,0
1551,480000,384000,0,1,0,0,1,0,0,429037,15233,413804,0,383821,12597,371224,0,369920,15098,354822,0,699944,14155,685789
1552,80000,64000,0,0,0,0,0,0,-1,0,0,0,-1,6150,6150,0,-1,0,0,0,-1,0,0,0
1553,180000,144000,0,0,0,0,0,0,-2,572,572,0,-2,803,803,0,-2,916,916,0,-2,1189,1189,0
1554,210000,168000,0,0,0,0,0,1,-1,1170,0,1170,2,780,0,780,0,390,0,390,0,69438,69438,0
1555,320000,256000,0,0,0,0,0,0,0,168370,8000,160370,0,169371,5500,163871,0,172868,6100,166768,0,150827,6000,144827
1556,10000,8000,0,0,0,0,0,1,2,420,0,420,4,420,0,420,4,420,0,420,4,420,0,420
1557,150000,120000,0,0,0,0,0,0,-1,-208,239,-447,-2,-208,0,-208,-2,993,1201,-208,-1,0,0,0
1558,30000,24000,0,1,1,1,1,0,0,29319,3700,25619,0,28510,0,28510,2,29813,2000,27813,0,30179,910,29269
1559,250000,200000,0,0,0,0,0,0,0,49181,1600,47581,0,34072,2000,32072,0,33419,1000,32419,0,33925,1100,32825
1560,130000,104000,0,0,0,0,0,0,-1,36659,36659,0,-1,23150,5000,18150,0,27376,5000,22376,0,33104,7000,26104
1561,140000,112000,0,0,0,0,0,0,0,50706,1958,48748,0,48847,1501,47346,0,47437,1619,45818,0,42576,1514,41062
1562,240000,192000,0,0,0,0,0,1,-2,-946,0,-946,-2,-946,0,-946,-2,-946,0,-946,-2,-946,0,-946
1563,10000,8000,0,1,1,1,1,1,0,8908,0,8908,2,9676,1000,8676,0,9680,4,9676,0,8343,167,8176
1564,150000,120000,0,0,0,0,0,0,0,1764,1764,0,-1,9558,9000,558,0,59865,55000,4865,0,55717,4000,51717
1565,40000,32000,0,0,0,0,0,0,-1,3430,3430,0,-1,-147,0,-147,-1,672,24672,-24000,-1,5408,5000,408
1566,30000,24000,0,1,1,0,0,1,0,26813,2000,24813,0,25868,1089,24779,0,25418,3000,22418,0,27572,5000,22572
1567,80000,64000,0,0,0,0,0,0,0,0,0,0,-2,0,0,0,-2,0,0,0,-2,0,0,0
1568,20000,16000,0,1,0,1,1,0,2,18117,1277,16840,0,17040,1300,15740,0,17763,1000,16763,0,17666,799,16867
1569,70000,56000,0,0,0,0,0,1,0,37175,2000,35175,0,38254,1700,36554,0,39017,1400,37617,0,39834,1446,38388
1570,80000,64000,0,0,0,0,0,0,0,23693,1639,22054,0,24089,1089,23000,0,24832,1132,23700,0,25269,1000,24269
1571,20000,16000,0,0,0,0,0,0,2,6302,1000,5302,2,7193,1000,6193,0,8075,1000,7075,0,8938,1000,7938
1572,70000,56000,0,0,0,0,0,0,0,20245,2000,18245,0,22904,3000,19904,0,22238,0,22238,2,23870,2000,21870
1573,470000,376000,0,0,0,0,0,0,0,248080,9000,239080,0,232961,8086,224875,0,217802,14700,203102,0,202092,7000,195092
1574,180000,144000,0,0,0,0,0,0,-1,9380,9443,-63,-1,3070,3262,-192,-1,8263,8302,-39,-1,12663,12668,-5
1575,170000,136000,0,0,0,0,0,1,-1,526,526,0,-1,526,526,0,-1,635,635,0,-1,760,760,0
1576,190000,152000,0,0,0,0,0,0,2,139664,6586,133078,0,142293,5881,136412,0,113086,3292,109794,0,115433,3399,112034
1577,280000,224000,0,0,0,0,0,0,0,166712,6000,160712,0,170059,6000,164059,0,154387,6000,148387,0,157832,6000,151832
1578,20000,16000,0,1,1,1,0,0,2,18437,1370,17067,0,19267,1200,18067,0,19696,1000,18696,0,16876,5000,11876
1579,300000,240000,0,0,0,0,0,0,-1,8534,8534,0,-1,14378,14378,0,-1,16245,4000,12245,0,19047,6550,12497
1580,240000,192000,0,0,0,0,0,0,-2,24315,24315,0,-2,3724,3724,0,-2,28347,28347,0,-2,11280,11280,0
1581,50000,40000,0,0,0,0,0,0,0,16323,0,16323,2,16752,1000,15752,0,17229,900,16329,0,18931,2000,16931
1582,500000,400000,0,0,0,0,0,0,-2,1664089,1684259,-20170,-1,121757,121831,-74,-1,97115,97670,-555,-2,377217,379267,-2050
1583,260000,208000,0,0,0,0,0,0,-2,1476,1476,0,-2,1476,1476,0,-2,20976,20976,0,-1,1476,1476,0
1584,260000,208000,0,0,0,0,0,0,-1,10319,10319,0,-1,4078,4078,0,-1,749,0,749,0,1040,1040,0
1585,80000,64000,1,1,0,0,0,1,0,84147,4092,80055,0,59671,2400,57271,0,80941,43532,37409,0,27436,1511,25925
1586,50000,40000,0,0,0,0,0,0,-2,677,677,0,-2,1200,1200,0,-2,666,666,0,-2,1480,1480,0
1587,60000,48000,0,0,0,0,0,0,0,36162,1400,34762,0,36560,5000,31560,0,40855,5000,35855,0,885,885,0
1588,100000,80000,0,0,0,0,0,0,2,18158,800,17358,2,18365,800,17565,2,17932,0,17932,2,18147,662,17485
1589,300000,240000,0,0,0,0,0,1,-1,8333,24000,-15667,-1,6666,6666,0,-1,8333,10000,-1667,-1,8333,8333,0
1590,130000,104000,0,0,0,0,0,0,0,108542,4560,103982,0,89356,3300,86056,0,91024,3509,87515,0,89779,3500,86279
1591,60000,48000,0,0,0,0,0,0,2,21332,700,20632,2,21680,1000,20680,2,23011,2000,21011,2,23498,1000,22498
1592,80000,64000,0,0,0,0,0,0,-2,0,0,0,-2,5963,5963,0,-2,1280,1280,0,-2,1243,1243,0
1593,230000,184000,0,0,0,0,0,0,0,2525,2525,0,-1,146959,146959,0,-1,150080,4452,145628,0,153186,4586,148600
1594,110000,88000,0,1,0,0,0,0,0,108869,3814,105055,0,43207,2000,41207,0,42954,1600,41354,0,43839,1600,42239
1595,60000,48000,0,1,1,1,1,0,4,58411,0,58411,4,58868,2001,56867,3,55232,0,55232,2,58430,4301,54129
1596,290000,232000,0,1,1,0,0,1,0,296384,10500,285884,0,248801,10000,238801,0,241983,15000,226983,0,230925,7844,223081
1597,780000,624000,0,0,0,0,0,0,-2,38686,39558,-872,-2,21482,22204,-722,-2,72628,82097,-9469,-2,182792,184322,-1530
1598,220000,176000,0,0,0,0,0,0,0,78297,3500,74797,0,78980,4000,74980,0,77817,2700,75117,0,77569,3000,74569
1599,50000,40000,0,0,0,0,0,0,0,28513,1565,26948,0,29341,1393,27948,0,29928,980,28948,0,29533,994,28539
1600,20000,16000,0,0,0,0,0,0,0,6653,1009,5644,0,2946,7,2939,0,1186,1190,-4,-1,416,416,0
1601,160000,128000,0,0,0,0,0,0,-1,4477,4477,0,-1,2682,2682,0,-1,29011,29011,0,-1,4000,4000,0
1602,90000,72000,0,0,0,0,0,1,0,47750,2500,45250,0,47169,3700,43469,0,46284,0,46284,2,47519,2200,45319
1603,240000,192000,0,0,0,0,0,0,-1,13158,13158,0,-1,6507,6860,-353,-1,2955,2295,660,0,1092,1092,0
1604,180000,144000,0,0,0,0,0,1,-2,0,0,0,-2,4279,4279,0,-1,488,488,0,-1,659,659,0
1605,200000,160000,0,0,0,0,0,0,0,30299,3000,27299,0,29516,0,29516,2,31378,2500,28878,2,31914,1200,30714
1606,260000,208000,0,0,0,0,0,0,-1,1161,1201,-40,-1,772,1,771,0,383,1,382,0,1661,1668,-7
1607,20000,16000,0,0,0,0,0,0,2,-4,0,-4,2,400,404,-4,-1,2800,2800,0,-1,17333,17333,0
1608,30000,24000,0,1,1,1,1,1,2,27905,1000,26905,2,27158,0,27158,2,29239,2518,26721,2,29791,1185,28606
1609,60000,48000,0,0,0,0,0,0,-2,-5,0,-5,-2,0,5,-5,-2,1360,1360,0,-2,1180,1180,0
1610,30000,24000,0,1,1,1,1,0,0,29792,5538,24254,0,30106,1030,29076,0,30318,1500,28818,0,28985,1500,27485
1611,630000,504000,0,0,0,0,0,0,0,455286,20000,435286,0,327021,12000,315021,0,334558,13000,321558,0,341439,13022,328417
1612,170000,136000,0,0,0,0,0,0,-1,3749,3761,-12,-1,1487,1495,-8,-1,1939,1939,0,-1,588,0,588
1613,20000,16000,0,0,0,0,0,0,0,6763,1257,5506,0,7283,1000,6283,0,7370,420,6950,0,7371,502,6869
1614,240000,192000,0,0,0,0,0,0,0,52613,10000,42613,0,21696,10000,11696,0,22807,22807,0,-1,22877,10000,12877
1615,30000,24000,0,0,0,0,0,1,2,11006,2046,8960,0,5584,0,5584,0,5268,0,5268,0,4112,0,4112
1616,300000,240000,0,0,0,0,0,1,2,6858,4004,2854,0,8048,2000,6048,0,1701,0,1701,0,2920,2920,0
1617,310000,248000,0,0,0,0,0,0,-1,368,500,-132,-1,-2444,0,-2444,-1,-2444,0,-2444,-2,151306,155438,-4132
1618,180000,144000,0,1,0,0,0,0,0,154206,6100,148106,0,135881,9710,126171,0,130728,4800,125928,2,123155,0,123155
1619,120000,96000,0,1,1,1,1,1,2,121895,4600,117295,0,121208,4512,116696,0,121678,4600,117078,0,122067,4600,117467
1620,30000,24000,0,1,1,1,1,0,0,25988,1500,24488,0,27107,1600,25507,0,27450,1000,26450,0,29193,2100,27093
1621,90000,72000,0,0,0,0,0,0,0,32827,1550,31277,0,33877,1600,32277,0,35311,2000,33311,0,36738,2000,34738
1622,180000,144000,0,0,0,0,0,0,-1,2962,2962,0,-1,6139,6366,-227,-1,1842,1842,0,-1,1115,1115,0
1623,360000,288000,0,0,0,0,0,0,0,96363,5438,90925,0,85616,3415,82201,0,79033,2430,76603,0,72152,2568,69584
1624,20000,16000,0,1,0,0,1,0,2,19612,1300,18312,0,16213,717,15496,0,16812,1000,15812,0,18382,2000,16382
1625,150000,120000,0,0,0,0,0,0,0,79088,5000,74088,0,81399,5000,76399,0,74009,6000,68009,0,65871,5000,60871
1626,220000,176000,0,0,0,0,0,1,2,32222,2600,29622,2,32983,1600,31383,2,34031,1600,32431,0,36321,3000,33321
1627,140000,112000,0,1,1,1,1,0,0,134654,6500,128154,0,138303,7500,130803,0,119845,5000,114845,0,122457,4700,117757
1628,80000,64000,0,1,0,0,0,0,0,77796,2300,75496,0,30300,1300,29000,0,29922,1300,28622,0,29120,1500,27620
1629,480000,384000,0,0,0,0,0,0,-1,213,213,0,-1,2133,2133,0,-1,3086,3086,0,-1,0,0,0
1630,220000,176000,0,0,0,0,0,0,0,167028,7000,160028,0,170480,6500,163980,0,173818,6000,167818,0,177556,6000,171556
1631,180000,144000,0,0,0,0,0,1,-1,437,437,0,-1,0,0,0,-1,4013,4013,0,-1,0,0,0
1632,250000,200000,0,1,0,0,0,0,0,245611,11000,234611,0,33017,4701,28316,0,182078,190071,-7993,-1,184036,8000,176036
1633,230000,184000,0,0,0,0,0,0,0,126107,5012,121095,0,105831,2000,103831,0,82694,2300,80394,0,65983,2400,63583
1634,50000,40000,1,1,0,0,0,0,0,72898,3700,69198,0,36103,5396,30707,0,29384,6,29378,2,29356,1003,28353
1635,180000,144000,0,0,0,0,0,0,0,28178,1500,26678,0,29055,2000,27055,0,59849,1400,58449,0,29840,1100,28740
1636,30000,24000,0,1,1,1,1,0,0,27222,1900,25322,0,27729,1330,26399,0,28437,1038,27399,0,25336,1128,24208
1637,200000,160000,0,0,0,0,0,1,-1,390,390,0,-1,390,390,0,-1,390,390,0,-1,390,390,0
1638,120000,96000,0,0,0,0,0,0,0,73143,2700,70443,0,75919,4000,71919,0,77059,3000,74059,0,78820,3000,75820
1639,340000,272000,0,0,1,1,1,0,-1,388126,388126,0,-1,358617,12500,346117,0,333690,11000,322690,0,302528,11000,291528
1640,50000,40000,0,0,0,0,0,0,0,28430,2000,26430,0,29160,1200,27960,0,31187,2500,28687,0,30537,0,30537
1641,150000,120000,0,1,1,0,0,0,0,148016,6000,142016,0,150128,5176,144952,0,94834,5000,89834,0,97487,4002,93485
1642,80000,64000,0,0,0,0,0,0,2,4251,1000,3251,0,4047,500,3547,0,3547,1000,2547,0,221,0,221
1643,150000,120000,0,0,0,0,0,0,0,2980,1000,1980,0,3234,2234,1000,0,0,0,0,0,0,0,0
1644,20000,16000,0,0,0,0,0,0,-1,8595,8595,0,-1,7454,149,7305,0,7208,144,7064,0,0,0,0
1645,150000,120000,0,0,0,0,0,0,-1,1339,1339,0,-1,0,0,0,-1,0,0,0,-2,8777,8777,0
1646,160000,128000,0,0,0,0,0,0,0,109050,5000,104050,0,112243,5000,107243,0,114513,4100,110413,0,114902,4192,110710
1647,170000,136000,0,0,0,0,0,0,0,0,0,0,0,0,0,0,-2,0,0,0,-2,0,0,0
1648,80000,64000,0,1,0,0,0,1,-1,76304,3409,72895,0,52774,1178,51596,0,11855,1926,9929,0,48944,52964,-4020
1649,230000,184000,0,0,0,0,0,0,-2,0,0,0,-2,0,0,0,-2,625,625,0,-1,514,514,0
1650,170000,136000,0,0,0,0,0,0,-1,5425,5425,0,-1,115,115,0,-1,505,505,0,-1,1012,1012,0
1651,260000,208000,0,0,0,0,0,0,0,12985,3000,9985,0,0,0,0,0,560,560,0,-1,0,0,0
1652,330000,264000,0,0,0,0,0,0,-2,-3283,817,-4100,-1,3542,6976,-3434,-1,7643,7645,-2,-1,9584,2188,7396
1653,170000,136000,0,0,0,0,0,0,-1,632,632,0,-1,316,0,316,0,466,466,0,-1,316,316,0
1654,250000,200000,0,0,0,0,0,1,-2,0,0,0,-2,0,0,0,-2,0,0,0,-2,0,0,0
1655,150000,120000,0,0,0,0,0,0,0,118785,4500,114285,0,117406,5400,112006,0,106323,3900,102423,0,102179,4500,97679
1656,10000,8000,0,0,0,0,0,1,0,3604,1000,2604,0,0,0,0,0,0,0,0,-2,0,0,0
1657,300000,240000,0,0,0,0,0,0,-1,774,0,774,2,2774,2000,774,0,2774,0,2774,0,14190,15000,-810
1658,120000,96000,0,0,0,0,0,0,-2,2134,2142,-8,-2,0,0,0,-2,0,0,0,-2,0,0,0
1659,20000,16000,0,0,1,1,1,0,0,17199,17199,0,-1,18367,1600,16767,0,18130,363,17767,0,18500,370,18130
1660,170000,136000,0,0,0,0,0,0,0,115606,9913,105693,0,121493,7900,113593,0,132016,10523,121493,0,145820,16289,129531
1661,180000,144000,0,0,0,0,0,0,2,5570,2005,3565,2,4722,31,4691,2,8643,5000,3643,0,7783,1000,6783
1662,150000,120000,0,0,1,1,1,0,0,137751,30000,107751,0,141330,5000,136330,0,146389,6088,140301,0,132617,5150,127467
1663,330000,264000,0,0,0,0,0,0,-1,6994,7006,-12,-1,632,2000,-1368,-1,316,0,316,0,38277,38277,0
1664,310000,248000,0,0,0,0,0,0,0,113788,56000,57788,0,106919,5000,101919,0,100656,4000,96656,0,93846,3300,90546
1665,60000,48000,0,0,0,0,0,1,0,40841,4800,36041,0,39952,0,39952,3,38081,0,38081,2,36483,1326,35157
1666,140000,112000,0,0,0,0,0,0,0,62503,3000,59503,0,61129,4000,57129,0,59089,5000,54089,0,58160,4000,54160
1667,500000,400000,0,0,0,0,0,0,0,33740,25099,8641,0,15272,2000,13272,0,17015,2000,15015,0,18740,2000,16740
1668,50000,40000,0,1,0,0,0,1,0,48888,3000,45888,0,37264,2000,35264,0,17486,1000,16486,0,18348,1000,17348
1669,130000,104000,0,0,0,0,0,0,0,28383,1769,26614,0,29018,1404,27614,0,29671,1493,28178,0,-2000,0,-2000
1670,390000,312000,0,0,0,0,0,0,-1,3730,3730,0,-1,9526,9526,0,-1,0,0,0,-1,2680,2680,0
1671,30000,24000,0,1,1,1,1,1,2,27026,1251,25775,2,27871,1596,26275,2,29017,1742,27275,2,28403,0,28403
1672,30000,24000,0,1,1,1,1,1,0,29103,2172,26931,0,29565,1523,28042,2,26319,0,26319,2,27738,2000,25738
1673,200000,160000,0,0,0,0,0,0,0,36052,10021,26031,0,38440,5000,33440,0,40555,6000,34555,0,49699,10000,39699
1674,360000,288000,0,0,0,0,0,0,-1,4489,4808,-319,-1,10218,10044,174,0,6509,4006,2503,0,15156,10046,5110
1675,30000,24000,0,0,0,0,0,0,0,6115,1000,5115,0,0,0,0,0,0,0,0,-2,0,0,0
1676,180000,144000,0,0,0,0,0,0,0,108874,4000,104874,0,111568,4500,107068,0,113817,4200,109617,0,116422,4500,111922
1677,20000,16000,1,1,0,0,1,0,0,28679,1300,27379,0,14768,1086,13682,0,18192,3677,14515,0,20372,2500,17872
1678,260000,208000,0,1,0,0,0,0,0,237497,10500,226997,0,215343,9150,206193,0,205576,7500,198076,0,207688,8000,199688
1679,50000,40000,0,0,0,0,0,0,2,390,390,0,-1,390,390,0,-1,390,390,0,-1,780,780,0
1680,240000,192000,0,0,0,0,0,0,0,36751,2002,34749,0,35625,1600,34025,0,33114,2000,31114,0,35473,3000,32473
1681,20000,16000,0,1,1,1,1,1,0,19752,2300,17452,0,19155,0,19155,2,20385,1525,18860,2,19218,0,19218
1682,180000,144000,0,0,0,0,0,0,-1,0,0,0,-1,1610,1610,0,-1,0,0,0,-1,0,0,0
1683,160000,128000,0,0,0,0,0,0,2,0,0,0,2,4775,4775,0,-1,456,456,0,-1,0,0,0
1684,30000,24000,0,1,0,0,0,0,2,24022,2,24020,2,24368,1608,22760,2,20859,0,20859,2,19633,900,18733
1685,360000,288000,0,0,0,0,0,0,-2,0,0,0,-2,0,0,0,-2,0,0,0,-2,0,0,0
1686,240000,192000,0,0,0,0,0,1,-2,7124,7124,0,-1,6860,21,6839,2,2959,2959,0,-1,6000,6000,0
1687,170000,136000,0,0,0,0,0,0,0,79823,3002,76821,0,79335,3000,76335,0,79506,3000,76506,0,80252,3500,76752
1688,200000,160000,0,0,0,0,0,0,-1,3632,3632,0,-1,7673,7673,0,-1,5830,2530,3300,0,6890,6000,890
1689,260000,208000,0,0,0,0,0,0,0,205530,9158,196372,0,-170000,0,-170000,0,171696,497000,-325304,-1,174151,10000,164151
1690,30000,24000,0,0,0,0,0,0,2,16635,1335,15300,0,15413,2000,13413,0,14296,0,14296,0,9090,0,9090
1691,230000,184000,0,0,0,0,0,0,-2,3543,3553,-10,-2,3351,3351,0,-2,-4,4,-8,-2,3267,3271,-4
1692,240000,192000,0,0,0,0,0,0,0,26526,1500,25026,0,28082,1800,26282,0,29695,1860,27835,0,31223,1800,29423
1693,90000,72000,0,0,0,0,0,1,-1,3402,1131,2271,0,8652,5381,3271,0,5381,4,5377,0,7190,7190,0
1694,90000,72000,0,0,0,0,0,0,-1,7956,7956,0,-1,499,499,0,-1,0,0,0,-1,5990,5990,0
1695,70000,56000,0,0,0,0,0,0,2,9511,0,9511,2,10828,1482,9346,0,11346,1000,10346,0,11589,426,11163
1696,200000,160000,0,0,0,0,0,0,0,142744,6000,136744,0,146363,6000,140363,0,149920,6000,143920,0,153107,6000,147107
1697,230000,184000,0,0,0,0,0,0,0,48294,1823,46471,0,49242,1771,47471,0,48831,1896,46935,0,51125,3232,47893
1698,250000,200000,0,0,0,0,0,0,-2,0,0,0,-2,0,0,0,-2,0,0,0,-2,0,0,0
1699,50000,40000,0,1,0,0,0,1,0,45445,2000,43445,0,38551,5008,33543,0,28056,1000,27056,0,28310,2000,26310
1700,230000,184000,0,0,0,0,0,0,-2,-3,0,-3,-2,-3,0,-3,-2,-3,0,-3,-2,-3,0,-3
1701,30000,24000,0,1,0,0,0,1,2,25141,9,25132,2,22272,1000,21272,0,22844,1013,21831,0,19436,1300,18136
1702,30000,24000,0,1,1,1,1,0,0,27774,1500,26274,0,28809,1500,27309,0,30399,2200,28199,2,29760,0,29760
1703,260000,208000,0,0,0,0,0,0,-1,1935,1935,0,-1,5365,5365,0,-1,0,0,0,-1,294,294,0
1704,70000,56000,1,1,1,1,1,0,0,128391,4551,123840,2,125183,9,125174,2,124527,4230,120297,0,125255,4253,121002
1705,290000,232000,0,0,0,0,0,0,0,167924,6000,161924,0,170227,6000,164227,0,164584,6000,158584,0,161912,6700,155212
1706,470000,376000,0,0,0,0,0,0,0,207970,8037,199933,0,212373,9048,203325,0,193628,10000,183628,0,184908,6115,178793
1707,100000,80000,0,0,0,0,0,0,-1,0,0,0,-1,85,85,0,-1,60,60,0,-1,520,520,0
1708,100000,80000,0,0,0,0,0,0,-2,0,0,0,-2,0,0,0,-2,0,0,0,-2,0,0,0
1709,600000,480000,0,0,0,0,0,0,0,459749,50000,409749,0,455910,15000,440910,0,463611,20000,443611,0,466570,15000,451570
1710,50000,40000,0,0,0,0,0,0,0,11353,4000,7353,0,12143,2000,10143,0,11753,2000,9753,0,11922,1000,10922
1711,320000,256000,0,0,0,0,0,0,0,59001,8232,50769,0,61565,10450,51115,0,59508,9697,49811,0,66541,16477,50064
1712,100000,80000,0,0,0,0,0,0,-1,470,470,0,-1,470,470,0,-1,0,0,0,-1,0,0,0
1713,100000,80000,0,0,0,1,1,0,0,81233,4000,77233,0,82990,4000,78990,0,84210,3500,80710,0,85987,3287,82700
1714,60000,48000,0,0,0,0,0,0,0,38533,1900,36633,0,39639,2000,37639,0,39619,1500,38119,0,39140,1900,37240
1715,120000,96000,0,0,0,0,0,0,-2,1549,1549,0,-2,757,757,0,-2,757,757,0,-2,1328,1328,0
1716,140000,112000,0,0,0,0,0,0,0,82558,0,82558,2,80376,3500,76876,0,85281,5900,79381,0,84688,0,84688
1717,230000,184000,0,0,0,0,0,0,0,25210,5516,19694,0,21433,2015,19418,0,18203,2014,16189,0,13931,2019,11912
1718,90000,72000,0,0,0,0,0,0,0,43712,0,43712,2,52966,10000,42966,2,51988,0,51988,2,56117,5000,51117
1719,90000,72000,0,0,0,0,0,0,0,47463,1875,45588,0,45812,1500,44312,0,41367,1400,39967,0,40278,1500,38778
1720,50000,40000,0,0,0,0,0,0,0,30873,1400,29473,0,24659,1612,23047,0,15849,0,15849,0,8540,0,8540
1721,60000,48000,0,0,0,0,0,0,-1,1131,1131,0,-1,441,441,0,-1,443,443,0,-1,732,580,152
1722,160000,128000,0,0,0,0,0,0,-1,0,0,0,-2,1188,1188,0,-1,0,0,0,-1,0,0,0
1723,60000,48000,0,1,0,0,0,0,0,54853,2000,52853,0,39112,1500,37612,0,39714,1500,38214,0,38850,1600,37250
1724,150000,120000,0,0,0,0,0,1,-1,1094,2000,-906,-1,6382,5288,1094,0,5288,0,5288,0,5288,0,5288
1725,120000,96000,0,0,0,0,0,1,0,16571,7703,8868,0,16607,600,16007,2,16043,0,16043,2,16379,595,15784
1726,200000,160000,0,0,0,0,0,0,-2,0,0,0,-2,4573,4573,0,-2,1242,1242,0,-2,0,0,0
1727,60000,48000,0,1,1,1,0,1,2,59200,4770,54430,2,57558,2250,55308,2,52992,0,52992,2,61325,50000,11325
1728,80000,64000,0,0,0,0,0,1,-1,1950,1000,950,0,1170,0,1170,0,780,0,780,0,780,0,780
1729,500000,400000,0,0,0,0,0,0,-1,3492,2506,986,0,3008,2015,993,0,16871,16883,-12,-1,19188,5013,14175
1730,480000,384000,0,0,0,0,0,0,-1,454,456,-2,-1,150198,150244,-46,-1,143388,2915,140473,0,157758,24550,133208
1731,80000,64000,0,0,0,0,0,1,0,22348,1708,20640,0,22063,1411,20652,0,8723,4,8719,0,7254,21,7233
1732,360000,288000,0,0,0,0,0,0,-2,0,0,0,-2,0,0,0,-2,0,0,0,-2,0,0,0
1733,80000,64000,0,0,0,0,0,0,0,61063,5804,55259,0,56202,121,56081,2,25775,1003,24772,0,24688,853,23835
1734,240000,192000,0,0,0,0,0,1,-1,2276,2276,0,-1,1486,1486,0,-1,1776,1776,0,-1,2308,2308,0
1735,210000,168000,0,0,0,0,0,1,2,163600,8000,155600,0,162303,8000,154303,0,162799,6000,156799,0,161912,6000,155912
1736,270000,216000,0,0,0,0,0,0,0,194534,10000,184534,0,199524,7841,191683,0,203514,6930,196584,0,208396,7800,200596
1737,30000,24000,0,1,1,1,1,1,0,27294,1762,25532,0,27216,1717,25499,0,26432,966,25466,0,30692,5739,24953
1738,50000,40000,0,1,1,1,1,0,-1,49289,1800,47489,0,49058,1800,47258,0,47512,1800,45712,0,48930,2200,46730
1739,240000,192000,0,0,0,0,0,0,0,130372,4873,125499,0,128921,5033,123888,0,120048,4204,115844,0,121292,4509,116783
1740,200000,160000,0,0,0,0,0,0,0,34800,2100,32700,0,33275,2000,31275,0,33435,3435,30000,0,32778,3000,29778
1741,80000,64000,0,0,0,0,0,0,-2,4949,4949,0,-2,967,967,0,-2,5762,5775,-13,-2,0,0,0
1742,30000,24000,0,0,0,0,0,1,2,2395,0,2395,2,2395,0,2395,7,2395,0,2395,7,2395,0,2395
1743,70000,56000,0,0,0,0,0,1,0,38783,2025,36758,0,3758,1000,2758,0,1261,25,1236,0,0,0,0
1744,80000,64000,0,1,0,0,0,0,0,78560,4000,74560,0,49399,2000,47399,0,48420,3000,45420,0,50600,3003,47597
1745,200000,160000,0,0,0,0,0,0,0,9889,1015,8874,0,0,0,0,0,9002,9002,0,-1,728,728,0
1746,70000,56000,0,0,0,0,0,0,2,36536,1500,35036,2,35651,0,35651,2,36427,1500,34927,0,37169,1500,35669
1747,120000,96000,0,0,0,0,0,0,-1,700,700,0,-1,10673,10673,0,-1,9671,2550,7121,-1,9332,0,9332
1748,80000,64000,0,1,1,0,0,0,0,76722,2700,74022,0,70370,2300,68070,0,64510,2500,62010,0,51695,2000,49695
1749,240000,192000,0,0,0,0,0,0,-1,14342,14371,-29,-1,11411,11411,0,-1,3006,3006,0,-1,13268,13336,-68
1750,90000,72000,0,0,0,0,0,0,0,70561,2600,67961,0,72021,2633,69388,0,73912,3108,70804,0,58301,2052,56249
1751,50000,40000,0,1,1,1,1,0,0,45665,2007,43658,0,49287,5003,44284,0,48290,303,47987,0,50000,3000,47000
1752,80000,64000,0,0,0,0,0,0,0,31721,1527,30194,0,32350,1156,31194,0,33031,1200,31831,0,33926,1445,32481
1753,240000,192000,0,0,0,0,0,0,0,139281,5036,134245,0,132487,4000,128487,0,107437,6200,101237,0,109237,5500,103737
1754,20000,16000,0,0,0,0,0,1,2,0,0,0,2,780,780,0,-1,390,0,390,0,390,390,0
1755,150000,120000,0,0,0,0,0,0,-1,8004,8004,0,-1,521,521,0,-1,3776,3776,0,-1,165,165,0
1756,550000,440000,0,0,0,0,0,0,0,246572,9071,237501,0,240595,8022,232573,0,237968,6797,231171,0,220199,7095,213104
1757,50000,40000,0,0,0,0,0,0,-1,0,0,0,-2,0,0,0,-2,4881,4881,0,-1,4634,0,4634
1758,160000,128000,0,0,0,0,0,0,-1,15193,15199,-6,-1,10845,10845,0,-1,46397,46397,0,-1,32334,1280,31054
1759,460000,368000,0,0,0,0,0,0,-2,9906,9906,0,-2,7586,7596,-10,-2,4706,4706,0,-2,4328,4328,0
1760,30000,24000,0,0,0,0,0,1,0,15815,1600,14215,0,16788,1540,15248,0,17787,1580,16207,0,17363,0,17363
1761,290000,232000,0,0,0,0,0,1,-2,0,0,0,-2,0,0,0,-2,1855,1855,0,-1,3940,3940,0
1762,190000,152000,0,0,0,0,0,1,0,105230,5361,99869,0,17907,1000,16907,0,-93,0,-93,0,-483,0,-483
1763,170000,136000,0,0,0,0,0,0,0,139384,7000,132384,0,141314,7000,134314,0,139252,5100,134152,0,139205,5300,133905
1764,110000,88000,0,0,0,0,0,0,0,63179,4500,58679,0,66637,4500,62137,0,68037,2500,65537,0,70448,3500,66948
1765,20000,16000,0,1,1,1,0,0,0,19261,1481,17780,0,20184,1404,18780,0,17016,0,17016,0,15725,0,15725
1766,30000,24000,0,0,0,0,0,1,2,0,0,0,2,780,780,0,-1,0,0,0,-1,0,0,0
1767,210000,168000,0,0,0,0,0,0,0,0,0,0,0,0,0,0,-2,0,0,0,-2,0,0,0
1768,310000,248000,0,0,0,0,0,0,-1,19781,1500,18281,0,22432,3000,19432,0,24058,2000,22058,0,25646,2000,23646
1769,500000,400000,0,0,0,0,0,0,0,104650,134011,-29361,-1,75583,8000,67583,0,26728,10000,16728,0,78226,78226,0
1770,40000,32000,0,0,0,0,0,0,2,12896,2554,10342,0,14675,2000,12675,0,17265,3000,14265,0,17974,1000,16974
1771,100000,80000,0,1,1,0,1,0,0,86735,3155,83580,0,87321,3504,83817,0,82289,3001,79288,0,83850,3301,80549
1772,50000,40000,0,0,0,0,0,0,-1,0,0,0,-2,0,0,0,-2,0,0,0,-2,6500,6500,0
1773,20000,16000,0,1,1,1,1,1,0,18248,0,18248,3,17657,0,17657,2,18007,644,17363,0,18385,668,17717
1774,30000,24000,0,0,0,0,0,0,0,21906,1500,20406,0,23183,1700,21483,0,13273,750,12523,0,3027,200,2827
1775,50000,40000,0,0,1,1,1,0,0,41462,1987,39475,0,42130,1655,40475,0,43011,1710,41301,0,43863,1719,42144
1776,100000,80000,0,0,0,0,0,0,0,0,0,0,0,0,0,0,-2,2743,2743,0,-1,1782,1782,0
1777,200000,160000,0,0,0,0,0,1,0,70015,4000,66015,0,72073,5000,67073,0,71690,2563,69127,0,73661,5000,68661
1778,160000,128000,0,0,0,0,0,0,0,47986,15000,32986,0,0,0,0,0,15655,15655,0,-1,0,0,0
1779,100000,80000,0,1,1,1,1,0,0,88734,7500,81234,0,86369,0,86369,2,89994,5001,84993,0,89681,3390,86291
1780,550000,440000,0,0,0,0,0,0,0,267274,11000,256274,0,273547,12300,261247,0,172198,6300,165898,0,176573,8000,168573
1781,140000,112000,0,0,0,0,0,0,0,59949,2000,57949,0,40979,1447,39532,0,42339,2000,40339,0,43529,2184,41345
1782,70000,56000,1,1,1,1,1,0,0,73326,0,73326,5,71568,0,71568,4,72540,2700,69840,3,71148,0,71148
1783,50000,40000,0,0,0,0,0,0,0,27507,2080,25427,0,28299,3000,25299,0,12012,1000,11012,0,8923,1000,7923
1784,60000,48000,0,0,0,0,0,1,0,8396,1500,6896,2,8113,0,8113,2,8971,1000,7971,0,10824,2000,8824
1785,230000,184000,0,0,0,0,0,0,0,0,0,0,0,30866,30866,0,-1,32332,2000,30332,0,30480,2000,28480
1786,30000,24000,0,1,1,1,1,0,0,29583,2019,27564,0,29166,1400,27766,0,29066,600,28466,0,29008,580,28428
1787,360000,288000,0,0,0,0,0,0,-1,2950,2950,0,-1,6366,6366,0,-1,11480,11480,0,-1,222,222,0
1788,80000,64000,0,1,1,1,1,1,0,73622,2623,70999,0,75092,2644,72448,0,75976,2743,73233,0,77511,2783,74728
1789,130000,104000,0,0,0,0,0,0,0,104394,3988,100406,0,103798,6000,97798,0,82816,3784,79032,0,78727,3010,75717
1790,100000,80000,0,0,0,0,0,0,-2,-4894,0,-4894,-2,-4894,0,-4894,-2,-4894,0,-4894,-2,-4894,0,-4894
1791,260000,208000,0,0,0,0,0,0,-1,1700,1700,0,-1,5190,5190,0,-1,8455,8455,0,-1,1462,1462,0
1792,50000,40000,0,0,0,0,0,0,0,10614,1157,9457,0,10478,411,10067,0,10490,608,9882,0,390,690,-300
1793,260000,208000,0,0,0,0,0,0,-1,0,0,0,-1,0,0,0,-2,0,0,0,-2,0,0,0
1794,30000,24000,0,1,1,1,0,0,-1,26745,0,26745,2,27345,1000,26345,0,25300,0,25300,0,0,0,0
1795,360000,288000,0,0,0,0,0,0,-1,0,0,0,-1,0,0,0,-2,0,0,0,-2,1459,1459,0
1796,200000,160000,0,0,0,0,0,1,0,4397,2000,2397,0,0,0,0,0,0,0,0,-2,0,0,0
1797,170000,136000,0,0,0,0,0,0,0,21577,1685,19892,0,20334,1231,19103,0,19161,608,18553,0,18613,650,17963
1798,300000,240000,0,0,0,0,0,0,-1,10184,11082,-898,-1,115184,115184,0,-1,63758,19800,43958,0,19813,0,19813
1799,260000,208000,0,0,0,0,0,0,-1,27201,20000,7201,0,27879,2000,25879,0,28420,2000,26420,0,39206,12000,27206
1800,60000,48000,0,0,0,0,0,1,0,42240,2500,39740,0,38884,2600,36284,2,34488,1500,32988,2,28838,0,28838
1801,60000,48000,1,1,0,0,0,1,0,85672,1900,83772,0,41483,1572,39911,0,19394,1000,18394,0,18893,700,18193
1802,230000,184000,0,0,0,0,0,0,0,80623,4539,76084,0,90997,2220,88777,0,62063,3214,58849,0,62003,2407,59596
1803,130000,104000,0,0,0,0,0,0,0,90672,3217,87455,0,89252,3177,86075,0,91118,3286,87832,0,95105,4200,90905
1804,140000,112000,0,1,1,1,1,0,0,128906,6200,122706,0,137279,12000,125279,0,140419,5500,134919,2,142254,5300,136954
1805,50000,40000,0,1,0,0,0,1,0,44450,2150,42300,0,956,956,0,-1,976,20,956,0,1976,1000,976
1806,180000,144000,0,0,0,0,0,0,0,17814,5000,12814,0,8260,2000,6260,0,9090,4110,4980,0,4441,4441,0
1807,20000,16000,0,1,1,1,0,0,0,20030,2450,17580,0,18475,2000,16475,0,17631,376,17255,0,3950,79,3871
1808,150000,120000,0,1,1,1,1,0,0,151632,6000,145632,0,151855,7000,144855,0,150713,5480,145233,0,148958,5400,143558
1809,300000,240000,0,0,0,0,0,0,0,6893,2000,4893,0,49379,49379,0,-1,49161,1500,47661,0,50646,2000,48646
1810,300000,240000,0,0,0,0,0,0,-2,-13,0,-13,-2,2155,2168,-13,-2,2402,2421,-19,-2,-10,0,-10
1811,250000,200000,0,0,0,0,0,0,-2,0,0,0,-2,0,0,0,-2,0,0,0,-2,0,0,0
1812,180000,144000,0,0,0,0,0,0,-1,-120,0,-120,-1,420,1000,-580,-1,460,500,-40,-1,460,460,0
1813,20000,16000,0,1,1,1,1,1,0,19157,1308,17849,0,19308,684,18624,0,19486,707,18779,0,19785,848,18937
1814,30000,24000,0,0,0,0,0,0,0,20762,3102,17660,0,22535,3008,19527,0,22622,3136,19486,0,11400,1103,10297
1815,220000,176000,0,0,0,0,0,0,0,132188,8000,124188,0,83844,5000,78844,0,89299,7000,82299,0,94777,7000,87777
1816,250000,200000,0,0,0,0,0,0,-2,1859,1859,0,-1,3582,2628,954,-1,18717,41000,-22283,-1,20213,3000,17213
1817,160000,128000,0,0,0,0,0,0,0,62503,3000,59503,0,63867,3000,60867,0,65206,3000,62206,0,69584,5600,63984
1818,20000,16000,0,0,1,1,1,1,2,19205,3473,15732,2,19712,1000,18712,2,19249,727,18522,0,38900,1100,37800
1819,20000,16000,0,0,0,0,0,0,0,14453,1300,13153,0,15320,1156,14164,0,11796,387,11409,0,9766,354,9412
1820,380000,304000,0,0,0,0,0,0,0,81365,60218,21147,0,87341,10076,77265,0,87358,15012,72346,0,103740,20667,83073
1821,190000,152000,0,0,0,0,0,0,0,42835,2835,40000,0,31982,5982,26000,0,36329,33329,3000,0,26964,1964,25000
1822,150000,120000,0,0,0,0,0,0,-2,20242,1000,19242,-2,5332,5003,329,-2,61826,61826,0,-1,5220,5000,220
1823,220000,176000,0,0,0,0,0,0,-1,2646,2646,0,-1,1125,1125,0,-1,0,0,0,-1,3455,3455,0
1824,200000,160000,0,0,0,0,0,0,0,155945,30000,125945,0,109271,7,109264,0,36753,7000,29753,0,78079,73000,5079
1825,100000,80000,0,0,0,0,0,0,-2,0,0,0,-2,0,0,0,-2,0,0,0,-2,0,0,0
1826,360000,288000,0,0,0,0,0,0,0,18797,2016,16781,0,15816,1095,14721,0,16112,1024,15088,0,10793,350,10443
1827,60000,48000,0,1,0,0,0,1,0,50135,1123,49012,0,19553,7553,12000,0,11896,474,11422,0,15241,3586,11655
1828,90000,72000,0,0,0,0,0,1,-1,316,316,0,-1,316,316,0,-1,316,316,0,-1,316,316,0
1829,230000,184000,0,0,0,0,0,0,-2,3587,3605,-18,-2,2663,2681,-18,-2,2660,2673,-13,-2,2997,3012,-15
1830,30000,24000,0,0,0,0,0,0,0,187,187,0,-1,1187,1000,187,0,0,0,0,0,1405,1405,0
1831,50000,40000,0,0,0,0,0,1,3,17014,1000,16014,2,17721,1592,16129,0,18184,1055,17129,0,20008,2421,17587
1832,20000,16000,0,0,0,0,0,0,0,12974,1392,11582,0,14192,2000,12192,0,14096,389,13707,0,7045,1000,6045
1833,120000,96000,0,0,0,0,0,0,3,316,0,316,2,316,316,0,-1,316,316,0,-1,316,316,0
1834,20000,16000,0,0,0,0,0,1,-1,780,780,0,-1,390,0,390,2,806,806,0,-1,19103,19103,0
1835,340000,272000,0,1,0,0,0,0,0,320614,7000,313614,0,21768,1500,20268,0,22405,1000,21405,0,24545,2500,22045
1836,200000,160000,0,0,0,0,0,0,0,102712,3555,99157,0,79902,3524,76378,0,59253,2300,56953,0,59826,2000,57826
1837,80000,64000,0,0,0,0,0,0,0,39944,0,39944,2,40744,1462,39282,0,42084,2000,40084,0,42923,1536,41387
1838,210000,168000,0,0,0,0,0,0,0,123657,3229,120428,0,112910,3165,109745,0,97400,1979,95421,0,9806,9806,0
1839,150000,120000,0,1,0,0,0,0,0,148258,6000,142258,0,106114,3220,102894,0,105951,3600,102351,0,78487,2670,75817
1840,140000,112000,0,0,0,0,0,0,0,102468,7000,95468,0,114718,15500,99218,0,111387,0,111387,2,116399,7000,109399
1841,20000,16000,0,1,1,1,1,0,0,20912,2502,18410,0,19480,1700,17780,0,19129,807,18322,0,20014,2002,18012
1842,50000,40000,0,1,0,0,0,0,0,49326,2155,47171,0,29584,1086,28498,0,19665,19001,664,0,19799,906,18893
1843,360000,288000,0,0,0,0,0,1,-2,2493,2505,-12,-2,-6,0,-6,-2,1299,1305,-6,-2,-2,0,-2
1844,50000,40000,0,1,1,0,0,0,0,49317,2000,47317,0,50855,2376,48479,0,18177,709,17468,0,18823,998,17825
1845,30000,24000,0,0,0,0,0,0,-2,4990,4990,0,-1,4322,4322,0,-1,1955,1955,0,-1,980,980,0
1846,460000,368000,0,1,0,0,0,0,0,394483,16017,378466,0,338220,13000,325220,0,347753,15000,332753,0,356161,15025,341136
1847,200000,160000,0,0,0,0,0,0,-2,264,264,0,-2,264,264,0,-2,264,264,0,-2,264,264,0
1848,300000,240000,0,0,0,0,0,0,-2,0,0,0,-2,0,0,0,-2,0,0,0,-2,0,0,0
1849,150000,120000,0,0,0,0,0,0,-1,13181,13181,0,-1,2010,2020,-10,-1,7790,7790,0,-1,0,0,0
1850,80000,64000,0,0,0,0,0,0,0,25986,2000,23986,0,23496,2000,21496,0,23601,2000,21601,0,24650,2000,22650
1851,100000,80000,0,1,0,0,0,0,2,90684,560,90124,2,23000,0,23000,2,25000,2000,23000,-2,0,0,0
1852,320000,256000,0,0,0,0,0,0,0,38544,6000,32544,0,44486,8000,36486,0,52319,10000,42319,0,51764,1900,49864
1853,500000,400000,0,0,0,0,0,1,-2,0,0,0,-2,0,0,0,-2,0,0,0,-2,0,0,0
1854,240000,192000,0,0,0,0,0,0,0,109419,5500,103919,0,111838,5500,106338,0,112727,4000,108727,0,115479,4500,110979
1855,180000,144000,0,0,0,0,0,0,-1,2272,2272,0,-1,3970,3970,0,-1,330,420,-90,-1,0,0,0
1856,70000,56000,0,0,0,0,0,1,2,50022,0,50022,2,53390,4200,49190,2,54579,2200,52379,2,55722,2200,53522
1857,280000,224000,0,1,0,0,0,0,0,369761,135477,234284,0,197666,6480,191186,0,152084,4026,148058,0,149887,4153,145734
1858,70000,56000,0,0,0,0,0,1,0,50396,1834,48562,0,51462,1900,49562,0,52609,2000,50609,0,53708,1945,51763
1859,200000,160000,0,0,0,0,0,0,-2,798,798,0,-1,0,0,0,-1,307,307,0,-2,497,497,0
1860,20000,16000,0,0,0,0,0,1,-2,0,0,0,-2,0,0,0,-2,0,0,0,-2,0,0,0
1861,50000,40000,0,1,1,1,1,0,2,48546,0,48546,2,49157,1900,47257,0,49890,1333,48557,0,48941,0,48941
1862,170000,136000,0,0,0,0,0,0,0,51798,4000,47798,0,53332,3000,50332,0,56303,4000,52303,0,59198,4000,55198
1863,200000,160000,0,0,0,0,0,0,0,39879,3000,36879,0,42946,4000,38946,0,46141,4000,42141,0,46305,3000,43305
1864,80000,64000,0,1,1,1,1,1,2,73788,4204,69584,2,74463,2790,71673,2,72834,0,72834,2,74190,3043,71147
1865,130000,104000,0,0,0,0,0,0,-1,11836,11836,0,-1,7216,2000,5216,0,8826,2000,6826,0,390,390,0
1866,200000,160000,0,0,0,0,0,0,-2,3977,3977,0,-2,0,0,0,-2,2500,2500,0,-2,199,199,0
1867,390000,312000,0,0,0,0,0,0,-1,3436,2000,1436,0,4868,1500,3368,0,5781,1000,4781,0,6681,1000,5681
1868,50000,40000,0,1,1,1,1,0,0,44669,1743,42926,0,45684,1758,43926,0,46592,1666,44926,0,47568,1725,45843
1869,130000,104000,0,0,0,0,0,1,2,69329,0,69329,2,74175,6000,68175,2,72383,0,72383,2,77217,6000,71217
1870,180000,144000,0,0,0,0,0,1,-1,31,0,31,2,31,0,31,2,1931,1900,31,0,878,878,0
1871,50000,40000,0,0,0,0,0,0,0,28610,1612,26998,0,28808,1200,27608,0,29403,1057,28346,0,20260,871,19389
1872,10000,8000,0,0,1,1,1,0,0,8986,1200,7786,0,9691,1000,8691,0,9889,1000,8889,0,10131,569,9562
1873,150000,120000,0,0,0,0,0,0,-1,16643,16701,-58,-1,4869,4883,-14,-1,9157,9199,-42,-1,9624,9652,-28
1874,50000,40000,0,1,1,1,1,0,0,50144,2306,47838,0,47838,2000,45838,0,48914,2000,46914,0,50442,2500,47942
1875,50000,40000,0,0,0,0,0,1,2,31062,1831,29231,0,33231,3000,30231,0,33736,1182,32554,2,33042,0,33042
1876,270000,216000,0,0,0,0,0,0,0,15896,15908,-12,-1,32396,20000,12396,0,50411,29000,21411,0,60957,22000,38957
1877,190000,152000,0,0,0,0,0,0,0,81481,4051,77430,0,75853,5013,70840,0,68074,3000,65074,0,64941,3000,61941
1878,150000,120000,0,0,0,0,0,0,-1,5487,5487,0,-1,2003,2020,-17,-1,-222,51,-273,-1,-222,0,-222
1879,30000,24000,0,1,1,1,1,1,0,26294,1441,24853,0,27308,1455,25853,0,27853,1000,26853,0,28504,1100,27404
1880,170000,136000,0,0,0,0,0,1,-1,25607,27107,-1500,-1,23922,1500,22422,0,24399,863,23536,0,24919,903,24016
1881,30000,24000,0,1,1,1,1,1,0,27535,1402,26133,0,29175,2042,27133,0,28625,0,28625,2,30383,2192,28191
1882,50000,40000,0,0,0,0,0,0,0,18172,1303,16869,0,18687,818,17869,0,19234,1000,18234,0,19552,787,18765
1883,80000,64000,0,0,0,0,0,0,0,19145,2000,17145,0,21807,3000,18807,0,24442,3000,21442,0,27038,3000,24038
1884,150000,120000,0,0,0,0,0,1,2,70507,111,70396,2,59123,2371,56752,2,39386,0,39386,2,20561,702,19859
1885,220000,176000,0,0,0,0,0,0,2,339,339,0,-1,207,500,-293,-1,207,0,207,0,12890,12999,-109
1886,80000,64000,0,0,0,0,0,1,0,40713,2000,38713,2,41153,1575,39578,2,40036,0,40036,2,40778,1700,39078
1887,180000,144000,0,0,0,0,0,1,0,82708,3100,79608,0,84433,3100,81333,0,86134,3100,83034,0,88251,3500,84751
1888,300000,240000,0,0,0,0,0,0,0,90827,3300,87527,0,78887,4505,74382,0,57682,4200,53482,0,35493,2500,32993
1889,30000,24000,0,0,0,0,0,1,0,13469,2000,11469,0,14045,1100,12945,2,14509,1000,13509,0,16962,2700,14262
1890,260000,208000,0,0,0,0,0,0,0,0,0,0,-2,0,0,0,-2,0,0,0,-2,0,0,0
1891,140000,112000,0,1,0,0,0,1,0,125360,5421,119939,0,99313,3926,95387,0,90623,3290,87333,0,92425,3310,89115
1892,90000,72000,0,1,1,1,1,0,0,86905,7500,79405,0,88310,4000,84310,0,79842,3000,76842,0,81235,2700,78535
1893,150000,120000,0,1,1,1,1,0,0,150540,7000,143540,0,153103,7000,146103,0,152060,5200,146860,0,151470,5500,145970
1894,110000,88000,0,1,1,1,1,1,2,99562,3700,95862,2,100532,3500,97032,2,102779,4000,98779,2,100966,0,100966
1895,110000,88000,0,0,0,0,0,0,0,50422,2500,47922,0,50990,2000,48990,0,52014,2000,50014,0,53206,2057,51149
1896,240000,192000,0,0,0,0,0,0,-2,0,0,0,-2,0,0,0,-2,0,0,0,-2,0,0,0
1897,80000,64000,0,0,0,0,0,0,0,37339,2000,35339,0,38419,1703,36716,0,39316,1600,37716,0,35902,1400,34502
1898,80000,64000,0,0,0,0,0,0,2,4220,3600,620,0,8540,4500,4040,0,8540,0,8540,0,8540,0,8540
1899,240000,192000,0,0,0,0,0,0,-1,3802,1901,1901,0,1901,0,1901,0,2165,2165,0,-1,1965,0,1965
1900,240000,192000,0,0,0,0,0,1,2,33996,1400,32596,2,34539,1400,33139,2,35238,1400,33838,2,35910,1400,34510
1901,40000,32000,0,0,0,0,0,1,0,39717,8017,31700,0,37263,7000,30263,0,35224,4000,31224,0,34111,5000,29111
1902,50000,40000,0,0,0,0,0,1,4,19045,0,19045,3,18300,0,18300,2,17900,0,17900,0,17900,0,17900
1903,220000,176000,0,0,0,0,0,0,-2,-11,0,-11,-2,12597,12608,-11,-1,44375,44375,0,-1,0,0,0
1904,230000,184000,0,0,0,0,0,0,2,8698,3000,5698,2,8398,0,8398,2,10898,2500,8398,0,7299,0,7299
1905,200000,160000,0,0,0,0,0,1,-2,1350,1350,0,-1,0,0,0,-1,1265,1265,0,-1,0,0,0
1906,70000,56000,0,0,0,0,0,0,0,28406,1500,26906,0,29013,1000,28013,0,29625,1001,28624,0,30404,1191,29213
1907,80000,64000,0,0,0,0,0,0,-1,19037,19037,0,-1,12344,0,12344,0,26344,14000,12344,0,1011,0,1011
1908,140000,112000,0,1,1,1,1,0,0,133547,7004,126543,0,134346,5013,129333,0,133933,5000,128933,0,137585,6000,131585
1909,160000,128000,0,1,1,0,0,0,0,154715,6500,148215,0,155026,4270,150756,0,79051,2518,76533,0,81089,2994,78095
1910,420000,336000,0,0,0,0,0,0,-2,18030,18442,-412,-2,11831,11943,-112,-2,11562,11620,-58,-2,46623,46856,-233
1911,430000,344000,0,0,0,0,0,0,0,312608,30000,282608,0,341552,35000,306552,0,345532,30000,315532,0,339050,20019,319031
1912,70000,56000,0,0,0,0,0,0,0,48493,3000,45493,0,48824,1400,47424,0,19000,500,18500,0,39000,20000,19000
1913,50000,40000,0,0,0,0,0,1,0,21750,1028,20722,0,4387,4387,0,-1,4392,4392,0,-1,9493,9493,0
1914,20000,16000,0,0,0,0,0,1,2,3800,1000,2800,0,0,0,0,0,0,0,0,-2,0,0,0
1915,50000,40000,0,1,0,0,0,0,0,49252,4063,45189,0,28838,1700,27138,0,2102,600,1502,0,19366,20000,-634
1916,360000,288000,0,0,0,0,0,1,-2,0,0,0,-2,0,0,0,-2,0,0,0,-2,0,0,0
1917,140000,112000,0,0,0,0,0,0,-2,-27,0,-27,-2,3788,3815,-27,-2,0,0,0,-2,9386,9386,0
1918,200000,160000,0,0,0,0,0,0,-1,1048,1048,0,-1,1294,1294,0,-1,0,0,0,-1,0,0,0
1919,90000,72000,0,0,0,0,0,0,0,43449,9000,34449,0,42451,0,42451,2,49718,8000,41718,2,48767,0,48767
1920,20000,16000,0,0,0,0,0,0,-1,543,543,0,-1,780,780,0,-1,2500,2500,0,-1,0,0,0
1921,160000,128000,0,0,0,0,0,1,0,0,0,0,0,0,0,0,-2,0,0,0,-2,0,0,0
1922,140000,112000,0,0,0,0,0,0,-2,38399,2400,35999,-2,39131,2132,36999,-2,39508,1617,37891,-2,3441,515,2926
1923,80000,64000,0,0,0,1,0,0,0,10859,1000,9859,0,59187,56500,2687,0,111059,2500,108559,0,56320,2500,53820
1924,30000,24000,0,0,1,1,0,0,0,25289,1600,23689,0,25971,1600,24371,0,25350,301,25049,2,5082,102,4980
1925,200000,160000,0,0,0,0,0,0,2,5881,5881,0,-1,0,20,-20,-1,3331,3331,0,-1,0,0,0
1926,500000,400000,0,0,0,0,0,0,0,24273,1292,22981,0,9508,9555,-47,0,23294,23310,-16,-1,2235,2244,-9
1927,250000,200000,0,0,0,0,0,0,0,73068,24000,49068,0,102311,30000,72311,0,75543,25000,50543,0,88283,30000,58283
1928,30000,24000,0,1,1,1,1,1,2,28635,150,28485,2,30127,2250,27877,2,30525,1000,29525,2,29793,0,29793
1929,200000,160000,0,1,1,1,0,0,0,190569,8000,182569,0,191730,8000,183730,0,171269,9000,162269,0,151550,7000,144550
1930,200000,160000,0,0,0,0,0,0,-1,-1,0,-1,-1,605,606,-1,-1,-5,0,-5,-1,-5,0,-5
1931,20000,16000,0,1,0,0,1,0,3,16082,0,16082,3,15529,0,15529,2,16525,1400,15125,2,16110,0,16110
1932,230000,184000,0,0,0,0,0,1,-2,0,0,0,-2,0,0,0,-2,0,0,0,-2,0,0,0
1933,40000,32000,0,0,0,0,0,0,2,1748,1749,-1,-1,832,0,832,0,416,0,416,0,1851,1851,0
1934,140000,112000,0,1,1,1,1,1,3,128479,5000,123479,2,129869,5000,124869,2,132540,4900,127640,2,135201,5000,130201
1935,170000,136000,0,0,0,0,0,0,-1,1122,1122,0,-1,1692,1692,0,-1,648,648,0,-1,0,0,0
1936,140000,112000,0,0,0,0,0,0,2,390,390,0,-1,780,780,0,-1,390,0,390,0,390,390,0
1937,50000,40000,0,0,0,0,0,1,0,0,0,0,0,0,0,0,-2,0,0,0,-2,0,0,0
1938,260000,208000,0,0,0,0,0,0,-1,217,217,0,-1,613,613,0,-1,2339,2339,0,-1,1474,0,1474
1939,170000,136000,0,0,0,0,0,0,0,51328,2236,49092,0,31541,2478,29063,0,47406,904,46502,0,23062,2546,20516
1940,170000,136000,0,0,0,0,0,0,-2,0,0,0,-2,0,0,0,-2,0,0,0,-2,0,0,0
1941,150000,120000,0,0,0,0,0,0,-2,10557,10557,0,-2,9974,9974,0,-2,11507,11507,0,-2,1926,1926,0
1942,150000,120000,0,0,0,0,0,0,0,99263,3500,95763,0,100920,3300,97620,0,86781,3027,83754,0,71408,3000,68408
1943,280000,224000,0,0,0,0,0,0,0,195621,53459,142162,0,96843,4000,92843,0,99232,4000,95232,0,102620,5000,97620
1944,80000,64000,0,0,0,0,0,0,-1,3647,3647,0,-1,2173,0,2173,2,390,0,390,0,780,780,0
1945,170000,136000,0,0,0,0,0,1,-1,3889,0,3889,2,4889,1000,3889,0,4139,0,4139,0,430,1000,-570
1946,500000,400000,0,0,0,0,0,0,-1,6738,6738,0,-1,2500,2510,-10,-1,0,0,0,-1,0,0,0
1947,110000,88000,0,1,1,1,1,1,0,113214,9900,103314,0,108350,0,108350,2,109072,8007,101065,2,106848,0,106848
1948,180000,144000,0,0,0,0,0,0,0,88542,4000,84542,0,92055,5000,87055,0,94038,3514,90524,0,95849,3478,92371
1949,360000,288000,0,0,0,0,0,0,-1,6342,6353,-11,-1,5077,5105,-28,-1,1274,1277,-3,-1,-6,0,-6
1950,360000,288000,0,0,0,0,0,0,0,205209,4385,200824,0,125982,11939,114043,0,128161,5681,122480,0,136447,10447,126000
1951,20000,16000,0,1,1,1,1,0,0,18546,2000,16546,0,18846,900,17946,0,18066,0,18066,0,17463,1000,16463
1952,380000,304000,0,0,0,0,0,0,0,216399,130533,85866,0,213259,7609,205650,0,203377,12000,191377,0,185056,7000,178056
1953,240000,192000,0,0,0,0,0,0,0,201267,9319,191948,0,182484,6200,176284,0,182478,5894,176584,0,175394,5100,170294
1954,50000,40000,0,0,0,0,0,0,0,33610,1500,32110,0,19221,1000,18221,0,18925,1000,17925,0,19608,1000,18608
1955,120000,96000,0,0,0,0,0,0,0,0,0,0,-2,0,0,0,-2,1344,1344,0,-1,881,929,-48
1956,220000,176000,0,0,0,0,0,1,-1,1381,1381,0,-1,3300,3300,0,-1,2452,2452,0,-1,2728,2728,0
1957,170000,136000,0,0,0,0,0,0,2,2400,0,2400,7,2400,0,2400,7,2400,0,2400,7,2400,0,2400
1958,70000,56000,1,1,1,0,0,0,2,91325,0,91325,2,93195,3204,89991,0,52925,2003,50922,0,52990,2013,50977
1959,50000,40000,0,0,0,0,0,1,2,35447,1800,33647,2,36061,1500,34561,2,36571,1400,35171,2,35850,0,35850
1960,180000,144000,0,0,0,0,0,1,-1,1335,1335,0,-1,366,366,0,-1,1811,1811,0,-1,1828,1828,0
1961,140000,112000,0,0,0,0,0,0,-1,19404,19404,0,-1,19498,10000,9498,0,9771,2000,7771,0,1106,1106,0
1962,250000,200000,0,0,0,0,0,0,-1,8402,8433,-31,-1,2765,13,2752,2,6037,6049,-12,-1,3561,17,3544
1963,500000,400000,0,0,0,0,0,0,-1,12724,12724,0,-1,12873,12873,0,-1,24010,24010,0,-1,27089,15000,12089
1964,500000,400000,0,0,0,0,0,0,0,38458,1639,36819,0,39222,1403,37819,0,40043,1452,38591,0,40854,1475,39379
1965,180000,144000,0,0,0,0,0,0,-2,606,606,0,-2,20972,20999,-27,-1,940,940,0,-1,1383,1383,0
1966,300000,240000,0,0,0,0,0,1,2,156171,0,156171,2,165556,12000,153556,2,169250,6500,162750,2,172804,6500,166304
1967,290000,232000,0,0,0,0,0,0,-1,632,632,0,-1,0,0,0,-1,3152,3152,0,-1,316,316,0
1968,360000,288000,0,0,0,0,0,0,-2,0,0,0,-2,0,0,0,-2,0,0,0,-2,0,0,0
1969,500000,400000,0,0,0,0,0,0,-2,2546,2569,-23,-2,5495,6360,-865,-2,180,3,177,-2,-486,0,-486
1970,110000,88000,0,1,1,0,0,0,2,108418,4308,104110,0,105373,3196,102177,0,71733,2536,69197,0,61020,2322,58698
1971,30000,24000,0,0,0,0,0,0,0,0,0,0,-2,0,0,0,-2,0,0,0,-2,0,0,0
1972,500000,400000,0,0,0,0,0,0,-1,1390,1320,70,0,3186,2007,1179,0,1649,1651,-2,0,2507,2517,-10
1973,70000,56000,0,0,0,0,0,0,0,40849,2025,38824,0,2917,58,2859,0,1473,29,1444,0,917,917,0
1974,340000,272000,0,0,0,0,0,0,0,177359,6501,170858,0,173334,6101,167233,0,176605,6201,170404,0,180205,6501,173704
1975,70000,56000,0,0,0,0,0,1,0,50178,3108,47070,0,29969,2000,27969,0,30081,1048,29033,0,29380,1095,28285
1976,200000,160000,0,0,0,0,0,1,-2,1466,1473,-7,-2,1466,1473,-7,-2,479,486,-7,-2,2448,3442,-994
1977,120000,96000,0,0,0,0,0,0,2,23763,2000,21763,0,25059,2000,23059,0,25641,1000,24641,0,26228,1000,25228
1978,50000,40000,0,1,1,1,1,1,0,45697,2000,43697,0,46873,2000,44873,0,47188,2000,45188,0,48532,2000,46532
1979,20000,16000,0,0,0,0,0,0,0,9540,1000,8540,0,10540,1000,9540,0,11540,1000,10540,0,0,0,0
1980,150000,120000,0,1,1,1,1,0,0,140600,6427,134173,0,142836,4951,137885,0,145714,4062,141652,0,148731,4188,144543
1981,100000,80000,0,0,0,0,0,0,2,58824,0,58824,2,29336,1330,28006,0,22979,1398,21581,0,-246,12,-258
1982,150000,120000,0,0,0,0,0,0,0,40589,1674,38915,0,41551,1636,39915,0,42420,1690,40730,0,43105,1544,41561
1983,120000,96000,0,0,0,0,0,0,-1,780,780,0,-1,470,470,0,-1,-170,0,-170,-1,180,500,-320
1984,90000,72000,0,1,1,1,1,0,0,92140,8100,84040,0,88296,0,88296,2,88357,3200,85157,0,85506,3000,82506
1985,230000,184000,0,0,0,0,0,0,-2,2520,2520,0,-2,2936,2936,0,-2,3493,3493,0,-2,3160,3160,0
1986,20000,16000,0,0,0,0,1,0,0,16579,4500,12079,0,15102,2500,12602,0,16795,3240,13555,0,34457,3000,31457
1987,50000,40000,0,1,0,0,0,0,0,50558,2493,48065,0,23921,856,23065,0,24423,887,23536,0,25059,1043,24016
1988,130000,104000,0,0,0,0,0,0,0,105091,4500,100591,0,100046,3500,96546,0,96090,6011,90079,0,90359,3200,87159
1989,110000,88000,0,0,0,0,0,0,0,63652,2450,61202,0,62738,2027,60711,0,50687,1710,48977,0,49850,1800,48050
1990,500000,400000,0,0,0,0,0,1,-1,844,1000,-156,-1,614,0,614,2,2887,3000,-113,-1,3850,4000,-150
1991,500000,400000,0,0,0,0,0,0,0,309466,20000,289466,0,246519,15000,231519,0,247263,9322,237941,0,251389,10000,241389
1992,60000,48000,0,0,0,0,0,0,-1,5691,5691,0,-1,21001,21028,-27,-1,17931,0,17931,0,2439,0,2439
1993,50000,40000,0,0,0,0,1,0,0,35777,1311,34466,0,7464,2000,5464,0,42705,42705,0,-1,43662,1569,42093
1994,20000,16000,0,0,1,1,1,1,0,17278,1293,15985,0,18289,1304,16985,0,18653,668,17985,0,19195,843,18352
1995,50000,40000,0,1,0,0,0,0,0,45434,2000,43434,0,34688,1900,32788,0,24124,1032,23092,0,21072,3000,18072
1996,140000,112000,0,0,0,0,0,0,0,26254,2000,24254,0,27728,2000,25728,0,28047,1000,27047,0,29315,1500,27815
1997,120000,96000,0,1,1,1,1,1,2,120471,6100,114371,0,117218,5700,111518,0,116871,4500,112371,0,122192,9000,113192
1998,20000,16000,0,0,1,0,0,0,0,15806,550,15256,2,29542,0,29542,2,15484,1445,14039,2,15046,0,15046
1999,10000,8000,0,0,0,0,1,0,0,6287,1500,4787,0,7521,1500,6021,0,8389,1000,7389,0,9252,1000,8252
2000,10000,8000,0,1,1,1,1,1,2,10025,1600,8425,2,10227,500,9727,2,9933,0,9933,2,9884,1000,8884
2001,50000,40000,0,0,0,0,0,0,-2,-2900,0,-2900,-2,-2900,0,-2900,-2,-2900,0,-2900,-2,-2900,0,-2900
2002,260000,208000,0,0,0,0,0,0,0,8024,1140,6884,0,9185,1301,7884,0,9384,500,8884,0,9426,341,9085
2003,320000,256000,0,0,0,0,0,0,-2,-20,0,-20,-2,-20,0,-20,-2,-20,0,-20,-2,-20,0,-20
2004,200000,160000,0,0,0,0,0,1,-2,0,0,0,-2,0,0,0,-2,0,0,0,-2,0,0,0
2005,400000,320000,0,0,0,0,0,0,-1,292,292,0,-1,12677,12677,0,-1,1650,1650,0,-1,1516,1516,0
2006,100000,80000,0,0,0,0,0,0,0,41587,1992,39595,0,42602,2007,40595,0,43327,1732,41595,0,47950,5506,42444
2007,50000,40000,0,0,0,0,0,1,0,18942,1289,17653,0,18811,658,18153,0,18183,659,17524,0,18561,679,17882
2008,100000,80000,0,0,0,0,0,0,0,19778,2000,17778,0,24939,6000,18939,0,28639,4000,24639,0,8370,4000,4370
2009,100000,80000,0,0,0,0,0,1,0,7298,3500,3798,0,7032,0,7032,2,7913,1000,6913,2,7642,0,7642
2010,520000,416000,0,0,0,0,0,0,0,381086,14200,366886,0,353074,12300,340774,0,330171,11200,318971,0,324386,11200,313186
2011,180000,144000,0,0,0,0,0,0,0,23801,1693,22108,0,24117,1009,23108,0,24468,888,23580,0,25106,1045,24061
2012,90000,72000,0,0,0,0,0,0,0,27090,1500,25590,0,27767,1800,25967,0,28108,1100,27008,0,29848,2200,27648
2013,180000,144000,0,0,0,0,0,1,0,29864,1432,28432,0,30632,1200,29432,0,31274,1072,30202,0,32144,1326,30818
2014,180000,144000,0,0,0,0,0,0,0,77013,3000,74013,0,69551,2367,67184,0,62960,3000,59960,0,59487,3554,55933
2015,10000,8000,0,0,1,1,1,1,3,8386,1000,7386,2,9069,1000,8069,2,9966,1000,8966,2,8410,0,8410
2016,30000,24000,0,1,1,1,1,1,2,28762,2378,26384,2,29485,1496,27989,3,28878,0,28878,2,30699,2462,28237
2017,30000,24000,0,0,0,0,0,0,0,4885,1020,3865,0,1065,1000,65,0,-264,0,-264,0,942,1206,-264
2018,300000,240000,0,0,0,0,0,0,0,115420,4600,110820,0,118149,7384,110765,0,110223,3500,106723,0,110449,3900,106549
2019,50000,40000,0,0,0,0,0,0,0,49131,11000,38131,0,38884,5000,33884,0,8144,1005,7139,0,8643,15000,-6357
2020,490000,392000,0,0,0,0,0,1,-1,1375,1381,-6,-1,230,230,0,-1,115,0,115,0,113,113,0
2021,220000,176000,0,1,1,1,1,0,0,213888,7729,206159,0,215125,9207,205918,0,216543,7917,208626,0,217390,7911,209479
2022,20000,16000,0,1,1,0,0,1,2,19476,1200,18276,0,16911,0,16911,0,11893,5000,6893,0,9583,1000,8583
2023,50000,40000,0,0,0,0,0,1,0,19240,1322,17918,0,20256,1338,18918,0,20918,1000,19918,0,22081,1500,20581
2024,110000,88000,0,0,0,0,0,1,2,60732,5700,55032,2,61938,2800,59138,2,63097,2300,60797,2,64492,2600,61892
2025,390000,312000,0,0,0,0,0,0,0,34131,10778,23353,0,31120,7063,24057,0,15768,7060,8708,0,30831,30009,822
2026,320000,256000,0,0,0,0,0,0,0,20819,5048,15771,0,20993,10029,10964,0,19089,10470,8619,0,16062,7027,9035
2027,330000,264000,0,0,0,0,0,0,-2,-363,363,-726,-2,137,513,-376,-1,4094,4107,-13,-1,607,607,0
2028,450000,360000,0,0,0,0,0,0,-1,0,0,0,-1,1000,1000,0,-1,17446,16446,1000,0,11062,0,11062
2029,100000,80000,0,0,0,0,0,0,-1,285,285,0,-1,-150,0,-150,-1,-585,0,-585,-2,1020,2040,-1020
2030,210000,168000,0,0,0,0,0,0,-2,2368,2376,-8,-1,316,316,0,-1,316,316,0,-2,316,316,0
2031,60000,48000,0,0,0,0,0,0,0,14555,2000,12555,0,15803,1500,14303,0,19217,3700,15517,0,18768,0,18768
2032,140000,112000,0,0,0,0,0,0,0,76230,10000,66230,0,77954,3393,74561,0,78953,3260,75693,0,81848,5000,76848
2033,270000,216000,0,0,0,0,0,0,-1,69553,70213,-660,-1,18607,19008,-401,-1,0,399,-399,-1,0,0,0
2034,130000,104000,0,0,0,0,0,0,-1,990,990,0,-1,990,990,0,-1,1130,1130,0,-1,990,1000,-10
2035,140000,112000,0,0,0,0,0,1,2,98949,3932,95017,0,100673,3717,96956,0,106935,8000,98935,0,104427,0,104427
2036,260000,208000,0,0,0,0,0,0,0,20725,3000,17725,0,21807,3000,18807,0,21216,1000,20216,0,22331,2000,20331
2037,80000,64000,0,0,0,0,0,0,0,47186,5013,42173,0,46882,5000,41882,0,49170,4000,45170,0,48269,0,48269
2038,110000,88000,0,0,0,0,0,0,0,62708,40000,22708,0,52873,3526,49347,0,48240,4515,43725,0,41313,3000,38313
2039,180000,144000,0,0,0,0,0,0,-1,9733,9740,-7,-1,4088,4088,0,-1,5428,5428,0,-1,13138,13138,0
2040,360000,288000,0,0,0,0,0,0,2,1656,1656,0,-1,1866,1866,0,-1,1473,1080,393,0,1080,1080,0
2041,260000,208000,0,0,0,0,0,0,0,142730,7000,135730,0,148307,8000,140307,0,152375,6500,145875,0,158435,8500,149935
2042,430000,344000,0,0,0,0,0,0,0,321019,36000,285019,0,272838,30000,242838,0,206081,30000,176081,0,163130,30000,133130
2043,80000,64000,0,1,1,1,1,0,0,80899,3200,77699,0,79387,3000,76387,0,81593,3500,78093,0,80254,3100,77154
2044,20000,16000,0,0,0,0,0,0,2,4093,0,4093,2,4866,1000,3866,0,6781,2000,4781,0,7668,1000,6668
2045,80000,64000,0,0,0,0,0,1,-2,0,0,0,-2,0,0,0,-2,0,0,0,-2,0,0,0
2046,400000,320000,0,0,0,0,0,0,0,51389,3023,48366,0,48272,3000,45272,0,49478,3000,46478,0,51242,3000,48242
2047,200000,160000,0,0,0,0,0,0,-1,0,0,0,-1,3239,3239,0,-1,0,0,0,-1,500,500,0
2048,500000,400000,0,0,0,0,0,0,-1,4464,4465,-1,-1,8722,8724,-2,-1,4137,0,4137,0,4123,4123,0
2049,30000,24000,0,0,0,0,0,0,0,22034,1000,21034,0,16312,326,15986,0,14614,292,14322,0,0,0,0
2050,30000,24000,0,1,1,1,1,1,2,29761,2000,27761,0,30203,1400,28803,0,29803,0,29803,0,29803,0,29803
2051,120000,96000,0,0,0,0,0,1,2,86024,3200,82824,0,91380,6800,84580,0,93263,3500,89763,2,95079,3500,91579
2052,70000,56000,0,0,0,0,0,0,2,49636,1900,47736,2,50517,2000,48517,2,51658,2100,49558,2,52758,2100,50658
2053,290000,232000,0,0,0,0,0,0,0,125088,4304,120784,0,123694,4000,119694,0,123518,5000,118518,0,124246,4100,120146
2054,110000,88000,0,1,1,1,1,1,2,93321,5,93316,2,94034,4000,90034,0,99531,7300,92231,0,96614,0,96614
2055,30000,24000,0,0,0,0,0,1,0,9009,0,9009,2,9333,1000,8333,0,9505,700,8805,0,8699,0,8699
2056,270000,216000,0,0,0,0,0,0,-1,3567,3567,0,-1,1556,1556,0,-1,7952,7952,0,-1,10794,4000,6794
2057,30000,24000,0,0,0,0,0,0,-2,2988,2988,0,-2,0,0,0,-2,30000,30000,0,-2,0,0,0
2058,230000,184000,0,0,0,0,0,1,-1,2784,2784,0,-1,2360,32,2328,0,1908,0,1908,0,97,0,97
2059,20000,16000,0,0,0,0,0,0,0,11580,1000,10580,0,780,780,0,-1,780,0,780,0,0,0,0
2060,210000,168000,0,0,0,0,0,1,2,79104,3000,76104,2,80399,3200,77199,2,81462,2500,78962,2,83366,3400,79966
2061,90000,72000,0,1,1,0,0,1,0,86181,4500,81681,0,86311,3500,82811,0,66572,2500,64072,0,68119,3500,64619
2062,120000,96000,0,0,0,0,0,1,-2,0,0,0,-2,0,0,0,-2,940,940,0,-1,170,170,0
2063,500000,400000,0,0,0,0,0,0,0,171462,10753,160709,0,99495,20134,79361,0,168313,110167,58146,0,233306,105000,128306
2064,140000,112000,0,1,1,1,1,0,0,124901,4706,120195,2,129675,9463,120212,2,121292,16,121276,2,121343,5002,116341
2065,20000,16000,0,1,1,1,1,0,4,17473,0,17473,3,16900,0,16900,2,17690,1376,16314,2,18255,1000,17255
2066,100000,80000,0,0,0,0,0,1,2,30882,5000,25882,2,30090,0,30090,2,34419,5000,29419,2,33714,0,33714
2067,90000,72000,0,0,0,0,0,0,2,0,0,0,2,9281,9281,0,-1,0,0,0,-1,340,340,0
2068,460000,368000,0,0,0,0,0,0,0,328208,20065,308143,0,320056,12000,308056,0,326599,12070,314529,0,337552,17000,320552
2069,120000,96000,0,0,0,0,0,0,-1,0,0,0,-1,582,582,0,-1,291,291,0,-1,0,0,0
2070,50000,40000,0,1,1,1,1,0,0,46706,0,46706,2,48066,2500,45566,0,49026,2000,47026,0,49755,2000,47755
2071,100000,80000,0,0,0,0,0,0,0,77303,3769,73534,0,60178,2008,58170,0,56436,1950,54486,0,51773,2001,49772
2072,30000,24000,0,1,1,1,1,0,0,30206,1457,28749,0,58287,1016,57271,0,29522,1207,28315,0,30103,1600,28503
2073,110000,88000,0,0,0,0,0,0,0,47251,4000,43251,0,46630,4000,42630,0,52889,10000,42889,0,53907,5000,48907
2074,460000,368000,0,0,0,0,0,0,0,74537,5036,69501,0,70481,5015,65466,0,85204,20005,65199,0,93194,10007,83187
2075,20000,16000,0,0,0,0,0,1,2,2400,0,2400,7,2400,0,2400,7,1800,0,1800,6,1200,0,1200
2076,500000,400000,0,0,0,0,0,0,-1,813,813,0,-1,17280,17280,0,-2,26162,26162,0,-2,2518,2534,-16
2077,10000,8000,0,0,0,0,0,0,-1,5400,5400,0,-1,5012,2,5010,0,1740,4,1736,0,390,0,390
2078,320000,256000,0,0,0,0,0,0,-1,41195,42067,-872,-1,89714,30014,59700,0,64646,39515,25131,0,6103,6110,-7
2079,350000,280000,0,0,0,0,0,0,0,163154,8902,154252,0,299409,213103,86306,0,250584,9036,241548,0,249412,10022,239390
2080,30000,24000,0,1,1,1,1,0,0,30910,3000,27910,0,30155,0,30155,2,30389,1068,29321,0,30418,2257,28161
2081,110000,88000,0,0,0,0,0,0,0,48737,1600,47137,0,50157,2000,48157,0,51560,2000,49560,0,52965,2000,50965
2082,210000,168000,0,0,0,0,0,0,0,99411,4500,94911,0,63322,2407,60915,0,73433,12700,60733,0,75381,3200,72181
2083,490000,392000,0,0,0,0,0,0,-1,274442,274526,-84,-1,233793,4693,229100,0,49461,989,48472,0,12207,12207,0
2084,200000,160000,0,1,1,1,1,0,0,184026,10000,174026,0,192069,11000,181069,0,198862,10043,188819,2,176770,0,176770
2085,50000,40000,0,1,0,0,0,0,0,43590,3128,40462,0,18264,1000,17264,0,18659,656,18003,0,18918,645,18273
2086,30000,24000,1,1,1,1,1,0,0,30047,0,30047,2,30869,3000,27869,0,29403,998,28405,0,29831,3000,26831
2087,50000,40000,0,1,1,1,1,1,2,49333,4070,45263,2,49708,1551,48157,2,45112,0,45112,2,42063,1528,40535
2088,200000,160000,0,0,0,0,0,0,-1,5865,5865,0,-1,1303,1303,0,-1,4579,4579,0,-1,1107,1107,0
2089,360000,288000,0,0,0,0,0,0,-1,1390,1395,-5,-1,8531,8531,0,-1,8531,0,8531,0,-33,0,-33
2090,150000,120000,1,1,1,1,1,0,2,192342,8000,184342,2,189717,2000,187717,2,195670,9000,186670,0,198611,8000,190611
2091,30000,24000,0,0,0,0,0,0,-1,390,0,390,2,15736,15736,0,-1,15525,1000,14525,0,0,0,0
2092,470000,376000,0,0,0,0,0,0,0,171997,6000,165997,0,165014,7100,157914,0,158839,5100,153739,0,148035,5200,142835
2093,150000,120000,0,0,0,0,0,0,0,33019,30000,3019,0,31366,3000,28366,0,31709,5000,26709,0,42632,15000,27632
2094,330000,264000,0,0,0,0,0,0,-1,519,707,-188,-1,452,452,0,-1,457,457,0,-1,0,0,0
2095,60000,48000,0,0,0,0,0,1,0,41531,3114,38417,2,42048,1496,40552,2,41241,0,41241,2,44056,3500,40556
2096,50000,40000,1,1,1,1,1,0,3,52026,0,52026,3,51899,1800,50099,2,50836,105,50731,2,47828,2300,45528
2097,180000,144000,0,0,0,0,0,0,-1,13647,13901,-254,-1,30848,30848,0,-1,15520,15520,0,-1,558,558,0
2098,150000,120000,0,0,0,0,0,0,0,105332,7041,98291,0,82191,3000,79191,0,77262,3116,74146,0,49851,2500,47351
2099,130000,104000,0,0,0,0,0,0,2,2000,13,1987,2,700,700,0,-1,0,0,0,-1,0,0,0
2100,200000,160000,0,0,0,0,0,0,-2,390,390,0,-2,390,390,0,-2,418,418,0,-2,1604,1604,0
2101,20000,16000,0,0,0,0,0,1,-1,390,390,0,-1,390,390,0,-1,390,390,0,-1,0,0,0
2102,30000,24000,0,0,0,0,0,0,0,22278,1506,20772,0,24423,2651,21772,0,19985,0,19985,2,15021,2044,12977
2103,50000,40000,0,0,0,0,0,0,0,28984,2000,26984,0,29422,2000,27422,0,0,0,0,0,0,0,0
2104,180000,144000,0,0,0,0,0,0,-2,0,0,0,-2,0,0,0,-2,0,0,0,-2,0,0,0
2105,50000,40000,1,1,1,0,0,1,0,58773,2428,56345,0,58918,1423,57495,0,0,0,0,0,0,0,0
2106,200000,160000,0,0,0,0,0,1,-2,0,0,0,-2,0,0,0,-2,0,0,0,-2,0,0,0
2107,30000,24000,0,0,0,0,0,0,0,12443,2100,10343,0,11949,0,11949,2,12107,500,11607,0,12907,1000,11907
2108,30000,24000,0,0,0,0,0,0,-2,0,0,0,-2,0,0,0,-2,300,300,0,-2,390,390,0
2109,80000,64000,0,1,0,0,0,1,2,74968,2968,72000,0,23867,1867,22000,0,23130,463,22667,0,0,0,0
2110,240000,192000,0,0,0,0,0,0,-1,2999,3010,-11,-1,2840,2840,0,-1,4114,4114,0,-1,5923,3923,2000
2111,20000,16000,1,1,1,0,0,0,0,77264,2500,74764,0,74319,2000,72319,0,9968,1000,8968,0,10769,1000,9769
2112,50000,40000,0,0,0,0,0,0,0,38343,2046,36297,0,32214,1866,30348,0,17292,310,16982,0,7501,300,7201
2113,100000,80000,0,0,1,1,0,0,-1,104346,100000,4346,0,91025,2017,89008,0,91120,1822,89298,0,1777,1777,0
2114,150000,120000,0,0,0,0,0,0,2,390,390,0,-1,780,780,0,-1,1746,1746,0,-1,0,0,0
2115,210000,168000,0,0,0,0,0,0,0,137000,5778,131222,0,55855,1955,53900,0,58370,3370,55000,0,59537,1913,57624
2116,20000,16000,0,1,1,1,1,0,2,18255,0,18255,2,20129,2500,17629,2,19528,0,19528,2,40068,800,39268
2117,140000,112000,0,0,0,0,0,0,0,0,0,0,-2,0,0,0,-2,0,0,0,-2,0,0,0
2118,120000,96000,0,0,0,0,0,0,0,86212,4001,82211,0,87003,3114,83889,0,88833,3232,85601,0,92348,5000,87348
2119,130000,104000,0,1,1,0,0,0,0,124030,7501,116529,0,119966,6621,113345,0,89588,3501,86087,0,91178,3501,87677
2120,90000,72000,0,0,0,0,0,0,0,8374,1300,7074,0,29525,22000,7525,0,28333,1000,27333,0,27879,1012,26867
2121,160000,128000,0,0,0,0,0,0,3,97701,0,97701,2,99434,2321,97113,0,99527,432,99095,0,16331,546,15785
2122,410000,328000,0,0,0,0,0,0,-2,0,0,0,-2,0,0,0,-2,0,0,0,-2,0,0,0
2123,140000,112000,0,0,0,0,0,0,0,106450,4000,102450,0,106422,4000,102422,0,104337,4000,100337,0,106886,4300,102586
2124,200000,160000,0,1,1,1,1,0,0,171784,6300,165484,0,175197,6276,168921,0,179069,6701,172368,0,189686,13800,175886
2125,50000,40000,0,0,0,0,0,0,0,25454,1500,23954,0,26030,1000,25030,0,26609,1000,25609,0,27662,1500,26162
2126,150000,120000,0,0,0,0,0,0,0,0,0,0,0,0,0,0,-2,0,0,0,-2,0,0,0
2127,50000,40000,1,1,0,0,0,0,0,64426,1565,62861,0,18430,641,17789,0,18020,648,17372,0,17991,654,17337
2128,360000,288000,0,0,0,0,0,0,-1,0,0,0,-1,0,0,0,-2,0,0,0,-2,0,0,0
2129,460000,368000,0,0,0,0,0,0,2,145081,7506,137575,0,130967,5024,125943,0,118659,2572,116087,0,15322,2005,13317
2130,50000,40000,0,0,0,0,0,0,0,9795,4239,5556,0,32694,28000,4694,0,28899,1015,27884,0,28924,2000,26924
2131,310000,248000,0,0,0,0,0,0,0,71464,2400,69064,0,72299,2212,70087,0,50967,1985,48982,0,51153,2422,48731
2132,110000,88000,0,0,0,0,0,1,0,66128,9600,56528,0,64477,0,64477,3,65413,2600,62813,2,66520,2300,64220
2133,80000,64000,0,0,0,0,0,0,0,20330,3500,16830,0,17050,3000,14050,0,10926,0,10926,0,10068,1000,9068
2134,280000,224000,0,0,0,0,0,0,-2,-10,0,-10,-2,3090,3100,-10,-1,240,240,0,-1,2010,2010,0
2135,100000,80000,0,0,0,0,0,0,0,32905,1385,31520,0,29866,971,28895,0,30503,1018,29485,0,28518,984,27534
2136,140000,112000,0,1,1,1,1,1,0,135784,4779,131005,0,136258,6000,130258,0,137747,6000,131747,0,138593,6000,132593
2137,50000,40000,0,0,0,0,0,0,0,21097,2000,19097,0,21759,1000,20759,0,22421,1000,21421,0,23061,1000,22061
2138,500000,400000,0,0,0,0,0,0,-1,1543,1543,0,-1,0,0,0,-1,0,0,0,-2,0,0,0
2139,80000,64000,0,0,0,0,0,1,0,41577,2000,39577,2,41595,1000,40595,2,43264,2500,40764,2,43402,1000,42402
2140,280000,224000,0,0,0,0,0,0,0,81193,3007,78186,0,82470,5000,77470,0,49630,2000,47630,0,46517,1700,44817
2141,300000,240000,0,0,0,0,0,0,0,51818,5000,46818,0,50244,5000,45244,0,49484,5000,44484,0,53472,5000,48472
2142,180000,144000,0,0,0,0,0,0,-2,0,0,0,-2,2072,2072,0,-1,-28,0,-28,-1,-28,0,-28
2143,30000,24000,0,0,1,1,1,1,2,26733,3500,23233,2,27016,1028,25988,2,24972,0,24972,2,25425,1000,24425
2144,330000,264000,0,0,0,0,0,1,-1,0,0,0,-1,0,0,0,-2,1588,1588,0,-1,0,0,0
2145,210000,168000,0,0,0,0,0,0,0,64150,3000,61150,0,66135,3000,63135,0,70118,5000,65118,0,67254,0,67254
2146,50000,40000,0,1,1,0,0,1,0,50036,2100,47936,0,48816,1500,47316,0,19587,1000,18587,0,18406,700,17706
2147,340000,272000,0,0,0,0,0,0,-1,526,526,0,-1,36374,36374,0,-1,32413,32413,0,-1,12092,12092,0
2148,240000,192000,0,0,0,0,0,0,-2,17102,1120,15982,-2,13367,13434,-67,-2,22659,22772,-113,-2,22707,22820,-113
2149,150000,120000,0,0,0,0,0,0,0,74722,2413,72309,0,77865,3776,74089,0,78819,2224,76595,0,80607,2448,78159
2150,10000,8000,0,0,1,0,1,0,0,6641,2234,4407,0,15318,1135,14183,0,8610,1086,7524,0,8790,319,8471
2151,210000,168000,0,0,0,0,0,0,-1,2529,2529,0,-1,3087,3087,0,-1,2811,2811,0,-1,3204,3204,0
2152,50000,40000,0,0,0,0,0,0,2,23130,1698,21432,0,24432,2000,22432,0,26862,3000,23862,0,29244,3000,26244
2153,90000,72000,0,1,1,1,0,0,0,78054,5000,73054,0,78116,4000,74116,0,75483,3315,72168,0,72821,7539,65282
2154,220000,176000,0,0,0,0,0,0,-1,30770,30775,-5,-1,949,949,0,-1,3359,3359,0,-1,619,619,0
2155,20000,16000,0,0,1,1,1,1,0,17043,1307,15736,0,18236,1500,16736,0,19376,1408,17968,0,18958,0,18958
2156,240000,192000,0,0,0,0,0,0,-1,4421,5000,-579,-1,8521,10112,-1591,-1,8323,0,8323,2,16620,13000,3620
2157,50000,40000,0,0,0,0,0,0,0,16028,2000,14028,0,17760,2000,15760,0,19462,2000,17462,0,22141,3000,19141
2158,200000,160000,0,1,1,1,1,0,0,185722,8500,177222,0,196732,16000,180732,0,188930,0,188930,2,192647,7500,185147
2159,40000,32000,0,0,0,0,0,1,2,21070,1000,20070,2,21420,1000,20420,0,23066,2000,21066,0,23683,1000,22683
2160,30000,24000,0,0,0,0,0,0,0,16790,3000,13790,0,12400,6000,6400,0,780,780,0,-1,0,0,0
2161,200000,160000,0,1,1,0,0,0,0,195191,8939,186252,0,182027,8099,173928,0,139901,5000,134901,0,135720,5000,130720
2162,300000,240000,0,0,0,0,0,0,-1,117497,121715,-4218,-1,110680,4000,106680,0,104016,5000,99016,0,109839,9000,100839
2163,50000,40000,0,1,1,0,0,1,0,48701,0,48701,2,49066,2500,46566,0,30177,1151,29026,0,29274,1156,28118
2164,230000,184000,0,0,0,0,0,0,-1,13375,13441,-66,-1,-10,0,-10,-1,8808,8818,-10,-1,6632,4,6628
2165,40000,32000,0,1,1,1,1,0,2,40985,4898,36087,2,40085,0,40085,3,39354,0,39354,2,40322,1800,38522
2166,430000,344000,0,0,0,0,0,0,-2,5741,5745,-4,-2,8897,8935,-38,-2,1350,1350,0,-2,10184,10184,0
2167,260000,208000,0,0,0,0,0,0,-1,0,0,0,-1,0,0,0,-2,0,0,0,-2,0,0,0
2168,300000,240000,0,0,0,0,0,0,-1,2476,2476,0,-1,5797,5797,0,-1,1542,0,1542,0,1256,1256,0
2169,50000,40000,0,0,0,0,0,0,0,29775,1800,27975,0,0,0,0,0,0,0,0,-2,0,0,0
2170,110000,88000,0,0,0,0,0,1,0,66639,3360,63279,0,57595,2100,55495,0,58814,2100,56714,0,60086,2200,57886
2171,190000,152000,0,0,0,0,0,1,2,5459,1000,4459,2,6214,1000,5214,2,7104,1000,6104,0,8973,2000,6973
2172,160000,128000,0,0,0,0,0,0,2,65439,2960,62479,0,66761,3007,63754,0,67628,2573,65055,0,68983,2600,66383
2173,300000,240000,0,0,0,0,0,0,-2,194,194,0,-1,1375,1181,194,0,13970,14039,-69,-1,1672,1679,-7
2174,300000,240000,0,0,0,0,0,0,-2,19999,20018,-19,-1,17139,1072,16067,0,10304,206,10098,0,16062,6003,10059
2175,340000,272000,0,1,1,0,0,0,0,331334,13214,318120,0,286660,12005,274655,0,263505,13005,250500,0,268256,10011,258245
2176,200000,160000,0,0,0,0,0,0,0,88227,4000,84227,0,82087,4000,78087,0,75285,3000,72285,0,78872,13000,65872
2177,500000,400000,0,0,0,0,0,1,-2,0,0,0,-2,0,0,0,-2,0,0,0,-2,0,0,0
2178,200000,160000,0,0,0,0,0,0,0,76740,6104,70636,0,67480,1839,65641,0,68843,1862,66981,0,70266,1918,68348
2179,30000,24000,0,0,0,0,0,0,0,10184,1851,8333,0,12408,2400,10008,0,11922,0,11922,3,12167,587,11580
2180,100000,80000,0,0,0,0,0,0,0,89406,43075,46331,0,77924,2750,75174,0,78683,2750,75933,0,77357,2800,74557
2181,130000,104000,0,0,0,0,0,0,0,106158,6003,100155,0,97685,4000,93685,0,80733,3000,77733,0,82883,4870,78013
2182,200000,160000,0,0,0,0,0,0,-1,10291,11000,-709,-1,0,0,0,-1,582,873,-291,-1,291,0,291
2183,390000,312000,0,0,0,0,0,0,0,82853,4502,78351,0,82747,3518,79229,0,44143,2003,42140,0,38488,3001,35487
2184,50000,40000,0,0,0,0,0,0,-1,832,832,0,-1,0,0,0,-1,1662,1662,0,-1,4537,4537,0
2185,60000,48000,0,1,0,0,0,0,0,60586,3800,56786,0,39144,3300,35844,0,39615,1900,37715,0,39334,1600,37734
2186,90000,72000,0,0,0,0,0,0,0,14027,1518,12509,0,13559,1500,12059,0,14331,1000,13331,0,14948,1000,13948
2187,50000,40000,0,1,1,1,1,0,0,48371,2062,46309,0,48629,1710,46919,0,49410,1923,47487,0,49568,1512,48056
2188,420000,336000,0,0,0,0,0,0,0,25419,1174,24245,0,10951,1133,9818,0,8126,291,7835,0,8313,318,7995
2189,130000,104000,0,0,0,0,0,0,0,42496,5542,36954,0,45954,4500,41454,0,51419,5465,45954,0,55919,4500,51419
2190,260000,208000,0,0,0,0,0,0,0,2924,1100,1824,0,2784,1000,1784,0,2413,300,2113,0,902,0,902
2191,360000,288000,0,0,0,0,0,0,-1,4960,1007,3953,0,5228,2006,3222,0,6552,2562,3990,0,3827,13,3814
2192,100000,80000,0,0,0,0,0,0,2,935,0,935,2,5362,5362,0,-1,4082,0,4082,0,-75,0,-75
2193,120000,96000,0,0,0,0,0,0,-1,827,827,0,-1,827,827,0,-1,1654,1654,0,-1,827,0,827
2194,200000,160000,0,0,0,0,0,0,-2,0,0,0,-2,5000,5000,0,-1,5000,0,5000,2,0,0,0
2195,360000,288000,0,0,0,0,0,0,-1,15000,15032,-32,-1,9744,9769,-25,-1,11114,11114,0,-1,8123,8123,0
2196,140000,112000,0,1,1,1,1,0,0,141949,19000,122949,0,141345,10400,130945,0,136379,0,136379,2,126211,4931,121280
2197,300000,240000,0,0,0,0,0,0,-2,0,0,0,-2,0,0,0,-2,0,0,0,-2,0,0,0
2198,360000,288000,0,0,0,0,0,1,-2,-307,0,-307,-2,-307,0,-307,-2,-307,0,-307,-2,-307,307,-614
2199,150000,120000,0,0,0,0,0,0,-1,2441,2441,0,-1,4471,4471,0,-1,2441,2441,0,-1,0,0,0
2200,350000,280000,0,0,0,0,0,0,-1,90588,91041,-453,-1,3047,3062,-15,-1,-4,0,-4,-1,920,924,-4
2201,100000,80000,0,0,0,0,0,0,-1,15798,15798,0,-1,390,390,0,-1,2265,2265,0,-1,1823,1823,0
2202,70000,56000,0,0,0,0,0,0,0,59186,7172,52014,0,48178,10000,38178,0,46197,1662,44535,0,48444,3000,45444
2203,320000,256000,0,0,0,0,0,0,2,109226,11,109215,2,111673,7013,104660,2,111053,4014,107039,2,105999,57,105942
2204,360000,288000,0,1,1,0,0,0,0,340216,15000,325216,0,344545,14000,330545,0,140386,5008,135378,0,144042,10055,133987
2205,140000,112000,0,0,0,0,0,0,-1,1744,1744,0,-1,1700,1700,0,-1,1700,1700,0,-1,4584,4584,0
2206,200000,160000,0,0,0,0,0,1,2,0,0,0,-2,0,0,0,-2,0,0,0,-2,0,0,0
2207,80000,64000,0,0,0,0,0,0,-2,0,0,0,-2,0,0,0,-2,0,0,0,-2,0,0,0
2208,320000,256000,0,0,0,0,0,0,-1,24495,24495,0,-1,29226,5036,24190,0,41415,20004,21411,0,20738,1250,19488
2209,20000,16000,0,0,0,1,1,0,0,8801,1200,7601,0,18601,10000,8601,0,18909,538,18371,0,39156,10000,29156
2210,240000,192000,0,0,0,0,0,0,0,124226,5834,118392,0,113133,3870,109263,0,113966,4000,109966,0,103360,3825,99535
2211,110000,88000,0,0,0,0,0,1,-1,0,0,0,-1,0,0,0,-2,0,0,0,-2,0,0,0
2212,250000,200000,0,0,0,0,0,0,-1,-1404,5000,-6404,-1,3596,5000,-1404,-1,8596,5000,3596,0,8941,4000,4941
2213,400000,320000,0,0,0,0,0,0,-1,1663,1667,-4,-1,5019,5039,-20,-1,9539,9579,-40,-1,1697,1703,-6
2214,270000,216000,0,0,0,0,0,0,-2,1100,1100,0,-2,300,300,0,-2,-200,0,-200,-2,-200,0,-200
2215,350000,280000,0,0,0,0,0,0,0,17772,1300,16472,0,18127,650,17477,0,18536,700,17836,0,19224,1000,18224
2216,30000,24000,0,0,0,0,0,0,-1,5242,5250,-8,-1,19705,19711,-6,-1,10417,10417,0,-1,9736,9979,-243
2217,230000,184000,0,0,0,0,0,0,-2,2562,2566,-4,-2,6245,6286,-41,-2,394,394,0,-2,987,989,-2
2218,240000,192000,0,0,0,0,0,0,-1,1530,1534,-4,-1,2961,2961,0,-1,5962,3001,2961,0,7336,2024,5312
2219,450000,360000,0,0,0,0,0,0,-2,481,483,-2,-2,29646,29707,-61,-2,10163,10214,-51,-2,10163,10214,-51
2220,140000,112000,0,0,0,0,0,0,-1,1204,1204,0,-1,700,0,700,0,748,748,0,-1,-784,0,-784
2221,180000,144000,0,0,0,0,0,1,-1,10600,10600,0,-1,0,0,0,-1,9510,9510,0,-1,9510,0,9510
2222,80000,64000,0,0,0,0,0,0,-2,431,431,0,-1,0,0,0,-1,0,0,0,-2,0,0,0
2223,30000,24000,0,1,0,0,0,0,0,25412,1200,24212,0,21658,1000,20658,0,980,1000,-20,-1,55,55,0
2224,50000,40000,0,0,0,0,0,1,0,37332,0,37332,2,39702,3000,36702,2,38932,0,38932,2,41770,3500,38270
2225,90000,72000,0,0,0,0,0,0,0,48950,21287,27663,0,20253,1353,18900,0,18810,1000,17810,0,19496,1000,18496
2226,60000,48000,0,0,0,0,0,0,-1,14020,14020,0,-1,4880,4880,0,-1,2034,2233,-199,-1,978,2968,-1990
2227,20000,16000,0,0,0,0,0,0,0,12115,1201,10914,0,12356,442,11914,0,12623,466,12157,0,13905,1500,12405
2228,340000,272000,0,0,0,0,0,0,2,-11,0,-11,2,35947,35958,-11,-1,83360,50000,33360,-1,82516,0,82516
2229,90000,72000,0,0,0,0,0,0,0,19670,1326,18344,0,14039,1095,12944,0,14218,377,13841,0,9427,288,9139
2230,380000,304000,0,0,0,0,0,0,-1,82860,89999,-7139,-1,753,753,0,-1,11599,11599,0,-1,8348,8348,0
2231,160000,128000,0,0,0,0,0,1,-1,396,396,0,-1,0,0,0,-1,688,688,0,-1,396,500,-104
2232,140000,112000,0,0,0,0,0,0,-1,51293,50006,1287,0,56740,9460,47280,0,59455,9461,49994,0,57532,2507,55025
2233,170000,136000,0,0,0,0,0,0,0,0,0,0,-2,0,0,0,-2,0,0,0,-2,0,0,0
2234,50000,40000,0,1,0,0,0,0,0,49222,2200,47022,0,29291,1187,28104,0,29391,1213,28178,0,29826,1073,28753
2235,30000,24000,0,0,0,0,0,0,0,25321,1696,23625,0,19455,1015,18440,0,0,0,0,0,0,0,0
2236,20000,16000,0,0,1,1,1,0,0,20076,20700,-624,-1,19875,2000,17875,0,19659,800,18859,0,19310,465,18845
2237,50000,40000,0,0,0,0,0,0,0,17606,1300,16306,0,17955,641,17314,0,18418,751,17667,0,18601,573,18028
2238,50000,40000,0,0,0,0,0,0,2,0,0,0,2,0,0,0,-2,0,0,0,-2,0,0,0
2239,210000,168000,0,0,0,0,0,1,-1,873,873,0,-1,148,148,0,-1,129,129,0,-1,292,292,0
2240,20000,16000,0,0,0,0,0,0,0,0,0,0,-2,0,0,0,-2,0,0,0,-2,0,0,0
2241,400000,320000,0,0,0,0,0,0,-1,1274,1274,0,-1,19143,19143,0,-1,20305,1305,19000,0,22063,2063,20000
2242,50000,40000,0,0,0,0,0,0,0,213,0,213,2,3336,3336,0,-1,1863,0,1863,0,390,0,390
2243,80000,64000,0,0,0,0,0,0,-1,444,444,0,-1,888,888,0,-1,888,444,444,0,444,0,444
2244,150000,120000,0,1,1,1,1,1,2,150785,5694,145091,0,140166,5014,135152,0,143125,5215,137910,0,151741,11016,140725
2245,200000,160000,0,0,0,0,0,0,-1,6632,6632,0,-1,0,0,0,-2,734,734,0,-1,584,0,584
2246,500000,400000,0,0,0,0,0,0,0,68761,6720,62041,0,70260,5000,65260,0,70143,5000,65143,0,68506,4000,64506
2247,150000,120000,0,0,0,0,0,0,-2,0,0,0,-2,0,0,0,-2,0,0,0,-2,0,0,0
2248,100000,80000,0,0,0,0,0,1,0,24246,0,24246,2,26839,3000,23839,2,26109,0,26109,2,27686,2000,25686
2249,20000,16000,0,0,0,0,0,1,-2,0,0,0,-2,0,0,0,-2,0,0,0,-2,0,0,0
2250,130000,104000,0,0,0,0,0,0,0,7350,1268,6082,0,3488,1010,2478,0,3991,4003,-12,-1,3077,3086,-9
2251,30000,24000,0,0,0,0,0,1,0,20803,1500,19303,2,21655,1500,20155,0,22646,1500,21146,0,23764,1500,22264
2252,50000,40000,0,0,0,0,0,0,0,16922,1603,15319,0,19319,3000,16319,0,17644,0,17644,2,18209,1000,17209
2253,30000,24000,0,1,1,1,1,1,2,27150,0,27150,2,28100,2300,25800,2,28104,1200,26904,2,28181,1300,26881
2254,350000,280000,0,0,0,0,0,1,2,254410,81256,173154,0,11423,8441,2982,0,8415,6,8409,2,10230,8013,2217
2255,150000,120000,0,0,0,0,0,0,0,40357,1700,38657,0,41284,1600,39684,0,42105,1507,40598,0,43146,1719,41427
2256,60000,48000,0,0,0,1,1,1,2,46838,1725,45113,0,50044,4000,46044,0,50923,2000,48923,2,52158,2200,49958
2257,120000,96000,0,0,0,0,0,0,-1,0,0,0,-2,974,974,0,-1,974,0,974,2,1624,650,974
2258,50000,40000,0,0,0,0,0,0,0,7218,1248,5970,0,6946,366,6580,0,6808,500,6308,0,6542,384,6158
2259,80000,64000,0,0,0,0,0,1,-1,2000,2000,0,-1,2000,2000,0,-1,2000,2000,0,-1,2000,2000,0
2260,390000,312000,0,0,0,0,0,1,0,180074,7508,172566,0,178025,6000,172025,0,198721,39604,159117,0,162444,6341,156103
2261,200000,160000,0,0,0,0,0,0,-2,18475,14068,4407,-2,1016,3,1013,-2,4934,4948,-14,-2,7749,7770,-21
2262,80000,64000,0,0,0,0,0,1,-2,1672,1672,0,-2,836,836,0,-2,0,0,0,-2,2902,2902,0
2263,50000,40000,0,1,1,1,0,0,0,47862,1800,46062,0,49064,2000,47064,0,66819,2300,64519,0,17288,2000,15288
2264,20000,16000,0,1,1,0,0,0,0,18285,1136,17149,0,18235,646,17589,0,16259,381,15878,0,10640,337,10303
2265,140000,112000,0,0,0,0,0,0,0,89977,4000,85977,0,92381,4000,88381,0,83641,3000,80641,0,86316,4000,82316
2266,50000,40000,0,0,0,0,0,0,-2,0,0,0,-2,0,0,0,-2,0,0,0,-2,19553,19553,0
2267,140000,112000,0,1,1,0,0,0,0,139270,6799,132471,0,137548,5100,132448,0,96340,3300,93040,0,94201,3400,90801
2268,100000,80000,0,0,0,0,0,0,-1,1791,1791,0,-1,2367,2367,0,-1,4589,4613,-24,-1,291,291,0
2269,170000,136000,0,0,0,0,0,0,-2,9311,9311,0,-1,10257,1257,9000,0,20872,10872,10000,0,34403,14003,20400
2270,20000,16000,0,0,0,0,0,0,-1,9944,0,9944,2,10142,500,9642,0,9591,380,9211,0,10400,1000,9400
2271,130000,104000,0,0,0,0,0,0,0,19887,5000,14887,0,11659,2000,9659,0,11735,2000,9735,0,8541,2000,6541
2272,320000,256000,0,0,0,0,0,0,0,85376,92586,-7210,-1,88585,5001,83584,0,101546,15001,86545,0,41685,3011,38674
2273,110000,88000,0,0,0,0,0,0,0,37086,2000,35086,0,37967,1500,36467,0,40551,3200,37351,0,39749,0,39749
2274,180000,144000,0,0,0,0,0,0,0,71259,3500,67759,0,66661,3000,63661,0,62770,3000,59770,0,58067,2300,55767
2275,180000,144000,0,0,0,0,0,0,-1,2458,2458,0,-1,305,305,0,-1,0,0,0,-1,0,0,0
2276,220000,176000,0,0,0,0,0,0,0,106534,4000,102534,0,109884,5500,104384,0,106114,3775,102339,0,108202,4100,104102
2277,210000,168000,0,0,0,0,0,0,-1,21874,21874,0,-1,20076,20076,0,-1,16171,16171,0,-1,586,586,0
2278,20000,16000,0,0,0,0,0,0,0,0,0,0,0,0,0,0,-2,0,0,0,-2,1000,1000,0
2279,200000,160000,0,0,0,0,0,0,-1,12610,13587,-977,-1,7850,7850,0,-1,977,0,977,0,9205,9205,0
2280,160000,128000,0,0,0,0,0,0,0,36512,1895,34617,0,36382,1606,34776,0,37105,1329,35776,0,38034,1528,36506
2281,170000,136000,0,0,0,0,0,0,-1,8846,8866,-20,-1,920,921,-1,-1,380,381,-1,-1,4765,4801,-36
2282,120000,96000,0,0,0,0,0,0,0,19528,2000,17528,0,19065,2000,17065,0,18617,1000,17617,0,21381,3000,18381
2283,180000,144000,0,0,0,0,0,0,-1,584,584,0,-1,1196,1202,-6,-1,3040,3049,-9,-1,8009,8009,0
2284,400000,320000,0,0,0,0,0,0,-1,4382,4403,-21,-1,1240,1250,-10,-1,167621,168459,-838,-1,3284,3301,-17
2285,330000,264000,0,0,0,0,0,0,-1,870,870,0,-1,0,0,0,-1,435,435,0,-1,435,435,0
2286,420000,336000,0,0,0,0,0,0,0,0,0,0,0,0,0,0,-2,0,0,0,-2,0,0,0
2287,70000,56000,0,0,0,0,0,0,0,52650,5000,47650,0,53099,1900,51199,2,51648,0,51648,2,55409,4600,50809
2288,300000,240000,0,0,0,0,0,0,-1,0,0,0,-1,12880,12880,0,-1,14895,2500,12395,0,9386,200,9186
2289,270000,216000,0,0,0,0,0,0,-2,16098,16098,0,-2,1350,1350,0,-2,558,558,0,-2,0,0,0
2290,330000,264000,0,0,0,0,0,0,0,79505,3500,76005,0,80589,19000,61589,0,76180,15000,61180,0,61693,3000,58693
2291,80000,64000,0,0,0,0,0,0,-1,0,0,0,-2,0,0,0,-2,0,0,0,-2,0,0,0
2292,140000,112000,0,0,0,0,0,0,-1,9920,10132,-212,-1,7078,7084,-6,-1,3936,4,3932,0,1555,1555,0
2293,20000,16000,0,0,0,0,0,0,0,6005,1039,4966,0,6411,1000,5411,0,3125,123,3002,0,3164,101,3063
2294,260000,208000,0,0,0,0,0,0,0,27879,2000,25879,0,28420,2000,26420,0,39206,12000,27206,0,37705,0,37705
2295,80000,64000,0,0,0,0,0,0,0,37082,2000,35082,0,38464,2000,36464,0,38922,1397,37525,0,40791,2500,38291
2296,500000,400000,0,0,0,0,0,0,0,10925,1244,9681,0,11795,1114,10681,0,14384,2703,11681,0,15806,3435,12371
2297,60000,48000,0,1,0,0,0,0,0,58987,3000,55987,0,17350,800,16550,0,17937,1000,16937,0,17298,1000,16298
2298,240000,192000,0,0,0,0,0,0,-1,0,0,0,-1,0,0,0,-2,0,0,0,-2,0,0,0
2299,120000,96000,0,1,1,1,1,0,0,119339,4400,114939,0,122334,5000,117334,0,121254,4600,116654,0,122094,5000,117094
2300,80000,64000,0,0,0,0,0,0,0,27979,3901,24078,0,22460,1001,21459,0,22743,1001,21742,0,22988,1001,21987
2301,500000,400000,0,0,0,0,0,0,0,133712,6000,127712,0,136069,5355,130714,0,67837,3500,64337,0,69514,2513,67001
2302,20000,16000,0,0,0,0,0,0,-1,0,0,0,-1,410,410,0,-1,0,1000,-1000,-1,-2000,2000,-4000
2303,200000,160000,0,0,0,0,0,0,-1,390,390,0,-1,561,561,0,-1,390,390,0,-1,390,390,0
2304,220000,176000,0,0,0,0,0,0,0,154508,6000,148508,0,152829,6814,146015,0,152842,5500,147342,0,152747,5800,146947
2305,90000,72000,0,0,0,0,0,0,0,35660,0,35660,2,36436,3000,33436,0,33548,10000,23548,0,32061,2000,30061
2306,100000,80000,0,0,0,0,0,0,2,1281,1281,0,2,3770,3786,-16,-2,2056,2056,0,-2,5628,5634,-6
2307,50000,40000,0,0,0,0,0,0,2,32714,1500,31214,2,32482,600,31882,2,33807,2000,31807,2,34398,1300,33098
2308,150000,120000,0,0,0,0,0,0,0,101441,4032,97409,0,100829,3410,97419,0,101913,4000,97913,0,96704,3665,93039
2309,10000,8000,0,0,1,1,0,1,2,9121,1200,7921,0,9926,1500,8426,0,8898,0,8898,2,7667,1000,6667
2310,50000,40000,0,0,0,0,0,1,-2,0,0,0,-2,0,0,0,-2,0,0,0,-2,550,550,0
2311,170000,136000,0,0,0,0,0,0,-2,0,0,0,-2,0,0,0,-2,0,0,0,-2,0,0,0
2312,220000,176000,0,0,0,0,0,0,-2,8553,8603,-50,-2,11652,11709,-57,-2,14968,15823,-855,-2,7898,7937,-39
2313,50000,40000,1,1,1,1,1,1,2,50011,0,50011,2,53469,5000,48469,2,50337,2005,48332,2,46903,0,46903
2314,330000,264000,0,0,0,0,0,0,0,229644,8095,221549,0,227587,8025,219562,0,227775,8175,219600,0,228203,8391,219812
2315,100000,80000,0,1,0,0,0,0,0,83231,2700,80531,0,62421,2270,60151,0,63814,2433,61381,0,65164,2530,62634
2316,150000,120000,0,0,0,0,0,1,2,-150,85,-235,2,974,1124,-150,-1,269,0,269,2,191,191,0
2317,220000,176000,0,0,0,0,0,1,0,31027,1820,29207,0,31807,1600,30207,0,33966,2688,31278,0,33288,0,33288
2318,80000,64000,0,0,0,0,0,0,0,42486,2000,40486,0,24500,1600,22900,0,28900,5000,23900,0,29400,1000,28400
2319,50000,40000,0,1,1,0,0,0,0,49556,2110,47446,0,49902,1456,48446,0,38391,1360,37031,0,29427,1057,28370
2320,450000,360000,0,0,0,0,0,0,0,39827,3001,36826,0,43978,5217,38761,0,389,1,388,0,389,390,-1
2321,60000,48000,0,1,1,1,1,1,0,55188,2000,53188,0,55960,2003,53957,0,56564,2003,54561,0,57464,2070,55394
2322,310000,248000,0,0,0,0,0,0,0,102740,4700,98040,0,97791,4250,93541,0,86200,3100,83100,0,83017,3100,79917
2323,200000,160000,0,1,1,1,1,0,0,196018,6600,189418,0,189865,5350,184515,0,193703,5500,188203,0,199154,7100,192054
2324,200000,160000,0,1,1,1,1,1,0,200852,10036,190816,0,197426,7126,190300,0,196341,6508,189833,0,197787,6011,191776
2325,700000,560000,0,0,0,0,0,0,0,109636,10000,99636,0,326,326,0,0,2016,2016,0,-2,61707,61707,0
2326,30000,24000,0,1,1,1,0,0,0,29398,1700,27698,0,29864,1500,28364,0,30115,1010,29105,0,15818,1000,14818
2327,140000,112000,0,0,0,0,0,0,-2,3169,3169,0,-2,5041,5041,0,-2,389,389,0,-2,3065,3065,0
2328,290000,232000,0,1,1,1,1,0,0,290268,10524,279744,0,296053,10600,285453,0,302793,11500,291293,0,307336,10000,297336
2329,20000,16000,0,1,1,1,1,0,-1,19292,0,19292,2,19545,1310,18235,0,18945,678,18267,0,19494,854,18640
2330,100000,80000,0,0,0,0,0,0,-1,2207,2207,0,-1,630,630,0,-1,540,540,0,-1,0,0,0
2331,180000,144000,0,1,1,1,1,0,0,173037,6352,166685,0,170470,5883,164587,0,174373,6427,167946,0,163873,6500,157373
2332,200000,160000,0,1,1,1,1,0,0,190983,7000,183983,0,188714,9000,179714,0,196262,10700,185562,0,198059,10600,187459
2333,230000,184000,0,0,0,0,0,0,-2,7697,7697,0,-2,5308,5308,0,-2,2048,2048,0,-2,6283,6283,0
2334,80000,64000,0,0,0,0,0,1,-1,0,0,0,-1,1000,1000,0,-1,0,0,0,-1,0,0,0
2335,150000,120000,0,0,1,1,0,0,0,121570,10000,111570,0,130780,10000,120780,0,130780,10000,120780,0,0,20000,-20000
2336,230000,184000,0,0,0,0,0,0,0,68831,2214,66617,0,61534,5904,55630,0,25914,5542,20372,0,36313,15502,20811
2337,80000,64000,0,0,0,0,0,0,-1,1441,1500,-59,-1,1608,1608,0,-1,1453,1453,0,-2,4287,4287,0
2338,50000,40000,0,1,1,0,0,0,-1,50710,2033,48677,0,50503,1776,48727,0,40140,2000,38140,0,-21364,29000,-50364
2339,300000,240000,0,0,0,0,0,0,-2,811,811,0,-2,1128,1128,0,-2,1750,1760,-10,-2,819,819,0
2340,30000,24000,0,1,0,0,1,1,4,24624,0,24624,3,23930,0,23930,2,28807,5288,23519,2,27781,0,27781
2341,70000,56000,0,1,1,0,0,0,0,67292,3100,64192,0,67091,2400,64691,0,49303,2000,47303,0,49350,2000,47350
2342,50000,40000,0,0,0,0,0,0,0,32904,1715,31189,0,28864,2000,26864,0,29708,3010,26698,0,29921,2000,27921
2343,30000,24000,0,1,1,0,0,0,0,29183,1500,27683,0,28983,0,28983,0,13100,500,12600,0,0,0,0
2344,50000,40000,0,1,1,0,0,0,0,48803,2063,46740,0,46472,2217,44255,0,19766,705,19061,0,19761,725,19036
2345,10000,8000,0,0,0,0,0,1,2,4060,4060,0,-1,4530,4530,0,-1,2140,2140,0,-1,1875,1875,0
2346,340000,272000,0,0,0,0,0,1,-2,35192,35212,-20,-2,30000,30000,0,-2,10766,10766,0,-2,33887,33905,-18
2347,220000,176000,0,0,0,0,0,1,0,15,16,-1,-1,947,1578,-631,-1,631,0,631,0,715,400,315
2348,80000,64000,0,0,0,0,0,0,0,45958,2007,43951,0,43437,1361,42076,0,41444,1512,39932,0,35501,2000,33501
2349,230000,184000,0,0,0,0,0,0,0,57074,2300,54774,0,50670,2000,48670,0,50652,2000,48652,0,51267,2000,49267
2350,80000,64000,0,1,1,0,0,0,0,80366,7014,73352,0,74782,44,74738,2,47767,1693,46074,0,49278,4000,45278
2351,200000,160000,0,0,0,0,0,0,0,104382,48617,55765,0,91888,3243,88645,0,88267,3000,85267,0,85471,3233,82238
2352,90000,72000,0,0,0,0,0,0,0,14033,0,14033,2,12628,2000,10628,0,20172,20172,0,-1,73512,73512,0
2353,470000,376000,0,0,0,0,0,1,0,151253,5214,146039,0,138087,4500,133587,0,109094,5000,104094,0,106004,4200,101804
2354,30000,24000,0,1,1,1,1,1,2,27857,1772,26085,0,29685,2600,27085,0,31260,2200,29060,2,30468,0,30468
2355,280000,224000,0,0,0,0,0,0,-1,930,930,0,-1,0,0,0,-1,0,0,0,-2,0,0,0
2356,230000,184000,0,0,0,0,0,0,-1,4556,4566,-10,-1,4316,4316,0,-1,4316,4316,0,-1,4316,4316,0
2357,300000,240000,0,1,1,1,1,1,0,258394,11000,247394,0,261024,11009,250015,0,260672,10000,250672,0,263894,10000,253894
2358,110000,88000,0,0,0,0,0,0,0,48586,5000,43586,0,48430,2000,46430,0,48150,2000,46150,0,48271,2000,46271
2359,80000,64000,0,0,0,0,0,0,0,15115,3000,12115,0,12465,4000,8465,0,6925,1260,5665,0,6049,6100,-51
2360,110000,88000,0,0,0,0,0,0,0,53403,3000,50403,0,56028,5000,51028,0,57996,3000,54996,0,59839,3000,56839
2361,260000,208000,0,0,0,0,0,0,0,212584,8201,204383,0,213851,7633,206218,0,215362,7436,207926,0,214879,7879,207000
2362,320000,256000,0,0,0,0,0,0,-1,23405,23421,-16,-1,16662,16683,-21,-1,38459,38459,0,-1,2836,2836,0
2363,160000,128000,0,0,0,0,0,0,-2,0,0,0,-2,1468,1468,0,-2,0,0,0,-2,0,0,0
2364,80000,64000,0,1,0,0,0,0,0,67097,3061,64036,0,50214,2000,48214,0,48738,1000,47738,0,3860,3860,0
2365,100000,80000,0,0,0,0,0,0,-2,0,0,0,-2,0,0,0,-2,0,0,0,-2,315,315,0
2366,50000,40000,0,1,1,0,0,0,2,50351,4690,45661,2,49038,0,49038,2,28661,1000,27661,0,30398,2159,28239
2367,470000,376000,0,0,0,0,0,0,0,48344,1542,46802,0,45433,1041,44392,0,45853,2019,43834,0,21158,789,20369
2368,20000,16000,0,0,0,0,0,1,0,14431,3000,11431,0,9150,5000,4150,0,10100,6000,4100,0,0,0,0
2369,80000,64000,0,0,0,0,0,1,0,50538,2000,48538,0,53314,29000,24314,0,27962,2004,25958,0,27873,2000,25873
2370,130000,104000,0,1,1,0,0,0,0,116183,6097,110086,0,115034,4085,110949,0,88163,3007,85156,0,87388,3028,84360
2371,20000,16000,0,0,0,0,0,0,0,0,0,0,0,0,0,0,-2,0,0,0,-2,0,0,0
2372,110000,88000,0,0,0,0,0,1,-1,300,300,0,-1,922,922,0,-1,3509,3509,0,-1,1979,0,1979
2373,240000,192000,0,0,0,0,0,0,0,197032,157500,39532,0,169878,0,169878,2,164926,5759,159167,0,160600,5775,154825
2374,20000,16000,0,0,0,0,0,0,0,2454,2296,158,0,2250,2296,-46,-1,2296,2342,-46,-1,4315,4315,0
2375,150000,120000,0,0,0,0,0,0,0,18600,4003,14597,0,13551,2551,11000,0,20759,15579,5180,0,21200,11200,10000
2376,20000,16000,0,0,0,0,0,0,0,6369,1106,5263,0,6891,628,6263,0,6635,0,6635,2,7287,762,6525
2377,490000,392000,0,0,0,0,0,0,-2,244033,244033,0,-1,224216,15011,209205,0,212123,9003,203120,0,214715,9019,205696
2378,20000,16000,0,1,1,1,1,1,2,17541,1305,16236,2,18250,1305,16945,0,19463,1518,17945,0,19010,0,19010
2379,100000,80000,0,0,0,0,0,0,0,30294,3000,27294,0,31734,3500,28234,0,32323,1500,30823,0,33648,2000,31648
2380,80000,64000,0,0,0,0,0,0,-2,0,0,0,-2,0,0,0,-2,0,0,0,-2,0,0,0
2381,50000,40000,0,0,0,0,0,1,2,2400,0,2400,7,2400,0,2400,7,2400,0,2400,7,2400,0,2400
2382,50000,40000,0,0,0,0,0,1,-1,1250,0,1250,2,1400,700,700,2,700,0,700,2,550,550,0
2383,240000,192000,0,0,0,0,0,0,0,0,0,0,0,0,0,0,-2,0,0,0,-2,0,0,0
2384,40000,32000,0,0,0,0,0,0,2,14708,0,14708,2,14704,500,14204,0,16997,2500,14497,0,16568,0,16568
2385,230000,184000,0,0,0,0,0,0,0,8392,1295,7097,0,8967,1300,7667,0,8729,468,8261,0,10816,2816,8000
2386,110000,88000,0,0,0,0,0,0,0,80984,2958,78026,0,80706,2803,77903,0,80580,2940,77640,0,77993,2821,75172
2387,110000,88000,0,0,0,0,0,0,0,47409,2191,45218,0,47743,1525,46218,0,45654,18236,27418,0,26525,1500,25025
2388,240000,192000,0,0,0,0,0,0,-2,0,0,0,-2,0,0,0,-2,0,0,0,-2,0,0,0
2389,110000,88000,0,0,0,0,0,0,0,43320,0,43320,2,48236,5651,42585,2,49195,1876,47319,2,48253,0,48253
2390,240000,192000,0,0,0,0,0,0,-1,1357,1357,0,-1,1559,1559,0,-1,23506,23506,0,-1,21532,1603,19929
2391,340000,272000,0,0,0,0,0,0,0,179607,6500,173107,0,177506,5830,171676,0,176233,6053,170180,0,173279,5200,168079
2392,230000,184000,0,0,0,0,0,0,0,3569,1000,2569,0,2845,0,2845,0,1935,2000,-65,-1,6781,5000,1781
2393,20000,16000,0,1,1,1,0,0,0,19293,1400,17893,0,19298,405,18893,0,19198,400,18798,0,0,0,0
2394,60000,48000,0,0,0,0,0,0,0,27436,3000,24436,0,29752,3000,26752,0,30351,4000,26351,0,28871,2000,26871
2395,50000,40000,0,0,0,0,0,1,0,18923,1000,17923,2,19310,1000,18310,0,19848,1000,18848,0,20367,1000,19367
2396,20000,16000,0,0,0,0,0,0,0,7120,3045,4075,0,8115,10000,-1885,-1,2594,0,2594,0,1610,1610,0
2397,450000,360000,0,0,0,0,0,0,-1,5535,5740,-205,-1,9856,9905,-49,-1,819,823,-4,-1,863,867,-4
2398,310000,248000,0,0,0,0,0,0,0,25567,1408,24159,0,21794,1209,20585,0,20911,622,20289,0,14023,600,13423
2399,80000,64000,0,1,1,1,1,1,2,77611,3000,74611,2,78683,2900,75783,2,80315,3000,77315,2,81887,3000,78887
2400,130000,104000,0,1,0,0,0,0,0,113283,5000,108283,0,101247,4000,97247,0,96939,10600,86339,0,81977,0,81977
2401,500000,400000,0,0,0,0,0,0,0,33040,4000,29040,0,30757,3000,27757,0,35559,5300,30259,0,38981,5000,33981
2402,200000,160000,0,0,0,0,0,1,2,24842,24846,-4,-1,28367,5004,23363,0,28721,1540,27181,0,20139,4,20135
2403,310000,248000,0,0,0,0,0,0,-1,912,919,-7,-1,1688,1696,-8,-1,5590,5617,-27,-1,1649,1657,-8
2404,60000,48000,0,0,0,0,0,0,-2,0,0,0,-2,0,0,0,-2,0,0,0,-2,150,150,0
2405,180000,144000,0,0,0,0,0,0,-1,18762,18762,0,-1,22928,22928,0,-1,3129,0,3129,0,2398,2398,0
2406,30000,24000,0,1,0,0,0,0,0,28002,94,27908,2,23879,1879,22000,0,4178,84,4094,0,0,0,0
2407,80000,64000,0,0,0,0,1,1,0,60102,3000,57102,0,61423,2500,58923,0,72197,11576,60621,0,71003,39,70964
2408,250000,200000,0,0,0,0,1,1,0,198588,9000,189588,0,203286,8000,195286,0,215882,16000,199882,0,214320,2000,212320
2409,500000,400000,0,0,0,0,0,0,0,81726,3006,78720,0,74297,2600,71697,0,66132,3000,63132,0,67695,2600,65095
2410,20000,16000,0,0,0,0,0,0,-1,370,5193,-4823,-1,-20,0,-20,-1,780,800,-20,-1,0,0,0
2411,110000,88000,0,1,0,0,0,0,0,107998,4016,103982,0,79211,3000,76211,0,77881,3000,74881,0,80628,4000,76628
2412,210000,168000,0,0,0,0,0,1,-2,0,0,0,-2,0,0,0,-2,0,0,0,-2,0,0,0
2413,170000,136000,0,0,0,0,0,0,2,30826,2008,28818,0,31996,5000,26996,0,33676,2037,31639,0,25301,2029,23272
2414,60000,48000,0,0,0,0,0,1,0,6733,1300,5433,0,7662,1200,6462,0,8529,1000,7529,0,9884,1500,8384
2415,140000,112000,0,0,0,0,0,1,-1,326,326,0,-1,1516,1516,0,-1,326,326,0,-1,1439,1439,0
2416,250000,200000,0,0,0,0,0,0,0,21218,2065,19153,0,10875,52,10823,0,3328,3336,-8,-1,1460,1460,0
2417,80000,64000,0,0,0,0,0,0,3,165,0,165,2,481,481,0,-1,316,0,316,2,151,0,151
2418,50000,40000,0,0,0,0,0,0,0,13089,1200,11889,0,13731,1232,12499,0,13891,891,13000,0,1769,4435,-2666
2419,280000,224000,0,0,0,0,0,0,-1,67765,2192,65573,0,63628,1899,61729,0,60860,1673,59187,0,60316,2125,58191
2420,240000,192000,0,0,0,0,0,0,-2,-10951,16,-10967,-2,88670,103751,-15081,-1,199444,117086,82358,0,178706,6146,172560
2421,20000,16000,0,1,0,0,0,1,0,17936,1500,16436,0,5995,1000,4995,0,7885,2000,5885,0,9657,2000,7657
2422,120000,96000,0,1,0,0,0,1,0,105810,3000,102810,2,98712,4100,94612,0,84856,4000,80856,0,70059,3600,66459
2423,50000,40000,0,1,1,0,0,0,0,49846,3600,46246,0,49303,2146,47157,0,29722,1004,28718,0,29624,1100,28524
2424,210000,168000,0,0,0,0,0,0,0,98562,3507,95055,0,100329,3334,96995,0,103697,4723,98974,0,91408,3418,87990
2425,160000,128000,0,0,0,0,0,0,-1,1849,2000,-151,-1,4715,4755,-40,-1,799,0,799,0,0,0,0
2426,100000,80000,0,0,0,0,0,0,0,58855,2500,56355,0,48570,1700,46870,0,47651,2100,45551,0,38481,2500,35981
2427,360000,288000,0,0,0,0,0,0,2,0,0,0,2,0,0,0,-2,0,0,0,-2,0,0,0
2428,170000,136000,0,0,0,0,0,0,0,93812,5000,88812,0,95613,5000,90613,0,95972,4400,91572,0,97230,3000,94230
2429,50000,40000,0,0,0,0,0,0,0,37338,1829,35509,0,31278,1644,29634,0,31811,4405,27406,0,28656,1104,27552
2430,360000,288000,0,0,0,0,0,0,0,138091,6135,131956,0,138123,4504,133619,0,140324,4669,135655,0,108772,4060,104712
2431,500000,400000,0,0,0,0,0,0,-1,3030,3030,0,-1,1167,1167,0,-1,2255,2255,0,-1,0,0,0
2432,170000,136000,0,0,0,0,0,0,0,17848,3848,14000,0,14000,4000,10000,0,124208,124208,0,-1,122955,5000,117955
2433,200000,160000,0,0,0,0,0,0,-2,-1,0,-1,-2,299,300,-1,-2,299,300,-1,-2,293,294,-1
2434,480000,384000,0,0,0,0,0,0,0,95336,4000,91336,0,97645,7172,90473,0,92109,4000,88109,0,79795,2500,77295
2435,130000,104000,0,1,0,0,0,0,3,127906,0,127906,2,86109,3029,83080,0,81941,4000,77941,0,84545,5000,79545
2436,130000,104000,0,0,0,0,0,0,-2,0,0,0,-2,0,0,0,-2,0,0,0,-2,0,0,0
2437,300000,240000,0,0,0,0,0,0,-1,26887,27187,-300,-1,23981,13981,10000,0,19378,9378,10000,0,12759,12759,0
2438,100000,80000,0,0,0,0,0,0,2,620,620,0,-1,296,296,0,-1,148,0,148,0,0,0,0
2439,120000,96000,0,0,0,0,0,0,0,62914,1258,61656,0,60584,60584,0,-1,61412,1228,60184,0,55572,0,55572
2440,80000,64000,0,0,0,0,0,0,0,78553,51432,27121,0,49340,1800,47540,0,48919,1800,47119,0,48443,1800,46643
2441,210000,168000,0,0,0,0,0,1,2,20079,17309,2770,0,17309,0,17309,0,2310,2310,0,-1,241,241,0
2442,250000,200000,0,0,0,0,0,0,0,117212,4068,113144,0,112623,3859,108764,0,110178,3597,106581,0,108176,3822,104354
2443,80000,64000,0,0,0,0,0,0,0,60514,1838,58676,0,48965,1434,47531,0,29648,1015,28633,0,28737,1505,27232
2444,50000,40000,0,1,0,0,0,0,0,52230,5144,47086,0,18887,591,18296,0,17693,577,17116,0,18074,609,17465
2445,400000,320000,0,0,0,0,0,0,-2,1228,1228,0,-1,3405,3405,0,-1,961,961,0,-1,-251,0,-251
2446,80000,64000,0,0,0,0,0,0,0,36275,1605,34670,0,37290,1620,35670,0,38030,1360,36670,0,38838,1420,37418
2447,360000,288000,0,0,0,0,0,0,0,43052,15044,28008,0,43596,10115,33481,0,33762,14026,19736,0,33391,5104,28287
2448,140000,112000,0,1,1,1,1,0,2,140047,4800,135247,2,141215,5006,136209,2,142019,5507,136512,2,137251,5,137246
2449,50000,40000,0,1,1,0,0,1,0,51145,4500,46645,0,45624,0,45624,2,29172,1153,28019,0,27291,1000,26291
2450,80000,64000,0,0,0,0,0,1,2,27770,0,27770,2,29396,2400,26996,2,29974,1200,28774,2,30529,1200,29329
2451,260000,208000,0,0,0,0,0,0,-2,725,727,-2,-2,2074,2074,0,-2,0,0,0,-2,585,585,0
2452,50000,40000,0,0,0,0,0,0,0,28764,1444,27320,0,28390,1100,27290,0,29443,1500,27943,0,29041,1100,27941
2453,100000,80000,0,0,0,0,0,0,0,50746,2400,48346,0,51158,1800,49358,0,49226,1800,47426,0,51211,2800,48411
2454,360000,288000,0,0,0,0,0,0,-2,390,390,0,-2,390,390,0,-2,390,390,0,-2,390,390,0
2455,50000,40000,0,0,0,0,0,0,2,29516,1,29515,2,29742,1070,28672,0,29898,1030,28868,0,24883,863,24020
2456,130000,104000,0,0,0,0,0,0,-2,2604,3500,-896,-1,2604,0,2604,0,1,0,1,0,1,0,1
2457,320000,256000,0,0,0,0,0,0,0,170336,6189,164147,0,173806,6309,167497,0,177425,6510,170915,0,181003,6600,174403
2458,20000,16000,0,0,1,1,1,0,0,17750,2180,15570,0,17175,0,17175,2,18716,1818,16898,0,18782,1000,17782
2459,20000,16000,0,0,1,1,0,0,-1,19325,19325,0,-1,19311,386,18925,0,18430,369,18061,0,400,400,0
2460,20000,16000,0,0,0,0,0,0,0,8746,1390,7356,0,3355,3355,0,-1,7143,7143,0,-1,1288,1288,0
2461,140000,112000,0,0,0,0,0,0,-1,109104,110330,-1226,-1,110336,5012,105324,0,67197,5000,62197,0,67910,3000,64910
2462,20000,16000,0,1,1,1,1,1,3,17176,780,16396,2,16605,0,16605,2,17185,1000,16185,0,18340,1600,16740
2463,390000,312000,0,0,0,0,0,0,-2,6203,1051,5152,-2,1518,1545,-27,-1,46365,47280,-915,-1,48795,3000,45795
2464,80000,64000,0,1,0,0,0,1,0,78410,4520,73890,0,55417,3311,52106,0,50733,50441,292,0,50441,1800,48641
2465,60000,48000,0,0,0,0,0,0,0,-27,18,-45,0,15273,15300,-27,-1,14766,5000,9766,-1,14687,15132,-445
2466,230000,184000,0,0,0,0,0,0,-1,44884,44884,0,-1,10086,202,9884,0,6905,405,6500,0,237,237,0
2467,30000,24000,0,0,0,0,0,0,-1,2300,2300,0,-1,0,0,0,-1,780,780,0,-1,0,0,0
2468,290000,232000,0,0,0,0,0,0,-2,10060,10060,0,-2,3946,3948,-2,-2,7388,7388,0,-2,4482,4482,0
2469,50000,40000,0,0,0,0,0,0,2,32600,0,32600,3,31777,0,31777,2,33966,2700,31266,2,34759,1500,33259
2470,240000,192000,0,0,0,0,0,0,0,4508,3632,876,0,8064,7100,964,0,4520,0,4520,0,4476,3500,976
2471,30000,24000,0,1,0,1,0,0,0,27486,1430,26056,0,25663,1684,23979,0,26979,2000,24979,0,24306,892,23414
2472,300000,240000,0,0,0,0,0,0,-2,744,744,0,-2,2826,3000,-174,-2,0,0,0,-2,18525,18525,0
2473,170000,136000,0,1,0,0,0,0,0,158426,4625,153801,0,96704,3510,93194,0,101555,9100,92455,0,97884,0,97884
2474,240000,192000,0,0,0,0,0,1,-2,0,0,0,-2,0,0,0,-2,0,0,0,-2,0,0,0
2475,10000,8000,0,0,0,0,0,0,0,0,0,0,-2,0,0,0,-2,400,400,0,-1,0,0,0
2476,10000,8000,0,0,0,0,0,0,0,6154,0,6154,2,6154,0,6154,0,6280,126,6154,0,0,0,0
2477,50000,40000,0,0,0,0,0,0,-1,390,390,0,-1,390,390,0,-1,390,390,0,-1,23269,23269,0
2478,60000,48000,0,0,0,0,0,0,0,40649,4506,36143,0,40843,2500,38343,0,40612,1800,38812,0,40656,4200,36456
2479,130000,104000,0,0,0,0,0,0,0,99208,4000,95208,0,102946,5300,97646,0,103750,3700,100050,0,105818,3600,102218
2480,40000,32000,0,0,0,0,0,0,-1,9495,9495,0,-1,6965,0,6965,0,2759,0,2759,0,0,0,0
2481,100000,80000,0,1,1,1,1,1,2,92431,3500,88931,0,97227,7000,90227,0,88899,0,88899,2,93766,7000,86766
2482,50000,40000,0,0,0,0,0,1,0,6797,1232,5565,0,7565,1000,6565,0,9565,2000,7565,0,11357,2000,9357
2483,10000,8000,0,0,0,0,0,0,-1,390,390,0,-1,390,390,0,-1,390,390,0,-1,0,0,0
2484,480000,384000,0,0,0,0,0,0,-2,0,0,0,-2,0,0,0,-2,330982,330982,0,-1,355339,30000,325339
2485,60000,48000,0,1,1,1,1,1,0,59675,3000,56675,0,60646,2500,58146,0,60071,2500,57571,0,60066,3000,57066
2486,60000,48000,0,0,0,0,0,0,-1,3630,2500,1130,0,578,578,0,-1,4825,4825,0,-1,6200,2000,4200
2487,210000,168000,0,0,0,0,0,0,-1,11876,11876,0,-1,11876,11876,0,-1,18954,18954,0,-1,11876,5000,6876
2488,20000,16000,0,0,0,0,0,0,-2,390,390,0,-2,390,390,0,-2,390,390,0,-2,390,390,0
2489,120000,96000,0,0,0,0,0,0,0,33231,2805,30426,0,-1320,0,-1320,0,-660,0,-660,-2,956,1616,-660
2490,50000,40000,0,0,1,1,1,0,0,41971,2000,39971,0,43020,2020,41000,0,46150,3800,42350,0,45288,0,45288
2491,20000,16000,0,0,1,0,0,1,0,17195,1341,15854,0,17499,1160,16339,0,16236,556,15680,0,10400,600,9800
2492,160000,128000,0,0,0,0,0,0,0,35275,5390,29885,0,34873,6000,28873,0,35677,5000,30677,0,34942,5000,29942
2493,210000,168000,0,0,0,0,0,0,-2,0,0,0,-2,0,0,0,-2,0,0,0,-2,0,0,0
2494,50000,40000,0,0,0,0,0,0,0,20161,2000,18161,0,20553,1000,19553,0,18933,1000,17933,0,18855,1000,17855
2495,50000,40000,0,0,0,0,0,0,0,15774,1267,14507,0,17087,1580,15507,0,17119,612,16507,0,17602,758,16844
2496,80000,64000,0,0,0,0,0,1,-1,396,0,396,2,792,792,0,-1,0,0,0,-1,396,396,0
2497,50000,40000,1,1,0,0,0,0,0,50073,0,50073,2,26550,1500,25050,0,25842,1090,24752,0,25996,2000,23996
2498,180000,144000,0,0,0,0,0,0,2,76942,3100,73842,0,80419,5000,75419,0,90715,11000,79715,0,37376,1000,36376
2499,90000,72000,0,0,0,0,0,0,0,6911,6911,0,-1,8774,2000,6774,0,9622,1000,8622,0,9824,357,9467
2500,360000,288000,0,0,0,0,0,1,2,2500,0,2500,2,2500,0,2500,2,2500,0,2500,2,0,0,0
2501,130000,104000,0,0,0,0,0,1,0,19992,3000,16992,0,22329,3000,19329,0,23964,2000,21964,0,23428,0,23428
2502,20000,16000,0,1,0,0,1,0,0,19200,1500,17700,0,17085,2000,15085,0,17953,2000,15953,0,19299,2000,17299
2503,300000,240000,0,0,0,0,0,0,0,103744,30022,73722,0,103422,5006,98416,0,111152,10014,101138,0,110811,4016,106795
2504,130000,104000,0,0,0,0,0,1,-1,1650,1650,0,-1,1650,1650,0,-1,1650,1650,0,-1,1650,1650,0
2505,60000,48000,0,0,0,0,0,0,2,24125,1301,22824,0,22597,1000,21597,0,20784,600,20184,0,15599,600,14999
2506,50000,40000,0,0,0,0,0,1,0,0,0,0,0,0,0,0,-2,0,0,0,-2,0,0,0
2507,20000,16000,0,0,0,0,1,1,3,15146,0,15146,2,15856,1266,14590,0,17090,1500,15590,0,16677,0,16677
2508,150000,120000,0,0,0,0,0,0,-1,1555,1555,0,-1,2126,2126,0,-1,60092,60092,0,-1,59831,3000,56831
2509,20000,16000,0,0,0,0,0,1,0,10720,1508,9212,0,10120,1000,9120,0,0,0,0,0,0,0,0
2510,50000,40000,0,0,0,0,0,1,-2,0,0,0,-2,0,0,0,-2,0,0,0,-2,0,0,0
2511,330000,264000,0,0,0,0,0,0,-1,6350,6350,0,-1,6033,6033,0,-1,2205,5649,-3444,-1,0,0,0
2512,80000,64000,0,0,0,0,0,0,0,37326,2000,35326,0,38203,1500,36703,0,39580,2000,37580,0,40920,2000,38920
2513,280000,224000,0,0,0,0,0,0,0,7043,0,7043,2,8932,2000,6932,0,9654,1000,8654,0,10774,2000,8774
2514,490000,392000,0,0,0,0,0,0,0,226020,9861,216159,0,212422,7055,205367,0,201680,6189,195491,0,164989,5046,159943
2515,230000,184000,0,0,0,0,0,0,0,25825,1500,24325,0,25908,1500,24408,0,26341,1000,25341,0,27898,2000,25898
2516,210000,168000,0,0,0,0,0,0,0,29104,3004,26100,0,29447,3058,26389,0,12411,1000,11411,0,5555,5000,555
2517,150000,120000,0,0,0,0,0,0,-2,0,0,0,-2,0,0,0,-2,0,0,0,-2,0,0,0
2518,100000,80000,0,0,0,0,0,0,0,41217,1900,39317,0,42193,1800,40393,0,44722,3200,41522,0,44024,0,44024
2519,30000,24000,0,0,0,0,0,0,2,1800,0,1800,6,1800,0,1800,6,1200,0,1200,5,600,0,600
2520,50000,40000,0,0,0,0,0,0,0,25862,1900,23962,0,12468,2400,10068,0,12381,250,12131,0,12683,500,12183
2521,240000,192000,0,0,0,0,0,1,0,162231,8005,154226,0,163255,6005,157250,0,165436,30912,134524,0,168178,5000,163178
2522,230000,184000,0,0,0,0,0,0,-1,3546,3546,0,-1,0,0,0,-1,1490,1490,0,-1,0,0,0
2523,100000,80000,0,0,0,0,0,0,0,71567,3181,68386,0,72410,2628,69782,0,73846,2640,71206,0,75556,2897,72659
2524,50000,40000,0,0,0,0,0,0,0,35639,3332,32307,0,18753,2000,16753,0,19091,2000,17091,0,19548,2000,17548
2525,280000,224000,0,0,0,0,0,1,-2,26330,26330,0,-1,6880,6880,0,-1,797,797,0,-1,4898,4898,0
2526,300000,240000,0,0,0,0,0,0,0,40618,11000,29618,0,52288,12288,40000,0,70000,20000,50000,0,100000,30000,70000
2527,50000,40000,0,0,0,0,0,0,0,14854,1040,13814,0,14125,1000,13125,0,12176,1000,11176,0,13827,3000,10827
2528,150000,120000,0,1,1,1,1,1,3,146844,5202,141642,2,145037,5300,139737,2,145349,5300,140049,2,145506,5300,140206
2529,300000,240000,0,0,0,0,0,0,-1,4339,4355,-16,-1,7423,7423,0,-1,4059,0,4059,0,2508,2508,0
2530,260000,208000,0,0,0,0,0,0,2,1668,1668,0,-1,446,0,446,2,123,490,-367,-1,35722,35722,0
2531,280000,224000,0,0,0,0,0,0,-2,1067,1072,-5,-2,3405,3422,-17,-2,1805,1814,-9,-2,2153,2162,-9
2532,190000,152000,0,0,0,0,0,0,0,120826,4202,116624,0,112211,4200,108011,0,110396,4200,106196,0,113386,5000,108386
2533,130000,104000,0,0,0,0,0,0,-2,3362,3372,-10,-1,-3,0,-3,-1,998,1001,-3,-1,937,939,-2
2534,20000,16000,0,0,0,0,0,0,0,0,0,0,0,0,0,0,-2,3244,3244,0,-1,3314,124,3190
2535,130000,104000,1,1,1,1,0,0,0,183828,6037,177791,0,164667,4646,160021,0,132746,4230,128516,0,57989,1941,56048
2536,210000,168000,0,0,0,0,0,0,-1,4465,0,4465,2,0,0,0,2,9306,9306,0,-1,5855,5855,0
2537,50000,40000,0,0,0,0,0,0,0,3865,1500,2365,0,7476,3666,3810,0,8384,2477,5907,0,8085,1306,6779
2538,280000,224000,0,0,0,0,0,0,-2,0,0,0,-2,0,0,0,-2,0,0,0,-2,35833,35833,0
2539,200000,160000,0,0,0,0,0,0,-1,1350,1350,0,-1,13524,13534,-10,-1,570,570,0,-1,2622,2622,0
2540,50000,40000,0,1,0,0,0,0,0,45438,1200,44238,0,39527,9,39518,0,7997,500,7497,0,462,462,0
2541,80000,64000,0,1,0,0,0,0,2,79788,2201,77587,0,29069,2000,27069,0,26551,1000,25551,0,27109,1000,26109
2542,310000,248000,0,0,0,0,0,0,0,4595,1023,3572,0,636,641,-5,-1,72955,73319,-364,-1,-18,0,-18
2543,50000,40000,0,0,0,0,0,0,0,7652,2000,5652,0,7161,1000,6161,0,7531,1500,6031,0,7033,0,7033
2544,80000,64000,0,0,0,0,0,0,-1,0,0,0,-1,0,0,0,-2,0,0,0,-2,0,0,0
2545,180000,144000,0,0,0,0,0,0,-1,10000,10000,0,-1,10000,10000,0,-1,20000,20000,0,-1,10338,10338,0
2546,80000,64000,0,0,0,0,0,0,-1,50097,50097,0,-1,48753,2000,46753,0,50000,2000,48000,0,49209,1933,47276
2547,240000,192000,0,0,0,0,0,0,-1,0,0,0,-2,0,0,0,-2,0,0,0,-2,0,0,0
2548,150000,120000,0,1,1,0,0,1,0,153981,6100,147881,0,129725,5100,124625,0,103050,4200,98850,0,54447,1900,52547
2549,200000,160000,0,1,0,0,0,0,0,205150,9200,195950,0,0,0,0,0,0,0,0,-2,0,0,0
2550,130000,104000,0,0,0,0,0,0,-1,2598,2598,0,-1,1299,0,1299,0,1299,1299,0,-1,1299,1299,0
2551,130000,104000,0,0,0,0,0,0,-1,27951,27951,0,-1,17255,17307,-52,-1,10400,10400,0,-1,18776,18776,0
2552,360000,288000,0,0,0,0,0,0,-1,990,990,0,-1,390,390,0,-1,390,390,0,-2,3103,3103,0
2553,320000,256000,0,0,0,0,0,0,-1,2488,2488,0,-1,21222,21238,-16,-1,15115,5000,10115,0,27279,15000,12279
2554,280000,224000,0,0,0,0,0,0,-2,0,0,0,-2,0,0,0,-2,0,0,0,-2,0,0,0
2555,200000,160000,0,0,0,0,0,0,0,61590,2507,59083,0,47301,2011,45290,0,47232,4140,43092,0,25231,5072,20159
2556,210000,168000,0,0,0,0,0,0,-1,838,1295,-457,-1,20372,20000,372,-1,36489,16489,20000,0,90261,60000,30261
2557,500000,400000,0,0,0,0,0,0,0,350017,13172,336845,0,347410,15200,332210,0,337015,12000,325015,0,332360,13617,318743
2558,130000,104000,0,0,0,0,0,0,-1,1205,1205,0,-1,1798,1798,0,-1,299,299,0,-1,1280,1280,0
2559,80000,64000,0,0,0,0,0,0,0,56477,2047,54430,0,57601,2060,55541,0,58807,2133,56674,0,60300,2469,57831
2560,360000,288000,0,0,0,0,0,1,-1,3746,3764,-18,-1,-4,0,-4,-1,906,910,-4,-1,850,854,-4
2561,90000,72000,0,1,1,1,1,1,0,87235,3114,84121,0,84511,3000,81511,0,84488,3100,81388,0,86184,3100,83084
2562,360000,288000,0,0,0,0,0,0,-2,-3,0,-3,-2,-3,0,-3,-2,711,714,-3,-1,875,879,-4
2563,230000,184000,0,0,0,0,0,0,-1,2269,2269,0,-1,9818,9818,0,-1,690,690,0,-1,5369,5369,0
2564,20000,16000,0,0,0,0,0,0,0,0,0,0,0,0,0,0,-2,0,0,0,-2,0,0,0
2565,50000,40000,0,0,0,0,0,1,0,29955,1799,28156,0,30666,1510,29156,0,31275,1119,30156,0,31940,1169,30771
2566,280000,224000,0,0,0,0,0,0,0,17644,4157,13487,0,0,0,0,0,5468,5468,0,-1,0,0,0
2567,500000,400000,0,0,0,0,0,0,-1,635,637,-2,-1,12416,12553,-137,-1,4022,4070,-48,-1,259,259,0
2568,170000,136000,0,0,0,0,0,0,0,132655,0,132655,2,134140,5000,129140,0,115892,5000,110892,0,116653,4500,112153
2569,260000,208000,0,0,0,0,0,0,0,112288,5550,106738,0,113388,5600,107788,0,114128,4100,110028,0,117005,4700,112305
2570,50000,40000,0,0,0,0,0,0,0,24459,1319,23140,0,23161,773,22388,0,22282,787,21495,0,20537,757,19780
2571,70000,56000,0,0,0,0,0,0,0,31450,3018,28432,0,29592,3338,26254,0,29703,3000,26703,0,19582,717,18865
2572,500000,400000,0,1,1,0,0,0,0,491956,325,491631,2,430637,15296,415341,0,376657,12137,364520,0,356636,12312,344324
2573,20000,16000,0,0,0,0,0,1,-2,0,0,0,-2,0,0,0,-2,0,0,0,-2,1473,1473,0
2574,50000,40000,0,0,0,0,0,0,-2,0,0,0,-2,0,0,0,-2,0,0,0,-2,0,2000,-2000
2575,80000,64000,0,0,0,0,0,0,0,10303,2000,8303,0,11737,2000,9737,0,10619,1000,9619,0,49872,40002,9870
2576,30000,24000,0,1,1,1,1,1,0,29956,1485,28471,0,29782,2000,27782,0,27290,1000,26290,0,27865,1014,26851
2577,130000,104000,0,0,0,0,0,0,0,62318,6000,56318,0,64214,3000,61214,0,44840,2000,42840,0,45969,2000,43969
2578,180000,144000,0,0,0,0,1,0,0,133743,100028,33715,0,135900,20000,115900,0,159631,26000,133631,0,160881,7000,153881
2579,180000,144000,0,0,0,0,0,0,0,11426,12099,-673,-1,96562,96562,0,-1,144345,49000,95345,0,141659,140000,1659
2580,290000,232000,0,0,0,0,0,0,-1,17495,17732,-237,-1,1528,1862,-334,-1,4176,4188,-12,-1,189,189,0
2581,610000,488000,0,0,0,0,0,0,-1,319014,1605,317409,2,347303,349395,-2092,-1,248893,250144,-1251,-1,269528,271099,-1571
2582,200000,160000,0,0,0,0,0,0,0,0,0,0,0,0,0,0,-2,42362,87000,-44638,-1,43094,1566,41528
2583,400000,320000,0,0,0,0,0,0,-1,6649,6676,-27,-1,3051,3051,0,-1,1926,5,1921,0,51669,51965,-296
2584,480000,384000,0,0,0,0,0,0,-1,7782,8037,-255,-1,4720,4523,197,0,4440,4462,-22,-1,96628,96665,-37
2585,400000,320000,0,0,0,0,0,0,0,22085,22085,0,-1,21021,420,20601,0,19761,56,19705,0,12613,687,11926
2586,90000,72000,0,0,0,0,0,0,2,68552,0,68552,2,67324,25000,42324,2,39573,0,39573,2,28610,2235,26375
2587,270000,216000,0,1,1,1,1,0,0,258759,10050,248709,0,225454,8370,217084,0,225032,8510,216522,0,225698,8250,217448
2588,80000,64000,0,1,1,1,1,0,0,81392,3130,78262,0,80966,3107,77859,0,79295,2847,76448,0,81142,3134,78008
2589,60000,48000,0,1,1,1,1,0,2,52664,2500,50164,2,53059,2000,51059,2,51468,0,51468,2,54511,4019,50492
2590,80000,64000,0,0,0,0,0,0,-1,14873,6500,8373,0,17364,3000,14364,0,17770,2000,15770,0,17460,3000,14460
2591,30000,24000,0,1,1,0,1,0,0,27376,1500,25876,0,28359,1450,26909,0,24844,889,23955,0,25364,920,24444
2592,50000,40000,0,0,0,0,0,0,0,23250,1686,21564,0,23564,1000,22564,0,30882,7764,23118,0,30242,0,30242
2593,80000,64000,0,0,0,0,0,0,0,41012,4850,36162,0,40052,0,40052,2,41110,1700,39410,0,42071,1800,40271
2594,70000,56000,0,1,0,0,0,0,0,59024,2490,56534,0,26008,1000,25008,0,28210,5746,22464,0,18296,2000,16296
2595,20000,16000,0,1,1,1,1,1,0,17541,1149,16392,0,19338,1946,17392,0,17889,0,17889,2,18486,1007,17479
2596,210000,168000,0,0,0,0,0,0,-2,379,379,0,-2,768,768,0,-2,2308,2308,0,-2,1026,1026,0
2597,360000,288000,0,0,0,0,0,0,-2,2500,2500,0,-2,0,0,0,-2,0,0,0,-2,0,0,0
2598,50000,40000,0,0,0,0,0,0,1,0,0,0,-2,0,0,0,-2,0,0,0,-2,0,0,0
2599,90000,72000,0,0,0,0,0,0,-2,403,403,0,-1,33982,33982,0,-1,30738,1000,29738,0,29018,1000,28018
2600,30000,24000,0,0,0,0,0,1,0,23826,2000,21826,0,20613,1000,19613,2,21269,1000,20269,0,22761,2000,20761
2601,100000,80000,0,0,0,0,0,0,0,74621,2800,71821,0,72567,3000,69567,0,77231,6000,71231,0,78780,3000,75780
2602,290000,232000,0,1,1,0,0,1,2,275075,0,275075,2,280512,10951,269561,0,202300,7238,195062,0,207510,8467,199043
2603,290000,232000,0,0,0,0,0,0,0,10326,1400,8926,0,11000,1000,10000,0,11000,0,11000,0,11417,11417,0
2604,120000,96000,0,0,0,0,0,0,2,316,316,0,-1,16885,16885,0,-1,46929,54629,-7700,-1,69521,77046,-7525
2605,50000,40000,0,0,0,0,0,0,0,6260,2000,4260,0,6760,500,6260,0,4762,2000,2762,0,5684,2000,3684
2606,80000,64000,0,0,0,0,0,0,0,36230,1155,35075,0,37235,1940,35295,0,38575,1500,37075,0,39590,1174,38416
2607,10000,8000,0,0,0,1,1,0,0,0,0,0,0,9601,9601,0,-1,10005,800,9205,0,9058,1000,8058
2608,20000,16000,0,0,0,0,0,0,-1,2182,2000,182,2,1500,0,1500,2,500,500,0,-1,0,0,0
2609,20000,16000,0,0,0,0,0,0,3,7187,0,7187,2,8367,1300,7067,2,7945,0,7945,3,7669,0,7669
2610,400000,320000,0,1,0,0,0,0,0,398634,14547,384087,0,210628,8078,202550,0,203102,6500,196602,0,85374,5000,80374
2611,50000,40000,0,0,0,0,0,0,2,3139,6024,-2885,-1,2464,5428,-2964,-1,6170,6170,0,-1,0,0,0
2612,80000,64000,0,1,0,0,0,0,0,78545,3269,75276,0,19212,1400,17812,0,36800,368,36432,0,18900,1000,17900
2613,360000,288000,0,0,0,0,0,0,-1,2310,2310,0,-1,1300,1300,0,-1,0,0,0,-1,348,348,0
2614,70000,56000,0,1,1,1,1,0,0,69936,2321,67615,0,68118,2391,65727,0,65942,2316,63626,0,62495,2466,60029
2615,100000,80000,0,0,0,0,0,0,-2,0,0,0,-2,0,0,0,-2,0,0,0,-2,0,0,0
2616,210000,168000,0,0,0,0,0,0,0,79668,4000,75668,0,92326,3402,88924,0,30500,2013,28487,0,25265,1026,24239
2617,60000,48000,0,0,0,0,0,0,-1,0,0,0,-2,300,300,0,-1,150,0,150,2,150,150,0
2618,310000,248000,0,0,0,0,0,0,-1,10131,10131,0,-1,2456,2456,0,-1,316,316,0,-1,316,316,0
2619,20000,16000,0,1,1,1,1,1,0,18345,1602,16743,0,18643,900,17743,0,19094,900,18194,0,19224,636,18588
2620,110000,88000,0,0,0,0,1,0,2,56414,3000,53414,0,56677,2000,54677,0,109583,53700,55883,0,107981,0,107981
2621,40000,32000,0,1,1,1,1,1,2,38180,1706,36474,0,40524,3050,37474,0,39720,0,39720,2,39860,1565,38295
2622,360000,288000,0,0,0,0,0,0,0,70881,2001,68880,0,53344,1318,52026,0,47058,1134,45924,0,8674,216,8458
2623,250000,200000,0,0,0,0,0,0,0,175711,6018,169693,0,153130,6887,146243,0,153859,6000,147859,0,103593,4001,99592
2624,340000,272000,0,0,0,0,0,1,0,271986,13012,258974,0,227152,8008,219144,0,221218,8343,212875,0,159462,9463,149999
2625,210000,168000,0,0,0,0,0,0,-1,1511,1515,-4,-1,54400,54409,-9,-1,81139,30000,51139,0,82585,3759,78826
2626,30000,24000,0,0,0,0,0,1,0,6655,2211,4444,0,6618,2101,4517,0,0,148,-148,0,0,0,0
2627,30000,24000,0,0,0,1,1,1,0,23130,0,23130,2,28790,6380,22410,2,28038,0,28038,3,27451,0,27451
2628,50000,40000,0,0,0,0,0,0,0,26633,2000,24633,0,19576,0,19576,2,15794,4532,11262,0,19496,4500,14996
2629,250000,200000,0,0,0,0,0,1,-1,6149,6159,-10,-1,26202,25846,356,0,6906,0,6906,0,3855,3855,0
2630,20000,16000,0,1,0,0,0,0,0,19571,1300,18271,0,14362,1000,13362,0,15127,1000,14127,0,15872,1000,14872
2631,280000,224000,0,0,0,0,0,0,-2,9127,9171,-44,-2,9656,9705,-49,-2,41434,41641,-207,-2,21732,21838,-106
2632,350000,280000,0,0,0,0,0,0,-2,0,0,0,-2,0,0,0,-2,0,0,0,-2,42800,42800,0
2633,300000,240000,0,0,0,0,0,0,2,32591,0,32591,2,34943,2900,32043,2,35536,1300,34236,2,36403,1600,34803
2634,50000,40000,0,0,0,0,0,0,0,20009,1700,18309,0,20877,1547,19330,0,19642,785,18857,0,18769,1000,17769
2635,30000,24000,0,0,0,0,0,0,0,2418,1000,1418,0,2009,500,1509,0,3009,1000,2009,0,7093,7093,0
2636,240000,192000,0,0,0,0,0,0,-1,9166,9212,-46,-1,6855,6949,-94,-1,8089,8134,-45,-1,9052,10043,-991
2637,360000,288000,0,0,0,0,0,0,-1,0,0,0,-2,1149,1149,0,-1,2386,2386,0,-1,5103,5103,0
2638,200000,160000,0,0,0,0,0,0,-2,-200,0,-200,-2,-200,0,-200,-2,2472,2672,-200,-2,0,0,0
2639,340000,272000,0,0,0,0,0,0,0,16308,16400,-92,-1,21065,15000,6065,0,20581,15000,5581,0,15936,10000,5936
2640,140000,112000,0,1,0,0,0,0,2,137377,5547,131830,0,93261,3242,90019,0,95368,3512,91856,0,97063,3333,93730
2641,360000,288000,0,0,0,0,0,0,0,190369,16000,174369,0,185069,5000,180069,0,195069,20000,175069,0,27004,30000,-2996
2642,150000,120000,0,0,0,0,0,0,-1,0,0,0,-2,0,0,0,-2,0,0,0,-2,0,0,0
2643,390000,312000,0,0,0,0,0,0,0,89672,5000,84672,0,83663,3200,80463,0,84449,9000,75449,0,75445,0,75445
2644,80000,64000,0,0,0,0,0,0,-2,390,390,0,-2,390,390,0,-2,390,390,0,-2,780,780,0
2645,170000,136000,0,0,0,0,0,1,-2,1980,1980,0,-2,0,0,0,-2,280,280,0,-2,280,280,0
2646,60000,48000,0,0,0,0,0,0,-1,7058,8028,-970,-1,8127,8127,0,-1,4557,15,4542,0,2992,2992,0
2647,180000,144000,0,0,0,0,0,0,-2,-1580,0,-1580,-2,-1580,0,-1580,-2,-1580,0,-1580,-2,-1580,0,-1580
2648,20000,16000,0,0,0,0,0,0,2,356,0,356,2,356,356,0,-1,4616,4616,0,-1,728,728,0
2649,160000,128000,0,0,0,0,0,1,-1,1350,1500,-150,-1,1310,1310,0,-1,2374,1444,930,-1,1444,0,1444
2650,30000,24000,0,1,1,1,1,0,2,28525,1452,27073,0,29091,1018,28073,0,28923,1038,27885,0,29553,1100,28453
2651,100000,80000,0,0,0,0,0,0,3,66924,4000,62924,2,72209,7000,65209,2,70451,0,70451,3,72179,3000,69179
2652,70000,56000,1,1,0,0,0,0,0,117846,1936,115910,0,49535,1874,47661,0,48247,1740,46507,0,49040,2000,47040
2653,30000,24000,0,1,1,1,0,0,0,28491,2000,26491,0,28091,0,28091,0,28664,573,28091,0,0,0,0
2654,50000,40000,0,0,0,0,0,1,3,29843,2000,27843,2,32257,3200,29057,2,35421,4000,31421,3,36265,2000,34265
2655,210000,168000,0,0,0,0,0,1,2,0,0,0,2,322,322,0,-1,150,150,0,-1,546,546,0
2656,50000,40000,0,1,1,0,0,0,0,49793,2061,47732,0,50032,1300,48732,0,18336,643,17693,0,18720,666,18054
2657,50000,40000,0,0,0,0,0,0,0,16177,2000,14177,0,15949,2000,13949,0,14319,1000,13319,0,17319,3000,14319
2658,80000,64000,0,0,0,0,0,0,0,57803,30000,27803,0,27562,1000,26562,0,28224,1000,27224,0,28867,1000,27867
2659,60000,48000,0,0,0,0,0,1,0,27022,2000,25022,0,28357,2000,26357,0,28992,1000,27992,0,24505,1000,23505
2660,160000,128000,0,1,1,1,1,0,0,155404,6000,149404,0,153234,5600,147634,0,156731,6000,150731,0,155818,6000,149818
2661,470000,376000,0,0,0,0,0,0,0,1518,1000,518,0,285,285,0,-1,688,688,0,-1,2100,2100,0
2662,130000,104000,0,0,0,0,0,0,-1,109,109,0,-1,109,0,109,2,109,0,109,0,0,0,0
2663,40000,32000,0,0,0,0,0,0,2,390,390,0,-1,540,540,0,-1,1080,1080,0,-1,540,0,540
2664,270000,216000,0,0,0,0,0,0,-1,69256,3168,66088,0,67842,3000,64842,0,68235,4000,64235,0,72706,8000,64706
2665,200000,160000,0,0,0,0,0,0,0,6328,6336,-8,-1,4714,10,4704,0,42184,39585,2599,0,39576,39,39537
2666,180000,144000,0,0,0,0,0,0,0,55352,10000,45352,0,63055,10000,53055,0,75046,15057,59989,0,65184,10010,55174
2667,100000,80000,0,0,0,0,0,0,6,32308,60,32248,5,31399,0,31399,4,30448,0,30448,3,29933,0,29933
2668,30000,24000,0,0,0,0,0,1,2,17991,0,17991,2,20182,2500,17682,2,19560,0,19560,2,21241,2000,19241
2669,330000,264000,0,1,1,1,1,0,0,335527,12378,323149,0,333860,12116,321744,0,335760,12450,323310,0,330121,12213,317908
2670,60000,48000,0,0,0,0,0,1,2,47939,0,47939,2,29351,1014,28337,0,28128,1001,27127,0,27811,1020,26791
2671,320000,256000,0,0,0,0,0,0,-1,507,0,507,2,-900,0,-900,2,3750,5330,-1580,-1,3216,3216,0
2672,200000,160000,0,0,0,0,0,0,2,99165,99165,0,-1,0,0,0,-1,0,0,0,-2,0,0,0
2673,20000,16000,1,1,1,1,1,1,6,21623,0,21623,5,21000,0,21000,4,20388,0,20388,3,19915,0,19915
2674,500000,400000,0,0,0,0,0,0,-1,3662,3722,-60,-1,0,0,0,-1,1770,1770,0,-2,3384,3384,0
2675,220000,176000,0,0,0,0,0,0,0,55863,2000,53863,0,57079,2000,55079,0,51202,2000,49202,0,53195,3200,49995
2676,80000,64000,0,0,0,0,0,0,-2,0,0,0,-2,0,0,0,-2,0,0,0,-2,0,0,0
2677,360000,288000,0,0,0,0,0,0,-2,1072,1100,-28,-2,1980,2025,-45,-2,10780,10819,-39,-2,2036,2110,-74
2678,130000,104000,0,1,1,1,1,0,0,121140,5000,116140,3,117767,0,117767,3,115640,0,115640,2,116062,4200,111862
2679,230000,184000,0,0,0,0,0,0,0,40170,5000,35170,0,43473,5000,38473,0,44663,3000,41663,0,47207,5000,42207
2680,240000,192000,0,0,0,0,0,0,2,6938,6938,0,-1,41858,41877,-19,-1,10416,0,10416,0,1711,1711,0
2681,60000,48000,0,0,0,0,0,0,0,13420,0,13420,2,15211,2000,13211,0,14395,1000,13395,0,16141,2000,14141
2682,80000,64000,0,0,0,0,0,0,2,23017,1280,21737,2,22349,0,22349,2,22791,814,21977,0,23331,905,22426
2683,490000,392000,0,0,0,0,0,0,-1,1460,1460,0,-1,6213,6213,0,-1,6040,7195,-1155,-1,1155,0,1155
2684,20000,16000,0,0,0,0,0,1,0,11998,1505,10493,0,13010,1517,11493,0,13750,1257,12493,0,13389,0,13389
2685,70000,56000,0,0,0,0,0,0,0,6209,1500,4709,0,6338,380,5958,0,6587,500,6087,0,6828,500,6328
2686,80000,64000,0,0,0,0,0,0,0,7420,1020,6400,0,1467,1467,0,0,7505,7505,0,-1,3837,135,3702
2687,150000,120000,0,1,1,1,1,0,0,136267,6419,129848,0,138934,6436,132498,0,140315,5113,135202,0,139258,5210,134048
2688,500000,400000,0,0,0,0,0,0,-2,67515,67533,-18,-2,68639,72049,-3410,-2,70302,70430,-128,-2,40721,40721,0
2689,140000,112000,0,1,1,1,1,1,0,138919,7750,131169,0,138035,5000,133035,0,138857,5379,133478,0,138894,5200,133694
2690,400000,320000,0,0,0,0,0,0,-2,22263,22263,0,-2,20511,20568,-57,-2,27808,27808,0,-2,8342,8342,0
2691,160000,128000,0,0,0,0,0,0,-1,4903,4905,-2,-1,5525,5525,0,-1,-10,10,-20,-1,-10,0,-10
2692,260000,208000,0,0,0,0,0,1,0,16376,1525,14851,0,2590,2590,0,-1,390,390,0,-1,390,390,0
2693,100000,80000,0,0,0,0,0,0,2,30485,1825,28660,0,32434,3100,29334,0,32592,1300,31292,2,33102,1500,31602
2694,230000,184000,0,0,0,0,0,0,-1,68813,65280,3533,0,4427,4446,-19,-1,13882,13949,-67,-1,41463,41660,-197
2695,110000,88000,0,0,0,0,0,0,-1,632,632,0,-1,150,150,0,-1,632,632,0,-1,166,0,166
2696,80000,64000,0,0,0,0,0,0,0,8632,2000,6632,0,10316,2000,8316,0,316,316,0,-1,2523,2523,0
2697,20000,16000,0,0,0,0,1,0,0,-1675,0,-1675,0,-1675,0,-1675,-2,16554,18359,-1805,-1,17359,1000,16359
2698,70000,56000,0,0,0,0,0,0,2,32492,1700,30792,2,33163,1500,31663,2,32334,0,32334,2,34647,3000,31647
2699,180000,144000,0,0,0,0,0,0,-1,0,0,0,-1,0,0,0,-2,0,0,0,-2,7322,7322,0
2700,50000,40000,0,0,0,0,0,1,-1,6015,6015,0,-1,5625,0,5625,0,3056,3056,0,-1,2439,2439,0
2701,50000,40000,0,0,0,0,0,0,0,22265,0,22265,0,23896,2000,21896,2,26514,3000,23514,0,28073,2000,26073
2702,200000,160000,0,0,0,0,0,1,0,164183,7000,157183,0,136199,5000,131199,0,139209,5000,134209,0,135742,5000,130742
2703,150000,120000,0,0,0,0,0,0,-1,112,112,0,-1,0,0,0,-2,3865,3865,0,-1,5562,5575,-13
2704,130000,104000,0,0,0,0,0,0,0,14323,5000,9323,0,7722,2822,4900,0,4689,5000,-311,-1,-3614,0,-3614
2705,290000,232000,0,0,0,0,0,0,-2,-309,0,-309,-2,63,500,-437,-2,227,590,-363,-2,946,1045,-99
2706,100000,80000,0,0,0,0,0,0,0,42238,1722,40516,0,41646,1603,40043,0,40976,1406,39570,0,40503,1598,38905
2707,280000,224000,0,0,0,0,0,1,2,192189,15000,177189,2,195517,8000,187517,2,199250,7000,192250,2,195874,0,195874
2708,260000,208000,0,0,0,0,0,0,-2,1880,1880,0,-2,0,0,0,-2,1000,1000,0,-2,0,0,0
2709,130000,104000,0,0,0,0,0,0,0,90160,3500,86660,2,87817,0,87817,2,89746,3499,86247,0,98655,10648,88007
2710,180000,144000,0,0,0,0,0,0,0,109327,4399,104928,0,77752,3008,74744,0,66202,2150,64052,0,58557,2147,56410
2711,460000,368000,0,0,1,0,0,0,0,380257,16000,364257,0,386847,15000,371847,0,301231,11000,290231,0,325831,30000,295831
2712,50000,40000,0,0,0,0,0,1,2,24838,2000,22838,0,25429,1000,24429,0,26020,1000,25020,0,26541,955,25586
2713,180000,144000,0,0,0,0,0,0,0,17322,2902,14420,0,13137,3047,10090,2,0,0,0,2,2293,2293,0
2714,340000,272000,0,0,0,0,0,0,0,0,0,0,0,0,0,0,-2,7687,7687,0,-1,21200,21200,0
2715,20000,16000,0,0,1,1,1,0,0,18923,3001,15922,0,19706,3000,16706,0,19818,2000,17818,0,20006,1002,19004
2716,470000,376000,0,0,0,0,0,0,0,165474,7046,158428,0,120644,10000,110644,0,119006,15029,103977,0,110780,15017,95763
2717,30000,24000,0,0,0,0,0,0,0,19107,2000,17107,0,20281,1500,18781,0,20941,1000,19941,0,21799,1200,20599
2718,230000,184000,0,0,0,0,0,0,-2,4777,4777,0,-2,1755,1763,-8,-2,2442,2445,-3,-2,2724,2727,-3
2719,50000,40000,0,1,0,0,0,1,2,49029,240,48789,2,25313,1000,24313,0,26006,1100,24906,0,27217,1800,25417
2720,160000,128000,0,0,0,0,0,0,0,114975,5800,109175,0,115923,4431,111492,0,107621,3854,103767,0,110006,4121,105885
2721,60000,48000,0,0,0,0,0,1,0,8460,3000,5460,0,10146,2500,7646,0,9413,0,9413,2,15997,15997,0
2722,390000,312000,0,0,0,0,0,0,0,34370,1500,32870,0,4968,1000,3968,0,5595,1004,4591,0,5318,2003,3315
2723,20000,16000,0,0,0,0,0,0,-2,0,0,0,-2,0,0,0,-2,0,0,0,-2,0,0,0
2724,40000,32000,0,1,1,1,1,0,3,40340,2000,38340,2,42332,3304,39028,2,41023,0,41023,3,42722,3000,39722
2725,60000,48000,0,1,1,1,1,0,0,58533,2800,55733,0,59349,2400,56949,0,55302,2100,53202,0,56563,2181,54382
2726,170000,136000,0,1,1,1,1,0,0,166062,7000,159062,0,170023,7000,163023,0,173854,7000,166854,0,179390,8000,171390
2727,280000,224000,0,0,0,0,0,0,0,7184,3000,4184,0,0,0,0,0,0,0,0,-2,0,0,0
2728,80000,64000,0,0,0,0,0,1,-1,100,100,0,-1,0,0,0,-1,1050,1050,0,-1,-150,0,-150
2729,290000,232000,0,0,0,0,0,0,-1,470,470,0,-1,119955,119685,270,0,119685,0,119685,0,9780,9780,0
2730,90000,72000,0,0,0,0,0,0,2,33212,33500,-288,-1,8978,0,8978,0,1782,0,1782,0,23173,25000,-1827
2731,140000,112000,0,0,0,0,0,0,0,17800,2000,15800,0,14869,2000,12869,0,12895,1000,11895,0,12833,1000,11833
2732,60000,48000,0,1,1,1,1,0,0,53271,1932,51339,0,54331,1944,52387,0,55513,2057,53456,0,56898,2351,54547
2733,50000,40000,0,0,0,0,0,0,0,31485,2000,29485,0,15281,4000,11281,0,18031,3000,15031,0,18233,1500,16733
2734,230000,184000,0,0,0,0,0,0,0,11717,2000,9717,0,7540,3540,4000,0,9941,5000,4941,0,6113,3113,3000
2735,280000,224000,0,0,0,0,0,0,-1,252,252,0,-1,2632,2656,-24,-1,5410,5410,0,-1,5834,5834,0
2736,500000,400000,0,0,0,0,0,0,-2,7303,7364,-61,-2,19436,19445,-9,-2,45604,45604,0,-2,25996,25996,0
2737,190000,152000,0,0,0,0,0,0,0,62206,3034,59172,0,63612,2439,61173,0,65422,3000,62422,0,67334,3000,64334
2738,60000,48000,0,0,0,0,0,0,0,39829,2500,37329,0,39324,2000,37324,0,32460,1100,31360,0,31735,1200,30535
2739,20000,16000,0,0,0,0,0,0,-2,450,450,0,-1,-150,0,-150,-1,750,900,-150,-1,568,568,0
2740,90000,72000,0,0,0,0,0,1,0,27465,3000,24465,0,27943,2000,25943,0,26152,1000,25152,0,25941,936,25005
2741,30000,24000,0,1,1,1,0,1,2,28966,0,28966,2,26902,1030,25872,0,25426,1049,24377,0,26799,5000,21799
2742,180000,144000,0,0,0,0,0,0,0,46667,5000,41667,0,31931,15000,16931,0,33928,5000,28928,0,35235,2000,33235
2743,480000,384000,0,0,0,0,0,0,-2,23479,23479,0,-2,52177,52209,-32,-2,54005,54005,0,-2,53853,54500,-647
2744,140000,112000,0,0,0,0,0,0,-1,390,390,0,-1,390,390,0,-1,6580,6580,0,-1,0,0,0
2745,150000,120000,0,0,0,0,0,0,-1,3125,3137,-12,-1,9643,9643,0,-2,4383,4395,-12,-1,2225,2229,-4
2746,50000,40000,0,0,0,0,1,0,0,5181,5196,-15,-1,8548,8557,-9,-1,50678,48011,2667,0,48220,2040,46180
2747,350000,280000,0,0,0,0,0,0,0,31838,3000,28838,0,32369,3000,29369,0,33478,1500,31978,0,83304,52000,31304
2748,470000,376000,0,0,0,0,0,0,0,78325,4177,74148,0,119866,126307,-6441,-1,-6187,36,-6223,-1,-8822,26,-8848
2749,200000,160000,0,0,0,0,0,1,-1,588,588,0,-1,111,111,0,-1,305,305,0,-1,432,432,0
2750,360000,288000,0,0,0,0,0,0,-1,-11035,0,-11035,-2,12319,32319,-20000,-1,6050,6050,0,-1,2125,2125,0
2751,50000,40000,0,0,0,0,0,0,0,19116,1600,17516,0,19543,1000,18543,0,20116,1000,19116,0,18163,1000,17163
2752,130000,104000,0,1,1,1,1,0,0,132927,5000,127927,0,131866,4600,127266,0,130707,5000,125707,0,129174,4614,124560
2753,220000,176000,0,0,0,0,0,0,-1,5797,5820,-23,-1,1195,1198,-3,-1,1797,1802,-5,-1,1195,1198,-3
2754,80000,64000,0,0,0,0,0,0,-1,4337,4507,-170,-1,0,999,-999,-1,2649,2649,0,-1,708,787,-79
2755,110000,88000,0,1,1,0,0,1,0,111642,4000,107642,2,109584,2975,106609,0,50281,22000,28281,0,49373,1726,47647
2756,200000,160000,0,0,0,0,0,0,2,27932,15015,12917,2,12585,0,12585,2,45031,45031,0,-1,19836,20000,-164
2757,70000,56000,0,0,0,0,0,0,0,45102,2050,43052,0,45861,1809,44052,0,47951,3000,44951,0,49252,2251,47001
2758,280000,224000,0,0,0,0,0,0,-2,396,396,0,-2,396,396,0,-2,10948,10948,0,-2,61123,61123,0
2759,240000,192000,0,0,0,0,0,0,-2,0,0,0,-2,0,0,0,-2,0,0,0,-2,0,0,0
2760,30000,24000,0,1,0,0,0,0,0,29378,1440,27938,0,22692,800,21892,0,24169,1800,22369,0,23782,108,23674
2761,60000,48000,0,0,0,0,0,1,0,28210,2000,26210,2,27473,0,27473,2,29176,2289,26887,2,28242,0,28242
2762,230000,184000,0,0,0,0,0,1,2,24185,2000,22185,0,25238,1435,23803,0,29803,5000,24803,0,34312,5000,29312
2763,50000,40000,0,1,0,0,0,0,0,47167,2050,45117,0,25142,2000,23142,0,4716,300,4416,0,4840,200,4640
2764,320000,256000,0,0,0,0,0,0,-1,416,416,0,-1,416,416,0,-1,1829,1829,0,-1,1833,1833,0
2765,120000,96000,0,0,0,0,0,0,-1,396,396,0,-1,392,392,0,-1,396,400,-4,-1,396,396,0
2766,220000,176000,0,0,0,0,0,0,0,94776,4000,90776,0,72842,5063,67779,0,46747,2000,44747,0,44236,1605,42631
2767,200000,160000,0,0,0,0,0,0,-2,642,642,0,-2,0,0,0,-2,0,0,0,-2,0,0,0
2768,30000,24000,0,0,0,0,0,0,0,0,0,0,0,196,196,0,-1,46,0,46,2,5346,5300,46
2769,410000,328000,0,0,0,0,0,0,-2,28961,29750,-789,-2,2954,3483,-529,-2,9942,10470,-528,-1,2628,2636,-8
2770,50000,40000,0,0,0,0,0,1,0,13876,2000,11876,0,13444,1000,12444,2,13367,1000,12367,0,13282,1000,12282
2771,180000,144000,0,0,0,0,0,0,-1,955,0,955,2,1565,1000,565,0,2175,1000,1175,0,2159,400,1759
2772,200000,160000,0,0,0,0,0,0,-2,18145,18458,-313,-2,14163,14170,-7,-2,7909,7909,0,-2,1485,1485,0
2773,130000,104000,0,0,0,0,0,0,0,88760,4013,84747,0,35671,1274,34397,0,36977,1878,35099,0,38931,3116,35815
2774,450000,360000,0,0,0,0,0,0,-2,0,0,0,-2,0,0,0,-2,0,0,0,-2,0,0,0
2775,30000,24000,1,1,1,1,1,1,6,32101,0,32101,5,31071,0,31071,4,30136,0,30136,3,28496,0,28496
2776,50000,40000,0,0,0,0,0,0,-1,0,0,0,-1,4699,4699,0,-1,0,0,0,-1,0,0,0
2777,150000,120000,0,0,0,0,0,0,-1,0,0,0,-1,1448,1448,0,-1,0,0,0,-1,0,0,0
2778,220000,176000,0,0,0,0,0,0,0,8605,3040,5565,0,5352,1000,4352,0,-5048,0,-5048,0,-5048,0,-5048
2779,240000,192000,0,0,0,0,0,0,-1,5736,5758,-22,-1,1000,0,1000,0,650,150,500,0,7574,7424,150
2780,50000,40000,0,0,0,0,0,0,0,7087,1118,5969,0,7227,258,6969,0,7378,267,7111,0,7527,271,7256
2781,10000,8000,0,1,1,1,1,1,2,10964,2500,8464,2,11153,1000,10153,2,10762,400,10362,2,10126,0,10126
2782,50000,40000,0,1,1,0,0,0,0,49319,4150,45169,0,50401,2232,48169,0,18919,750,18169,0,19469,929,18540
2783,150000,120000,0,0,0,0,0,0,0,118583,4500,114083,0,95094,2524,92570,0,50999,2000,48999,0,35383,2000,33383
2784,210000,168000,0,0,0,0,0,0,-1,1520,1520,0,-1,916,0,916,0,586,586,0,-1,1466,1466,0
2785,300000,240000,0,0,0,0,0,0,0,190060,7542,182518,0,189912,7930,181982,0,145909,6534,139375,0,127078,6153,120925
2786,50000,40000,0,0,0,0,0,0,0,13898,1000,12898,0,0,0,0,0,0,0,0,-2,0,0,0
2787,240000,192000,0,0,0,0,0,0,-1,0,0,0,-1,0,0,0,-2,0,0,0,-2,0,0,0
2788,140000,112000,0,1,1,1,1,0,0,132135,5000,127135,0,126622,5000,121622,0,127495,6000,121495,0,119304,6000,113304
2789,210000,168000,0,0,0,0,0,0,0,139854,4700,135154,0,138054,4515,133539,0,136674,4426,132248,0,136196,4436,131760
2790,70000,56000,0,1,1,1,1,0,0,66446,3000,63446,0,67786,1903,65883,0,69686,2458,67228,0,70500,1900,68600
2791,60000,48000,0,1,1,1,1,0,4,59595,2000,57595,5,58079,0,58079,4,56892,0,56892,3,55826,0,55826
2792,440000,352000,0,0,0,0,0,0,-1,21349,20000,1349,0,11569,12000,-431,-1,-1401,0,-1401,-1,1773,3773,-2000
2793,40000,32000,0,0,0,1,1,1,0,32144,1900,30244,0,33157,1851,31306,0,33657,1351,32306,0,34359,1394,32965
2794,100000,80000,0,0,0,0,0,1,-1,0,0,0,-1,6270,6270,0,-1,-396,0,-396,-1,-396,0,-396
2795,30000,24000,0,1,1,0,0,0,0,27617,1400,26217,0,28546,1300,27246,0,13487,700,12787,0,8307,1000,7307
2796,20000,16000,0,0,0,0,0,1,0,882,900,-18,-1,882,0,882,2,914,182,732,2,930,16,914
2797,20000,16000,0,1,0,0,0,0,0,17198,1121,16077,0,14253,460,13793,0,18475,6000,12475,0,13878,624,13254
2798,150000,120000,0,1,1,1,1,0,0,154652,5877,148775,0,157819,5804,152015,0,155982,5763,150219,0,154158,5669,148489
2799,360000,288000,0,0,0,0,0,0,-2,0,0,0,-2,0,0,0,-2,0,0,0,-2,0,0,0
2800,20000,16000,0,0,0,0,0,0,-1,390,390,0,-1,1052,1052,0,-1,662,0,662,0,1202,2030,-828
2801,60000,48000,0,1,0,0,0,0,0,54178,2000,52178,0,44518,2000,42518,0,28636,3000,25636,0,28957,1300,27657
2802,260000,208000,0,0,0,0,0,0,-2,0,0,0,-2,1368,1368,0,-2,101,101,0,-2,955,955,0
2803,50000,40000,0,1,1,0,0,0,0,50361,2600,47761,0,50152,2011,48141,0,28119,2000,26119,0,28238,3510,24728
2804,450000,360000,0,0,0,0,0,0,-1,2226,2243,-17,-1,1878,2236,-358,-1,-25,0,-25,-1,5029,5054,-25
2805,80000,64000,0,0,0,0,0,0,0,47663,2000,45663,0,48350,2000,46350,0,47208,2000,45208,0,46292,2000,44292
2806,140000,112000,0,0,0,0,0,0,0,104440,30000,74440,0,88467,7981,80486,0,71519,3000,68519,0,63150,3000,60150
2807,280000,224000,0,0,0,0,0,1,0,0,0,0,0,189841,189841,0,-1,193313,6022,187291,0,192742,6078,186664
2808,500000,400000,0,0,0,0,0,0,-1,0,0,0,-1,282562,282562,0,-1,288459,11000,277459,0,293233,9572,283661
2809,60000,48000,0,0,0,0,0,0,0,49425,4731,44694,0,16941,2000,14941,0,13349,10000,3349,0,14826,3000,11826
2810,230000,184000,0,0,0,0,0,0,-1,11666,20000,-8334,-1,18844,18844,0,-1,34983,34983,0,-1,53935,408,53527
2811,400000,320000,0,0,0,0,0,0,2,3710,3828,-118,-1,33605,33627,-22,-1,47029,47029,0,-1,39400,40000,-600
2812,360000,288000,0,0,0,0,0,0,-2,0,0,0,-2,0,0,0,-2,0,0,0,-2,0,0,0
2813,130000,104000,0,0,0,0,0,0,0,0,0,0,0,0,0,0,-2,0,0,0,-2,0,0,0
2814,110000,88000,0,0,0,0,0,0,1,65064,68500,-3436,-1,66102,3114,62988,0,54275,4016,50259,0,51791,2000,49791
2815,190000,152000,0,0,0,0,0,0,-1,0,0,0,-1,0,0,0,-2,0,0,0,-2,0,0,0
2816,170000,136000,0,0,0,0,0,0,2,0,0,0,2,2038,2038,0,-1,0,0,0,-1,0,0,0
2817,20000,16000,0,0,0,0,0,1,5,12276,0,12276,4,11790,0,11790,3,11460,0,11460,2,14090,3000,11090
2818,500000,400000,0,0,0,0,0,0,-2,0,0,0,-2,0,0,0,-2,0,0,0,-2,0,0,0
2819,170000,136000,0,0,0,0,0,1,0,87885,3500,84385,0,84534,4000,80534,0,74758,4000,70758,0,78633,6000,72633
2820,50000,40000,0,0,0,0,0,0,0,37248,3000,34248,0,30640,1200,29440,0,16158,2000,14158,0,0,0,0
2821,110000,88000,0,0,0,0,0,0,-1,0,0,0,-2,0,0,0,-2,0,0,0,-2,0,0,0
2822,100000,80000,0,0,0,0,0,0,-1,390,390,0,-1,390,390,0,-1,390,390,0,-1,390,390,0
2823,340000,272000,0,1,1,0,0,1,0,350031,14000,336031,0,304706,11000,293706,0,250216,9000,241216,0,253526,10000,243526
2824,200000,160000,0,0,0,0,0,0,0,12907,1500,11407,0,15369,3000,12369,0,15863,750,15113,0,16059,600,15459
2825,140000,112000,0,0,0,0,0,0,-1,923,923,0,-1,1751,1751,0,-1,573,573,0,-1,873,873,0
2826,320000,256000,0,1,1,1,1,0,0,325024,12500,312524,0,322246,11900,310346,0,297637,10503,287134,0,301575,10886,290689
2827,200000,160000,0,0,0,0,0,0,0,54414,3008,51406,0,53504,2006,51498,0,53670,2045,51625,0,45539,1346,44193
2828,20000,16000,0,0,0,1,1,1,0,15784,0,15784,2,17517,2000,15517,2,17097,0,17097,2,18654,2000,16654
2829,330000,264000,0,0,0,0,0,0,0,180566,7903,172663,0,182604,6418,176186,0,186415,6633,179782,0,190303,6852,183451
2830,120000,96000,0,0,0,0,0,0,0,0,0,0,-2,970,970,0,-2,5576,5576,0,-1,0,0,0
2831,20000,16000,0,0,0,0,0,0,0,19836,5000,14836,0,14354,500,13854,0,10962,500,10462,0,9274,246,9028
2832,1000000,800000,0,0,0,1,1,0,0,535020,50723,484297,0,891586,896040,-4454,-1,927171,50000,877171,0,961664,50000,911664
2833,50000,40000,0,0,0,0,0,0,0,7483,1274,6209,0,7709,500,7209,0,7934,500,7434,0,8242,440,7802
2834,500000,400000,0,0,0,0,0,0,-1,-150,0,-150,-1,150,300,-150,-1,6805,6805,0,-1,0,0,0
2835,140000,112000,0,0,0,0,0,0,0,112527,5000,107527,0,91802,3600,88202,0,94114,4000,90114,0,91201,4000,87201
2836,20000,16000,0,0,1,1,1,0,2,16540,1273,15267,0,17267,1000,16267,0,17475,631,16844,0,17838,650,17188
2837,50000,40000,0,1,1,0,0,0,0,43976,0,43976,2,44287,2500,41787,0,38113,1500,36613,0,30778,2000,28778
2838,450000,360000,0,0,0,0,0,0,-2,7266,7299,-33,-2,8331,8364,-33,-2,8188,8266,-78,-2,10455,10505,-50
2839,230000,184000,0,0,0,0,0,0,-1,4982,5008,-26,-1,43509,43736,-227,-1,2271,2282,-11,-1,13486,13553,-67
2840,10000,8000,0,0,1,0,0,1,2,8642,8642,0,-1,9151,800,8351,2,8023,107,7916,3,5475,200,5275
2841,200000,160000,0,0,0,0,0,0,-2,4144,4144,0,-2,57836,57836,0,-2,1810,1810,0,-2,0,0,0
2842,20000,16000,0,1,1,1,1,0,2,19853,1626,18227,0,19894,1615,18279,0,19993,710,19283,0,20030,720,19310
2843,50000,40000,0,0,0,0,0,1,2,33988,0,33988,2,36311,3200,33111,2,36918,1500,35418,2,36191,0,36191
2844,180000,144000,0,0,0,0,0,0,0,18177,3006,15171,0,16866,5020,11846,0,15067,5000,10067,0,7615,2000,5615
2845,20000,16000,1,1,1,1,1,1,-1,22469,0,22469,3,21780,0,21780,2,20363,1000,19363,0,20199,800,19399
2846,290000,232000,0,1,0,0,0,0,0,250180,8607,241573,0,236027,8000,228027,0,221443,8525,212918,0,198031,8476,189555
2847,260000,208000,0,1,0,0,0,0,0,245404,9708,235696,0,169632,5929,163703,0,165098,5622,159476,0,151157,5465,145692
2848,210000,168000,0,0,0,0,0,0,0,6811,3000,3811,0,10161,5000,5161,0,2922,2922,0,-1,1461,0,1461
2849,350000,280000,0,0,0,0,0,0,-1,4322,4333,-11,-1,4992,5005,-13,-1,4295,4305,-10,-1,5952,5963,-11
2850,60000,48000,0,0,0,0,0,0,0,11722,11000,722,0,10937,1220,9717,0,21528,21528,0,-1,20835,780,20055
2851,20000,16000,0,0,0,0,0,0,0,16383,1408,14975,2,15831,0,15831,3,15438,0,15438,2,17371,2346,15025
2852,20000,16000,0,0,0,0,0,0,2,10620,1265,9355,0,11355,1000,10355,0,11209,244,10965,0,11299,500,10799
2853,180000,144000,0,0,0,0,0,0,2,126527,5,126522,2,126407,5008,121399,0,131572,10006,121566,0,127154,10,127144
2854,170000,136000,0,0,0,0,0,0,0,11888,1000,10888,0,10802,216,10586,0,1477,1477,0,-1,1302,1302,0
2855,140000,112000,0,0,0,0,0,0,-1,3957,3957,0,-1,5241,5241,0,-1,3943,3943,0,-1,3933,3933,0
2856,50000,40000,0,0,0,0,0,0,0,21147,1800,19347,0,21964,1500,20464,0,21405,1000,20405,0,20297,1000,19297
2857,290000,232000,0,0,0,0,0,0,2,18249,0,18249,2,20305,2305,18000,0,26615,6615,20000,0,27063,1896,25167
2858,20000,16000,0,1,0,0,0,1,2,19077,1023,18054,0,11993,240,11753,0,0,0,0,0,0,0,0
2859,380000,304000,1,1,1,1,1,1,3,384705,0,384705,2,383332,15135,368197,0,381423,13212,368211,0,377466,13529,363937
2860,50000,40000,0,0,0,0,0,0,0,38417,1408,37009,0,27038,1000,26038,0,26254,1000,25254,0,26352,1000,25352
2861,150000,120000,0,0,0,0,0,0,0,43027,1316,41711,0,4946,1004,3942,0,3460,104,3356,0,4112,2012,2100
2862,150000,120000,0,0,0,0,0,0,0,19394,2000,17394,0,18956,2000,16956,0,20684,2000,18684,0,22237,2000,20237
2863,50000,40000,0,1,1,1,1,0,0,46022,3000,43022,0,46903,2000,44903,0,47837,2000,45837,0,48383,2000,46383
2864,280000,224000,0,0,0,0,0,0,-2,14059,14059,0,-2,2693,2693,0,-2,697,697,0,-2,5776,5776,0
2865,260000,208000,0,0,0,0,0,0,-2,0,0,0,-2,167,167,0,-2,-810,810,-1620,-2,-810,0,-810
2866,70000,56000,0,0,0,0,0,1,-1,3455,3000,455,-1,3245,0,3245,2,1686,0,1686,2,1681,0,1681
2867,30000,24000,0,1,1,1,1,1,2,28991,0,28991,2,29066,1178,27888,0,29340,1223,28117,0,30786,2435,28351
2868,50000,40000,0,0,0,0,0,0,0,28302,2000,26302,0,13881,1500,12381,0,14376,1100,13276,0,15261,1500,13761
2869,40000,32000,0,0,0,0,0,0,0,21406,2000,19406,0,24735,4000,20735,0,24050,0,24050,2,43317,20000,23317
2870,170000,136000,0,0,0,0,0,0,-1,0,0,0,-1,0,0,0,-2,0,0,0,-2,4750,4750,0
2871,140000,112000,0,0,0,0,0,0,0,107659,4537,103122,0,109104,3800,105304,0,109352,3823,105529,0,101534,3806,97728
2872,270000,216000,0,0,0,0,0,0,0,113771,6039,107732,0,103023,3367,99656,0,108340,20033,88307,0,96962,3486,93476
2873,360000,288000,0,0,0,0,0,0,-2,0,0,0,-2,3602,3602,0,-1,1197,1197,0,-1,0,0,0
2874,220000,176000,0,0,0,0,0,0,-2,0,0,0,-2,0,0,0,-2,0,0,0,-2,0,0,0
2875,230000,184000,0,0,0,0,0,0,0,173679,6593,167086,0,92937,2966,89971,0,94552,3135,91417,0,76849,2956,73893
2876,50000,40000,0,0,0,0,0,1,3,21163,507,20656,2,19894,1300,18594,0,19758,1000,18758,0,19324,700,18624
2877,100000,80000,0,0,0,0,0,1,0,6418,1000,5418,2,6781,1000,5781,2,6144,0,6144,2,7638,2000,5638
2878,280000,224000,0,0,0,0,0,0,0,100542,4188,96354,0,103087,5000,98087,0,103983,3679,100304,0,105638,3703,101935
2879,280000,224000,0,0,0,0,0,0,0,211850,7584,204266,0,209651,7416,202235,0,214520,8000,206520,0,213520,7639,205881
2880,50000,40000,0,1,1,0,0,0,0,48940,2329,46611,0,50545,2943,47602,0,29523,990,28533,0,28960,1168,27792
2881,90000,72000,1,1,1,1,0,1,2,105806,0,105806,2,98257,2915,95342,0,91442,3154,88288,0,66762,2977,63785
2882,170000,136000,0,0,0,0,0,0,-1,0,0,0,-2,0,0,0,-2,0,0,0,-2,0,0,0
2883,50000,40000,0,1,1,1,1,0,0,47248,1750,45498,0,48241,1700,46541,0,49196,1800,47396,0,50296,2023,48273
2884,170000,136000,0,0,0,0,0,0,-2,0,0,0,-2,0,0,0,-2,0,0,0,-2,0,0,0
2885,170000,136000,0,1,1,0,0,0,0,161315,8000,153315,0,164366,7800,156566,0,124387,4600,119787,0,120529,5000,115529
2886,70000,56000,0,0,0,0,0,0,0,11179,2000,9179,0,8688,295,8393,0,8295,1000,7295,0,10147,2000,8147
2887,300000,240000,0,0,0,0,0,0,-2,0,0,0,-2,970,970,0,-1,0,0,0,-1,89,89,0
2888,200000,160000,0,0,0,0,0,0,-1,-6,0,-6,-2,3044,3050,-6,-2,4412,4412,0,-1,3412,0,3412
2889,10000,8000,0,0,0,1,1,0,2,8297,1000,7297,2,8792,1000,7792,0,9277,1000,8277,0,9744,1000,8744
2890,30000,24000,0,1,1,1,1,1,0,26679,2500,24179,0,27779,2000,25779,0,28691,2000,26691,0,29726,2000,27726
2891,500000,400000,0,0,0,0,0,0,-1,104279,104279,0,-1,103945,2085,101860,0,101945,1130,100815,0,90193,45551,44642
2892,180000,144000,0,0,0,0,0,0,-2,1548,1548,0,-2,768,768,0,-2,0,0,0,-2,0,0,0
2893,150000,120000,0,0,0,0,0,0,-1,3190,3205,-15,-1,389,390,-1,-1,389,390,-1,-1,389,390,-1
2894,170000,136000,0,0,1,0,0,1,0,115372,5200,110172,0,211577,5000,206577,0,120407,5000,115407,0,122952,5000,117952
2895,360000,288000,0,0,0,0,0,0,-1,79795,80401,-606,-1,49160,32083,17077,0,2847,2907,-60,0,-13,13,-26
2896,90000,72000,0,0,0,0,0,0,-2,2366,2366,0,-2,-1438,1068,-2506,-2,-1438,0,-1438,-2,66129,67567,-1438
2897,20000,16000,0,0,0,0,0,0,0,9961,1150,8811,0,10310,499,9811,0,10372,361,10011,0,9838,573,9265
2898,360000,288000,0,0,0,0,0,0,-2,21865,21888,-23,-2,44440,44640,-200,-2,3904,3904,0,-2,0,0,0
2899,20000,16000,0,0,1,1,1,0,0,17291,1600,15691,0,17588,1000,16588,0,18034,1000,17034,0,18658,1500,17158
2900,230000,184000,0,0,0,0,0,0,0,178221,6707,171514,0,156627,3000,153627,0,128110,2725,125385,0,121517,3544,117973
2901,170000,136000,0,0,0,0,0,0,0,32292,2301,29991,0,32372,2379,29993,0,31202,2202,29000,0,31688,2688,29000
2902,500000,400000,0,0,0,0,0,0,-1,22893,22893,0,-1,52002,53198,-1196,-1,16521,0,16521,0,-38,0,-38
2903,140000,112000,0,0,0,0,0,0,0,113921,5600,108321,0,114348,4500,109848,0,111382,4200,107182,0,112458,4500,107958
2904,50000,40000,0,0,0,0,0,0,0,10593,1178,9415,0,11358,943,10415,0,11033,0,11033,2,11402,553,10849
2905,30000,24000,0,0,0,0,0,1,3,4090,0,4090,2,2829,0,2829,0,2108,1801,307,0,1801,0,1801
2906,270000,216000,0,0,0,0,0,0,0,204532,10064,194468,0,196061,9238,186823,0,180142,6000,174142,0,185838,8044,177794
2907,130000,104000,0,1,1,1,1,0,0,109902,4030,105872,0,112635,4600,108035,0,114472,4200,110272,0,117556,5000,112556
2908,200000,160000,0,0,0,0,0,0,-2,0,0,0,-2,0,0,0,-2,0,0,0,-2,3983,3983,0
2909,290000,232000,0,0,0,0,0,0,0,157691,22429,135262,0,158720,5530,153190,0,144085,4442,139643,0,143663,5887,137776
2910,220000,176000,0,0,0,0,0,0,0,161778,5669,156109,0,165741,7599,158142,0,175823,14800,161023,0,29765,2303,27462
2911,30000,24000,0,0,0,0,0,1,2,13984,1234,12750,0,14350,600,13750,0,14650,532,14118,0,15156,750,14406
2912,150000,120000,0,0,0,0,0,0,-1,6164,6201,-37,-1,3370,3386,-16,-1,7279,7299,-20,-1,4445,1166,3279
2913,290000,232000,0,0,0,0,0,0,0,7964,2016,5948,0,10335,5000,5335,0,12000,2000,10000,0,13463,1463,12000
2914,50000,40000,0,1,0,0,0,0,0,43889,1981,41908,0,35324,1344,33980,0,24146,810,23336,0,22914,828,22086
2915,80000,64000,0,1,0,0,0,1,0,69714,3103,66611,0,57318,3000,54318,0,46921,1800,45121,0,41072,1500,39572
2916,230000,184000,0,0,0,0,0,0,0,87972,3000,84972,0,57846,1928,55918,0,57798,2000,55798,0,52071,2500,49571
2917,450000,360000,0,0,0,0,0,0,-2,13887,1200,12687,-2,17255,5255,12000,-2,17515,4566,12949,-2,0,0,0
2918,50000,40000,0,0,0,0,0,0,-2,0,0,0,-2,0,0,0,-2,0,0,0,-2,0,0,0
2919,340000,272000,0,0,0,0,0,0,-1,5221,5269,-48,-1,7627,8193,-566,-1,580,596,-16,-1,999,999,0
2920,200000,160000,0,0,0,0,0,0,0,34064,1500,32564,2,30519,2547,27972,0,26166,2500,23666,0,28097,2500,25597
2921,400000,320000,0,0,0,0,0,0,0,6298,1001,5297,0,138307,138307,0,-1,149548,16996,132552,-1,148632,5010,143622
2922,10000,8000,0,0,0,1,1,0,2,7559,1300,6259,0,9564,2300,7264,0,9264,0,9264,2,9862,900,8962
2923,500000,400000,0,0,0,0,0,0,0,369045,15000,354045,0,382231,20000,362231,0,204593,10000,194593,0,211655,10000,201655
2924,100000,80000,0,0,0,0,0,1,-1,1042,1042,0,-1,1004,1004,0,-1,1612,1650,-38,-1,622,622,0
2925,50000,40000,0,0,0,0,0,0,0,17728,2000,15728,0,17886,1300,16586,0,18043,1000,17043,0,19134,1500,17634
2926,280000,224000,0,1,1,1,1,0,0,270705,10750,259955,0,278771,12500,266271,0,283434,11000,272434,0,259699,9600,250099
2927,120000,96000,0,0,0,0,0,0,-1,4748,4748,0,-1,7002,7020,-18,-1,202,559,-357,-1,345,500,-155
2928,100000,80000,0,0,0,0,0,0,2,1250,0,1250,2,1250,0,1250,5,1250,0,1250,5,650,0,650
2929,230000,184000,0,0,0,0,0,0,-1,120000,90000,30000,0,0,0,0,0,0,0,0,-2,0,0,0
2930,30000,24000,0,1,1,1,1,1,2,25963,1433,24530,0,27030,1500,25530,0,29079,2500,26579,0,29865,1400,28465
2931,70000,56000,0,0,0,0,0,0,2,2752,1500,1252,0,1048,0,1048,0,462,0,462,0,830,1123,-293
2932,50000,40000,0,0,0,0,0,0,0,20376,1136,19240,0,10203,483,9720,0,9868,340,9528,0,9700,368,9332
2933,70000,56000,0,0,0,0,0,0,0,25059,1415,23644,0,25559,915,24644,0,26094,947,25147,0,26612,952,25660
2934,30000,24000,0,1,1,1,1,0,0,28183,2000,26183,0,25484,1400,24084,0,27062,2000,25062,0,28703,2100,26603
2935,50000,40000,0,0,0,0,0,0,-1,7752,7752,0,-1,596,596,0,-1,18396,18396,0,-1,5769,5769,0
2936,110000,88000,0,1,1,1,1,0,0,109443,7845,101598,0,106637,4000,102637,2,106665,4000,102665,0,92417,3500,88917
2937,50000,40000,0,0,0,0,0,1,2,27533,1764,25769,0,28569,3400,25169,0,28901,1100,27801,0,31095,2660,28435
2938,360000,288000,0,0,0,0,0,1,-1,3189,3215,-26,-1,3093,3104,-11,-1,4019,2026,1993,0,2407,2414,-7
2939,90000,72000,0,0,0,0,0,0,2,69402,0,69402,2,1332,0,1332,0,1604,272,1332,0,958,166,792
2940,230000,184000,0,0,0,0,0,0,0,5975,2001,3974,0,11072,6018,5054,0,10021,5007,5014,0,14431,5010,9421
2941,270000,216000,0,0,0,0,0,0,-1,6125,6129,-4,-1,0,0,0,-1,0,0,0,-2,29961,29961,0
2942,230000,184000,0,0,0,0,0,0,-1,3962,4007,-45,-1,1410,0,1410,0,1410,1410,0,-1,1410,1410,0
2943,160000,128000,0,0,0,0,0,1,-2,0,0,0,-2,0,0,0,-2,0,0,0,-2,0,0,0
2944,400000,320000,0,0,0,0,0,0,-2,5750,5750,0,-2,132866,132872,-6,-2,21780,21780,0,-2,41050,20525,20525
2945,200000,160000,0,1,1,1,1,0,0,198168,7266,190902,0,189696,7000,182696,0,192462,7940,184522,0,194025,7009,187016
2946,180000,144000,0,0,0,0,1,0,0,144021,6000,138021,0,146539,5300,141239,0,149286,5500,143786,0,151900,5500,146400
2947,250000,200000,0,0,0,0,0,0,0,39711,10000,29711,0,47523,10000,37523,0,52726,6000,46726,0,57649,6000,51649
2948,130000,104000,0,0,0,0,0,0,2,12075,0,12075,2,15844,4300,11544,2,15295,0,15295,2,16885,2000,14885
2949,10000,8000,0,0,0,1,0,1,0,7784,1000,6784,2,8547,1000,7547,0,8907,600,8307,0,6844,200,6644
2950,60000,48000,0,0,0,0,0,1,2,32577,5300,27277,2,31754,0,31754,2,34228,3000,31228,2,35128,1600,33528
2951,30000,24000,0,1,1,0,0,0,0,29622,1500,28122,0,30271,1000,29271,0,24536,1000,23536,0,22913,1000,21913
2952,130000,104000,0,1,0,0,0,1,2,130477,6000,124477,0,99119,5000,94119,0,101535,5000,96535,0,89883,100207,-10324
2953,50000,40000,0,1,1,0,0,0,0,48560,2500,46060,0,49826,2608,47218,0,34318,700,33618,0,19884,3381,16503
2954,150000,120000,0,0,0,1,1,0,0,118843,10050,108793,0,137751,30000,107751,0,141330,5000,136330,0,146389,6088,140301
2955,30000,24000,0,1,1,1,1,1,2,25502,0,25502,2,28588,3509,25079,2,27616,0,27616,3,27903,1128,26775
2956,60000,48000,0,0,0,0,0,0,0,0,0,0,0,0,0,0,-2,0,0,0,-2,0,0,0
2957,340000,272000,0,0,0,0,0,0,-1,325,325,0,-1,580,580,0,-1,9664,9664,0,-1,29200,29200,0
2958,120000,96000,0,1,0,0,0,0,2,112976,3500,109476,0,63658,2000,61658,0,38495,1500,36995,0,38226,1500,36726
2959,320000,256000,0,0,0,0,0,0,0,178390,0,178390,2,180346,8000,172346,0,178832,7000,171832,0,182860,7000,175860
2960,200000,160000,0,0,0,0,0,0,-1,0,0,0,-1,1000,1000,0,-1,0,0,0,-1,0,0,0
2961,90000,72000,0,0,0,0,0,0,0,61071,3908,57163,0,44821,2100,42721,0,24653,884,23769,0,25254,1000,24254
2962,200000,160000,0,0,0,0,0,0,0,64699,3000,61699,0,66029,3000,63029,0,66836,2500,64336,0,68390,2632,65758
2963,280000,224000,0,0,0,0,0,0,0,106539,5245,101294,0,106361,3800,102561,0,108590,3881,104709,0,110915,4069,106846
2964,140000,112000,0,0,0,0,0,0,-1,1176,1176,0,-1,0,0,0,-1,780,780,0,-1,642,642,0
2965,180000,144000,0,0,0,0,0,0,0,50140,3003,47137,0,60607,10607,50000,0,67976,7976,60000,0,20412,5412,15000
2966,360000,288000,0,0,0,0,0,0,-1,2145,2145,0,-1,9944,9944,0,-1,4540,4540,0,-1,8024,8024,0
2967,120000,96000,0,0,0,0,0,0,-2,0,0,0,-2,0,0,0,-2,0,0,0,-2,0,0,0
2968,110000,88000,0,1,0,0,0,0,0,107386,3300,104086,0,78268,3012,75256,0,75846,3008,72838,0,75685,3000,72685
2969,360000,288000,0,0,0,0,0,0,0,24996,2670,22326,0,17509,1062,16447,0,5486,514,4972,0,5295,113,5182
2970,320000,256000,0,0,0,0,0,0,-2,1294,2588,-1294,-2,2310,2310,0,-2,50720,50720,0,-2,51736,51736,0
2971,40000,32000,0,0,0,0,0,1,2,22040,0,22040,2,23396,2000,21396,2,20430,0,20430,2,20763,1000,19763
2972,30000,24000,1,1,0,0,0,1,0,45414,1366,44048,0,21331,1000,20331,0,21987,1000,20987,0,22452,980,21472
2973,70000,56000,0,1,1,1,1,0,0,70949,2714,68235,0,68782,2632,66150,0,68100,2600,65500,0,68677,2800,65877
2974,90000,72000,0,0,0,0,0,0,-1,0,0,0,-1,0,0,0,-2,0,0,0,-2,0,0,0
2975,210000,168000,0,0,0,0,0,0,0,4100,1000,3100,0,0,0,0,0,10790,10790,0,-1,7373,7373,0
2976,70000,56000,0,0,0,0,0,1,2,28184,0,28184,2,28449,1030,27419,0,30379,2400,27979,0,30931,1200,29731
2977,120000,96000,0,0,0,0,0,0,-2,0,0,0,-2,0,0,0,-2,0,0,0,-2,0,0,0
2978,80000,64000,0,0,0,0,0,0,-1,18634,18754,-120,-1,5433,5449,-16,-1,2053,2059,-6,-1,5781,5798,-17
2979,240000,192000,0,0,0,0,0,0,-2,1130,1133,-3,-1,3525,3525,0,-1,0,0,0,-2,2116,2116,0
2980,200000,160000,0,1,1,1,0,0,0,198233,6342,191891,0,200350,4007,196343,0,200390,4008,196382,0,19959,19959,0
2981,80000,64000,0,0,0,0,0,0,0,6383,6387,-4,-1,5016,102,4914,0,1760,35,1725,0,2783,1850,933
2982,210000,168000,0,0,0,0,0,0,-2,0,0,0,-2,0,0,0,-2,0,0,0,-2,0,0,0
2983,320000,256000,0,0,0,0,0,0,-2,9572,9579,-7,-2,3826,3826,0,-2,737,737,0,-2,3865,3865,0
2984,470000,376000,0,0,0,0,0,0,0,145293,6000,139293,0,148871,6000,142871,0,152309,6000,146309,0,155769,6000,149769
2985,170000,136000,0,1,1,0,0,0,0,168441,8100,160341,0,171664,8000,163664,0,112130,4300,107830,0,114561,4400,110161
2986,160000,128000,0,0,0,0,0,0,-1,0,0,0,-2,0,0,0,-2,1893,1893,0,-1,0,0,0
2987,250000,200000,0,0,0,0,0,0,-1,63462,2138,61324,0,45710,1566,44144,0,43537,1582,41955,0,38367,1318,37049
2988,170000,136000,0,0,0,0,0,1,0,115807,5727,110080,0,119857,7500,112357,0,117100,2000,115100,2,118079,4200,113879
2989,200000,160000,0,0,0,0,0,0,0,54762,2573,52189,0,55858,2604,53254,0,56338,1997,54341,0,57360,2228,55132
2990,340000,272000,0,0,0,0,0,0,-1,27050,27283,-233,-1,29103,29255,-152,-1,58997,58276,721,0,12518,12565,-47
2991,200000,160000,0,0,0,0,0,0,-1,382,382,0,-1,10383,10383,0,-1,7030,0,7030,0,0,3036,-3036
2992,20000,16000,0,0,0,0,0,0,0,9342,1139,8203,0,556,556,0,-1,19967,20191,-224,-1,1742,1742,0
2993,180000,144000,0,0,0,0,0,1,0,7996,0,7996,2,8960,1166,7794,0,6310,126,6184,0,4656,112,4544
2994,90000,72000,0,0,0,0,0,0,2,45640,99,45541,2,41539,1500,40039,0,39373,1500,37873,0,32080,2015,30065
2995,240000,192000,0,1,1,1,1,0,0,213460,7800,205660,0,217816,7907,209909,0,222214,8021,214193,0,227174,8610,218564
2996,280000,224000,0,0,0,0,0,0,-1,25088,25100,-12,-1,9427,9427,0,-2,2829,2838,-9,-2,198,198,0
2997,50000,40000,0,1,0,0,0,0,0,43763,1614,42149,0,37657,1627,36030,0,38530,1500,37030,0,39409,1500,37909
2998,170000,136000,0,0,0,0,0,0,0,134832,5667,129165,0,70479,9223,61256,0,0,0,0,0,0,0,0
2999,300000,240000,0,0,0,0,0,0,0,203164,20219,182945,0,164371,7500,156871,0,161331,6500,154831,0,154515,7500,147015
3000,380000,304000,0,1,0,0,0,0,0,327342,9543,317799,0,247528,6106,241422,0,128386,3013,125373,0,128820,3398,125422
3001,200000,160000,0,0,0,0,0,0,-2,1356,1356,0,-2,0,0,0,-2,984,984,0,-2,134,134,0
3002,90000,72000,0,0,0,0,0,0,-1,1114,2806,-1692,-1,657,2256,-1599,-1,1332,2274,-942,-1,780,780,0
3003,70000,56000,0,1,1,1,1,0,0,69582,3100,66482,0,69589,2800,66789,0,68728,2600,66128,0,69304,2940,66364
3004,50000,40000,0,0,0,0,0,0,0,18500,2200,16300,0,18864,1000,17864,2,19807,1500,18307,2,19407,0,19407
3005,130000,104000,0,0,0,0,0,0,-2,-470,0,-470,-2,-470,0,-470,-2,47296,47766,-470,-1,0,0,0
3006,90000,72000,0,0,0,0,0,0,0,22132,1582,20550,0,63204,770,62434,0,19412,1696,17716,0,18099,820,17279
3007,270000,216000,0,0,0,0,0,0,-2,4180,1000,3180,-2,1833,2,1831,-2,511,1,510,-2,6635,6668,-33
3008,80000,64000,0,0,0,0,0,0,2,39422,2006,37416,0,33954,4000,29954,0,29070,0,29070,2,27785,1118,26667
3009,30000,24000,0,0,0,0,0,1,3,15910,1150,14760,2,16752,1400,15352,2,16197,0,16197,3,16583,800,15783
3010,70000,56000,0,0,0,0,0,0,0,37887,1200,36687,0,37876,758,37118,0,6736,6736,0,-1,4162,0,4162
3011,20000,16000,0,0,0,0,0,0,0,13181,13181,0,-1,12596,5,12591,0,11699,1033,10666,0,2154,1781,373
3012,270000,216000,0,0,0,0,0,0,-1,18118,18118,0,-1,147189,147500,-311,-1,170268,60000,110268,0,170268,15000,155268
3013,200000,160000,0,0,0,0,0,0,-2,6843,6880,-37,-2,1320,1320,0,-2,5983,5983,0,-2,1922,1922,0
3014,260000,208000,0,0,0,0,0,0,0,193708,10005,183703,0,163477,7000,156477,0,139993,5500,134493,0,133197,5000,128197
3015,300000,240000,0,0,0,0,0,0,-2,3025,2004,1021,-2,4128,2003,2125,-2,1726,1726,0,-2,-587,692,-1279
3016,100000,80000,0,0,0,0,0,0,0,24148,1011,23137,0,0,0,0,0,0,0,0,-2,0,0,0
3017,440000,352000,0,0,0,0,0,0,0,444912,226848,218064,-1,218064,8300,209764,0,222734,8300,214434,0,227445,8300,219145
3018,180000,144000,0,0,0,0,0,0,0,71866,3300,68566,0,72140,2140,70000,0,60885,1885,59000,0,32397,4000,28397
3019,500000,400000,0,0,0,0,0,0,-1,43892,43864,28,0,6420,6453,-33,0,49240,49470,-230,-2,6772,3723,3049
3020,20000,16000,0,0,0,0,0,0,0,11974,2004,9970,0,11467,5013,6454,0,10469,3010,7459,0,9380,3690,5690
3021,240000,192000,0,0,0,0,0,0,0,177380,7005,170375,0,126645,4601,122044,0,128877,5000,123877,0,121803,5300,116503
3022,220000,176000,0,0,0,0,0,0,2,54788,2421,52367,0,54468,1964,52504,0,51920,2000,49920,0,49016,2000,47016
3023,160000,128000,0,0,0,0,0,0,0,40180,3000,37180,0,41318,2000,39318,0,42605,2000,40605,0,43857,2000,41857
3024,90000,72000,0,0,0,0,0,1,2,0,0,0,-2,0,0,0,-2,0,0,0,-2,0,0,0
3025,200000,160000,0,0,0,0,0,0,0,97400,4500,92900,0,4283,4283,0,-1,145769,148192,-2423,-1,143712,5133,138579
3026,30000,24000,0,0,0,0,0,1,-1,2280,0,2280,2,248,248,0,-1,248,0,248,0,-150,0,-150
3027,240000,192000,0,0,0,0,0,1,0,166064,6520,159544,0,0,0,0,0,0,0,0,-2,0,0,0
3028,30000,24000,0,1,1,1,1,1,7,29656,0,29656,6,28914,0,28914,5,28172,0,28172,4,27444,0,27444
3029,50000,40000,0,0,0,0,0,1,0,26191,28293,-2102,-1,25193,0,25193,2,25742,1100,24642,0,27171,2030,25141
3030,400000,320000,0,0,0,0,0,0,0,50773,1421,49352,0,39676,1381,38295,0,30680,770,29910,0,27761,731,27030
3031,20000,16000,0,1,1,1,1,1,0,17827,1593,16234,0,17874,640,17234,0,18288,702,17586,0,18557,612,17945
3032,140000,112000,0,0,0,0,0,0,0,30129,3011,27118,0,21477,5000,16477,0,26097,5000,21097,0,24767,3000,21767
3033,500000,400000,0,0,0,0,0,0,0,44226,5014,39212,0,40712,5005,35707,0,37311,4000,33311,0,27068,5000,22068
3034,250000,200000,0,0,0,0,0,0,-1,6833,2000,4833,0,8766,2000,6766,0,9539,1000,8539,0,9779,319,9460
3035,360000,288000,0,0,0,0,0,0,-1,1227,1227,0,-2,1541,1541,0,-2,1389,1389,0,-2,390,390,0
3036,370000,296000,0,0,0,0,0,0,-1,189957,7002,182955,0,188960,6854,182106,0,195476,15960,179516,0,184094,0,184094
3037,70000,56000,0,0,0,0,0,1,2,56580,4000,52580,0,24991,1500,23491,0,16036,3000,13036,0,16667,2500,14167
3038,160000,128000,0,0,0,0,0,1,0,38038,3683,34355,0,38683,1564,37119,2,37764,0,37764,2,39053,2053,37000
3039,20000,16000,0,1,1,1,1,0,0,17830,1276,16554,0,18184,630,17554,0,18565,653,17912,0,19076,798,18278
3040,80000,64000,0,0,0,0,0,0,0,50642,1920,48722,0,47283,1541,45742,0,42340,1502,40838,0,40223,1619,38604
3041,160000,128000,0,0,0,0,0,0,0,77045,3034,74011,0,69659,3010,66649,0,70186,5011,65175,0,75249,10006,65243
3042,200000,160000,0,0,0,0,0,1,-1,1261,1261,0,-1,0,0,0,-1,1261,1261,0,-1,-1261,0,-1261
3043,200000,160000,0,0,0,0,0,0,-2,0,0,0,-2,0,0,0,-2,0,0,0,-2,0,0,0
3044,270000,216000,0,0,0,0,0,0,2,20924,4000,16924,0,22448,2000,20448,0,15490,0,15490,2,17343,2000,15343
3045,410000,328000,0,0,0,0,0,1,2,72083,0,72083,2,76603,6147,70456,2,74964,0,74964,2,76370,2577,73793
3046,50000,40000,0,0,0,0,0,1,0,8506,800,7706,2,8716,500,8216,0,8926,500,8426,0,9128,500,8628
3047,80000,64000,0,0,0,0,0,0,-1,0,0,0,-1,0,0,0,-2,0,0,0,-2,1650,1650,0
3048,20000,16000,0,1,1,1,1,1,3,19465,1600,17865,2,19649,800,18849,2,19978,950,19028,2,20512,1000,19512
3049,100000,80000,0,0,0,0,0,0,2,4480,1795,2685,2,764,0,764,2,528,13,515,0,933,933,0
3050,50000,40000,0,0,0,0,0,1,2,39148,5500,33648,2,38233,0,38233,3,37318,0,37318,2,39757,3036,36721
3051,30000,24000,0,1,1,1,1,1,0,29963,3500,26463,0,28835,0,28835,2,30174,2297,27877,2,28603,40,28563
3052,300000,240000,0,0,0,0,0,0,-2,0,0,0,-2,0,0,0,-2,0,0,0,-2,0,0,0
3053,20000,16000,0,1,1,0,0,0,0,18841,1500,17341,0,18989,1000,17989,0,11583,1000,10583,0,11859,1000,10859
3054,10000,8000,1,1,1,1,1,0,0,17734,1286,16448,0,9081,500,8581,0,8877,320,8557,0,9261,529,8732
3055,400000,320000,0,0,0,0,0,0,-1,-42,0,-42,-1,-42,0,-42,-2,-42,0,-42,-2,1058,1100,-42
3056,150000,120000,0,0,0,0,0,0,0,21423,1500,19923,0,23927,3000,20927,0,25718,2000,23718,0,136667,111338,25329
3057,150000,120000,0,0,0,0,0,0,-2,3766,4097,-331,-2,3289,3371,-82,-2,8356,8923,-567,-2,10916,13919,-3003
3058,110000,88000,0,0,0,0,0,0,2,0,0,0,2,632,948,-316,-1,316,0,316,0,632,632,0
3059,150000,120000,0,0,0,0,0,0,-1,19796,19796,0,-1,1725,1725,0,-1,1150,1150,0,-1,0,0,0
3060,200000,160000,0,0,0,0,0,0,-1,163,0,163,2,2231,2250,-19,-1,2048,0,2048,2,4732,2732,2000
3061,170000,136000,0,0,0,0,0,0,0,44572,2578,41994,0,43211,2300,40911,0,41394,2000,39394,2,37958,1200,36758
3062,100000,80000,0,0,0,0,0,0,2,12605,1418,11187,0,10437,250,10187,0,7920,306,7614,0,7350,524,6826
3063,10000,8000,0,0,0,1,0,0,-1,3071,1200,1871,0,4012,1000,3012,0,9882,1000,8882,0,5857,1000,4857
3064,50000,40000,0,0,0,0,0,0,0,28383,1500,26883,0,28937,1432,27505,0,29119,1004,28115,0,29334,1035,28299
3065,290000,232000,0,0,0,0,0,1,-1,0,0,0,-2,3692,3692,0,-2,0,0,0,-2,1957,1957,0
3066,200000,160000,0,0,0,0,0,0,0,44233,4000,40233,0,45124,1267,43857,0,46252,1500,44752,0,47207,1500,45707
3067,240000,192000,0,0,0,0,0,0,0,49001,2200,46801,0,47026,1923,45103,0,45827,1682,44145,0,39527,2000,37527
3068,220000,176000,0,0,0,0,0,0,-1,12681,12681,0,-1,84674,84674,0,-1,35326,35326,0,-1,1026,1026,0
3069,50000,40000,0,0,0,0,0,0,0,14959,1850,13109,0,16204,1800,14404,0,16536,900,15636,0,17118,1000,16118
3070,170000,136000,0,0,0,0,0,0,0,34688,2000,32688,0,30542,3000,27542,0,61032,1000,60032,0,23711,6000,17711
3071,80000,64000,0,0,0,0,0,1,2,22677,0,22677,2,23692,1395,22297,0,25406,2109,23297,0,26050,1196,24854
3072,80000,64000,0,0,0,0,0,1,2,46466,0,46466,2,48183,2800,45383,2,49057,1800,47257,2,51091,3000,48091
3073,500000,400000,0,0,0,0,0,0,-2,3981,3981,0,-2,0,0,0,-2,3672,3672,0,-2,7617,7617,0
3074,90000,72000,0,1,1,1,1,1,0,81415,3805,77610,0,81878,3100,78778,0,83206,3200,80006,0,85350,4100,81250
3075,60000,48000,0,0,0,0,0,1,2,22437,1500,20937,2,22771,1000,21771,2,23099,1000,22099,2,23583,1000,22583
3076,30000,24000,0,0,0,0,0,0,0,16130,1268,14862,0,16462,600,15862,0,16808,611,16197,0,17140,612,16528
3077,50000,40000,0,0,0,0,0,0,-1,1134,0,1134,2,1073,1200,-127,-1,1312,1500,-188,-1,51,0,51
3078,140000,112000,0,0,0,0,0,0,0,61422,2200,59222,0,52576,2400,50176,0,51301,2000,49301,0,48202,2050,46152
3079,210000,168000,0,0,0,0,0,0,0,118652,93575,25077,0,8757,1000,7757,0,8936,179,8757,0,9118,182,8936
3080,100000,80000,0,0,0,0,0,0,-2,0,0,0,-2,0,0,0,-2,249,249,0,-1,317,317,0
3081,220000,176000,0,1,0,0,0,0,2,207870,7109,200761,0,172612,6050,166562,0,166705,6000,160705,0,166192,9111,157081
3082,320000,256000,0,0,0,0,0,0,-2,12680,12743,-63,-2,5522,5542,-20,-1,44743,44956,-213,-1,18931,19011,-80
3083,10000,8000,0,0,0,0,1,1,0,2736,0,2736,2,3654,1000,2654,0,3729,75,3654,0,9446,994,8452
3084,30000,24000,0,0,0,0,0,1,2,1405,1405,0,-1,3844,3427,417,0,3427,0,3427,0,417,0,417
3085,70000,56000,0,0,0,0,0,0,0,33390,1497,31893,0,26457,947,25510,0,27165,1134,26031,0,27562,1000,26562
3086,100000,80000,0,0,0,0,0,0,0,52600,3000,49600,0,52336,2025,50311,0,55831,5000,50831,0,56265,3000,53265
3087,100000,80000,0,1,1,1,1,0,0,101350,4000,97350,0,101324,4000,97324,0,101475,4000,97475,0,100558,4000,96558
3088,150000,120000,0,1,1,1,1,0,2,142275,10275,132000,2,144427,6000,138427,2,146702,6000,140702,2,150647,6100,144547
3089,290000,232000,0,0,0,0,0,0,-1,0,0,0,-2,0,0,0,-2,0,0,0,-2,0,0,0
3090,210000,168000,0,0,0,0,0,1,-1,4049,4049,0,-1,345,348,-3,-1,650,650,0,-1,3217,3217,0
3091,200000,160000,0,0,0,0,0,0,-2,188,188,0,-1,0,0,0,-1,0,0,0,-2,0,0,0
3092,240000,192000,0,0,0,0,0,0,0,43538,1725,41813,0,44402,1589,42813,0,45333,1646,43687,0,46551,1972,44579
3093,300000,240000,0,0,0,0,0,0,-2,0,876,-876,-2,876,876,0,-1,0,0,0,-1,0,0,0
3094,190000,152000,0,0,0,0,0,0,-1,-1024,0,-1024,-2,-1397,1580,-2977,-2,-1953,556,-2509,-2,-825,2047,-2872
3095,80000,64000,0,0,0,0,0,1,2,43231,3800,39431,2,42236,0,42236,2,44924,3400,41524,2,44072,0,44072
3096,230000,184000,0,0,0,0,0,0,-2,6164,6164,0,-2,3612,3612,0,-2,7756,7761,-5,-2,4906,4906,0
3097,60000,48000,0,0,0,0,0,0,0,22095,1000,21095,0,14293,5000,9293,0,12217,12217,0,-1,16170,8000,8170
3098,20000,16000,0,0,0,0,0,0,2,16614,1358,15256,0,15941,1065,14876,0,13205,327,12878,0,6009,187,5822
3099,50000,40000,0,0,0,0,0,0,2,41247,1595,39652,0,9818,505,9313,0,9003,500,8503,0,9203,500,8703
3100,20000,16000,0,0,0,0,0,0,-1,204,0,204,3,204,0,204,2,-14,0,-14,2,-2400,20,-2420
3101,340000,272000,0,0,0,0,0,0,0,65826,61883,3943,0,63877,2147,61730,0,53845,1855,51990,0,51983,1774,50209
3102,310000,248000,0,0,0,0,0,1,0,26113,1500,24613,0,22661,1000,21661,0,20351,2000,18351,0,16639,1000,15639
3103,280000,224000,0,0,0,0,0,0,-2,22284,22302,-18,-2,20232,20274,-42,-2,17567,17567,0,-2,20027,20027,0
3104,200000,160000,0,0,0,0,0,0,0,82617,3000,79617,0,83284,2500,80784,0,64520,3000,61520,0,54178,2000,52178
3105,20000,16000,0,1,1,1,0,0,0,19068,1681,17387,0,19642,1255,18387,0,27988,672,27316,0,1280,52,1228
3106,320000,256000,0,0,1,1,1,1,0,262825,10000,252825,0,268326,9876,258450,0,284625,20900,263725,0,290787,11000,279787
3107,200000,160000,0,0,0,0,0,0,-2,5628,5628,0,-1,5540,23,5517,0,16378,16378,0,0,4850,4850,0
3108,30000,24000,0,0,0,1,1,0,0,22929,1696,21233,0,25433,3200,22233,0,26228,1500,24728,2,25679,0,25679
3109,360000,288000,0,0,0,0,0,0,-1,640,640,0,-1,0,0,0,-1,0,0,0,-2,4750,4750,0
3110,80000,64000,0,1,0,1,1,0,0,69504,5002,64502,0,68262,4500,63762,0,70547,3000,67547,0,73040,3000,70040
3111,90000,72000,0,0,0,0,0,0,-1,179,179,0,-1,0,0,0,-1,0,0,0,-2,0,0,0
3112,390000,312000,0,0,0,0,0,0,0,290201,11000,279201,0,295606,11000,284606,0,300709,10656,290053,0,305904,11000,294904
3113,210000,168000,0,0,0,0,0,0,-1,4412,4425,-13,-1,2700,2708,-8,-1,3578,3588,-10,-1,4075,4087,-12
3114,200000,160000,0,0,0,0,0,0,-1,83,499,-416,-1,667,1000,-333,-1,251,0,251,0,-165,0,-165
3115,80000,64000,0,0,0,0,0,0,0,29995,1318,28677,0,27297,1200,26097,0,21524,2000,19524,0,23005,2000,21005
3116,240000,192000,0,0,0,0,0,0,-1,0,0,0,-1,4670,4670,0,-1,0,0,0,-1,0,0,0
3117,180000,144000,0,0,0,0,0,0,0,10771,1500,9271,0,11965,1431,10534,0,11903,369,11534,0,12769,1000,11769
3118,120000,96000,0,0,0,0,0,0,-2,7342,7492,-150,-1,7029,0,7029,2,7172,143,7029,0,7338,166,7172
3119,180000,144000,0,0,0,0,0,0,0,147042,5000,142042,0,127814,5000,122814,0,130331,4900,125431,0,132845,5000,127845
3120,50000,40000,0,0,0,0,0,0,-2,0,4,-4,-2,0,700,-700,-2,0,0,0,-2,0,0,0
3121,280000,224000,0,0,0,0,0,1,-1,3057,4585,-1528,-1,1333,0,1333,2,302,302,0,-1,5419,5419,0
3122,260000,208000,0,0,0,0,0,0,-1,782,782,0,-1,790,790,0,-1,849,849,0,-1,12319,12319,0
3123,160000,128000,0,0,0,0,0,0,-1,354,354,0,-1,355,1,354,0,47,48,-1,-1,605,906,-301
3124,500000,400000,0,0,0,0,0,0,0,92651,5140,87511,0,93725,3510,90215,0,95517,3461,92056,0,97581,3646,93935
3125,170000,136000,0,0,0,0,0,0,-1,1471,1471,0,-1,3398,3398,0,-1,1929,2,1927,0,11966,11966,0
3126,190000,152000,0,0,0,0,0,0,0,121378,4222,117156,0,75252,2705,72547,0,79028,5000,74028,0,81548,4000,77548
3127,260000,208000,0,0,0,0,0,0,0,27842,1305,26537,0,25366,1113,24253,0,19533,528,19005,0,14214,406,13808
3128,230000,184000,0,0,0,0,0,0,-1,517,667,-150,-1,53,0,53,2,603,700,-97,-1,10141,10200,-59
3129,270000,216000,0,0,0,0,0,0,0,59464,3000,56464,0,54715,3019,51696,0,51796,5000,46796,0,53256,5000,48256
3130,360000,288000,0,0,0,0,0,1,-1,-114,0,-114,-1,-200,0,-200,-2,-200,0,-200,-2,-200,0,-200
3131,70000,56000,0,0,0,0,0,1,0,48618,2500,46118,0,51134,3600,47534,0,50222,0,50222,2,48874,1754,47120
3132,110000,88000,0,0,0,0,0,0,-2,67912,2044,65868,-2,50994,2026,48968,-2,40652,2097,38555,-2,5785,1011,4774
3133,280000,224000,0,1,1,1,0,0,2,277026,10031,266995,0,280771,10021,270750,0,270992,7111,263881,0,111885,34,111851
3134,30000,24000,0,1,1,1,1,0,2,31380,3600,27780,2,30277,0,30277,2,30028,1100,28928,0,30198,1050,29148
3135,150000,120000,0,0,0,0,0,0,0,49746,10000,39746,0,51500,2900,48600,0,0,10000,-10000,0,0,0,0
3136,30000,24000,0,0,0,0,0,0,0,3617,1000,2617,0,3787,1200,2587,0,4820,2000,2820,0,914,914,0
3137,360000,288000,0,0,0,0,0,0,0,93753,3357,90396,0,87660,2973,84687,0,78206,2819,75387,0,70147,2468,67679
3138,50000,40000,0,1,1,1,1,1,2,45250,3000,42250,2,46003,1800,44203,2,44193,0,44193,2,44838,1500,43338
3139,270000,216000,0,0,0,0,0,0,0,69339,3000,66339,0,67497,2500,64997,0,68446,2435,66011,0,69799,3000,66799
3140,60000,48000,0,1,1,1,1,1,2,49857,1500,48357,2,50737,2000,48737,2,52602,3000,49602,2,53613,2000,51613
3141,90000,72000,0,0,0,0,0,0,2,10289,4000,6289,2,10816,1000,9816,2,11333,1000,10333,0,11997,1000,10997
3142,20000,16000,0,0,0,0,1,0,0,15133,0,15133,2,15582,1000,14582,0,16677,1500,15177,0,16259,0,16259
3143,130000,104000,0,0,0,0,0,0,-1,264,264,0,-1,264,264,0,-1,0,0,0,-1,678,942,-264
3144,20000,16000,0,0,0,1,1,1,0,15370,1300,14070,0,16411,1300,15111,0,16839,700,16139,0,17267,700,16567
3145,180000,144000,0,0,0,0,0,0,-1,0,0,0,-1,0,0,0,-2,0,0,0,-2,0,0,0
3146,140000,112000,0,0,0,0,0,0,0,13271,5004,8267,0,11243,1451,9792,0,12091,1000,11091,0,12691,1000,11691
3147,170000,136000,0,1,1,1,1,0,0,165597,7600,157997,0,163424,7800,155624,0,163204,6348,156856,0,159257,6200,153057
3148,30000,24000,0,0,0,0,0,0,-1,126,0,126,2,4462,4462,0,-1,0,0,0,-1,150,150,0
3149,310000,248000,0,0,0,0,0,0,2,225003,9950,215053,0,234185,17828,216357,0,222139,9,222130,2,224655,7951,216704
3150,320000,256000,0,0,0,0,0,1,2,215392,18300,197092,2,218370,8000,210370,2,220977,7700,213277,2,225021,7700,217321
3151,30000,24000,0,0,0,0,0,0,0,0,0,0,-2,0,0,0,-2,0,0,0,-2,0,0,0
3152,120000,96000,0,0,0,0,0,0,0,82451,3000,79451,0,84177,3100,81077,0,85945,3122,82823,0,87813,3300,84513
3153,50000,40000,0,0,0,0,0,0,0,6270,1000,5270,0,6000,120,5880,0,5810,200,5610,0,390,390,0
3154,50000,40000,0,1,1,0,0,0,0,49746,2084,47662,0,50365,1703,48662,0,35157,975,34182,0,19796,683,19113
3155,150000,120000,0,0,0,0,0,0,-1,11985,12005,-20,-1,24310,24322,-12,-1,17280,6000,11280,0,36986,37000,-14
3156,120000,96000,0,0,0,0,0,1,-2,0,0,0,-2,0,0,0,-2,0,0,0,-2,0,0,0
3157,50000,40000,0,0,1,1,1,0,-1,43085,5000,38085,-1,42093,0,42093,2,44393,3000,41393,0,45682,2000,43682
3158,50000,40000,0,1,0,0,0,1,0,50612,2449,48163,0,29975,1778,28197,0,30559,2382,28177,0,29433,0,29433
3159,60000,48000,0,0,0,0,0,1,0,30920,1759,29161,0,27817,1500,26317,0,26281,940,25341,0,26830,972,25858
3160,500000,400000,0,0,0,0,0,0,-1,9558,9570,-12,-1,7426,7432,-6,-1,11130,11130,0,-1,15382,10000,5382
3161,120000,96000,0,1,0,0,0,1,0,118684,5007,113677,0,88557,4000,84557,0,91124,4003,87121,0,88094,4003,84091
3162,360000,288000,0,0,0,0,0,0,-1,1480,1480,0,-1,2330,2330,0,-1,2286,2550,-264,-1,4385,3000,1385
3163,160000,128000,0,0,0,0,0,0,-1,1086,1086,0,-1,1874,1874,0,-1,2920,2920,0,-1,0,0,0
3164,310000,248000,0,1,0,0,0,0,0,265931,11200,254731,0,245884,10840,235044,0,200380,9361,191019,0,221201,5300,215901
3165,20000,16000,0,0,1,0,0,1,0,18300,2800,15500,0,18100,0,18100,0,-1900,0,-1900,0,0,1900,-1900
3166,400000,320000,0,0,0,0,0,0,-1,994,994,0,-1,5030,5030,0,-1,4568,0,4568,0,500,500,0
3167,50000,40000,0,1,0,0,0,0,0,46076,1685,44391,0,19092,659,18433,0,18227,658,17569,0,18285,656,17629
3168,220000,176000,0,0,0,0,0,1,0,29518,3000,26518,0,29569,6000,23569,0,28587,5000,23587,0,21201,1136,20065
3169,470000,376000,0,0,0,0,0,0,-2,-3,0,-3,-2,-3,0,-3,-2,352,355,-3,-2,0,0,0
3170,400000,320000,0,0,0,0,0,0,0,192054,42263,149791,0,20660,20663,-3,-1,18242,6020,12222,0,15609,3500,12109
3171,390000,312000,0,0,0,0,0,0,-1,17331,17375,-44,-1,78340,70077,8263,0,76892,15103,61789,0,57954,3290,54664
3172,110000,88000,0,0,0,0,0,0,0,40359,3007,37352,0,34533,3000,31533,0,36819,3000,33819,0,32467,3000,29467
3173,50000,40000,0,0,0,0,0,0,-2,0,0,0,-2,0,0,0,-2,0,0,0,-2,0,0,0
3174,100000,80000,0,0,0,0,1,0,0,77919,2854,75065,0,79597,3000,76597,0,88685,10400,78285,0,87773,600,87173
3175,100000,80000,0,0,0,0,0,0,-2,0,0,0,-2,1054,1054,0,-1,1230,1230,0,-1,1054,1054,0
3176,150000,120000,0,0,0,0,0,0,-2,8830,5000,3830,-2,16864,16864,0,-2,17199,18000,-801,-2,20025,20025,0
3177,150000,120000,0,0,0,0,0,0,0,19790,1850,17940,0,50123,101123,-51000,-1,45987,1650,44337,0,46555,1700,44855
3178,50000,40000,0,1,1,1,1,1,2,50006,1800,48206,2,48846,0,48846,2,45944,1624,44320,0,46925,1700,45225
3179,150000,120000,0,0,0,0,0,0,2,390,390,0,-1,1366,1366,0,-1,780,0,780,0,0,0,0
3180,480000,384000,0,0,0,0,0,0,-2,257,257,0,-2,1697,1697,0,-2,188,188,0,-2,22507,22507,0
3181,160000,128000,0,0,0,0,0,0,-2,0,0,0,-2,0,0,0,-2,0,0,0,-2,0,0,0
3182,240000,192000,0,0,0,0,0,0,0,0,0,0,0,1000,1000,0,-1,0,0,0,-1,167747,167747,0
3183,400000,320000,0,0,0,0,0,0,0,7716,3716,4000,0,12538,5000,7538,0,17305,5000,12305,0,22499,5668,16831
3184,30000,24000,0,1,0,0,0,0,0,28317,1431,26886,0,16454,483,15971,0,450,0,450,0,1400,700,700
3185,60000,48000,0,1,0,0,0,0,0,57183,1800,55383,0,24564,1000,23564,0,24155,1100,23055,0,25023,1200,23823
3186,200000,160000,0,0,0,0,0,0,0,71050,3000,68050,0,68967,3015,65952,0,47951,1600,46351,0,45519,1600,43919
3187,160000,128000,0,0,0,0,0,0,-2,1276,1276,0,-2,372,372,0,-2,372,372,0,-2,372,372,0
3188,200000,160000,0,0,0,0,0,0,-2,1144,1147,-3,-2,933,935,-2,-2,1207,1210,-3,-2,3149,3158,-9
3189,400000,320000,0,0,0,0,0,0,-1,72201,72356,-155,-1,199209,199209,0,-1,179290,411,178879,0,9780,0,9780
3190,230000,184000,0,0,0,0,0,0,-1,0,0,0,-1,2458,2458,0,-1,2458,0,2458,0,2458,0,2458
3191,450000,360000,0,0,0,0,0,0,-1,0,0,0,-2,0,0,0,-2,0,0,0,-2,0,0,0
3192,20000,16000,0,0,0,0,0,0,-1,8015,0,8015,2,3668,0,3668,0,3508,3508,0,-1,5278,5278,0
3193,150000,120000,0,1,0,0,0,0,2,134757,6203,128554,0,85874,2819,83055,0,84665,3109,81556,0,78130,2842,75288
3194,320000,256000,0,0,0,0,0,1,-1,-150,0,-150,-1,150,500,-350,-1,21565,21565,0,-1,4818,5000,-182
3195,180000,144000,0,0,0,0,0,1,0,6363,1000,5363,0,7363,1000,6363,0,3723,1000,2723,0,2645,500,2145
3196,50000,40000,0,1,0,0,0,1,0,49584,1600,47984,0,19791,700,19091,0,18518,670,17848,0,19078,866,18212
3197,30000,24000,0,1,0,0,1,0,0,28068,1288,26780,0,23362,982,22380,0,29837,32000,-2163,-1,30357,2000,28357
3198,50000,40000,0,0,0,0,0,0,0,27577,1481,26096,0,28528,1432,27096,0,28689,992,27697,0,29289,1027,28262
3199,210000,168000,0,0,0,0,0,0,-1,0,0,0,-1,0,0,0,-2,0,0,0,-2,0,0,0
3200,430000,344000,0,0,0,0,0,0,-1,336073,325470,10603,0,325463,20003,305460,0,38290,39068,-778,-1,21800,21800,0
3201,110000,88000,0,0,0,0,0,0,0,66068,2212,63856,0,61486,2100,59386,0,60695,2200,58495,0,58147,2200,55947
3202,360000,288000,0,0,0,0,0,1,-2,0,200,-200,-2,3000,3000,0,-1,0,0,0,-1,0,0,0
3203,200000,160000,0,0,0,0,0,1,-1,3030,1700,1330,2,1695,5,1690,2,10569,10624,-55,-1,9777,9816,-39
3204,130000,104000,0,0,0,0,0,1,0,8176,1500,6676,0,8884,1000,7884,0,9737,1000,8737,0,11404,2000,9404
3205,300000,240000,0,0,0,0,0,1,-1,360,360,0,-1,360,360,0,-1,980,980,0,-1,360,360,0
3206,290000,232000,0,0,0,0,0,0,-2,500,501,-1,-2,0,0,0,-2,0,0,0,-2,0,0,0
3207,500000,400000,0,1,1,1,0,0,0,414453,13670,400783,0,422168,13596,408572,0,423674,14454,409220,0,413326,33720,379606
3208,60000,48000,0,1,0,0,0,0,2,54087,2400,51687,0,37613,1316,36297,0,39038,2000,37038,0,37814,1531,36283
3209,80000,64000,0,0,0,0,0,0,2,8026,1088,6938,0,3878,1000,2878,0,3618,1000,2618,0,0,958,-958
3210,50000,40000,0,0,0,0,0,1,0,19207,1580,17627,0,18963,1000,17963,0,19741,1000,18741,0,19901,1500,18401
3211,230000,184000,0,0,0,0,0,0,-2,249,249,0,-1,0,0,0,-1,449,449,0,-1,1530,1530,0
3212,200000,160000,0,0,0,0,0,1,0,139282,4916,134366,0,138462,4505,133957,0,134497,4205,130292,0,126617,4145,122472
3213,50000,40000,0,0,0,0,0,0,2,19521,2000,17521,0,19247,807,18440,0,19816,1000,18816,0,20015,1000,19015
3214,170000,136000,0,1,1,1,1,0,0,166003,8000,158003,0,167287,6300,160987,0,165510,6000,159510,0,168507,6500,162007
3215,290000,232000,0,0,0,0,0,0,0,49979,2569,47410,0,36439,1532,34907,0,33231,987,32244,0,32131,1002,31129
3216,180000,144000,0,0,0,0,0,1,-2,0,0,0,-2,0,0,0,-2,0,0,0,-2,0,0,0
3217,80000,64000,0,0,0,0,0,1,0,10511,0,10511,2,11529,1200,10329,0,12332,1000,11332,0,13128,1000,12128
3218,140000,112000,0,0,0,0,0,0,0,56000,2000,54000,0,0,0,0,0,0,0,0,-2,0,0,0
3219,240000,192000,0,0,0,0,0,0,0,-4,0,-4,-2,-4,0,-4,-2,801,805,-4,-1,192850,192869,-19
3220,50000,40000,0,0,0,0,0,1,0,13957,1254,12703,0,16703,3000,13703,0,17052,617,16435,0,17391,621,16770
3221,50000,40000,0,0,0,0,0,0,0,15433,1469,13964,0,15037,463,14574,0,10527,381,10146,0,10736,383,10353
3222,240000,192000,0,0,0,0,0,0,0,129371,5000,124371,0,132218,5000,127218,0,136003,6000,130003,0,139798,6000,133798
3223,230000,184000,0,0,0,0,0,0,-1,11744,9359,2385,0,9359,0,9359,0,19002,19002,0,-1,8443,8740,-297
3224,60000,48000,0,0,0,0,0,0,0,13266,1029,12237,0,19876,19507,369,0,19274,1000,18274,0,17923,358,17565
3225,210000,168000,0,0,0,0,0,0,0,7906,2400,5506,0,5111,200,4911,0,2069,205,1864,0,0,0,0
3226,100000,80000,0,0,0,0,0,0,0,177,0,177,2,1170,1170,0,-1,390,0,390,0,0,0,0
3227,100000,80000,0,0,0,0,0,1,-1,1585,1589,-4,-1,-1,0,-1,-1,-1,0,-1,-2,2994,2995,-1
3228,230000,184000,0,0,0,0,0,1,0,61465,2158,59307,0,57637,2610,55027,0,58172,2022,56150,0,57560,2064,55496
3229,200000,160000,0,0,0,0,0,0,-1,2946,2946,0,-1,390,390,0,-1,390,390,0,-1,390,0,390
3230,110000,88000,0,1,1,1,1,1,0,91505,0,91505,2,98566,8600,89966,2,99700,3800,95900,2,97833,0,97833
3231,180000,144000,0,0,0,0,0,0,-2,0,0,0,-2,0,0,0,-2,0,0,0,-2,0,0,0
3232,140000,112000,0,1,1,1,0,1,0,135494,4912,130582,0,136679,3781,132898,0,130812,2500,128312,0,67349,3000,64349
3233,140000,112000,0,1,0,0,0,1,0,141805,10000,131805,0,26141,5000,21141,0,7373,6000,1373,0,81185,76000,5185
3234,50000,40000,0,0,0,0,0,1,0,36263,1918,34345,0,37061,1700,35361,0,37943,1500,36443,0,42305,5000,37305
3235,50000,40000,0,0,1,0,0,0,-2,47714,50224,-2510,-1,48685,2195,46490,0,18139,649,17490,0,18519,672,17847
3236,250000,200000,0,0,0,0,0,0,-1,1536,1536,0,-1,1010,1010,0,-1,5572,5572,0,-1,794,794,0
3237,320000,256000,0,0,0,0,0,0,-1,3345,3398,-53,-1,1104,1104,0,-1,82434,82434,0,-1,82319,0,82319
3238,210000,168000,0,0,0,0,0,1,0,58338,1897,56441,0,59529,1936,57593,0,60720,1952,58768,0,61980,2013,59967
3239,50000,40000,0,0,0,0,0,1,2,19499,0,19499,2,21578,2385,19193,2,20940,0,20940,2,22605,2000,20605
3240,200000,160000,0,0,0,0,0,0,-2,0,218,-218,-2,23648,23648,0,-2,575,575,0,-2,847,847,0
3241,150000,120000,0,0,0,0,0,0,0,60254,2200,58054,0,59604,2300,57304,0,60707,2213,58494,0,61988,2300,59688
3242,70000,56000,0,1,0,0,0,0,0,68750,3100,65650,0,59186,7172,52014,0,48178,10000,38178,0,46197,1662,44535
3243,200000,160000,0,0,0,0,0,0,-1,8187,8187,0,-1,1261,1261,0,-1,1261,1261,0,-1,1261,1261,0
3244,210000,168000,0,0,0,0,0,0,-2,0,0,0,-2,150,150,0,-1,150,150,0,-1,150,150,0
3245,30000,24000,0,0,0,0,0,0,-1,15685,15685,0,-1,5476,5827,-351,-1,0,0,0,-1,0,0,0
3246,590000,472000,0,0,0,0,0,0,0,127961,5693,122268,0,128112,6007,122105,0,128798,5013,123785,0,128467,4701,123766
3247,150000,120000,0,0,0,0,0,0,-1,12515,13000,-485,-1,10749,12006,-1257,-1,7549,7000,549,0,5749,0,5749
3248,320000,256000,0,0,0,0,0,0,-2,360,360,0,-2,360,360,0,-2,0,0,0,-2,720,720,0
3249,30000,24000,0,1,0,0,0,0,2,29235,1600,27635,0,14040,1000,13040,0,500,0,500,0,22292,22292,0
3250,400000,320000,0,0,0,0,0,0,-2,389,390,-1,-2,320,321,-1,-2,14185,14255,-70,-2,389,390,-1
3251,10000,8000,0,1,1,0,0,1,2,9802,1000,8802,2,8450,0,8450,2,4060,1000,3060,0,0,900,-900
3252,50000,40000,0,0,0,0,0,0,0,35063,0,35063,2,36176,2000,34176,0,38269,3000,35269,0,37521,0,37521
3253,360000,288000,0,0,0,0,0,0,0,234192,7300,226892,0,190211,5800,184411,0,173557,5600,167957,0,146511,5600,140911
3254,240000,192000,0,0,0,0,0,0,-1,20740,19000,1740,0,21274,2624,18650,0,888,888,0,-1,360,360,0
3255,360000,288000,0,0,0,0,0,0,-1,11850,11850,0,-1,12533,13898,-1365,-1,7477,7477,0,-1,7718,7718,0
3256,280000,224000,0,0,0,0,0,0,0,44598,1369,43229,0,38322,3002,35320,0,38255,3005,35250,0,31427,1505,29922
3257,90000,72000,0,0,0,0,0,0,-1,400,0,400,2,0,0,0,2,950,950,0,-1,400,0,400
3258,50000,40000,0,1,1,1,1,0,0,48349,2426,45923,0,46192,2100,44092,0,45272,1600,43672,0,46230,2000,44230
3259,400000,320000,0,0,0,0,0,0,-2,0,0,0,-2,0,0,0,-2,45374,45374,0,-1,46306,1113,45193
3260,240000,192000,0,0,0,0,0,0,-2,697,700,-3,-2,-3,0,-3,-2,635,638,-3,-2,1269,1275,-6
3261,180000,144000,0,0,0,0,0,0,-2,392,392,0,-2,1592,1596,-4,-2,1304,1308,-4,-2,8,0,8
3262,120000,96000,0,0,0,0,0,0,-2,0,0,0,-2,0,0,0,-2,0,0,0,-2,0,0,0
3263,150000,120000,0,0,0,0,0,0,-1,-31,0,-31,-1,-31,0,-31,-2,-31,0,-31,-2,-31,0,-31
3264,180000,144000,0,1,1,1,1,1,2,179230,0,179230,2,181763,7000,174763,0,180019,7000,173019,0,171711,6150,165561
3265,150000,120000,0,0,0,0,0,0,0,100826,5002,95824,0,103297,5189,98108,0,111784,14002,97782,0,108887,8,108879
3266,220000,176000,0,0,0,0,0,0,0,165222,8100,157122,0,168145,8200,159945,0,169162,6000,163162,0,172041,6200,165841
3267,60000,48000,0,0,0,0,0,0,-2,0,0,0,-2,0,0,0,-2,982,982,0,-1,832,0,832
3268,400000,320000,0,0,0,0,0,1,3,269528,0,269528,2,269278,150,269128,0,269278,0,269278,0,1976,3355,-1379
3269,70000,56000,0,0,0,0,0,0,0,48867,2300,46567,0,47808,2300,45508,0,43022,2000,41022,0,44077,1900,42177
3270,130000,104000,0,0,0,0,0,0,0,44577,1711,42866,0,45013,1587,43426,0,45695,1823,43872,0,46283,1956,44327
3271,180000,144000,0,0,0,0,0,0,-1,2700,2700,0,-1,12000,12000,0,-1,0,0,0,-1,1995,1995,0
3272,70000,56000,0,0,0,0,0,0,-2,6389,6405,-16,-2,0,0,0,-2,0,0,0,-2,0,0,0
3273,30000,24000,0,0,1,0,0,0,0,26143,3002,23141,0,26929,2130,24799,0,19610,2,19608,2,20591,3004,17587
3274,80000,64000,0,0,0,0,0,0,2,47168,3667,43501,2,45312,0,45312,2,46263,1680,44583,0,47341,1848,45493
3275,350000,280000,0,0,0,0,0,0,-2,23907,23916,-9,-1,28528,25528,3000,0,24965,2965,22000,0,5727,5753,-26
3276,50000,40000,0,0,0,0,0,0,0,17918,2000,15918,0,16072,1000,15072,0,17041,2000,15041,0,19028,2396,16632
3277,240000,192000,0,0,0,0,0,0,0,187841,8123,179718,0,186140,6700,179440,0,191678,10000,181678,0,191816,7700,184116
3278,20000,16000,1,1,1,1,1,1,7,23214,0,23214,6,22583,0,22583,5,21662,0,21662,4,21031,0,21031
3279,210000,168000,0,0,0,0,0,0,-1,1443,1443,0,-1,1443,1443,0,-1,1443,1443,0,-1,1443,1443,0
3280,320000,256000,0,0,0,0,0,0,-2,6992,6992,0,-2,3741,3755,-14,-2,10138,10138,0,-2,15745,15745,0
3281,50000,40000,0,0,0,0,0,0,0,7358,7000,358,0,2912,2900,12,0,2881,2500,381,0,553,400,153
3282,80000,64000,0,0,0,0,0,1,0,0,0,0,0,0,0,0,-2,0,0,0,-2,0,0,0
3283,20000,16000,0,1,1,1,1,0,0,18957,2000,16957,0,19334,666,18668,0,19373,714,18659,0,19460,810,18650
3284,240000,192000,0,0,0,0,0,1,-2,0,0,0,-2,0,0,0,-2,0,0,0,-2,1306,1306,0
3285,170000,136000,0,0,0,0,0,0,0,78440,3000,75440,0,80141,3000,77141,0,81862,3000,78862,0,84237,4000,80237
3286,20000,16000,0,1,1,1,1,1,2,18880,0,18880,2,22215,4613,17602,2,20638,0,20638,4,19342,0,19342
3287,340000,272000,0,0,0,0,0,0,-1,44092,39774,4318,0,31292,43325,-12033,-1,17391,5000,12391,0,21678,10000,11678
3288,150000,120000,0,0,0,0,0,1,0,98795,4275,94520,0,98925,3550,95375,0,100017,3750,96267,0,99607,3600,96007
3289,30000,24000,0,1,1,1,1,0,0,28478,3000,25478,0,27754,0,27754,2,28186,1001,27185,0,30240,2500,27740
3290,50000,40000,0,1,1,0,0,0,0,47162,2316,44846,0,47696,1850,45846,0,36476,1500,34976,0,32654,1200,31454
3291,30000,24000,1,1,1,1,1,0,3,31091,0,31091,2,31002,2300,28702,2,29879,0,29879,2,29382,996,28386
3292,50000,40000,0,0,0,0,0,0,0,21897,2000,19897,0,23404,2000,21404,0,0,0,0,0,0,0,0
3293,200000,160000,0,0,0,0,0,0,-1,0,0,0,-1,489,489,0,-1,320,320,0,-1,732,732,0
3294,20000,16000,0,0,0,0,0,1,0,7846,1500,6346,0,10715,3000,7715,0,10406,0,10406,4,9953,0,9953
3295,50000,40000,0,0,0,0,0,0,0,27520,1723,25797,0,25928,1100,24828,0,26470,1111,25359,0,27077,1200,25877
3296,50000,40000,0,0,0,0,0,0,0,30356,1600,28756,0,31342,1498,29844,0,32644,2627,30017,0,32719,1400,31319
3297,30000,24000,0,1,1,1,1,1,3,28286,1000,27286,2,27533,0,27533,2,28189,1100,27089,0,28805,1100,27705
3298,200000,160000,0,0,0,0,0,0,0,5117,2117,3000,0,6877,1877,5000,0,7504,1504,6000,0,8148,1148,7000
3299,30000,24000,0,1,1,0,0,1,2,30199,2000,28199,0,30010,2000,28010,0,24660,1500,23160,0,22042,2000,20042
3300,240000,192000,0,0,0,0,0,1,-1,0,0,0,-2,0,0,0,-2,0,0,0,-2,0,0,0
3301,20000,16000,0,0,0,0,0,0,-1,11094,2679,8415,0,9351,502,8849,0,8562,224,8338,0,8058,513,7545
3302,240000,192000,0,0,0,0,0,0,0,159998,8000,151998,0,161434,7000,154434,0,163403,6000,157403,0,167230,8000,159230
3303,90000,72000,0,0,0,0,0,0,0,29564,1774,27790,0,29710,920,28790,0,29700,1102,28598,0,0,4014,-4014
3304,100000,80000,0,0,0,0,0,0,-1,652,652,0,-1,326,0,326,0,326,326,0,-1,326,326,0
3305,50000,40000,0,0,0,0,0,0,0,39877,44447,-4570,-1,28471,2202,26269,0,29309,2004,27305,0,28409,1202,27207
3306,70000,56000,1,1,1,0,0,0,0,86287,3000,83287,0,65287,2000,63287,0,35345,3000,32345,0,9360,5000,4360
3307,110000,88000,0,0,0,0,0,0,-1,5050,5050,0,-1,63032,63032,0,-1,33228,1100,32128,0,31073,1100,29973
3308,80000,64000,0,0,0,0,0,1,0,22227,4000,18227,0,48215,50012,-1797,-1,45618,10000,35618,0,37799,10000,27799
3309,130000,104000,0,1,1,1,1,0,0,120889,5000,115889,0,118293,5000,113293,0,121312,5000,116312,0,121162,5000,116162
3310,50000,40000,0,0,0,0,0,0,0,29500,1435,28065,0,28914,1149,27765,0,29529,1197,28332,0,29319,1009,28310
3311,20000,16000,0,0,0,0,0,0,0,13702,3234,10468,0,14713,1245,13468,0,15068,600,14468,0,15425,600,14825
3312,260000,208000,0,0,0,0,0,0,-2,355,355,0,-1,2165,2835,-670,-1,2165,335,1830,-2,0,335,-335
3313,50000,40000,0,0,0,0,0,1,0,35920,1253,34667,0,19987,2504,17483,0,18971,1004,17967,0,18654,1509,17145
3314,30000,24000,0,1,1,1,1,0,0,27064,3000,24064,0,27884,2000,25884,0,29190,2000,27190,0,25789,1069,24720
3315,260000,208000,0,0,0,0,0,1,0,1076,1076,0,-1,696,0,696,0,1012,1012,0,-1,530,530,0
3316,180000,144000,0,1,1,0,0,0,-2,181255,7017,174238,-2,174825,8201,166624,-2,140909,8246,132663,-2,177257,186732,-9475
3317,150000,120000,0,0,0,0,0,0,0,79726,3048,76678,0,76986,4000,72986,0,78038,3500,74538,0,78321,3000,75321
3318,500000,400000,0,0,0,0,0,0,-2,552,552,0,-2,6360,6360,0,-2,0,0,0,-2,6054,6054,0
3319,150000,120000,0,1,1,1,1,0,0,144947,3825,141122,0,140696,3361,137335,0,143607,3469,140138,0,136575,3812,132763
3320,110000,88000,0,0,0,0,0,0,0,10466,2007,8459,0,3537,1000,2537,0,1378,0,1378,0,316,316,0
3321,300000,240000,0,0,0,0,0,0,0,70306,3500,66806,0,99217,30049,69168,0,142188,50000,92188,0,145013,5200,139813
3322,420000,336000,0,0,0,0,0,0,-1,33433,33595,-162,-1,28468,16000,12468,0,35669,36625,-956,-1,23317,23317,0
3323,160000,128000,0,0,0,0,0,0,-2,396,396,0,-2,396,396,0,-2,396,396,0,-2,1353,1353,0
3324,120000,96000,0,0,0,1,1,1,0,79570,5000,74570,0,106523,30000,76523,0,108614,3900,104714,2,107519,4000,103519
3325,190000,152000,0,0,0,0,0,0,-1,3527,3562,-35,-1,3869,3869,0,-1,4468,4468,0,-1,-12,12,-24
3326,140000,112000,0,0,0,0,0,0,-1,7541,7541,0,-1,10661,10661,0,-1,2214,2214,0,-1,6020,6020,0
3327,50000,40000,0,0,0,0,0,1,0,8681,1169,7512,0,8039,1000,7039,0,4952,4986,-34,-1,390,390,0
3328,360000,288000,0,0,0,0,0,0,0,3794,4294,-500,-2,8521,8535,-14,-2,7119,1535,5584,-2,5725,5753,-28
3329,280000,224000,0,0,0,0,0,1,-1,1196,1245,-49,-1,19875,19875,0,-1,599,599,0,-1,850,850,0
3330,600000,480000,0,0,0,0,0,0,-1,23471,23537,-66,-1,30871,31171,-300,-1,17314,17348,-34,-1,10000,10000,0
3331,100000,80000,0,0,0,0,0,0,0,46686,2500,44186,0,44497,3000,41497,0,44674,2000,42674,0,42653,5000,37653
3332,50000,40000,0,0,0,0,0,1,2,23700,1600,22100,2,24016,1000,23016,2,23332,0,23332,2,24849,1896,22953
3333,80000,64000,0,0,0,0,0,0,0,27543,3024,24519,0,51180,1200,49980,0,27017,2000,25017,0,28560,2000,26560
3334,210000,168000,0,0,0,0,0,1,0,34174,1846,32328,0,34141,1209,32932,0,34456,1248,33208,0,34737,1247,33490
3335,80000,64000,0,0,0,0,0,1,0,49814,2500,47314,0,45292,2010,43282,0,43190,2000,41190,0,39457,2000,37457
3336,200000,160000,0,0,0,0,0,0,0,58998,2200,56798,0,60219,2200,58019,0,61748,2500,59248,0,64220,3500,60720
3337,230000,184000,0,0,0,0,0,0,0,1000,1000,0,-1,0,0,0,-1,0,0,0,-2,0,0,0
3338,280000,224000,0,0,0,0,0,1,0,86472,4700,81772,2,87457,3300,84157,2,88281,3150,85131,2,86749,0,86749
3339,200000,160000,0,0,0,0,0,0,-1,1669,1669,0,-1,142,144,-2,-1,1100,1100,0,-1,6861,6861,0
3340,90000,72000,0,0,0,0,0,0,-1,0,0,0,-2,0,0,0,-2,0,0,0,-2,0,0,0
3341,500000,400000,0,0,0,0,0,0,0,91805,3200,88605,0,76152,2766,73386,0,62783,2100,60683,0,44422,1703,42719
3342,160000,128000,0,0,0,0,0,0,0,6000,6000,0,-2,15866,15866,0,-1,4168,4168,0,-1,2067,2067,0
3343,50000,40000,0,0,0,0,0,1,0,37701,0,37701,2,28181,1300,26881,0,28711,1100,27611,0,29368,1100,28268
3344,50000,40000,0,0,0,0,0,0,2,34686,0,34686,2,39097,5000,34097,2,38171,0,38171,2,39396,2000,37396
3345,300000,240000,0,0,0,0,0,0,-1,0,0,0,-1,0,0,0,-2,0,0,0,-2,0,0,0
3346,180000,144000,0,0,0,0,0,0,-1,166,166,0,-1,6988,6822,166,0,6822,466,6356,0,466,0,466
3347,140000,112000,0,0,0,0,0,0,0,16459,1286,15173,0,14753,1476,13277,0,13437,423,13014,0,14745,3000,11745
3348,180000,144000,0,0,0,0,0,1,2,101204,3582,97622,2,98680,0,98680,2,100644,3605,97039,0,102750,3731,99019
3349,80000,64000,0,0,0,0,0,1,-1,32320,32320,0,-1,0,0,0,-1,0,0,0,-2,0,0,0
3350,20000,16000,0,1,1,0,0,0,0,18127,1600,16527,0,18605,1030,17575,0,16351,1000,15351,0,16928,1000,15928
3351,500000,400000,0,0,0,0,0,0,-1,110704,35000,75704,0,99984,10000,89984,0,71135,10000,61135,0,56594,2430,54164
3352,420000,336000,0,1,1,1,1,1,0,388363,15522,372841,0,390003,14000,376003,0,398229,14500,383729,0,409615,18007,391608
3353,430000,344000,0,0,0,0,0,0,0,44848,10002,34846,0,39219,2000,37219,0,32008,5000,27008,0,19397,2000,17397
3354,100000,80000,0,0,0,0,0,0,0,22576,10000,12576,0,18247,1500,16747,0,22029,4000,18029,0,19540,5000,14540
3355,450000,360000,0,0,0,0,0,1,0,152936,11000,141936,0,150996,11000,139996,0,149094,11000,138094,0,147297,11000,136297
3356,230000,184000,0,0,0,0,0,0,0,118467,6000,112467,0,108826,4000,104826,0,100862,4000,96862,0,92481,3500,88981
3357,80000,64000,0,1,1,1,0,1,2,78772,0,78772,2,76818,2000,74818,0,70319,3000,67319,0,-1560,0,-1560
3358,30000,24000,0,0,0,1,1,1,2,23578,2000,21578,0,25871,3000,22871,0,26143,1000,25143,0,26724,1000,25724
3359,200000,160000,0,0,0,0,0,0,-2,8264,9288,-1024,-1,7776,0,7776,0,2814,2814,0,-1,2610,2610,0
3360,180000,144000,0,0,0,0,0,1,2,16915,500,16415,2,17532,1200,16332,2,18429,1500,16929,0,20126,2000,18126
3361,100000,80000,0,0,0,0,0,0,-1,586,586,0,-1,3195,3195,0,-1,3732,3732,0,-1,42605,42605,0
3362,200000,160000,0,0,0,0,0,0,0,20289,2000,18289,0,43432,31162,12270,0,149388,157142,-7754,-1,136192,10418,125774
3363,80000,64000,0,0,0,0,0,0,0,11885,1435,10450,0,8254,1350,6904,0,5144,5144,0,-1,15365,15365,0
3364,360000,288000,0,0,0,0,0,0,-2,0,0,0,-2,0,0,0,-2,0,0,0,-2,0,0,0
3365,30000,24000,0,1,1,1,1,0,0,29012,1500,27512,0,29754,1200,28554,0,30211,1300,28911,0,29853,1500,28353
3366,200000,160000,1,1,1,1,1,0,0,203592,0,203592,2,194238,7000,187238,0,192451,7350,185101,0,196355,7300,189055
3367,50000,40000,0,0,0,0,0,1,7,36238,0,36238,6,36374,1000,35374,5,35229,0,35229,4,34365,0,34365
3368,50000,40000,0,1,1,1,1,0,0,45047,3160,41887,0,45632,1740,43892,0,46535,1748,44787,0,47351,1650,45701
3369,70000,56000,0,0,0,0,0,0,-2,42935,48323,-5388,-1,28346,0,28346,2,27279,2001,25278,0,28976,3000,25976
3370,90000,72000,0,1,0,0,0,0,2,83949,2549,81400,0,47118,1583,45535,0,44942,1444,43498,0,45886,1500,44386
3371,140000,112000,0,0,0,0,0,0,-1,7936,2000,5936,0,13194,5600,7594,0,5692,0,5692,2,8410,3002,5408
3372,480000,384000,0,0,0,0,0,0,0,300134,30000,270134,0,315067,20000,295067,0,321825,12000,309825,0,328781,12500,316281
3373,280000,224000,0,1,0,0,0,0,2,280882,7500,273382,2,218619,0,218619,2,201679,6500,195179,0,195934,7000,188934
3374,500000,400000,0,0,0,0,0,0,-1,2122,2133,-11,-1,34159,34313,-154,-1,3340,17,3323,0,24752,24875,-123
3375,390000,312000,0,0,0,0,0,0,0,47532,5006,42526,0,49414,5006,44408,0,51380,5008,46372,0,50661,3004,47657
3376,50000,40000,0,0,0,0,0,1,0,26953,1500,25453,0,27860,1376,26484,0,28420,936,27484,0,29045,1000,28045
3377,50000,40000,0,0,0,0,0,0,0,31900,4400,27500,0,31090,0,31090,2,31837,1400,30437,0,32555,1400,31155
3378,30000,24000,0,0,0,0,0,0,-1,1972,1972,0,-1,182,183,-1,-1,0,0,0,-1,0,0,0
3379,90000,72000,0,1,1,1,1,1,2,89939,0,89939,2,91176,3656,87520,0,91331,7100,84231,0,87588,0,87588
3380,230000,184000,0,0,0,0,0,0,-2,2418,3588,-1170,-2,1428,1428,0,-2,4398,4398,0,-2,5748,5748,0
3381,450000,360000,0,0,0,0,0,0,0,62223,2528,59695,0,65522,10179,55343,0,61413,10013,51400,0,63547,5183,58364
3382,150000,120000,0,0,0,0,0,0,-2,88831,40146,48685,-2,1931,1941,-10,-2,26265,26396,-131,-2,0,0,0
3383,220000,176000,0,0,0,0,0,0,-2,-3322,23000,-26322,-2,-3322,0,-3322,-2,-3622,0,-3622,-2,-2852,3000,-5852
3384,110000,88000,0,1,0,0,0,0,0,103276,4431,98845,0,67886,2700,65186,0,39457,1500,37957,0,39424,1500,37924
3385,50000,40000,0,1,1,1,1,1,2,47619,4000,43619,2,46455,0,46455,2,47432,1432,46000,0,48442,3100,45342
3386,30000,24000,0,1,1,1,1,0,4,29721,0,29721,4,28961,0,28961,3,29397,1200,28197,2,29988,1200,28788
3387,100000,80000,0,0,0,0,0,0,2,11166,4250,6916,2,10099,0,10099,2,10861,1209,9652,2,9932,0,9932
3388,200000,160000,0,0,0,0,0,0,0,144302,5141,139161,0,137700,5032,132668,0,135443,9400,126043,0,128229,4400,123829
3389,270000,216000,1,1,1,0,0,0,0,308133,13000,295133,0,263516,12000,251516,0,94062,5000,89062,0,92618,4000,88618
3390,50000,40000,0,0,0,0,0,0,2,21678,4351,17327,2,21032,0,21032,2,21465,784,20681,0,24103,3000,21103
3391,20000,16000,1,1,0,0,0,0,0,21774,1200,20574,0,10707,378,10329,0,10539,389,10150,0,10757,400,10357
3392,180000,144000,0,0,0,0,0,1,-1,1981,1981,0,-1,4241,4241,0,-1,4542,4542,0,-1,5261,5261,0
3393,320000,256000,0,1,1,0,0,1,0,324589,10000,314589,2,320622,450,320172,2,252323,7025,245298,0,253557,7161,246396
3394,260000,208000,0,0,0,0,0,1,-1,-3098,20,-3118,-1,11377,50000,-38623,-1,0,0,0,-1,0,0,0
3395,90000,72000,0,0,0,0,0,1,0,73870,3000,70870,0,58792,2205,56587,0,58402,2300,56102,0,59633,2300,57333
3396,50000,40000,0,1,0,0,0,1,0,49063,2343,46720,0,16908,1178,15730,0,13112,654,12458,0,2280,2280,0
3397,200000,160000,0,0,0,0,0,0,-2,10430,10671,-241,-2,3576,3576,0,-2,2522,2522,0,-2,934,934,0
3398,560000,448000,0,0,0,0,0,0,0,23991,1446,22545,0,15488,14720,768,0,12579,427,12152,0,11400,1000,10400
3399,200000,160000,0,0,0,0,0,0,-2,0,0,0,-2,0,0,0,-2,67052,67052,0,-1,0,0,0
3400,40000,32000,0,1,1,1,1,1,2,35800,0,35800,2,36839,2000,34839,0,35967,2000,33967,0,36586,3000,33586
3401,350000,280000,0,0,0,0,0,0,0,224591,7957,216634,0,255247,35300,219947,0,259512,9247,250265,0,283724,29459,254265
3402,50000,40000,0,0,0,0,0,0,2,13962,1500,12462,2,13440,0,13440,2,14416,1200,13216,2,14043,0,14043
3403,30000,24000,0,0,0,0,0,1,2,21165,1646,19519,0,21281,762,20519,0,22938,2000,20938,0,22422,0,22422
3404,130000,104000,0,0,0,0,0,0,0,91200,2270,88930,0,45400,0,45400,0,0,0,0,0,0,0,0
3405,500000,400000,0,0,0,0,0,0,-1,2312,2321,-9,-1,2928,2928,0,-1,0,0,0,-1,0,0,0
3406,400000,320000,0,0,0,0,0,0,-2,3328,6656,-3328,-2,3328,3328,0,-2,3828,3828,0,-2,4893,4893,0
3407,180000,144000,0,0,0,0,0,1,-1,52687,0,52687,2,52096,2000,50096,0,51508,2000,49508,0,50867,2000,48867
3408,80000,64000,0,1,1,0,0,0,0,74050,3000,71050,0,73361,2700,70661,0,56966,2000,54966,0,59130,5000,54130
3409,80000,64000,0,0,0,0,0,0,-1,0,652,-652,-2,652,652,0,-1,0,0,0,-1,326,326,0
3410,200000,160000,0,0,0,0,0,0,-2,1981,2059,-78,-2,3959,3978,-19,-2,5382,5403,-21,-1,0,0,0
3411,80000,64000,0,0,0,0,0,0,0,43261,2000,41261,0,44537,2000,42537,0,45794,2000,43794,0,47893,3000,44893
3412,50000,40000,0,1,0,0,0,0,0,50004,2170,47834,0,17751,617,17134,0,17725,631,17094,0,17688,635,17053
3413,200000,160000,0,0,0,0,0,1,0,81890,4000,77890,0,0,0,0,0,0,0,0,-2,0,0,0
3414,320000,256000,0,0,0,0,0,0,0,101849,4364,97485,0,92474,18000,74474,0,95279,4000,91279,0,77536,2576,74960
3415,250000,200000,0,0,0,0,0,0,0,137119,5000,132119,0,141367,5847,135520,0,133174,5000,128174,0,136481,5000,131481
3416,30000,24000,0,1,1,1,1,0,0,29765,3600,26165,0,28933,0,28933,2,29205,978,28227,0,29630,2300,27330
3417,50000,40000,0,0,0,0,0,1,2,20039,0,20039,2,20042,700,19342,0,20097,750,19347,0,20288,900,19388
3418,200000,160000,0,0,0,0,0,0,-1,4318,4351,-33,-1,1640,1654,-14,-2,6614,6614,0,-1,707,707,0
3419,160000,128000,0,0,0,0,0,0,0,86019,3500,82519,0,87990,3500,84490,0,87186,4000,83186,0,84373,3500,80873
3420,20000,16000,0,0,0,0,0,1,-1,390,390,0,-1,21515,10728,10787,-1,2942,59,2883,0,0,0,0
3421,400000,320000,0,0,0,0,0,0,0,13810,6000,7810,0,18230,10000,8230,0,25050,10000,15050,0,10209,5000,5209
3422,70000,56000,0,1,1,0,0,1,0,67488,3100,64388,0,58246,2200,56046,0,48859,1600,47259,0,46688,1850,44838
3423,170000,136000,0,0,0,0,0,0,0,15437,3437,12000,0,13838,2115,11723,0,14915,2920,11995,0,10090,1500,8590
3424,30000,24000,0,0,0,0,0,0,0,18524,2000,16524,0,19923,2000,17923,2,19305,0,19305,2,20994,2000,18994
3425,80000,64000,0,0,0,0,0,0,0,12339,1235,11104,0,11312,1101,10211,0,8324,270,8054,0,7079,1000,6079
3426,280000,224000,0,0,0,0,0,0,0,101651,5000,96651,0,103776,3800,99976,0,105617,3500,102117,0,107788,3500,104288
3427,50000,40000,0,0,0,0,0,0,0,18919,1675,17244,0,24227,15000,9227,0,25229,2610,22619,0,12150,0,12150
3428,210000,168000,0,0,0,0,0,0,0,-18,0,-18,-2,-18,0,-18,-2,-18,0,-18,-2,-18,0,-18
3429,180000,144000,0,0,0,0,0,0,0,19917,12000,7917,0,22659,12659,10000,0,16114,10000,6114,0,15587,9000,6587
3430,300000,240000,0,0,0,0,0,1,-1,1000,1000,0,-1,1000,1000,0,-1,2000,2000,0,-1,1000,1000,0
3431,290000,232000,0,0,0,0,0,0,-1,21429,21542,-113,-1,2228,2239,-11,-1,156721,156733,-12,-1,157203,7219,149984
3432,20000,16000,0,1,1,1,1,0,0,17781,1282,16499,0,17289,700,16589,0,17710,700,17010,0,18217,800,17417
3433,30000,24000,1,1,1,1,1,1,4,30937,0,30937,3,29999,6,29993,2,29214,1054,28160,0,29846,1111,28735
3434,50000,40000,0,0,0,0,0,0,0,15694,1700,13994,0,16431,1300,15131,0,17056,900,16156,0,17581,800,16781
3435,50000,40000,0,1,1,0,0,1,0,48540,2007,46533,0,48355,1822,46533,0,18184,651,17533,0,18591,700,17891
3436,80000,64000,0,0,0,0,0,1,2,7039,1416,5623,0,7595,943,6652,0,7053,100,6953,2,7082,443,6639
3437,20000,16000,0,0,0,0,0,1,2,6920,1638,5282,2,6911,251,6660,2,6655,0,6655,2,7191,647,6544
3438,80000,64000,0,0,0,0,0,0,0,26686,2000,24686,0,28372,2000,26372,0,28345,3000,25345,0,27279,5000,22279
3439,210000,168000,0,0,0,0,0,0,0,135322,0,135322,2,136339,4546,131793,0,143681,9524,134157,0,140425,2,140423
3440,80000,64000,0,0,0,0,0,0,0,15674,15674,0,-1,-1,0,-1,-1,-1,0,-1,-2,-1,0,-1
3441,310000,248000,0,1,0,0,0,1,0,270591,9672,260919,0,252989,8826,244163,0,225814,8100,217714,0,231165,9000,222165
3442,310000,248000,0,0,0,0,0,1,-1,0,200,-200,-1,0,0,0,-2,6960,6960,0,-1,6008,6008,0
3443,500000,400000,0,0,0,0,0,0,-2,7570,7570,0,-2,1576,1576,0,-2,0,0,0,-2,13295,13295,0
3444,210000,168000,0,0,0,0,0,0,0,0,0,0,0,0,0,0,-2,0,0,0,-2,0,0,0
3445,70000,56000,0,0,0,0,0,0,0,56925,2000,54925,0,28421,3000,25421,0,8706,1100,7606,0,29275,28000,1275
3446,360000,288000,0,0,0,0,0,0,-2,11609,11624,-15,-2,10070,10070,0,-2,5079,5079,0,-2,4086,4086,0
3447,320000,256000,0,0,0,0,0,0,0,0,0,0,0,0,0,0,-2,589,589,0,-1,-4543,0,-4543
3448,190000,152000,0,1,1,1,1,0,0,193400,7222,186178,0,193278,7300,185978,0,192956,7100,185856,0,193039,7380,185659
3449,230000,184000,0,0,0,0,0,0,0,172056,7500,164556,0,172615,6500,166115,0,174555,6500,168055,0,177010,7000,170010
3450,20000,16000,0,0,0,0,0,1,0,4050,1068,2982,0,4129,147,3982,0,4367,304,4063,0,4613,467,4146
3451,130000,104000,0,0,0,0,0,1,2,52993,2000,50993,2,51546,0,51546,2,52663,2100,50563,0,53737,2100,51637
3452,90000,72000,0,1,1,0,0,0,0,89053,3096,85957,0,82623,4000,78623,0,70740,3000,67740,0,69237,2829,66408
3453,50000,40000,0,0,0,0,0,0,0,11597,1553,10044,0,6611,7511,-900,-1,7349,1000,6349,0,7570,343,7227
3454,200000,160000,0,0,0,0,0,0,0,13249,13000,249,0,22319,10000,12319,0,17279,5000,12279,0,9853,5000,4853
3455,50000,40000,0,0,0,0,0,0,0,28924,1485,27439,0,29521,1472,28049,0,29876,1217,28659,0,30201,1347,28854
3456,220000,176000,0,0,0,0,0,0,2,1066,1066,0,-1,2404,2404,0,-1,1338,0,1338,0,19082,19082,0
3457,150000,120000,0,0,0,0,0,0,-1,669,669,0,-1,0,0,0,-1,13453,13453,0,-1,5773,5773,0
3458,150000,120000,0,0,0,0,0,0,-1,6962,6962,0,-1,9301,9301,0,-1,9266,9266,0,-1,6441,6441,0
3459,10000,8000,0,0,0,0,0,1,2,8104,2400,5704,2,7807,0,7807,2,8329,615,7714,2,6613,0,6613
3460,200000,160000,0,0,0,0,0,0,0,66870,3000,63870,0,68752,3000,65752,0,70485,3000,67485,0,71887,2575,69312
3461,200000,160000,0,0,0,0,0,0,-2,0,0,0,-2,304,304,0,-1,13489,13489,0,-1,6788,6788,0
3462,200000,160000,0,0,0,0,0,1,-1,5122,5122,0,-1,1936,0,1936,0,1771,1771,0,-1,0,0,0
3463,360000,288000,0,0,0,0,0,0,-1,11201,11244,-43,-1,9718,9747,-29,-1,8781,8806,-25,-1,11846,11872,-26
3464,50000,40000,0,0,0,0,0,1,-1,252,252,0,-1,-570,0,-570,-1,-570,0,-570,-2,-1000,0,-1000
3465,140000,112000,0,0,0,0,0,0,0,45887,2800,43087,0,137487,100005,37482,0,111602,3800,107802,0,111552,3990,107562
3466,360000,288000,0,0,0,0,0,0,-2,9007,10000,-993,-2,9500,10000,-500,-2,8675,9000,-325,-2,6573,6600,-27
3467,140000,112000,0,0,0,0,0,0,0,0,0,0,0,0,0,0,-2,0,0,0,-2,5302,5302,0
3468,20000,16000,1,1,1,0,1,0,0,39053,1909,37144,0,20055,1666,18389,0,19606,5000,14606,0,19925,703,19222
3469,120000,96000,0,0,0,0,0,0,0,70683,3000,67683,0,71504,2300,69204,0,73230,2600,70630,0,73613,2500,71113
3470,280000,224000,0,0,0,0,0,0,2,226452,5509,220943,2,215692,7604,208088,2,194206,0,194206,2,185854,9200,176654
3471,50000,40000,0,0,0,0,0,0,0,37890,2000,35890,2,37131,150,36981,3,38381,2000,36381,2,39585,2000,37585
3472,20000,16000,0,0,0,0,0,1,2,300,0,300,2,300,0,300,2,300,0,300,2,300,0,300
3473,200000,160000,0,0,0,0,0,1,-2,-792,792,-1584,-2,-792,0,-792,-2,-792,0,-792,-2,69708,70500,-792
3474,50000,40000,0,1,1,0,0,0,0,51447,6739,44708,0,49895,29,49866,2,20317,700,19617,0,19460,704,18756
3475,90000,72000,0,0,0,0,0,0,0,28847,2000,26847,0,28747,2000,26747,0,29177,2000,27177,0,29452,2000,27452
3476,160000,128000,0,0,0,0,0,0,0,47681,0,47681,2,46039,1742,44297,0,47197,1900,45297,0,46683,1703,44980
3477,50000,40000,0,0,0,0,0,0,0,32616,1500,31116,0,29788,1500,28288,0,27562,1200,26362,0,26129,1078,25051
3478,340000,272000,0,0,0,0,0,0,-2,132,132,0,-2,132,132,0,-2,132,132,0,-2,112847,112847,0
3479,610000,488000,0,0,0,0,0,0,0,67887,2100,65787,0,58397,2150,56247,0,105301,50000,55301,0,105965,4700,101265
3480,310000,248000,0,0,0,0,0,0,0,81964,3505,78459,0,74927,3500,71427,0,71636,2000,69636,0,66409,2200,64209
3481,50000,40000,0,0,0,0,0,0,0,36384,2505,33879,0,32913,2100,30813,0,9397,500,8897,0,9755,500,9255
3482,200000,160000,0,0,0,0,0,0,-1,5129,5129,0,-1,14997,17653,-2656,-1,2996,2996,0,-1,5525,6143,-618
3483,230000,184000,0,0,0,0,0,0,0,19649,1500,18149,0,17969,1000,16969,0,10888,2000,8888,0,8657,1023,7634
3484,30000,24000,0,0,0,0,0,0,2,13268,1970,11298,2,12758,0,12758,2,13549,1000,12549,2,14673,1500,13173
3485,90000,72000,0,0,0,0,0,0,0,49858,2012,47846,0,43303,1603,41700,0,29888,1208,28680,0,24973,1000,23973
3486,300000,240000,0,0,0,0,0,0,0,40743,4000,36743,0,41226,1446,39780,2,40263,0,40263,2,42788,3179,39609
3487,50000,40000,0,1,0,0,0,1,2,42958,10,42948,2,37812,8656,29156,0,15617,1044,14573,0,9625,349,9276
3488,170000,136000,0,1,1,1,0,0,-1,171459,8000,163459,0,173310,8127,165183,0,240738,4810,235928,0,135722,5000,130722
3489,400000,320000,0,0,0,0,0,0,0,22071,9177,12894,0,18161,90,18071,0,14669,14709,-40,-1,686,686,0
3490,250000,200000,0,0,0,0,0,0,-2,0,0,0,-2,0,0,0,-2,4501,4501,0,-2,282,282,0
3491,240000,192000,0,0,0,0,0,0,2,38552,19000,19552,0,18580,437,18143,0,12773,1000,11773,0,5423,1000,4423
3492,30000,24000,0,1,0,0,0,1,0,27758,2000,25758,0,22720,2000,20720,0,19136,614,18522,0,14452,924,13528
3493,280000,224000,0,0,0,0,0,0,-1,786,786,0,-1,1028,1028,0,-1,889,698,191,0,698,0,698
3494,80000,64000,0,0,0,0,0,0,-1,4111,4120,-9,-1,940,949,-9,-1,1550,1550,0,-1,4030,4030,0
3495,40000,32000,0,0,0,0,0,0,0,19076,5000,14076,0,15838,1560,14278,0,17616,7000,10616,0,11081,497,10584
3496,210000,168000,0,0,0,0,0,0,0,100117,4100,96017,2,101212,3600,97612,0,101197,4500,96697,0,103175,4000,99175
3497,50000,40000,0,0,0,0,0,1,2,150,0,150,4,150,0,150,4,150,0,150,4,150,0,150
3498,60000,48000,0,1,0,0,0,1,2,54851,2293,52558,0,38863,1367,37496,0,39135,1407,37728,0,39049,1410,37639
3499,10000,8000,0,0,0,1,0,0,0,8567,4700,3867,0,10046,2502,7544,0,10063,1500,8563,0,10132,3000,7132
3500,30000,24000,0,0,0,0,1,0,0,-191,250,-441,0,24149,25000,-851,-1,25452,2000,23452,0,25104,1000,24104
3501,170000,136000,0,1,1,1,1,0,0,161973,6000,155973,0,167201,10000,157201,0,161327,7000,154327,0,171863,16000,155863
3502,180000,144000,0,0,0,0,0,1,-1,-200,0,-200,-1,2000,2200,-200,-1,0,0,0,-1,19726,19726,0
3503,210000,168000,0,0,0,0,0,0,-1,4651,4651,0,-1,4746,95,4651,0,3938,301,3637,0,3479,3479,0
3504,120000,96000,0,1,1,0,0,0,0,117204,6000,111204,0,116835,4000,112835,0,77926,4000,73926,0,76993,3000,73993
3505,20000,16000,0,0,0,0,0,1,2,12779,1212,11567,0,13033,466,12567,0,13308,485,12823,0,13985,900,13085
3506,300000,240000,0,0,0,0,0,1,-2,0,0,0,-2,0,0,0,-2,0,0,0,-2,0,0,0
3507,220000,176000,0,0,0,0,0,0,-2,4863,4863,0,-2,1917,1917,0,-2,809,809,0,-2,709,709,0
3508,220000,176000,0,1,1,1,0,1,4,197022,0,197022,3,198088,6000,192088,2,187000,0,187000,2,179703,14004,165699
3509,200000,160000,0,0,0,0,0,0,-1,388,390,-2,-1,822,830,-8,-1,386,400,-14,-1,540,550,-10
3510,200000,160000,0,0,0,0,0,1,2,2500,0,2500,2,2500,0,2500,2,2500,0,2500,2,2500,0,2500
3511,30000,24000,0,0,0,0,0,1,-2,0,0,0,-2,0,0,0,-2,0,0,0,-2,7035,7035,0
3512,210000,168000,0,1,0,0,1,0,0,201848,10015,191833,0,168664,10000,158664,0,172013,5331,166682,0,175557,5748,169809
3513,50000,40000,0,0,0,0,0,1,2,34935,2800,32135,2,34076,0,34076,3,34685,1300,33385,2,33976,0,33976
3514,220000,176000,0,0,0,0,0,0,-1,3067,3470,-403,-1,1771,1771,0,-1,2326,2333,-7,-1,390,390,0
3515,270000,216000,0,0,0,0,0,0,0,186008,5959,180049,0,173810,6863,166947,0,159418,3762,155656,0,139200,3907,135293
3516,50000,40000,0,0,0,0,0,0,0,20165,1775,18390,0,10732,10732,0,-1,10566,384,10182,0,10757,757,10000
3517,200000,160000,0,0,0,0,0,0,-1,0,0,0,-1,0,0,0,-2,0,0,0,-2,0,0,0
3518,610000,488000,0,0,0,0,0,0,0,276887,11000,265887,0,260761,10000,250761,0,266747,11000,255747,0,271886,10000,261886
3519,260000,208000,0,0,0,0,0,0,-2,2493,2507,-14,-2,2290,2297,-7,-2,432,432,0,-2,0,0,0
3520,210000,168000,0,0,0,0,0,1,-1,90,90,0,-1,90,90,0,-1,180,180,0,-1,90,0,90
3521,60000,48000,0,1,1,1,1,0,0,53898,2000,51898,0,54960,1962,52998,0,56054,1974,54080,0,55263,2159,53104
3522,70000,56000,0,0,0,0,0,0,0,3344,1084,2260,0,4303,1043,3260,0,4243,1000,3243,0,5248,2000,3248
3523,230000,184000,0,0,0,0,0,0,0,97383,5016,92367,0,97487,5000,92487,0,96588,5000,91588,0,95221,5000,90221
3524,440000,352000,0,0,0,0,0,0,-2,5683,5683,0,-2,-20,20,-40,-2,-20,0,-20,-2,9881,9901,-20
3525,280000,224000,0,0,0,0,0,0,-2,0,0,0,-2,0,0,0,-2,0,0,0,-2,0,0,0
3526,20000,16000,0,1,1,1,1,1,2,19148,2273,16875,2,18542,0,18542,2,20122,1882,18240,2,19400,0,19400
3527,200000,160000,0,0,0,0,0,0,-1,-12,0,-12,-1,1081,1093,-12,-1,1884,1893,-9,-1,2089,2097,-8
3528,70000,56000,0,1,0,0,0,1,0,69776,2500,67276,0,51450,928,50522,0,26516,2000,24516,0,27044,969,26075
3529,200000,160000,0,0,0,0,0,0,0,147936,30000,117936,0,149573,6000,143573,0,152574,6000,146574,0,156323,7000,149323
3530,450000,360000,0,0,0,0,0,0,-2,0,0,0,-2,0,0,0,-2,0,0,0,-2,0,0,0
3531,50000,40000,0,0,0,0,0,0,0,27008,1500,25508,0,28324,1800,26524,0,8044,500,7544,0,8414,500,7914
3532,100000,80000,0,1,1,1,1,0,0,84140,3300,80840,0,86400,3881,82519,0,87275,2500,84775,0,89082,2519,86563
3533,30000,24000,0,0,0,1,1,0,0,14588,2231,12357,0,30158,16310,13848,0,29562,1051,28511,0,29818,1103,28715
3534,450000,360000,0,0,0,0,0,0,-1,3119,3128,-9,-1,8970,9008,-38,-1,1323,1323,0,-1,11990,12008,-18
3535,200000,160000,0,1,1,1,1,0,2,178983,14500,164483,2,180784,6400,174384,2,184201,7000,177201,2,187467,7000,180467
3536,200000,160000,0,0,0,0,0,1,-1,65,65,0,-1,0,0,0,-1,0,0,0,-2,5162,5162,0
3537,460000,368000,0,0,0,0,0,0,-1,47633,47830,-197,-1,1296,1296,0,-1,0,0,0,-1,0,0,0
3538,200000,160000,0,0,0,0,0,0,0,26451,2000,24451,0,27437,1437,26000,0,29401,2401,27000,0,31939,3000,28939
3539,50000,40000,0,0,0,0,0,1,0,29253,2100,27153,0,14199,1000,13199,0,14965,1000,13965,0,15712,1000,14712
3540,20000,16000,0,0,0,1,1,1,0,15580,1576,14004,0,16304,1300,15004,0,17059,1000,16059,0,18056,1400,16656
3541,170000,136000,0,1,1,1,1,0,0,143695,6500,137195,0,145550,5500,140050,0,154113,10774,143339,0,151786,0,151786
3542,300000,240000,0,0,0,0,0,0,0,103834,6122,97712,0,99368,1987,97381,0,101600,2232,99368,0,560,560,0
3543,110000,88000,0,0,0,0,0,0,0,26428,1554,24874,0,23043,1212,21831,0,20338,0,20338,0,7680,0,7680
3544,70000,56000,0,1,0,0,0,1,0,70511,3500,67011,0,48772,0,48772,2,27026,2200,24826,2,26056,0,26056
3545,210000,168000,0,1,0,0,0,0,0,177865,5896,171969,0,89227,4800,84427,0,90027,3500,86527,0,93076,5000,88076
3546,40000,32000,0,0,0,0,0,1,2,0,0,0,2,1170,1170,0,-1,780,0,780,0,0,0,0
3547,30000,24000,0,0,0,0,0,0,0,13198,1196,12002,0,13222,1000,12222,0,14620,2000,12620,0,17376,3000,14376
3548,360000,288000,0,0,0,0,0,1,-1,51414,20094,31320,0,17993,1000,16993,0,11546,11546,0,-1,9771,0,9771
3549,20000,16000,0,1,1,1,1,0,0,18748,1357,17391,0,19627,1236,18391,0,19624,623,19001,0,19652,653,18999
3550,280000,224000,0,0,0,0,0,0,-2,0,0,0,-2,0,0,0,-2,0,0,0,-2,0,0,0
3551,30000,24000,0,0,0,0,0,1,2,1950,0,1950,2,1950,0,1950,7,1950,0,1950,7,1950,0,1950
3552,60000,48000,0,1,1,0,0,0,0,61279,3200,58079,0,61017,2535,58482,0,30117,2331,27786,0,29526,0,29526
3553,240000,192000,0,0,0,0,0,0,2,141471,0,141471,2,39578,2000,37578,0,46489,7592,38897,0,45632,0,45632
3554,130000,104000,0,1,1,0,0,0,2,133207,6867,126340,0,131578,5660,125918,0,101612,3800,97812,0,101650,3677,97973
3555,260000,208000,0,0,0,0,0,1,-2,3074,3084,-10,-1,0,691,-691,-1,688,0,688,-2,2605,2613,-8
3556,200000,160000,0,0,0,0,0,0,-2,2479,2479,0,-2,0,0,0,-2,0,0,0,-2,0,0,0
3557,70000,56000,0,0,0,0,0,0,0,14563,1500,13063,0,14625,600,14025,0,15589,1200,14389,0,15189,0,15189
3558,60000,48000,0,0,0,0,1,1,0,45781,0,45781,2,48814,3814,45000,0,49802,1802,48000,0,51034,2034,49000
3559,20000,16000,0,1,1,1,1,0,2,19771,0,19771,3,20241,1000,19241,2,19364,0,19364,2,18260,1000,17260
3560,260000,208000,0,0,0,0,0,1,0,155963,6025,149938,0,148701,5703,142998,0,141039,5123,135916,0,143838,5148,138690
3561,120000,96000,0,0,0,0,0,1,1,0,0,0,-2,0,0,0,-2,0,0,0,-2,0,0,0
3562,90000,72000,0,1,1,1,1,0,2,88577,7200,81377,2,86365,0,86365,2,91105,6200,84905,2,89347,24,89323
3563,220000,176000,0,0,0,0,0,0,-2,4690,4714,-24,-2,16331,16493,-162,-1,77894,97910,-20016,0,2576,0,2576
3564,20000,16000,0,0,0,0,0,1,0,5979,1183,4796,0,6796,1000,5796,0,6463,0,6463,3,2255,0,2255
3565,200000,160000,0,0,0,0,0,0,0,38685,38759,-74,-1,22125,102,22023,0,17778,17868,-90,-1,24354,25125,-771
3566,50000,40000,0,0,0,0,0,0,0,13656,2000,11656,0,14949,1500,13449,0,16567,2000,14567,0,16826,2000,14826
3567,270000,216000,0,0,0,0,0,0,0,0,0,0,0,0,0,0,-2,4448,4448,0,-1,5667,1300,4367
3568,150000,120000,0,0,0,0,0,0,0,83467,3100,80367,0,86076,4000,82076,0,87829,3536,84293,0,58213,2200,56013
3569,30000,24000,0,0,0,1,1,0,0,22058,3500,18558,0,24598,3000,21598,0,26564,2500,24064,0,27521,2000,25521
3570,80000,64000,0,1,1,1,1,1,2,70081,3126,66955,0,70899,2578,68321,0,75331,5616,69715,0,74005,0,74005
3571,230000,184000,0,0,0,0,0,0,-1,855,855,0,-1,0,0,0,-1,590,590,0,-1,0,0,0
3572,350000,280000,0,0,0,0,0,1,-2,0,0,0,-2,0,0,0,-2,0,0,0,-2,0,0,0
3573,100000,80000,0,1,1,0,0,0,0,93076,5000,88076,0,91241,4000,87241,0,62242,4000,58242,0,9565,1000,8565
3574,70000,56000,0,1,1,1,1,1,2,71281,2800,68481,0,73229,6500,66729,0,71426,0,71426,2,68911,2821,66090
3575,140000,112000,0,0,0,0,0,0,0,111948,3079,108869,0,58672,3000,55672,0,59199,2000,57199,0,54286,2000,52286
3576,50000,40000,0,0,0,0,0,1,-1,3207,0,3207,2,0,0,0,2,1250,1250,0,-1,5245,5245,0
3577,360000,288000,0,0,0,0,0,0,-2,0,0,0,-2,0,0,0,-2,0,0,0,-2,0,0,0
3578,50000,40000,0,0,0,0,0,0,-1,0,0,0,-2,0,0,0,-2,0,0,0,-2,0,0,0
3579,230000,184000,0,0,0,0,0,0,0,25996,3000,22996,0,28240,3000,25240,0,30450,3000,27450,0,31798,2000,29798
3580,200000,160000,0,0,0,0,0,0,-2,5028,5028,0,-2,13784,13800,-16,-1,14482,2900,11582,0,11836,3100,8736
3581,210000,168000,0,0,0,0,0,0,-2,9000,9017,-17,-2,7905,7905,0,-2,1434,1434,0,-2,1008,1008,0
3582,20000,16000,0,0,0,0,0,1,2,2255,0,2255,2,2255,0,2255,7,2255,0,2255,7,2255,0,2255
3583,120000,96000,0,0,0,0,0,0,0,47753,2000,45753,0,48950,2000,46950,0,50149,2000,48149,0,51159,2000,49159
3584,50000,40000,0,1,0,0,0,0,2,42052,2000,40052,0,22679,1500,21179,0,19099,1000,18099,0,19648,1000,18648
3585,20000,16000,0,0,0,0,1,1,0,5491,1000,4491,0,831,831,0,-1,20088,20500,-412,-1,19733,1000,18733
3586,120000,96000,0,0,0,1,0,0,0,96000,2000,94000,0,98000,2000,96000,0,100000,2000,98000,0,0,0,0
3587,140000,112000,0,1,1,0,0,0,0,135695,6500,129195,0,121943,4322,117621,0,111348,12200,99148,0,107488,0,107488
3588,210000,168000,0,0,0,0,0,0,-1,141555,141555,0,-1,140550,4272,136278,0,153587,20150,133437,0,153278,6000,147278
3589,60000,48000,0,0,0,0,0,0,0,24779,1800,22979,0,25322,1287,24035,0,19248,813,18435,0,18061,700,17361
3590,400000,320000,0,0,0,0,0,0,-1,15377,15384,-7,-1,14757,14757,0,-1,44843,44843,0,-1,6622,6622,0
3591,280000,224000,0,0,0,0,0,1,-2,11169,11055,114,-2,2300,2311,-11,-2,0,0,0,-2,10551,10551,0
3592,140000,112000,0,0,0,0,0,0,-1,5842,5842,0,-1,9422,8956,466,-1,8956,0,8956,2,316,316,0
3593,20000,16000,0,0,0,0,0,0,0,11788,1000,10788,0,9607,192,9415,0,9191,184,9007,0,0,0,0
3594,50000,40000,0,0,0,0,0,0,-2,19313,1500,17813,-2,19304,419,18885,-2,19725,455,19270,-2,5770,115,5655
3595,200000,160000,0,0,0,0,0,0,-1,313,313,0,-1,152,152,0,-1,148,148,0,-1,498,498,0
3596,290000,232000,0,0,0,0,0,0,-2,11495,11527,-32,-2,11214,15537,-4323,-2,4084,4873,-789,-2,6348,26348,-20000
3597,40000,32000,0,1,1,1,1,1,2,34305,0,34305,2,34985,1250,33735,0,35719,1296,34423,0,36428,1302,35126
3598,50000,40000,0,0,0,0,0,0,-1,4230,4247,-17,-1,1243,1243,0,-1,1904,1094,810,0,0,0,0
3599,360000,288000,0,0,0,0,0,0,-1,0,0,0,-1,0,0,0,-2,0,0,0,-2,0,0,0
3600,320000,256000,0,0,0,0,0,0,-2,1403,3290,-1887,-2,24305,11465,12840,-1,7463,7537,-74,-1,1957,1966,-9
3601,50000,40000,0,0,0,0,0,0,0,20803,20000,803,0,18395,700,17695,0,18386,665,17721,0,18420,727,17693
3602,10000,8000,0,1,0,0,1,1,0,9272,1000,8272,0,-8758,0,-8758,0,8989,30000,-21011,-1,9202,500,8702
3603,20000,16000,0,0,0,0,0,0,0,15277,2000,13277,0,13478,1000,12478,0,16978,5000,11978,0,12914,12914,0
3604,180000,144000,0,0,0,0,0,0,0,0,0,0,0,0,0,0,-2,0,0,0,-2,0,0,0
3605,240000,192000,0,1,1,1,1,0,0,236518,11000,225518,0,232756,10300,222456,0,214781,7700,207081,0,219313,8000,211313
3606,50000,40000,1,1,1,1,1,1,2,52298,0,52298,3,50778,0,50778,2,48055,3130,44925,0,45704,2532,43172
3607,50000,40000,0,1,0,0,0,1,2,44443,1280,43163,0,19522,662,18860,0,19775,837,18938,0,20325,1000,19325
3608,290000,232000,0,0,0,0,0,0,0,116427,6000,110427,0,103550,4000,99550,0,64527,3000,61527,0,64030,2500,61530
3609,90000,72000,0,0,0,0,0,0,0,16733,1280,15453,0,17453,1000,16453,0,17970,950,17020,0,18175,652,17523
3610,60000,48000,0,1,1,1,1,0,0,55395,2557,52838,0,56416,2500,53916,0,58792,4500,54292,0,56130,0,56130
3611,200000,160000,0,0,0,0,0,0,0,36792,10008,26784,0,49648,15011,34637,0,33498,5010,28488,0,30895,153,30742
3612,20000,16000,0,0,1,0,1,0,0,17575,3000,14575,0,17063,3,17060,3,15711,7,15704,2,28600,2058,26542
3613,160000,128000,0,0,0,0,0,0,-2,0,0,0,-2,708,708,0,-1,560,560,0,-1,0,0,0
3614,50000,40000,0,1,1,1,1,1,2,43658,3500,40158,2,44644,2000,42644,2,43798,0,43798,2,44912,2000,42912
3615,210000,168000,0,1,1,1,1,1,0,193397,8495,184902,0,195027,7800,187227,0,199236,7378,191858,0,203241,7800,195441
3616,50000,40000,0,0,0,0,0,0,0,9762,1500,8262,0,8620,400,8220,0,9303,1000,8303,0,8693,1000,7693
3617,90000,72000,1,1,1,0,0,0,0,91508,0,91508,2,86167,3752,82415,0,49479,1726,47753,0,50704,2003,48701
3618,150000,120000,0,1,1,1,1,1,0,144163,8000,136163,0,146171,5775,140396,0,136004,5000,131004,0,138903,5200,133703
3619,80000,64000,0,1,1,0,0,1,2,82713,4000,78713,2,80838,0,80838,2,49575,1920,47655,0,48354,1800,46554
3620,20000,16000,0,0,0,0,0,0,0,13648,1500,12148,0,13924,1400,12524,0,15685,2000,13685,0,15292,0,15292
3621,170000,136000,0,0,0,0,0,0,0,127407,5609,121798,0,146833,70000,76833,0,64268,2700,61568,0,58970,2200,56770
3622,70000,56000,0,0,1,0,0,0,1,71562,140043,-68481,-1,68709,1830,66879,0,28528,1021,27507,0,29171,1103,28068
3623,40000,32000,0,1,1,1,1,0,0,37987,1888,36099,0,37100,1458,35642,0,37098,1489,35609,0,37846,1510,36336
3624,20000,16000,0,1,1,1,1,1,2,18867,1146,17721,0,19253,532,18721,0,20003,900,19103,0,19470,781,18689
3625,50000,40000,0,0,0,0,0,0,0,0,0,0,-2,0,0,0,-2,0,0,0,-2,0,0,0
3626,100000,80000,0,0,0,0,0,0,0,36260,0,36260,2,36995,1285,35710,0,39355,2916,36439,0,39982,1368,38614
3627,320000,256000,0,0,0,0,0,0,-2,3663,3696,-33,-2,992,997,-5,-2,1627,1635,-8,-2,6661,6694,-33
3628,50000,40000,0,0,0,0,0,0,2,28662,2000,26662,0,29476,1500,27976,0,4011,1000,3011,0,1000,1000,0
3629,420000,336000,0,0,0,0,0,0,0,56125,2200,53925,0,49114,1700,47414,0,47563,1800,45763,0,45829,1700,44129
3630,360000,288000,0,0,0,0,0,0,-1,1489,1489,0,-1,-356,0,-356,-1,9824,10560,-736,-1,2010,2010,0
3631,150000,120000,0,1,0,0,0,0,2,148994,6103,142891,0,80196,3220,76976,0,74328,3028,71300,0,66806,5052,61754
3632,240000,192000,0,0,0,0,0,0,-2,0,0,0,-2,0,0,0,-2,0,0,0,-2,0,0,0
3633,180000,144000,0,0,0,0,0,0,-1,334,337,-3,-1,9379,9379,0,-1,1100,1100,0,-1,43505,43505,0
3634,360000,288000,0,0,0,0,0,0,-1,2600,0,2600,2,2800,200,2600,0,2800,0,2800,0,0,0,0
3635,300000,240000,0,0,0,0,0,0,-1,25895,25500,395,0,16416,6000,10416,0,3972,3972,0,-1,2200,2200,0
3636,20000,16000,0,0,0,0,0,0,0,6098,2000,4098,0,6840,1000,5840,0,8560,2000,6560,0,13410,5000,8410
3637,60000,48000,0,1,0,0,0,1,0,60661,2000,58661,0,29095,900,28195,0,17636,889,16747,0,31406,21500,9906
3638,30000,24000,0,0,0,0,0,1,0,0,0,0,0,0,0,0,-2,0,0,0,-2,0,0,0
3639,200000,160000,0,0,0,0,0,0,-1,316,316,0,-1,316,316,0,-1,316,316,0,-1,316,316,0
3640,50000,40000,0,0,0,0,0,1,0,34836,1660,33176,0,18488,1272,17216,0,19716,1500,18216,0,17932,644,17288
3641,200000,160000,0,1,0,0,0,0,2,164665,0,164665,2,155614,6100,149514,0,145920,5792,140128,0,104728,4240,100488
3642,50000,40000,0,0,0,0,0,0,-1,6910,9000,-2090,-1,6314,88,6226,2,18544,18596,-52,-1,12894,5023,7871
3643,10000,8000,0,0,1,1,1,0,2,8792,1146,7646,0,9117,471,8646,0,9305,483,8822,0,9504,502,9002
3644,50000,40000,0,1,0,0,0,0,0,43711,1902,41809,0,33626,1000,32626,0,19371,841,18530,0,19808,900,18908
3645,140000,112000,0,1,1,0,0,0,0,136194,7000,129194,0,137490,5421,132069,0,106322,4000,102322,0,104583,4000,100583
3646,210000,168000,0,0,0,0,0,0,-1,-55,0,-55,-2,-55,0,-55,-2,-55,0,-55,-2,-55,0,-55
3647,100000,80000,0,0,0,0,0,1,0,49854,2500,47354,0,51400,3000,48400,0,0,0,0,0,0,0,0
3648,200000,160000,0,0,0,0,0,1,2,142460,5500,136960,2,144098,5500,138598,2,147124,5500,141624,2,149531,5000,144531
3649,60000,48000,0,0,0,0,0,0,0,30710,2000,28710,0,28914,1500,27414,0,29823,1500,28323,0,28916,1500,27416
3650,420000,336000,0,0,0,0,0,0,0,54678,5000,49678,0,55403,3000,52403,0,56260,3000,53260,0,57598,3000,54598
3651,180000,144000,0,0,0,0,0,1,0,11695,1700,9995,0,5891,300,5591,0,753,0,753,0,21753,21000,753
3652,100000,80000,0,0,0,0,0,0,0,74105,1792,72313,0,75617,1828,73789,0,77150,1855,75295,0,78953,2121,76832
3653,140000,112000,0,0,0,0,1,1,2,112144,5600,106544,0,114789,6000,108789,0,115590,4200,111390,0,118221,4500,113721
3654,90000,72000,0,0,0,0,0,0,0,10220,10000,220,0,12044,10016,2028,0,27847,25000,2847,0,8251,8000,251
3655,200000,160000,0,0,0,0,0,0,0,58112,10188,47924,0,23949,1074,22875,0,9270,209,9061,0,4496,112,4384
3656,210000,168000,0,0,0,0,0,0,0,42884,2027,40857,0,23547,1045,22502,0,18574,1000,17574,0,12466,500,11966
3657,60000,48000,0,0,0,0,0,0,0,31499,6037,25462,0,16773,5084,11689,0,11568,6000,5568,0,9727,4000,5727
3658,100000,80000,0,0,0,0,0,0,-1,780,780,0,-1,390,0,390,0,390,390,0,-1,7140,7140,0
3659,360000,288000,0,0,0,0,0,0,0,0,0,0,0,277,277,0,-1,2599,2602,-3,-1,3941,2019,1922
3660,50000,40000,0,0,0,0,0,0,0,10581,1163,9418,0,10818,400,10418,0,11050,790,10260,0,10880,400,10480
3661,20000,16000,0,0,0,0,0,0,2,1650,0,1650,4,1650,0,1650,4,1650,0,1650,4,1650,0,1650
3662,260000,208000,0,0,0,0,0,1,-1,582,582,0,-1,291,0,291,0,0,0,0,0,291,130291,-130000
3663,30000,24000,0,0,0,0,0,0,0,24514,10096,14418,0,4083,4083,0,-1,6234,6255,-21,-1,0,0,0
3664,340000,272000,0,1,1,1,1,0,0,335659,13000,322659,0,336498,13000,323498,0,321941,12000,309941,0,315006,12000,303006
3665,50000,40000,0,0,0,0,0,0,-1,3595,3622,-27,-1,900,900,0,-1,6483,6483,0,-1,0,0,0
3666,100000,80000,0,0,0,0,0,1,0,42699,1800,40899,0,44020,2032,41988,0,44588,1600,42988,0,45521,1652,43869
3667,350000,280000,0,0,0,0,0,0,0,200654,7360,193294,0,196308,8568,187740,0,192735,6600,186135,0,190735,6711,184024
3668,120000,96000,0,1,1,1,1,0,0,116955,4541,112414,0,109973,4100,105873,0,108693,4100,104593,0,104890,4000,100890
3669,140000,112000,0,0,0,0,0,1,-1,2421,2000,421,0,5021,5021,0,-1,2646,2646,0,-1,6117,5541,576
3670,180000,144000,0,0,0,0,0,0,0,68862,4000,64862,0,71970,5000,66970,0,69843,3000,66843,0,67219,2700,64519
3671,280000,224000,0,0,0,0,0,0,-1,1379,1383,-4,-1,1885,1890,-5,-1,143,143,0,-1,1250,1253,-3
3672,200000,160000,0,0,0,0,0,0,0,69596,2536,67060,0,32709,1065,31644,0,31816,10020,21796,0,33368,6097,27271
3673,240000,192000,0,0,0,0,0,0,-1,5596,5596,0,-1,3328,3328,0,-1,3763,3763,0,-1,9529,9529,0
3674,240000,192000,0,0,0,0,0,0,-1,-348,0,-348,-1,152,500,-348,-1,272,500,-228,-1,5291,5291,0
3675,50000,40000,0,0,0,0,0,0,0,18911,1700,17211,0,20090,1800,18290,0,20334,875,19459,0,20856,1000,19856
3676,110000,88000,0,1,1,1,1,0,2,105325,3700,101625,2,102220,0,102220,2,107970,7500,100470,2,103301,0,103301
3677,30000,24000,0,0,0,0,0,1,0,25067,3026,22041,0,23237,0,23237,2,0,0,0,2,0,0,0
3678,20000,16000,0,0,0,0,0,0,-1,596,600,-4,-1,630,700,-70,-1,664,700,-36,-1,598,600,-2
3679,220000,176000,0,0,0,0,0,0,0,10417,10417,0,-1,9363,1061,8302,0,7898,525,7373,0,5758,0,5758
3680,180000,144000,0,0,0,0,0,0,-2,178,178,0,-1,1500,1500,0,-1,0,0,0,-1,1118,1118,0
3681,160000,128000,0,0,0,0,0,0,-1,1496,1496,0,-1,1496,1496,0,-1,1496,1496,0,-1,1496,1496,0
3682,550000,440000,0,0,0,0,0,0,0,389694,20000,369694,0,342198,20000,322198,0,344808,12000,332808,0,347188,12000,335188
3683,20000,16000,0,0,0,0,0,0,0,7102,1202,5900,0,5035,1000,4035,0,5152,117,5035,0,2150,246,1904
3684,500000,400000,0,0,0,0,0,0,0,339278,15000,324278,0,85500,4000,81500,0,87192,4000,83192,0,92581,6784,85797
3685,230000,184000,0,0,0,0,0,0,0,178559,6528,172031,0,172772,6000,166772,0,175057,6500,168557,0,177113,7000,170113
3686,90000,72000,0,0,0,0,0,0,0,13009,13009,0,-1,17405,4627,12778,0,20115,3000,17115,0,19655,0,19655
3687,510000,408000,0,0,0,0,0,0,0,72730,8000,64730,0,64746,20000,44746,0,24040,24040,0,0,23791,23791,0
3688,20000,16000,0,0,0,0,0,1,2,-15000,0,-15000,2,-15000,0,-15000,-2,-15000,0,-15000,-2,-15000,0,-15000
3689,50000,40000,0,0,0,0,0,0,0,31293,1042,30251,2,29256,0,29256,2,29870,1080,28790,0,30503,1515,28988
3690,80000,64000,0,1,1,1,1,1,2,87525,8000,79525,2,78266,0,78266,2,74967,5000,69967,2,66512,0,66512
3691,20000,16000,0,1,1,1,1,0,2,19004,1640,17364,0,19558,1589,17969,0,19176,1000,18176,0,19441,1001,18440
3692,60000,48000,0,0,0,0,0,1,2,19638,2000,17638,0,18919,2000,16919,0,16853,1000,15853,0,29682,20000,9682
3693,210000,168000,0,1,0,0,0,0,0,200035,7542,192493,0,96882,11538,85344,0,99087,3735,95352,0,101427,4129,97298
3694,90000,72000,0,0,0,0,0,0,-2,3904,3904,0,-2,686,686,0,-2,686,686,0,-2,686,686,0
3695,160000,128000,0,0,0,0,0,0,-1,5958,7916,-1958,-1,55914,56116,-202,-1,23285,23302,-17,-1,29170,11580,17590
3696,400000,320000,0,0,0,0,0,0,-1,188,188,0,-1,188,188,0,-1,177,177,0,-1,2378,2400,-22
3697,230000,184000,0,0,0,0,0,0,-1,0,0,0,-1,0,0,0,-2,0,0,0,-2,0,0,0
3698,500000,400000,0,0,0,0,0,0,-1,0,0,0,-2,0,0,0,-2,0,0,0,-2,2300,2300,0
3699,180000,144000,0,0,0,0,0,0,0,30900,1900,29000,0,0,0,0,0,0,0,0,-2,5386,5386,0
3700,200000,160000,0,0,0,0,0,0,0,134572,7000,127572,0,61450,3000,58450,0,-200,0,-200,0,-200,0,-200
3701,140000,112000,0,1,1,1,1,0,0,123390,4558,118832,0,127557,6300,121257,0,117961,4221,113740,0,120570,4500,116070
3702,100000,80000,0,0,0,0,0,1,-1,2043,2043,0,-1,4830,4830,0,-1,3535,0,3535,0,4307,4307,0
3703,100000,80000,0,0,0,0,0,1,0,45779,2200,43579,0,46912,2200,44712,0,49715,3900,45815,0,48791,0,48791
3704,30000,24000,0,0,0,0,1,0,0,23702,3700,20002,0,23026,0,23026,2,27798,5335,22463,2,27219,0,27219
3705,80000,64000,0,0,0,0,0,1,2,26700,4300,22400,2,27064,1100,25964,2,27685,1200,26485,2,27091,0,27091
3706,120000,96000,0,0,0,0,0,0,-2,475,478,-3,-2,804,804,0,-2,245,245,0,-2,100,144,-44
3707,90000,72000,0,0,0,0,0,0,-1,4602,8853,-4251,-1,28426,28990,-564,-1,8978,9028,-50,-1,5104,5119,-15
3708,130000,104000,0,0,0,0,0,0,0,36357,3000,33357,0,37878,2500,35378,0,39489,3000,36489,0,41833,3000,38833
3709,180000,144000,0,0,0,0,0,0,0,9227,9000,227,0,3235,0,3235,2,2655,2668,-13,-1,7251,7251,0
3710,80000,64000,0,0,0,0,0,0,-1,164,164,0,-1,1369,1369,0,-1,830,830,0,-1,132,132,0
3711,100000,80000,1,1,1,1,1,0,0,106142,5300,100842,0,102449,3605,98844,0,100212,3500,96712,0,102674,4100,98574
3712,60000,48000,0,0,0,0,0,0,2,3309,1000,2309,2,3606,500,3106,2,3400,0,3400,2,3844,500,3344
3713,270000,216000,0,0,0,0,0,0,-2,0,0,0,-2,0,0,0,-2,0,0,0,-2,0,0,0
3714,110000,88000,0,0,0,0,0,0,0,9275,2000,7275,0,5751,2000,3751,0,10592,5000,5592,0,9701,3470,6231
3715,160000,128000,0,0,0,0,0,1,0,421,421,0,-1,421,421,0,-1,2876,2876,0,-1,1949,1949,0
3716,60000,48000,0,1,1,0,0,1,0,61333,2893,58440,0,60082,2210,57872,0,38897,938,37959,0,39422,1188,38234
3717,50000,40000,0,1,1,0,0,1,0,48990,2005,46985,0,49261,1745,47516,0,0,0,0,0,0,0,0
3718,390000,312000,0,0,0,0,0,0,0,61735,5000,56735,0,63337,5000,58337,0,59693,4000,55693,0,62776,4000,58776
3719,410000,328000,0,1,1,1,1,1,0,363666,14600,349066,0,369776,15500,354276,0,368779,14000,354779,0,369358,13580,355778
3720,20000,16000,0,0,0,0,0,0,0,15300,1206,14094,0,12776,256,12520,0,3585,72,3513,0,0,0,0
3721,300000,240000,0,0,0,0,0,0,0,36156,1797,34359,0,30305,750,29555,0,30155,0,30155,2,561,561,0
3722,160000,128000,0,0,0,0,0,0,0,119697,5000,114697,2,116284,0,116284,2,119248,5000,114248,0,122228,4958,117270
3723,380000,304000,0,0,0,0,0,0,0,69221,6018,63203,0,46858,3000,43858,0,33060,4000,29060,0,27047,4000,23047
3724,300000,240000,0,0,0,0,0,0,-1,1561,1561,0,-1,2106,2106,0,-1,2656,2656,0,-1,4274,4274,0
3725,220000,176000,0,0,0,0,0,0,-1,326,326,0,-1,326,326,0,-1,326,326,0,-1,322,322,0
3726,30000,24000,0,1,1,1,0,0,2,27240,1500,25740,0,27440,600,26840,0,28000,560,27440,0,0,0,0
3727,20000,16000,0,0,0,0,0,1,0,0,0,0,0,0,0,0,-2,0,0,0,-2,0,0,0
3728,60000,48000,0,0,0,0,0,0,0,31328,3000,28328,0,30905,1420,29485,0,30237,2000,28237,0,28461,1164,27297
3729,50000,40000,0,0,0,0,0,0,0,39141,2000,37141,0,35524,8156,27368,0,30842,30000,842,0,17043,1644,15399
3730,80000,64000,0,0,0,0,0,1,0,25924,2000,23924,0,16558,1300,15258,0,17280,1000,16280,0,17652,650,17002
3731,360000,288000,0,0,0,0,0,1,-1,0,0,0,-2,0,0,0,-2,906,906,0,-1,0,0,0
3732,70000,56000,0,0,0,0,0,0,0,23432,2000,21432,0,24217,1500,22717,0,19108,1000,18108,0,19649,1000,18649
3733,230000,184000,0,0,0,0,0,0,0,8926,8926,0,-1,13283,5291,7992,0,20060,20060,0,-1,3904,3904,0
3734,140000,112000,0,0,0,0,0,1,2,52903,2400,50503,2,53652,2200,51452,2,52201,0,52201,2,55497,4300,51197
3735,300000,240000,0,0,0,0,0,0,-1,256,256,0,-1,0,0,0,-1,0,0,0,-2,126,126,0
3736,50000,40000,0,0,0,0,0,1,0,39945,1904,38041,0,40254,2214,38040,0,20040,1000,19040,0,3563,129,3434
3737,130000,104000,0,0,0,0,0,0,0,40437,3200,37237,0,9919,1200,8719,0,10295,500,9795,0,7964,447,7517
3738,30000,24000,0,1,1,0,0,0,0,28812,1200,27612,0,28762,1020,27742,0,10404,10404,0,-1,8578,51000,-42422
3739,180000,144000,0,0,0,0,0,0,-2,2771,2771,0,-2,390,390,0,-2,0,0,0,-2,0,0,0
3740,560000,448000,0,0,0,0,0,0,-2,2740,2740,0,-2,2740,2740,0,-2,1703,1703,0,-2,27802,27802,0
3741,260000,208000,0,1,1,0,0,0,0,247462,9000,238462,0,252073,8300,243773,0,195628,6576,189052,0,199646,7000,192646
3742,50000,40000,0,0,0,0,0,0,0,26237,1425,24812,0,19296,1598,17698,0,19127,819,18308,0,18997,705,18292
3743,250000,200000,0,0,0,0,0,0,0,37329,15054,22275,0,26339,7885,18454,0,4836,4836,0,-1,9655,9655,0
3744,450000,360000,0,0,0,0,0,0,-2,0,0,0,-2,4376,4376,0,-2,0,0,0,-2,0,0,0
3745,360000,288000,0,0,0,0,0,0,-2,0,0,0,-2,0,0,0,-2,0,0,0,-2,0,0,0
3746,70000,56000,0,1,0,0,0,0,0,69309,2908,66401,0,36808,1318,35490,0,37734,1520,36214,0,38353,1400,36953
3747,130000,104000,0,0,0,0,0,1,-1,6690,6704,-14,-1,-1018,21018,-22036,-1,89445,92610,-3165,-1,90179,3272,86907
3748,180000,144000,0,0,0,0,0,0,2,3842,3842,0,-1,7146,5000,2146,0,10480,5000,5480,0,13886,10000,3886
3749,240000,192000,0,1,0,0,0,0,0,240896,11217,229679,0,135900,4855,131045,0,135853,4000,131853,0,127777,3200,124577
3750,50000,40000,0,0,0,0,0,0,-2,26924,1448,25476,-2,27458,982,26476,-2,28036,1020,27016,-2,28772,1200,27572
3751,200000,160000,0,0,0,0,0,0,-1,15765,15818,-53,-2,3997,4009,-12,-2,4931,4945,-14,-2,429,429,0
3752,320000,256000,0,0,0,0,0,0,0,41733,4027,37706,0,34534,3002,31532,0,36170,3008,33162,0,31775,1059,30716
3753,260000,208000,0,0,0,0,0,1,-1,16832,16666,166,0,16332,16666,-334,-1,16332,16666,-334,-1,-334,0,-334
3754,30000,24000,0,0,0,0,0,0,0,19962,0,19962,2,18191,1450,16741,2,12134,0,12134,2,6879,500,6379
3755,100000,80000,0,0,0,0,0,0,0,60841,3000,57841,0,61434,2200,59234,0,62743,2300,60443,0,66677,5000,61677
3756,70000,56000,0,0,0,0,0,0,0,53080,0,53080,2,49153,2000,47153,0,47139,2000,45139,0,37610,2000,35610
3757,20000,16000,0,0,0,0,0,0,0,4120,1197,2923,0,3802,269,3533,0,3484,269,3215,0,3152,261,2891
3758,100000,80000,0,1,1,1,1,0,0,86295,3052,83243,0,86945,3264,83681,0,94526,10398,84128,0,91630,0,91630
3759,300000,240000,0,0,0,0,0,0,-2,0,0,0,-2,0,0,0,-2,0,0,0,-2,0,0,0
3760,30000,24000,0,0,0,0,0,1,0,9152,1321,7831,0,10282,1451,8831,0,10180,349,9831,0,10394,362,10032
3761,90000,72000,0,0,0,0,0,0,2,2323,2323,0,-1,1073,0,1073,2,1073,1073,0,-1,9699,9699,0
3762,200000,160000,0,0,0,0,0,1,0,133976,5000,128976,0,136646,4888,131758,0,145147,10700,134447,0,142651,0,142651
3763,110000,88000,0,0,0,0,0,1,-2,0,0,0,-2,0,0,0,-2,0,0,0,-2,150,300,-150
3764,50000,40000,0,0,0,0,0,0,-1,11512,11512,0,-1,11512,0,11512,0,8490,0,8490,0,0,0,0
3765,300000,240000,0,0,0,0,0,1,-2,0,0,0,-2,0,0,0,-2,0,0,0,-2,0,0,0
3766,150000,120000,0,0,0,0,0,0,-2,2178,2184,-6,-2,1536,1542,-6,-2,626,626,0,-2,621,621,0
3767,100000,80000,0,0,0,0,0,1,2,76063,3200,72863,2,77224,3000,74224,2,75385,0,75385,2,78991,5000,73991
3768,50000,40000,0,0,0,0,0,1,2,39490,2000,37490,0,27835,2537,25298,0,23391,1500,21891,0,24507,1500,23007
3769,300000,240000,0,0,0,0,0,0,0,204975,7009,197966,0,159596,6000,153596,0,116322,6100,110222,0,247931,245000,2931
3770,20000,16000,0,0,0,1,1,0,0,17562,2659,14903,0,17322,1419,15903,0,17119,606,16513,0,17350,500,16850
3771,50000,40000,0,0,0,1,1,1,0,37800,1900,35900,0,51457,51457,0,-1,50463,0,50463,2,41758,1642,40116
3772,80000,64000,0,0,0,0,0,0,-2,15854,15854,0,-2,10000,10000,0,-2,10000,10000,0,-2,10000,10000,0
3773,50000,40000,0,0,0,0,0,0,0,31368,1003,30365,0,9454,189,9265,0,6020,120,5900,0,5000,100,4900
3774,190000,152000,0,1,0,0,0,1,0,184403,3000,181403,2,90887,4100,86787,0,90097,3200,86897,0,90295,3264,87031
3775,50000,40000,0,0,0,0,0,0,0,11396,2000,9396,0,13190,2000,11190,0,14967,2000,12967,0,16551,2000,14551
3776,20000,16000,0,1,1,1,1,1,2,18052,1300,16752,0,18562,810,17752,0,18814,700,18114,0,19500,1000,18500
3777,290000,232000,0,0,0,0,0,0,0,9020,3000,6020,0,-77,0,-77,0,8123,8200,-77,-1,210989,205000,5989
3778,20000,16000,0,1,1,1,0,0,2,19946,1289,18657,0,19037,491,18546,0,19233,2586,16647,0,14764,5000,9764
3779,290000,232000,0,0,0,0,0,0,0,8890,1529,7361,0,13338,5063,8275,0,10542,5000,5542,0,20076,10010,10066
3780,50000,40000,1,1,1,0,0,1,2,52792,0,52792,2,50167,1400,48767,0,31778,0,31778,0,32427,649,31778
3781,300000,240000,0,1,0,0,0,1,0,271952,12000,259952,0,193403,7200,186203,0,187562,6500,181062,0,191069,6173,184896
3782,30000,24000,0,0,0,0,0,0,-1,10008,10024,-16,-1,9336,9340,-4,-1,24339,24363,-24,-1,16710,5714,10996
3783,50000,40000,0,0,0,0,0,0,0,0,0,0,-2,0,0,0,-2,0,0,0,-2,0,0,0
3784,190000,152000,0,0,0,0,0,0,0,70009,3529,66480,0,65845,3000,62845,0,67347,2600,64747,0,70096,4000,66096
3785,360000,288000,0,0,0,0,0,0,-2,0,0,0,-2,0,0,0,-2,0,0,0,-2,0,0,0
3786,360000,288000,0,0,0,0,0,0,-2,587,590,-3,-2,1647,1670,-23,-2,1745,1748,-3,-2,597,600,-3
3787,50000,40000,0,0,0,0,0,0,-1,134,134,0,-1,134,0,134,0,0,0,0,0,0,0,0
3788,110000,88000,0,1,1,0,0,1,0,109325,4398,104927,0,111264,4196,107068,0,56311,1857,54454,0,58271,8271,50000
3789,20000,16000,0,0,0,0,0,0,-1,780,780,0,-1,0,0,0,-1,0,0,0,-2,0,0,0
3790,90000,72000,0,0,0,0,0,0,-2,2469,2469,0,-2,827,827,0,-2,0,0,0,-2,1654,1654,0
3791,200000,160000,0,0,0,0,0,0,0,3820,3820,0,-1,0,0,0,-1,0,0,0,-2,0,0,0
3792,170000,136000,0,0,0,0,0,0,-1,2015,2015,0,-1,2015,2015,0,-1,2015,2015,0,-1,1925,1925,0
3793,340000,272000,0,0,0,0,0,0,-1,7796,7796,0,-1,1653,1653,0,-1,6185,6185,0,-1,415,415,0
3794,240000,192000,0,0,0,0,0,0,-1,1051,1051,0,-1,671,671,0,-1,291,291,0,-1,671,671,0
3795,360000,288000,0,0,0,0,0,0,-2,198840,200222,-1382,-2,390,1044,-654,-2,390,390,0,-2,390,390,0
3796,160000,128000,0,0,0,0,0,0,-2,8899,12038,-3139,-1,6257,10696,-4439,-1,-1197,613,-1810,-1,12151,14262,-2111
3797,120000,96000,0,1,0,0,0,0,0,108538,5000,103538,0,94833,4121,90712,0,49078,2000,47078,0,40643,2000,38643
3798,310000,248000,0,0,0,0,0,0,-2,0,0,0,-2,235,235,0,-2,0,0,0,-2,0,0,0
3799,110000,88000,0,1,1,0,0,1,0,105199,5720,99479,0,104587,3078,101509,0,49001,2000,47001,0,45093,2000,43093
3800,30000,24000,0,0,0,0,0,0,-1,3963,16,3947,2,4514,4527,-13,-1,3129,675,2454,0,675,0,675
3801,200000,160000,0,0,0,0,0,1,0,162377,10000,152377,0,174501,15000,159501,0,155355,0,155355,2,129942,10000,119942
3802,240000,192000,0,0,0,0,0,1,-1,9927,9951,-24,-1,3633,3633,0,-1,3603,3603,0,-1,926,926,0
3803,20000,16000,1,1,1,1,1,1,2,20732,0,20732,3,19946,0,19946,2,19546,0,19546,0,19546,0,19546
3804,90000,72000,0,0,0,0,0,0,0,16985,1000,15985,0,12985,1000,11985,0,285,500,-215,-1,-4715,0,-4715
3805,90000,72000,0,0,0,0,0,0,0,53990,5100,48890,0,51752,0,51752,2,50346,200,50146,0,48811,20,48791
3806,200000,160000,0,0,0,0,0,0,0,0,0,0,-2,0,0,0,-2,0,0,0,-2,0,0,0
3807,260000,208000,0,0,0,0,0,0,0,158124,5115,153009,0,62373,2000,60373,0,746,746,0,-1,-45734,5025,-50759
3808,100000,80000,0,0,0,0,0,0,0,45117,2000,43117,0,25845,2030,23815,0,7141,3000,4141,0,9141,2000,7141
3809,280000,224000,0,0,0,0,0,0,-1,4197,4399,-202,-1,3755,18,3737,0,0,0,0,0,0,0,0
3810,140000,112000,0,0,0,0,0,1,-1,4326,4326,0,-1,6380,6398,-18,-1,48866,48866,0,-1,23797,3500,20297
3811,170000,136000,0,0,0,0,0,1,0,123414,5800,117614,0,114180,6000,108180,0,122332,11600,110732,0,120270,0,120270
3812,300000,240000,1,1,1,1,1,0,0,325020,11877,313143,0,319750,10487,309263,0,265136,7831,257305,0,262378,8092,254286
3813,80000,64000,1,1,1,1,1,0,0,163959,6000,157959,0,168187,6000,162187,0,171869,5500,166369,0,175524,5500,170024
3814,150000,120000,0,0,0,0,0,0,-2,0,0,0,-2,0,0,0,-2,0,0,0,-2,0,0,0
3815,10000,8000,0,0,1,1,1,0,0,9018,1136,7882,0,9198,316,8882,0,9896,833,9063,0,9703,100,9603
3816,210000,168000,0,0,0,0,0,0,0,118496,5000,113496,0,116033,4036,111997,0,114617,5000,109617,0,108328,4000,104328
3817,200000,160000,0,0,0,0,0,0,-1,381,381,0,-2,1060,1060,0,-1,429,429,0,-1,0,0,0
3818,60000,48000,0,0,0,0,0,0,0,50293,5000,45293,0,26667,2000,24667,0,26608,1000,25608,0,27665,1500,26165
3819,300000,240000,0,0,0,0,0,0,-1,3420,3000,420,0,814,0,814,0,-494,0,-494,0,8006,8500,-494
3820,50000,40000,0,0,0,0,0,0,0,19894,1600,18294,0,20294,1000,19294,0,20145,900,19245,0,20175,1000,19175
3821,150000,120000,0,0,0,0,0,0,0,68125,6000,62125,0,66432,0,66432,2,73312,8023,65289,2,72015,0,72015
3822,100000,80000,0,0,0,0,0,1,-1,7725,2704,5021,0,11246,5250,5996,0,9755,4,9751,0,8260,0,8260
3823,400000,320000,0,0,0,0,0,0,-1,5856,8863,-3007,-1,6401,1032,5369,0,389,390,-1,-1,21447,21448,-1
3824,260000,208000,0,0,0,0,0,1,-1,4970,4970,0,-1,4012,4012,0,-1,3651,3651,0,-1,5600,5600,0
3825,150000,120000,0,0,0,0,0,0,-1,0,0,0,-1,1872,1872,0,-1,0,0,0,-1,113,113,0
3826,150000,120000,0,0,0,0,0,0,0,23590,5003,18587,0,27810,5000,22810,0,38000,10190,27810,0,0,0,0
3827,100000,80000,0,0,0,0,0,0,-2,12146,12146,0,-2,752,752,0,-2,5931,5931,0,-2,7855,7855,0
3828,80000,64000,0,0,0,0,0,1,-1,24770,24770,0,-1,3366,3366,0,-1,1473,1473,0,-1,44314,44314,0
3829,230000,184000,0,0,0,0,0,0,0,2720,1000,1720,0,3720,1000,2720,0,0,0,0,0,0,0,0
3830,380000,304000,0,0,0,0,0,0,2,2300,2300,0,-1,632,632,0,-1,316,0,316,0,316,316,0
3831,210000,168000,0,0,0,0,0,0,-1,31793,31793,0,-1,32943,1943,31000,0,30019,819,29200,0,30657,763,29894
3832,50000,40000,0,0,0,0,0,0,0,22300,3007,19293,0,4067,1000,3067,0,1290,1290,0,-1,0,0,0
3833,90000,72000,0,0,0,0,0,0,0,42219,3000,39219,0,1769,1000,769,0,2269,500,1769,0,3269,1000,2269
3834,220000,176000,0,0,0,0,0,0,0,33494,3000,30494,0,29518,3000,26518,0,29569,6000,23569,0,28587,5000,23587
3835,200000,160000,0,1,0,0,0,0,0,189643,9427,180216,0,115046,5934,109112,0,24895,13000,11895,0,35410,11000,24410
3836,150000,120000,0,0,0,0,0,0,0,42405,1800,40605,0,43498,1800,41698,0,44596,1800,42796,0,45700,2000,43700
3837,230000,184000,0,0,0,0,0,0,2,0,0,0,-2,0,0,0,-2,0,0,0,-2,470,470,0
3838,200000,160000,0,0,0,0,0,0,-2,618,621,-3,-2,605,608,-3,-2,3098,3114,-16,-2,805,1003,-198
3839,50000,40000,0,1,0,0,0,0,0,49234,1452,47782,0,21067,1200,19867,0,15007,300,14707,0,31043,27000,4043
3840,320000,256000,0,0,0,0,0,0,-1,8477,8489,-12,-1,18428,18443,-15,-1,119,0,119,0,9416,9416,0
3841,130000,104000,0,0,0,0,0,0,0,86004,3059,82945,0,87718,3080,84638,0,90720,4355,86365,0,87851,3323,84528
3842,80000,64000,1,1,1,0,0,0,2,80903,6,80897,2,80215,3636,76579,0,63296,2646,60650,0,49854,2000,47854
3843,80000,64000,0,0,0,0,0,0,0,40805,3681,37124,0,35740,1300,34440,2,32684,0,32684,2,32605,1500,31105
3844,320000,256000,0,0,0,0,0,0,0,199761,7821,191940,0,187759,7361,180398,0,68920,2227,66693,0,62702,2046,60656
3845,250000,200000,0,0,0,0,0,0,-1,0,0,0,-1,0,0,0,-2,955,955,0,-2,8175,8200,-25
3846,170000,136000,1,1,1,1,1,1,0,181490,9000,172490,0,169608,7000,162608,0,163255,3500,159755,0,168395,7000,161395
3847,110000,88000,0,1,0,0,0,0,0,107558,3500,104058,0,80437,10000,70437,0,79727,3000,76727,0,81001,3000,78001
3848,340000,272000,0,0,0,0,0,0,0,167592,6207,161385,0,162628,5758,156870,0,142779,4853,137926,0,139548,4940,134608
3849,50000,40000,0,0,0,0,1,1,0,27068,1451,25617,0,28604,1987,26617,0,28199,1039,27160,0,58428,1500,56928
3850,360000,288000,0,1,1,0,0,0,0,366591,15502,351089,0,331833,13801,318032,0,288709,9852,278857,0,290583,10224,280359
3851,220000,176000,0,0,0,0,0,0,0,173565,8000,165565,0,176156,7000,169156,0,175745,7000,168745,0,160362,7000,153362
3852,220000,176000,0,0,0,0,0,0,0,93311,3600,89711,0,67900,3100,64800,0,64150,4000,60150,0,6000,6000,0
3853,20000,16000,0,0,1,1,0,0,0,17371,2000,15371,0,17873,651,17222,0,18073,500,17573,0,10817,1000,9817
3854,260000,208000,0,0,0,0,0,0,0,140836,5188,135648,0,153026,15000,138026,0,156108,7500,148608,0,158893,7000,151893
3855,220000,176000,0,0,0,0,0,0,0,125917,5600,120317,0,124683,5000,119683,0,127890,8000,119890,0,131520,6000,125520
3856,160000,128000,0,0,0,0,0,0,0,67648,2311,65337,2,66020,0,66020,2,67386,2377,65009,0,68336,2000,66336
3857,180000,144000,0,0,0,0,0,0,-2,5527,1000,4527,-2,1600,340,1260,-2,2600,1000,1600,-2,390,390,0
3858,440000,352000,0,1,1,1,1,0,0,447326,16519,430807,0,447112,16513,430599,0,438187,15800,422387,0,447543,16531,431012
3859,80000,64000,0,0,0,0,0,0,0,20896,1651,19245,0,21604,1359,20245,0,22035,790,21245,0,22496,817,21679
3860,80000,64000,0,1,1,1,1,0,0,81584,6900,74684,0,78795,0,78795,2,79402,2800,76602,0,80385,3100,77285
3861,140000,112000,0,1,1,0,0,0,0,138087,7210,130877,0,141620,15128,126492,0,110532,0,110532,2,111638,4200,107438
3862,50000,40000,0,0,1,1,1,0,0,47091,23000,24091,0,41660,1120,40540,0,47368,6000,41368,0,49317,2675,46642
3863,330000,264000,0,0,0,0,0,0,-1,15440,15440,0,-1,45033,35033,10000,0,64723,30000,34723,0,3784,3874,-90
3864,100000,80000,0,0,0,0,0,0,0,44601,2100,42501,0,45598,2000,43598,0,46752,2000,44752,0,48008,2010,45998
3865,30000,24000,0,0,0,0,0,1,0,15908,0,15908,2,16029,321,15708,0,6501,6501,0,-1,0,0,0
3866,240000,192000,0,0,0,0,0,1,-1,10412,10420,-8,-1,4578,1150,3428,0,5928,5928,0,-1,5619,3619,2000
3867,150000,120000,0,0,0,0,0,1,2,67164,65,67099,2,54078,1346,52732,0,9778,5051,4727,0,389,8601,-8212
3868,320000,256000,0,0,0,0,0,0,0,66871,4700,62171,0,69339,3000,66339,0,31525,5000,26525,0,30861,5000,25861
3869,380000,304000,0,0,0,0,0,0,-1,22101,22211,-110,-1,24038,24159,-121,-1,41215,41417,-202,-1,35010,35184,-174
3870,30000,24000,0,0,0,0,0,1,2,17969,0,17969,2,20645,3000,17645,2,21666,1500,20166,2,21170,0,21170
3871,240000,192000,0,0,0,0,0,0,-1,11366,11366,0,-1,14231,14231,0,-1,11135,11135,0,-1,7774,7774,0
3872,10000,8000,0,1,1,1,0,1,0,9784,1000,8784,0,9984,200,9784,0,9780,196,9584,0,0,0,0
3873,330000,264000,0,0,0,0,0,1,-2,0,0,0,-2,0,0,0,-2,0,0,0,-2,0,0,0
3874,140000,112000,0,0,0,0,0,0,0,21048,2500,18548,0,22332,2000,20332,0,30228,12988,17240,0,316,2168,-1852
3875,300000,240000,0,0,0,0,0,0,-1,780,780,0,-1,390,0,390,2,780,780,0,-1,780,0,780
3876,390000,312000,0,0,0,0,0,0,0,47678,12006,35672,0,47753,13006,34747,0,38671,4006,34665,0,50795,25011,25784
3877,50000,40000,0,1,0,0,0,0,0,49187,2454,46733,0,17518,1588,15930,0,17710,780,16930,0,18079,803,17276
3878,120000,96000,0,0,0,0,0,0,0,0,0,0,0,6849,6849,0,-1,6598,0,6598,2,16205,10000,6205
3879,80000,64000,0,0,0,0,0,0,0,41048,1874,39174,0,31786,2000,29786,0,29105,1011,28094,0,28294,1100,27194
3880,220000,176000,0,0,0,0,0,0,-2,0,0,0,-2,0,0,0,-2,0,0,0,-2,0,0,0
3881,150000,120000,0,0,0,0,0,0,0,16452,2000,14452,0,17281,2000,15281,0,18576,2000,16576,0,18783,2000,16783
3882,310000,248000,0,0,0,0,0,0,0,77097,7097,70000,0,7636,7636,0,-1,0,0,0,-1,0,0,0
3883,50000,40000,0,0,0,0,0,0,0,2636,2636,0,-1,4652,2500,2152,0,6390,2128,4262,0,8880,2880,6000
3884,50000,40000,0,0,0,0,0,0,0,26135,2000,24135,0,26730,1167,25563,0,12180,1017,11163,0,18179,18179,0
3885,360000,288000,0,0,0,0,0,0,0,2224,5,2219,2,1206,12,1194,0,-11,0,-11,0,2216,2227,-11
3886,90000,72000,0,1,0,0,0,0,0,88988,5100,83888,0,50780,2200,48580,0,50929,2200,48729,0,48735,1944,46791
3887,140000,112000,0,0,0,0,0,0,-2,0,0,0,-2,0,0,0,-2,959,959,0,-1,0,0,0
3888,20000,16000,0,0,0,0,0,0,-2,2227,2227,0,-2,1357,1357,0,-2,1357,1357,0,-2,4500,4500,0
3889,50000,40000,0,1,1,1,1,0,0,45510,2063,43447,0,46501,2054,44447,0,47119,1672,45447,0,47321,1946,45375
3890,220000,176000,0,0,0,0,0,1,2,6442,1300,5142,0,7458,1281,6177,0,8177,1000,7177,0,111816,103860,7956
3891,360000,288000,0,0,0,0,0,1,-1,0,0,0,-2,0,0,0,-2,0,0,0,-2,629,629,0
3892,150000,120000,0,0,0,0,0,0,0,34300,2500,31800,0,35100,1000,34100,0,-1200,0,-1200,0,-1200,0,-1200
3893,140000,112000,0,0,0,0,0,1,2,1982,1982,0,-1,991,0,991,0,1091,1091,0,-1,1420,1420,0
3894,100000,80000,0,1,1,0,0,0,0,94977,3000,91977,0,97332,3139,94193,0,74637,27000,47637,0,77386,4000,73386
3895,170000,136000,0,0,0,0,0,0,0,138145,4707,133438,0,125499,4400,121099,0,124205,4450,119755,0,123940,4650,119290
3896,30000,24000,0,0,0,0,0,0,0,3437,1100,2337,0,5365,2000,3365,0,6275,1000,5275,0,7172,1000,6172
3897,210000,168000,0,0,0,0,0,0,0,70449,3357,67092,0,66311,2098,64213,0,26802,610,26192,0,25029,763,24266
3898,80000,64000,0,1,1,1,1,0,2,72307,6507,65800,2,70556,0,70556,2,74021,5260,68761,2,75675,3000,72675
3899,590000,472000,0,0,0,0,0,0,-2,35498,35552,-54,-2,0,0,0,-2,0,0,0,-2,0,0,0
3900,50000,40000,0,0,0,0,0,1,0,5391,1100,4291,0,6401,1106,5295,0,6528,233,6295,0,6664,241,6423
3901,50000,40000,0,0,0,0,0,0,0,12630,2022,10608,0,9215,2000,7215,0,9215,0,9215,0,8011,1000,7011
3902,400000,320000,0,0,0,0,0,0,-2,11192,11242,-50,-2,0,0,0,-2,0,0,0,-2,0,0,0
3903,120000,96000,0,1,1,1,1,1,2,122209,4436,117773,0,122047,4370,117677,0,122019,4440,117579,0,130079,12600,117479
3904,110000,88000,0,1,0,0,0,0,0,104855,3900,100955,0,74737,3000,71737,0,76058,2900,73158,0,77254,3000,74254
3905,220000,176000,0,0,0,0,0,0,-1,10836,10836,0,-1,26227,18590,7637,0,18590,0,18590,0,785,785,0
3906,450000,360000,0,0,0,0,0,0,0,232762,50171,182591,0,208005,7096,200909,0,194608,6604,188004,0,201044,10012,191032
3907,60000,48000,0,1,1,1,1,0,0,54784,5000,49784,2,58232,5000,53232,2,61670,5000,56670,4,65120,5000,60120
3908,100000,80000,0,0,0,0,0,0,-1,476,476,0,-1,476,476,0,-1,476,476,0,-1,1075,1075,0
3909,80000,64000,0,0,0,0,0,0,-1,1130,1246,-116,-1,397,397,0,-1,42857,42860,-3,-1,41864,7,41857
3910,200000,160000,0,0,0,0,0,1,-1,2500,2500,0,-1,0,0,0,-1,0,0,0,-2,0,0,0
3911,230000,184000,0,0,0,0,0,0,2,6254,6270,-16,-1,16549,14085,2464,0,6392,6396,-4,0,1828,9,1819
3912,50000,40000,0,0,0,0,0,0,2,19590,800,18790,2,19209,200,19009,2,19456,674,18782,0,35976,636,35340
3913,50000,40000,0,0,0,0,0,0,-1,20731,15,20716,2,13555,587,12968,0,2338,2338,0,-1,41191,41191,0
3914,150000,120000,0,0,0,0,0,0,-1,4592,0,4592,2,8617,4025,4592,0,2190,407,1783,0,1369,0,1369
3915,240000,192000,0,0,0,0,0,0,0,454,454,0,-1,2500,2500,0,-1,0,0,0,-1,0,0,0
3916,200000,160000,0,0,0,0,0,0,0,153409,14834,138575,0,145476,0,145476,2,119025,4575,114450,0,115255,4180,111075
3917,310000,248000,0,1,1,0,0,0,0,301646,10979,290667,0,292673,10950,281723,0,253269,9281,243988,0,256259,9304,246955
3918,50000,40000,0,0,0,0,0,0,0,9541,9021,520,0,5411,6000,-589,-1,4782,4000,782,0,3192,2500,692
3919,290000,232000,0,0,0,0,0,0,-1,2417,2429,-12,-1,4583,4598,-15,-1,1402,7,1395,0,3227,3227,0
3920,210000,168000,0,0,0,0,0,0,-1,820,820,0,-1,820,820,0,-1,820,820,0,-1,820,820,0
3921,50000,40000,0,1,0,0,0,0,0,50355,2000,48355,0,0,0,0,0,0,0,0,-2,0,0,0
3922,220000,176000,0,1,1,1,1,0,0,216513,9639,206874,0,196219,7123,189096,0,200117,7162,192955,0,204312,7419,196893
3923,20000,16000,0,0,0,0,0,0,0,-391,160,-551,0,19413,20394,-981,-1,12223,347,11876,0,2110,2110,0
3924,80000,64000,0,1,1,0,0,0,0,77438,2734,74704,0,67054,2215,64839,0,60270,4000,56270,0,56138,2036,54102
3925,220000,176000,0,0,0,0,0,0,0,29708,3000,26708,0,25407,800,24607,0,25109,5000,20109,0,23320,5000,18320
3926,50000,40000,0,0,0,0,0,1,0,3403,3423,-20,-1,1999,2005,-6,-1,500,501,-1,-1,0,0,0
3927,50000,40000,0,0,0,0,0,0,-2,0,0,0,-2,6954,6954,0,-1,7361,500,6861,0,6957,1000,5957
3928,130000,104000,0,0,0,0,0,0,-2,0,0,0,-2,0,0,0,-2,0,0,0,-2,0,0,0
3929,50000,40000,0,1,0,0,0,0,0,49158,1298,47860,0,19270,700,18570,0,18776,800,17976,0,19167,815,18352
3930,180000,144000,0,0,0,0,0,0,0,0,0,0,-2,0,0,0,-2,0,0,0,-2,0,0,0
3931,430000,344000,0,0,0,0,0,0,-1,31401,31448,-47,-1,417588,417588,0,-1,3414,3414,0,-1,4761,4761,0
3932,360000,288000,0,1,1,0,0,0,0,320709,22023,298686,0,310208,12023,298185,0,289883,10023,279860,0,279709,10823,268886
3933,50000,40000,0,0,0,0,0,0,0,26372,0,26372,2,26992,1400,25592,0,27693,1100,26593,0,29237,2100,27137
3934,140000,112000,0,0,0,0,0,0,-1,0,0,0,-2,0,0,0,-2,0,0,0,-2,0,0,0
3935,50000,40000,0,0,0,0,0,0,2,35046,5,35041,2,28893,1200,27693,0,28772,2000,26772,0,27521,1100,26421
3936,210000,168000,0,1,1,0,0,0,0,212391,9207,203184,0,208931,8500,200431,0,146005,5200,140805,0,145343,5200,140143
3937,20000,16000,0,0,0,0,0,0,-2,1464,1464,0,-2,1466,1466,0,-2,1691,1691,0,-2,4565,4565,0
3938,100000,80000,0,0,0,0,0,0,0,48783,2000,46783,0,49981,2000,47981,0,44211,1514,42697,0,48568,5000,43568
3939,130000,104000,0,1,0,0,0,0,0,128300,6000,122300,0,89007,4200,84807,0,90126,3500,86626,0,98665,10000,88665
3940,160000,128000,0,0,0,0,0,0,-1,3707,3707,0,-1,6987,6991,-4,-1,3853,77,3776,0,4613,4613,0
3941,200000,160000,0,0,0,0,0,0,-1,3587,3598,-11,-1,0,0,0,-1,2160,2160,0,-1,900,900,0
3942,350000,280000,0,0,0,0,0,0,-1,3816,0,3816,2,4223,4223,0,-1,1414,1414,0,-1,5941,5941,0
3943,30000,24000,0,0,0,1,1,0,0,24124,1725,22399,0,27012,3613,23399,0,26279,0,26279,2,26831,975,25856
3944,120000,96000,0,0,0,0,0,0,0,80333,3062,77271,0,82497,3000,79497,0,84438,2773,81665,0,86332,3000,83332
3945,150000,120000,0,1,1,0,0,0,0,148839,6112,142727,0,147746,6023,141723,0,116537,4626,111911,0,36404,1035,35369
3946,180000,144000,0,0,0,0,0,0,-1,1190,1190,0,-1,1079,0,1079,0,659,659,0,-1,90,90,0
3947,90000,72000,0,0,0,0,0,1,2,29268,0,29268,2,31776,3000,28776,2,32456,1500,30956,2,31800,0,31800
3948,110000,88000,0,1,0,0,0,0,0,98160,5045,93115,0,57257,7021,50236,0,54863,7000,47863,0,53510,5000,48510
3949,180000,144000,0,1,1,1,1,0,0,183936,8021,175915,0,181370,6315,175055,0,179904,6432,173472,0,172758,6409,166349
3950,70000,56000,0,1,0,0,0,1,0,62497,3200,59297,0,47581,2000,45581,0,48805,2000,46805,0,50018,2000,48018
3951,50000,40000,0,0,0,0,0,0,-1,103,103,0,-1,249,245,4,0,386,386,0,-1,11504,11504,0
3952,170000,136000,0,0,0,0,0,0,-2,0,0,0,-2,0,0,0,-2,0,0,0,-2,0,0,0
3953,300000,240000,0,0,0,0,0,0,0,195533,5536,189997,0,98158,5052,93106,0,66438,1794,64644,0,68863,5000,63863
3954,180000,144000,0,0,0,0,0,0,0,109741,5000,104741,0,112907,5000,107907,0,115924,5000,110924,0,118832,5000,113832
3955,160000,128000,0,0,0,0,0,0,-1,2164,2164,0,-1,3975,2000,1975,0,3720,1500,2220,0,5668,2000,3668
3956,250000,200000,0,0,0,0,0,0,0,6126,1500,4626,0,7514,1500,6014,0,8883,1500,7383,0,12860,4200,8660
3957,20000,16000,0,0,0,0,1,0,-1,15018,10000,5018,0,15991,1549,14442,0,18442,3000,15442,0,18827,790,18037
3958,190000,152000,0,0,0,0,0,0,-1,478,478,0,-1,10035,10035,0,-1,24345,24345,0,-1,1150,1191,-41
3959,160000,128000,0,0,0,0,0,0,-1,326,326,0,-1,326,326,0,-1,326,326,0,-1,326,326,0
3960,150000,120000,0,0,0,0,0,0,2,1782,1782,0,-1,1600,1600,0,-1,0,0,0,-1,11665,11665,0
3961,230000,184000,0,0,0,0,0,0,-2,2035,2035,0,-2,6337,6337,0,-2,3388,3388,0,-2,2132,2132,0
3962,20000,16000,0,0,0,0,0,0,0,6097,0,6097,3,6339,511,5828,2,5143,300,4843,0,5126,300,4826
3963,30000,24000,0,0,0,0,0,0,0,18127,2013,16114,0,14439,2001,12438,0,11026,2002,9024,0,10523,1500,9023
3964,40000,32000,0,0,0,0,0,0,0,19085,1665,17420,0,17550,1000,16550,0,0,0,0,0,0,0,0
3965,30000,24000,0,0,0,0,0,1,0,21520,1600,19920,0,18669,700,17969,0,15710,1401,14309,0,15308,0,15308
3966,500000,400000,0,0,0,0,0,0,0,333041,15040,318001,0,294173,12018,282155,0,300616,15028,285588,0,266973,10038,256935
3967,400000,320000,0,0,0,0,0,0,0,97702,3780,93922,0,98972,3000,95972,0,101154,3004,98150,0,102371,2988,99383
3968,20000,16000,0,0,0,0,1,1,2,16572,4000,12572,0,15556,1238,14318,0,18268,4500,13768,0,17319,675,16644
3969,170000,136000,0,0,0,0,0,1,-2,550,550,0,-1,0,0,0,-1,0,0,0,-2,0,0,0
3970,80000,64000,0,0,0,0,0,0,-2,0,0,0,-2,0,0,0,-2,0,0,0,-2,442,442,0
3971,150000,120000,0,0,0,0,0,0,-2,0,0,0,-2,65696,65696,0,-1,67148,3000,64148,0,68460,3000,65460
3972,20000,16000,0,0,0,0,0,0,0,11292,1220,10072,0,10790,608,10182,0,780,780,0,-1,780,0,780
3973,150000,120000,0,0,0,0,0,1,-2,0,0,0,-2,0,0,0,-2,0,0,0,-2,0,0,0
3974,30000,24000,0,0,1,0,1,0,0,26319,3000,23319,0,26868,2000,24868,0,25345,3304,22041,0,26781,2000,24781
3975,80000,64000,0,0,0,0,0,1,2,59831,2100,57731,2,60554,2300,58254,2,61938,2500,59438,2,63269,2500,60769
3976,150000,120000,0,0,0,0,0,0,-1,0,0,0,-1,0,0,0,-2,0,0,0,-2,0,0,0
3977,200000,160000,0,0,0,0,0,0,-2,15546,15616,-70,-2,1665,1673,-8,-2,3370,3385,-15,-2,-36,0,-36
3978,100000,80000,0,0,0,0,0,0,0,1473,1473,0,-1,2946,2946,0,-1,1473,0,1473,0,540,540,0
3979,180000,144000,0,0,0,0,0,0,-1,0,0,0,-1,7500,7500,0,-1,4100,4100,0,-1,0,0,0
3980,50000,40000,1,1,1,1,0,0,0,86152,4000,82152,0,56250,2257,53993,0,57603,2000,55603,0,19336,2000,17336
3981,180000,144000,0,0,0,0,0,0,-2,22630,22657,-27,-2,7777,7777,0,-2,3089,3089,0,-2,8429,8429,0
3982,10000,8000,0,0,0,0,0,0,-1,5797,5805,-8,-1,7727,4013,3714,0,4196,4217,-21,0,0,4,-4
3983,20000,16000,0,1,1,1,1,0,0,19991,1296,18695,0,20305,1000,19305,0,19349,696,18653,0,20467,2213,18254
3984,50000,40000,0,0,0,0,0,1,2,26755,4000,22755,2,26026,0,26026,2,27310,2000,25310,0,29729,3000,26729
3985,140000,112000,0,0,0,0,0,0,0,6455,1108,5347,0,6847,500,6347,0,8075,1500,6575,0,8592,650,7942
3986,20000,16000,0,1,0,0,0,1,0,19900,1000,18900,0,390,390,0,-1,390,390,0,-1,0,0,0
3987,210000,168000,0,0,0,0,0,0,-1,1409,1409,0,-1,1549,1549,0,-1,2454,2454,0,-1,946,946,0
3988,170000,136000,0,0,0,0,0,0,0,63311,3000,60311,0,57304,2200,55104,0,51663,2000,49663,0,45795,1700,44095
3989,210000,168000,0,0,0,0,0,0,-1,871,871,0,-1,871,871,0,-1,2042,2042,0,-1,1021,0,1021
3990,70000,56000,0,0,0,0,0,0,-1,14336,15000,-664,-1,13155,4000,9155,0,3929,4000,-71,-1,1953,0,1953
3991,620000,496000,0,0,0,0,0,0,0,59306,2500,56806,0,60479,2500,57979,0,61467,2300,59167,0,63159,3000,60159
3992,360000,288000,0,0,0,0,0,0,-1,26194,26194,0,-1,0,0,0,-1,3550,3550,0,-1,2511,2511,0
3993,200000,160000,0,0,0,0,0,0,-2,0,0,0,-2,0,0,0,-2,0,0,0,-2,0,0,0
3994,100000,80000,0,0,0,0,0,0,0,17916,1506,16410,0,12233,1209,11024,0,6741,0,6741,0,-24,0,-24
3995,30000,24000,0,1,1,1,0,1,0,26257,2000,24257,0,27641,2000,25641,0,29335,2000,27335,0,10493,1000,9493
3996,230000,184000,0,0,0,0,0,0,0,153635,6015,147620,0,74503,2663,71840,0,46254,5015,41239,0,141916,100095,41821
3997,50000,40000,0,0,0,0,0,0,-1,1448,1448,0,-1,2535,2535,0,-1,0,0,0,-1,0,0,0
3998,260000,208000,0,0,0,0,0,0,0,93742,4026,89716,0,93369,3481,89888,0,82476,141,82335,0,73789,20074,53715
3999,40000,32000,0,1,1,1,1,0,0,37648,1700,35948,0,38804,2000,36804,0,39651,2000,37651,0,40794,2000,38794
4000,240000,192000,0,0,0,0,0,0,2,14015,14015,0,-1,0,0,0,-1,1317,1317,0,-1,566,0,566
4001,110000,88000,0,0,0,0,0,0,0,21654,2000,19654,0,21998,1400,20598,0,23255,2000,21255,0,24527,1800,22727
4002,410000,328000,0,0,0,0,0,1,0,5063,4867,196,0,1019,803,216,0,14585,14436,149,0,5370,5396,-26
4003,250000,200000,0,0,0,0,0,0,0,67448,2658,64790,0,68165,3000,65165,0,68787,4000,64787,0,70111,3000,67111
4004,180000,144000,0,1,1,0,0,0,0,169362,8000,161362,0,163957,5500,158457,0,138409,5000,133409,0,132864,5500,127364
4005,170000,136000,0,0,0,0,0,0,0,21660,5000,16660,0,23307,6538,16769,0,15135,4167,10968,0,3527,3527,0
4006,140000,112000,0,0,0,0,0,0,0,17985,0,17985,2,20225,3000,17225,0,27407,7800,19607,0,10833,0,10833
4007,500000,400000,0,0,0,0,0,1,-1,5306,5308,-2,-1,5453,1000,4453,0,3221,0,3221,0,1269,0,1269
4008,20000,16000,1,1,1,1,1,0,7,35381,0,35381,6,31539,0,31539,5,27409,0,27409,4,23567,0,23567
4009,50000,40000,0,0,0,0,0,1,0,19281,2400,16881,0,18679,5700,12979,0,12980,8000,4980,0,8592,3062,5530
4010,500000,400000,0,0,0,0,0,0,0,28171,28005,166,0,26498,22000,4498,0,45212,33000,12212,0,35223,22000,13223
4011,70000,56000,0,0,0,0,0,1,2,45375,2051,43324,2,44350,0,44350,2,46996,3697,43299,2,47951,1853,46098
4012,200000,160000,0,0,1,0,0,0,-2,2321,2321,0,-2,327194,163597,163597,-2,6680,6680,0,-2,3963,3963,0
4013,50000,40000,0,1,0,0,0,1,2,42977,2000,40977,0,36737,1317,35420,0,19865,700,19165,0,16499,599,15900
4014,110000,88000,0,0,0,0,0,0,0,19413,1392,18021,0,20204,1183,19021,0,16627,511,16116,0,14980,1151,13829
4015,500000,400000,0,0,0,0,0,0,-1,17740,17840,-100,-1,36657,36639,18,0,2631,2644,-13,-1,26231,26363,-132
4016,450000,360000,0,0,0,0,0,0,0,118192,12029,106163,0,82644,35524,47120,0,17720,38,17682,0,7068,2015,5053
4017,50000,40000,0,1,1,1,1,0,0,47306,400,46906,2,49296,3000,46296,2,47220,2,47218,2,49584,4005,45579
4018,50000,40000,0,0,0,0,0,0,0,20486,1645,18841,0,21241,1400,19841,0,21788,900,20888,0,23281,2000,21281
4019,200000,160000,0,0,0,0,0,0,0,7246,3320,3926,0,3506,0,3506,2,2376,2400,-24,-1,123687,127187,-3500
4020,20000,16000,0,0,0,0,0,1,-1,5081,5081,0,-1,888,888,0,-1,0,0,0,-1,0,0,0
4021,70000,56000,0,0,0,0,0,1,0,25059,2000,23059,0,26834,2400,24434,0,14112,2012,12100,0,28191,14500,13691
4022,140000,112000,0,0,0,0,0,0,0,76167,6029,70138,0,66410,8000,58410,0,71150,6000,65150,0,75781,6000,69781
4023,200000,160000,0,0,0,0,0,0,0,5134,1001,4133,0,245,501,-256,0,56,201,-145,-2,167,501,-334
4024,80000,64000,0,0,0,0,0,0,0,61018,1752,59266,0,36084,1105,34979,0,13693,1499,12194,0,79701,78000,1701
4025,210000,168000,0,0,0,0,0,0,-1,-204,0,-204,-1,-204,0,-204,-2,-204,0,-204,-2,-204,0,-204
4026,470000,376000,0,0,0,0,0,0,0,143173,7000,136173,0,145293,6000,139293,0,148871,6000,142871,0,152309,6000,146309
4027,360000,288000,0,0,0,0,0,0,0,77461,20000,57461,0,79025,3500,75525,0,75556,2300,73256,0,63097,5000,58097
4028,360000,288000,0,0,0,0,0,0,-1,19560,19623,-63,-1,8894,222,8672,0,5329,5355,-26,-1,998,998,0
4029,50000,40000,0,0,0,0,0,1,0,4166,1000,3166,0,0,0,0,0,0,0,0,-2,0,0,0
4030,90000,72000,0,0,0,0,0,0,0,44354,2037,42317,0,45372,2055,43317,0,46317,2000,44317,0,51292,5913,45379
4031,30000,24000,0,0,0,0,0,0,-1,390,390,0,-1,1050,1050,0,-2,1251,1851,-600,-1,962,962,0
4032,170000,136000,0,0,0,0,0,0,0,37069,0,37069,2,37960,1508,36452,0,38796,1600,37196,0,39267,1264,38003
4033,140000,112000,0,0,0,0,0,0,0,111220,3910,107310,0,75706,4604,71102,0,69278,4000,65278,0,58589,3000,55589
4034,50000,40000,0,0,0,0,0,0,0,11151,1073,10078,0,7921,230,7691,0,6949,241,6708,0,4716,138,4578
4035,290000,232000,0,0,0,0,0,0,2,2467,2467,0,-1,166,200,-34,-1,4030,6000,-1970,-1,9097,6000,3097
4036,200000,160000,0,0,0,0,0,0,-1,33749,1492,32257,0,28355,1402,26953,0,29465,2002,27463,0,30885,2007,28878
4037,260000,208000,0,0,0,0,0,1,-1,3896,0,3896,2,119498,119498,0,-1,109399,3500,105899,0,111203,3983,107220
4038,350000,280000,0,0,0,0,0,0,-1,15059,15059,0,-1,13000,13000,0,-1,25300,25300,0,-1,626,626,0
4039,50000,40000,0,0,0,0,0,0,2,22782,5000,17782,0,32304,10000,22304,0,31519,0,31519,2,23724,6724,17000
4040,210000,168000,0,0,0,0,0,0,0,171135,10000,161135,0,166199,10000,156199,0,144060,10000,134060,0,132326,10000,122326
4041,20000,16000,0,0,0,0,0,0,0,0,1000,-1000,-2,1828,1828,0,-1,2800,1500,1300,0,0,0,0
4042,240000,192000,0,0,0,0,0,1,2,2500,0,2500,2,0,0,0,2,0,0,0,-2,0,0,0
4043,200000,160000,0,0,0,0,0,0,-1,4251,4251,0,-1,1358,1358,0,-1,300,300,0,-1,0,8909,-8909
4044,30000,24000,0,0,0,0,0,0,-1,3312,3321,-9,-1,3145,3154,-9,-1,3022,3031,-9,-1,3247,3339,-92
4045,200000,160000,0,0,0,0,0,1,2,-125,0,-125,2,-515,0,-515,-2,-905,0,-905,-2,-905,0,-905
4046,320000,256000,0,0,0,0,0,0,0,241384,12000,229384,0,156047,7500,148547,0,153955,6200,147755,0,133407,4600,128807
4047,80000,64000,0,0,0,0,0,0,-1,0,0,0,-1,680,680,0,-1,2862,2862,0,-1,5539,5539,0
4048,10000,8000,0,0,1,1,1,0,0,8305,1700,6605,0,9405,1230,8175,0,9100,0,9100,2,13392,761,12631
4049,200000,160000,0,0,0,0,0,1,2,54736,5000,49736,2,55424,2000,53424,2,56101,2000,54101,2,57137,1900,55237
4050,340000,272000,0,0,0,0,0,0,0,193224,9000,184224,2,192578,4000,188578,2,195073,7200,187873,0,206924,15200,191724
4051,230000,184000,0,0,0,0,0,0,-1,3878,397,3481,2,4824,2720,2104,2,2720,0,2720,2,1526,1000,526
4052,250000,200000,0,0,0,0,0,0,2,0,0,0,2,0,0,0,-2,0,0,0,-2,1604,1604,0
4053,30000,24000,0,0,0,0,0,0,2,8339,1000,7339,0,8730,1000,7730,0,9386,1300,8086,0,3014,0,3014
4054,10000,8000,0,0,0,0,0,0,0,0,0,0,-2,0,0,0,-2,1864,1864,0,-1,1720,50,1670
4055,220000,176000,0,1,1,1,1,0,0,209214,9800,199414,0,210965,7200,203765,0,214989,7700,207289,0,203159,7500,195659
4056,10000,8000,0,0,0,1,1,0,0,7447,1200,6247,0,8777,1500,7277,0,8956,400,8556,0,9731,1000,8731
4057,130000,104000,0,0,0,0,0,0,-2,0,0,0,-2,0,0,0,-2,0,0,0,-2,0,0,0
4058,60000,48000,0,0,0,0,0,1,0,36558,0,36558,2,37945,2000,35945,0,38782,1600,37182,0,39582,1600,37982
4059,270000,216000,0,0,0,0,0,0,4,212058,8000,204058,3,207226,0,207226,3,202394,0,202394,2,231339,32236,199103
4060,130000,104000,0,0,0,0,0,0,0,104535,4000,100535,0,105349,6500,98849,0,105254,5400,99854,0,120756,124582,-3826
4061,50000,40000,0,0,0,0,0,0,0,6985,1055,5930,0,6354,656,5698,0,4908,0,4908,2,3724,133,3591
4062,20000,16000,0,1,1,1,1,1,2,18219,800,17419,2,17095,0,17095,2,19748,3500,16248,2,18722,0,18722
4063,230000,184000,0,0,0,0,0,0,0,170063,10000,160063,0,176893,10000,166893,0,183699,10000,173699,0,188700,10000,178700
4064,50000,40000,0,0,0,0,0,1,0,8434,1200,7234,0,8604,310,8294,0,8865,400,8465,0,9058,340,8718
4065,160000,128000,0,0,0,0,0,1,-1,625,625,0,-1,406,406,0,-1,338,338,0,-1,0,0,0
4066,20000,16000,0,0,0,0,0,0,-2,0,2000,-2000,-2,-1000,1000,-2000,-2,0,1000,-1000,-2,1222,1222,0
4067,260000,208000,0,0,0,0,0,0,0,115398,20084,95314,0,146597,50029,96568,0,159844,20139,139705,0,145729,15147,130582
4068,300000,240000,0,0,0,0,0,0,-2,0,0,0,-2,0,0,0,-2,0,0,0,-2,0,0,0
4069,300000,240000,0,0,0,0,0,0,-1,849,849,0,-1,0,0,0,-1,0,0,0,-2,112,112,0
4070,30000,24000,1,1,1,1,1,0,0,32006,1573,30433,0,31672,1500,30172,0,31247,1300,29947,0,30673,1300,29373
4071,30000,24000,0,1,1,1,1,0,0,28740,1448,27292,0,29313,1021,28292,0,29019,1040,27979,0,28916,1216,27700
4072,360000,288000,0,0,0,0,0,0,-1,10990,11046,-56,-1,74562,74934,-372,-1,-28,0,-28,-1,5677,5705,-28
4073,150000,120000,0,0,0,0,0,0,0,87096,7900,79196,0,84806,0,84806,2,85822,3300,82522,0,87504,3200,84304
4074,340000,272000,0,1,0,0,0,0,0,322454,11000,311454,0,275928,10000,265928,0,264601,10000,254601,0,265494,10000,255494
4075,90000,72000,0,1,0,0,0,1,0,88616,2625,85991,0,56887,2511,54376,0,46700,1501,45199,0,47272,1391,45881
4076,20000,16000,0,0,0,0,0,0,0,13560,1099,12461,0,11748,333,11415,0,10632,2000,8632,0,10019,2000,8019
4077,310000,248000,0,0,0,0,0,1,0,176630,6630,170000,0,180315,6379,173936,0,184072,6586,177486,0,188194,7086,181108
4078,20000,16000,0,0,0,0,0,1,0,19400,19400,0,-1,0,0,0,-1,0,0,0,-2,17666,17666,0
4079,50000,40000,0,0,0,0,0,1,0,15109,1210,13899,0,14125,487,13638,0,14034,508,13526,0,14946,1534,13412
4080,230000,184000,0,0,0,0,0,0,0,54463,5000,49463,0,53008,5000,48008,0,52835,10000,42835,0,40015,3000,37015
4081,50000,40000,0,0,0,1,0,0,0,0,0,0,0,50551,50551,0,-1,40590,0,40590,2,39384,1600,37784
4082,300000,240000,0,0,0,0,0,0,-1,69190,69190,0,-1,0,0,0,-1,686,686,0,-1,2927,2927,0
4083,50000,40000,0,1,1,1,1,0,0,49661,2013,47648,0,49581,1747,47834,0,49550,2012,47538,0,48871,2000,46871
4084,230000,184000,0,0,0,0,0,0,-1,65868,50014,15854,0,58171,8242,49929,0,56033,7032,49001,0,47192,5030,42162
4085,260000,208000,0,0,0,0,0,1,0,146127,9500,136627,0,143637,0,143637,2,154531,12766,141765,2,147016,0,147016
4086,30000,24000,0,0,0,0,0,0,-1,4440,0,4440,2,4050,0,4050,0,3660,0,3660,0,3660,0,3660
4087,20000,16000,0,1,1,1,0,0,0,18500,1400,17100,0,19014,1243,17771,0,19019,638,18381,0,17484,2000,15484
4088,220000,176000,0,1,1,1,1,0,0,217237,9656,207581,0,198681,7189,191492,0,202479,7404,195075,0,206221,7490,198731
4089,190000,152000,0,0,0,0,0,1,2,110887,4500,106387,2,111871,4300,107571,2,114223,4300,109923,2,116577,4400,112177
4090,20000,16000,0,1,1,0,0,0,0,17549,1400,16149,0,17702,1171,16531,0,10400,600,9800,0,0,0,0
4091,150000,120000,0,1,0,0,1,1,2,150080,2305,147775,2,47214,0,47214,2,144862,98828,46034,2,148153,4241,143912
4092,260000,208000,0,0,0,0,0,0,-2,0,0,0,-2,0,0,0,-2,0,0,0,-2,0,0,0
4093,10000,8000,1,1,1,0,0,1,0,13598,1528,12070,0,9378,0,9378,2,4883,730,4153,0,5001,199,4802
4094,20000,16000,0,0,0,0,0,0,0,5760,1500,4260,0,3343,1007,2336,0,1510,7,1503,0,0,0,0
4095,140000,112000,0,0,0,0,0,0,-1,0,0,0,-1,814,814,0,-1,0,0,0,-1,0,0,0
4096,50000,40000,0,0,0,0,0,1,0,21312,2130,19182,0,17398,500,16898,0,17773,2000,15773,0,17368,2000,15368
4097,200000,160000,0,0,0,0,1,0,0,151020,11620,139400,0,152040,5000,147040,2,164405,15000,149405,2,161525,0,161525
4098,160000,128000,0,0,0,0,0,1,-1,1302,0,1302,2,1852,1852,0,-1,736,0,736,0,3542,3542,0
4099,230000,184000,0,0,0,0,0,0,0,2425,2425,0,-1,2425,2425,0,-1,3850,3850,0,-1,2425,1000,1425
4100,240000,192000,0,0,0,0,0,0,-1,316,316,0,-1,632,632,0,-1,0,0,0,-1,316,316,0
4101,30000,24000,0,0,0,0,0,1,2,23785,3500,20285,2,24422,1319,23103,2,23688,0,23688,2,19626,800,18826
4102,10000,8000,0,0,0,1,1,1,0,7803,0,7803,2,8623,1100,7523,0,9527,1000,8527,0,9780,504,9276
4103,20000,16000,0,0,0,0,0,1,-2,0,0,0,-2,0,0,0,-2,0,0,0,-2,0,0,0
4104,50000,40000,0,1,1,1,1,1,0,45930,4000,41930,0,44891,0,44891,2,47654,3500,44154,2,48721,2000,46721
4105,190000,152000,0,0,0,0,0,1,-2,0,0,0,-2,0,0,0,-2,0,0,0,-2,0,0,0
4106,50000,40000,1,1,1,1,1,0,0,51981,0,51981,4,50805,0,50805,3,51518,1800,49718,2,50713,108,50605
4107,20000,16000,0,0,0,0,1,1,0,16059,1600,14459,0,16081,580,15501,0,17423,1600,15823,0,17695,700,16995
4108,50000,40000,0,0,0,0,0,1,0,14762,1000,13762,2,15232,1000,14232,0,16988,2000,14988,0,17912,1200,16712
4109,30000,24000,0,0,0,0,0,1,2,22544,4500,18044,2,21889,0,21889,2,22721,1500,21221,0,23401,1200,22201
4110,110000,88000,1,1,1,1,1,0,0,221798,0,221798,2,111960,4400,107560,0,111636,4218,107418,0,111733,4323,107410
4111,170000,136000,0,0,0,0,0,0,0,120475,6040,114435,0,109993,4000,105993,0,115151,8000,107151,0,112232,0,112232
4112,300000,240000,0,0,0,0,0,0,-2,0,0,0,-2,0,0,0,-2,0,0,0,-2,0,0,0
4113,420000,336000,0,0,0,0,0,0,0,19304,10013,9291,0,22304,10000,12304,0,28465,10000,18465,0,38182,20000,18182
4114,380000,304000,0,0,0,0,0,1,-1,8499,8549,-50,-1,53235,53471,-236,-1,101439,101785,-346,-1,34579,117,34462
4115,80000,64000,0,0,0,0,0,0,-1,898,898,0,-1,425,425,0,-1,0,0,0,-1,2791,2791,0
4116,50000,40000,0,0,0,0,0,1,0,20131,1200,18931,0,19940,399,19541,0,390,390,0,-1,540,540,0
4117,360000,288000,0,0,0,0,0,0,-2,0,0,0,-2,0,0,0,-2,0,0,0,-2,0,0,0
4118,10000,8000,0,1,1,1,1,0,0,9451,0,9451,3,9169,0,9169,2,10056,1002,9054,2,8559,0,8559
4119,20000,16000,0,0,0,0,0,0,0,-1001,0,-1001,0,-1,1000,-1001,-2,-1,0,-1,-2,-1,0,-1
4120,250000,200000,0,0,0,0,0,0,-1,3186,3186,0,-1,5161,5161,0,-1,0,0,0,-1,13714,13714,0
4121,200000,160000,0,0,0,0,0,0,0,3627,3700,-73,-1,6303,3000,3303,0,73,390,-317,0,-63,128,-191
4122,340000,272000,0,0,0,0,0,0,0,66293,3049,63244,0,57657,2706,54951,0,53035,1870,51165,0,54693,3000,51693
4123,80000,64000,0,0,0,0,0,1,-1,12540,0,12540,2,1261,0,1261,0,2705,2705,0,-1,1261,0,1261
4124,220000,176000,0,0,0,0,1,0,2,173233,0,173233,2,176859,8000,168859,0,182393,10000,172393,0,187446,8000,179446
4125,60000,48000,0,0,0,0,0,0,-2,15798,15798,0,-1,0,0,0,-1,0,0,0,-2,11688,11688,0
4126,90000,72000,0,0,0,0,0,0,-1,12148,12148,0,-1,880,880,0,-1,10880,10880,0,-1,880,880,0
4127,120000,96000,0,0,0,0,0,0,0,15452,2000,13452,0,12491,3010,9481,0,3550,1000,2550,0,2729,2000,729
4128,120000,96000,0,0,0,0,0,0,0,89890,4793,85097,0,88030,3013,85017,0,88579,3014,85565,0,89566,3522,86044
4129,310000,248000,0,0,0,0,0,0,-1,10124,10124,0,-1,10130,6,10124,0,7958,7958,0,-1,0,0,0
4130,190000,152000,0,0,0,0,0,1,2,117568,6000,111568,0,103011,5000,98011,0,101336,3300,98036,0,91215,5000,86215
4131,50000,40000,0,0,0,0,0,0,0,17217,1363,15854,0,18005,1151,16854,0,18369,515,17854,0,18888,670,18218
4132,330000,264000,0,0,0,0,0,0,-1,0,0,0,-1,0,0,0,-2,0,0,0,-2,0,0,0
4133,180000,144000,0,0,0,0,0,0,0,58994,2150,56844,0,60047,2200,57847,0,61389,2500,58889,0,63048,3000,60048
4134,30000,24000,0,0,0,0,0,1,2,200,0,200,2,200,0,200,2,200,0,200,2,200,0,200
4135,150000,120000,0,0,0,0,0,1,3,416,416,0,2,416,416,0,-1,416,416,0,-1,416,416,0
4136,240000,192000,0,0,0,0,0,1,-2,0,0,0,-2,0,0,0,-2,0,0,0,-2,0,0,0
4137,180000,144000,0,0,0,0,0,0,-1,10726,10726,0,-1,24104,24104,0,-1,326,326,0,-1,326,326,0
4138,20000,16000,0,0,0,0,0,0,0,8879,3000,5879,0,10926,3000,7926,0,17536,7000,10536,0,2090,2090,0
4139,140000,112000,0,0,0,0,0,0,0,0,0,0,0,150,150,0,-1,1550,1550,0,-1,98426,106155,-7729
4140,90000,72000,0,0,0,0,0,0,0,26046,14790,11256,0,10689,5000,5689,0,12455,5249,7206,0,15181,9932,5249
4141,10000,8000,0,0,0,0,0,1,2,1050,0,1050,3,1050,0,1050,3,1050,0,1050,3,1050,0,1050
4142,50000,40000,0,1,0,0,0,0,0,48890,2284,46606,0,8694,311,8383,0,8876,322,8554,0,9052,323,8729
4143,230000,184000,0,0,0,0,0,0,-1,0,0,0,-1,1012,1012,0,-1,0,0,0,-1,753,753,0
4144,270000,216000,0,0,0,0,0,0,0,104390,69563,34827,0,94856,2891,91965,0,86461,2689,83772,0,83650,3012,80638
4145,250000,200000,0,0,0,0,0,0,0,16780,1510,15270,0,16807,537,16270,0,17158,556,16602,0,17500,559,16941
4146,110000,88000,0,0,0,0,0,0,0,78516,5800,72716,2,79829,3200,76629,2,81603,3200,78403,2,83206,3100,80106
4147,170000,136000,0,0,0,0,0,0,-2,1000,2000,-1000,-1,1000,0,1000,2,0,0,0,2,0,0,0
4148,300000,240000,0,0,0,0,0,0,-2,3973,10000,-6027,-1,3973,0,3973,0,1244,1244,0,-1,1631,1631,0
4149,360000,288000,0,0,0,0,0,0,-1,-16,0,-16,-1,-16,0,-16,-2,3267,3283,-16,-1,3438,3455,-17
4150,60000,48000,0,1,1,1,1,0,0,50109,0,50109,2,50979,2000,48979,0,52998,3000,49998,0,54264,2300,51964
4151,200000,160000,0,0,0,0,0,0,-1,828,828,0,-1,0,0,0,-1,497,497,0,-1,1809,1809,0
4152,230000,184000,0,0,0,0,0,0,-1,326,326,0,-1,326,326,0,-1,326,326,0,-1,326,326,0
4153,80000,64000,0,1,0,0,0,1,0,78692,3100,75592,0,56032,2000,54032,0,57248,2100,55148,0,58515,2200,56315
4154,230000,184000,0,0,0,0,0,0,0,66081,2579,63502,0,64495,2100,62395,0,60511,2000,58511,0,57450,2000,55450
4155,50000,40000,0,0,0,0,0,0,0,18725,1165,17560,0,17848,522,17326,0,14610,1000,13610,0,11314,485,10829
4156,50000,40000,0,0,0,0,0,0,0,19313,2613,16700,0,18700,0,18700,2,0,0,0,2,0,0,0
4157,20000,16000,0,1,1,1,1,0,0,18340,1700,16640,0,18317,1570,16747,0,18747,1000,17747,0,19328,1000,18328
4158,360000,288000,0,0,0,0,0,0,-1,913,920,-7,-1,465,465,0,-1,157,157,0,-1,4247,4247,0
4159,240000,192000,0,0,0,0,0,1,0,193335,7500,185835,0,194976,7000,187976,0,197168,6622,190546,0,196918,17150,179768
4160,180000,144000,0,0,0,0,0,0,-1,5264,5293,-29,0,1521,1523,-2,0,0,0,0,-2,0,0,0
4161,40000,32000,0,0,0,0,0,1,2,11940,1200,10740,0,12241,500,11741,0,12544,500,12044,0,12835,500,12335
4162,40000,32000,0,1,1,1,1,0,2,39322,5000,34322,2,38319,0,38319,2,39531,2000,37531,0,40224,1400,38824
4163,50000,40000,0,0,0,0,0,0,-2,0,0,0,-2,0,0,0,-2,0,0,0,-2,0,0,0
4164,80000,64000,0,0,0,0,0,0,0,24099,5048,19051,0,7764,229,7535,0,4804,303,4501,0,10221,6018,4203
4165,280000,224000,0,0,0,0,0,0,-1,0,0,0,-1,0,0,0,-2,0,0,0,-2,0,0,0
4166,200000,160000,0,0,0,0,0,0,-1,-60,0,-60,-2,1740,1800,-60,-1,0,0,0,-1,0,0,0
4167,50000,40000,0,1,1,0,0,0,0,48124,2500,45624,0,48171,1781,46390,0,19401,2000,17401,0,19412,695,18717
4168,80000,64000,0,0,0,0,0,0,2,26856,1459,25397,0,27844,1447,26397,0,27480,983,26497,0,28061,1023,27038
4169,230000,184000,0,0,0,0,0,1,-1,57255,57326,-71,-1,34289,34311,-22,-1,0,0,0,-1,0,0,0
4170,220000,176000,0,0,0,0,0,0,0,177515,7160,170355,0,166282,6495,159787,0,100244,3993,96251,0,-607,0,-607
4171,120000,96000,0,1,1,0,0,0,0,115299,5000,110299,0,117498,4620,112878,0,89417,3200,86217,0,91370,3300,88070
4172,240000,192000,0,0,0,0,0,0,-2,4908,4908,0,-2,5638,5638,0,-2,2582,2587,-5,-2,4127,4127,0
4173,200000,160000,0,1,1,0,0,1,0,198576,7282,191294,0,186981,5835,181146,0,137486,5000,132486,0,140473,5500,134973
4174,90000,72000,0,0,0,0,0,0,-1,0,0,0,-1,1066,1066,0,-1,1752,1752,0,-1,569,569,0
4175,50000,40000,0,0,0,0,0,0,0,23299,1600,21699,0,22672,1400,21272,0,21440,429,21011,0,19304,386,18918
4176,200000,160000,0,0,0,0,0,1,2,114247,5000,109247,2,115896,5000,110896,2,112545,0,112545,2,115565,5000,110565
4177,60000,48000,0,0,0,0,0,0,0,0,1414,-1414,0,41645,0,41645,0,41833,2000,39833,0,41481,1503,39978
4178,50000,40000,0,0,0,0,0,0,0,41981,2564,39417,0,2888,1000,1888,0,2640,0,2640,0,2140,500,1640
4179,140000,112000,0,1,0,0,0,0,0,133265,6350,126915,0,82163,2900,79263,0,83238,2950,80288,0,85383,4000,81383
4180,180000,144000,0,0,0,0,0,0,0,50035,2200,47835,0,50749,1846,48903,0,51903,2000,49903,0,52991,1923,51068
4181,350000,280000,0,1,0,0,0,0,0,326921,12127,314794,0,210500,9557,200943,0,201775,8000,193775,0,171242,6500,164742
4182,230000,184000,0,0,0,0,0,0,0,18175,1928,16247,0,12109,1014,11095,0,11616,1000,10616,0,10134,203,9931
4183,170000,136000,0,0,0,0,0,0,-1,199,199,0,-1,1628,1628,0,-1,0,0,0,-1,4968,4968,0
4184,360000,288000,0,0,0,0,0,0,-2,0,0,0,-2,0,0,0,-2,0,0,0,-2,0,0,0
4185,150000,120000,0,0,0,0,0,0,2,800,15800,-15000,-1,56800,56800,0,-1,54588,0,54588,0,-7,7,-14
4186,50000,40000,0,1,1,0,0,0,0,50543,9000,41543,0,49032,2000,47032,0,19830,2000,17830,0,18299,700,17599
4187,470000,376000,0,1,0,0,0,1,0,485382,15937,469445,0,360959,11891,349068,0,338592,120000,218592,0,123737,6380,117357
4188,320000,256000,0,0,0,0,0,1,-1,6144,6146,-2,-1,14977,9473,5504,0,9473,0,9473,0,8002,5,7997
4189,30000,24000,0,0,0,0,0,0,-1,850,850,0,-1,2158,2158,0,-1,0,0,0,-1,1935,1935,0
4190,350000,280000,0,0,0,0,0,0,-1,0,0,0,-2,0,0,0,-2,0,0,0,-2,687,687,0
4191,240000,192000,0,0,0,0,0,0,-1,2688,2688,0,-1,2688,2688,0,-1,2688,2688,0,-1,2688,2688,0
4192,30000,24000,0,0,0,0,0,0,-1,833,833,0,-1,326,326,0,-1,802,802,0,-1,802,326,476
4193,340000,272000,0,0,0,0,0,1,-1,332,332,0,-1,142202,142402,-200,-1,139245,6,139239,2,116431,20032,96399
4194,200000,160000,0,0,0,0,0,0,0,146128,5217,140911,0,138919,4894,134025,0,132778,4800,127978,0,136272,5900,130372
4195,250000,200000,0,0,1,0,1,0,2,205681,17000,188681,2,200988,0,200988,2,217830,20000,197830,2,223254,9078,214176
4196,30000,24000,0,0,0,0,0,1,0,2552,1300,1252,0,1992,0,1992,2,1583,0,1583,0,1320,150,1170
4197,180000,144000,0,0,0,0,0,0,0,0,0,0,-2,1000,1000,0,-1,2190,2190,0,-1,0,0,0
4198,150000,120000,0,1,0,0,0,0,-1,143248,6502,136746,0,109930,4333,105597,0,80987,2810,78177,0,80938,3100,77838
4199,270000,216000,0,0,0,0,0,0,-1,2000,2000,0,-1,2000,2000,0,-1,0,0,0,-1,4759,4759,0
4200,80000,64000,0,1,1,0,0,0,0,74943,5000,69943,0,75399,3000,72399,0,53373,5000,48373,0,55554,3000,52554
4201,180000,144000,0,0,0,0,0,0,0,72031,4000,68031,0,77597,7501,70096,0,72079,0,72079,2,66310,3001,63309
4202,230000,184000,0,0,0,0,0,0,-2,1200,1406,-206,-2,2735,2735,0,-2,3231,3241,-10,-2,909,913,-4
4203,210000,168000,0,0,0,0,0,0,-1,45408,45408,0,-1,28138,28138,0,-1,6356,2900,3456,0,2900,0,2900
4204,30000,24000,0,1,0,0,0,0,0,30128,5137,24991,0,25178,2189,22989,0,21060,2007,19053,0,16893,1009,15884
4205,110000,88000,0,0,0,0,0,1,-1,4680,4756,-76,-1,880,880,0,-1,880,880,0,-1,880,880,0
4206,50000,40000,0,0,0,1,1,0,0,40703,2038,38665,0,44350,4685,39665,0,43517,0,43517,2,46821,3982,42839
4207,310000,248000,0,0,0,0,0,0,0,62102,6031,56071,0,65875,10057,55818,0,60387,5028,55359,0,43328,5060,38268
4208,50000,40000,0,0,0,0,0,0,0,36554,1621,34933,0,19367,1000,18367,0,19705,1000,18705,0,19696,1000,18696
4209,150000,120000,0,0,0,0,0,0,0,7861,2000,5861,0,7691,2000,5691,0,0,0,0,0,0,0,0
4210,150000,120000,0,0,0,0,0,0,0,7315,2500,4815,0,11295,6023,5272,0,10413,5000,5413,0,16745,6745,10000
4211,170000,136000,0,0,0,0,0,0,-1,0,0,0,-2,0,0,0,-2,0,0,0,-2,0,0,0
4212,90000,72000,0,0,0,0,0,1,0,36133,2500,33633,0,38240,3000,35240,2,37325,0,37325,2,39725,3000,36725
4213,220000,176000,0,0,0,1,1,1,-1,776,0,776,2,221876,221876,0,-1,223986,7500,216486,2,204957,4,204953
4214,30000,24000,0,0,0,0,0,0,0,23455,1370,22085,0,24179,1294,22885,0,24289,1015,23274,0,24649,900,23749
4215,260000,208000,0,0,0,0,0,0,0,138021,4439,133582,0,98578,3079,95499,0,84967,3020,81947,0,83224,3036,80188
4216,70000,56000,0,0,0,0,0,0,2,46445,3006,43439,0,46759,4659,42100,0,21265,1000,20265,0,14379,1000,13379
4217,170000,136000,0,0,0,0,0,0,-2,-189,0,-189,-2,-189,0,-189,-2,-189,0,-189,-2,-189,0,-189
4218,460000,368000,0,0,0,0,0,0,-1,1711,2229,-518,-1,-2,2,-4,-1,7126,7128,-2,-1,1996,10,1986
4219,60000,48000,0,0,0,0,0,0,0,44004,2000,42004,0,26940,1200,25740,0,9971,0,9971,0,-11798,0,-11798
4220,280000,224000,0,0,0,0,0,0,0,127768,4584,123184,0,130339,3647,126692,0,133035,3757,129278,0,135715,3799,131916
4221,80000,64000,0,0,0,0,0,0,2,32141,1659,30482,0,28622,4000,24622,0,24619,0,24619,2,23211,1000,22211
4222,180000,144000,0,0,0,0,0,0,0,21221,2000,19221,0,18190,2004,16186,0,17919,2500,15419,0,18402,3000,15402
4223,50000,40000,0,1,0,0,0,0,0,46645,2403,44242,0,19114,6700,12414,0,19341,1000,18341,0,20047,1000,19047
4224,300000,240000,0,0,0,0,0,0,0,13145,1519,11626,0,11890,2000,9890,0,12695,1005,11690,0,13763,2068,11695
4225,90000,72000,0,0,0,0,0,0,0,29230,5000,24230,0,32747,4000,28747,0,38217,6000,32217,0,43744,8000,35744
4226,10000,8000,0,0,0,1,0,0,0,7100,1000,6100,0,9305,4000,5305,0,9805,500,9305,0,5720,2500,3220
4227,310000,248000,0,1,1,0,0,0,0,315544,13567,301977,0,309272,13203,296069,0,240119,8765,231354,0,235799,9643,226156
4228,200000,160000,0,0,0,0,0,0,0,77221,5000,72221,0,110294,35000,75294,0,68214,6000,62214,0,72103,5000,67103
4229,50000,40000,0,0,0,0,0,0,0,22744,10000,12744,0,18484,1500,16984,0,16378,3000,13378,0,13352,2803,10549
4230,150000,120000,0,0,0,0,0,0,0,31732,6300,25432,0,26989,0,26989,2,33624,10000,23624,0,29786,2000,27786
4231,380000,304000,0,0,0,0,0,0,-2,7352,7352,0,-2,3401,3401,0,-2,1042,1042,0,-2,4000,4000,0
4232,200000,160000,0,0,0,0,0,0,-2,4006,4034,-28,-2,941,945,-4,-2,2357,2366,-9,-2,2945,2947,-2
4233,130000,104000,0,0,0,0,0,0,-1,1403,1411,-8,-1,5773,5790,-17,-2,2464,2571,-107,-2,2108,2214,-106
4234,130000,104000,0,0,0,0,0,0,0,27376,1461,25915,0,28415,1500,26915,0,28980,1037,27943,0,29738,1225,28513
4235,180000,144000,0,1,0,0,0,0,0,180769,6126,174643,0,141352,4856,136496,0,142078,4990,137088,0,141695,5133,136562
4236,290000,232000,0,0,0,0,0,0,-1,5248,5275,-27,-2,32307,32563,-256,-1,28492,29143,-651,-1,1799,1809,-10
4237,200000,160000,0,0,0,0,0,0,-2,0,0,0,-2,500,500,0,-2,2057,2057,0,-2,23322,23322,0
4238,110000,88000,0,1,1,1,1,0,0,114367,5500,108867,2,111064,0,111064,2,112123,4400,107723,0,111575,4500,107075
4239,500000,400000,0,0,0,0,0,1,-2,12855,12859,-4,-2,18041,18041,0,-2,286939,292462,-5523,-1,286836,10593,276243
4240,320000,256000,0,0,0,0,0,0,0,122093,6371,115722,0,105425,3043,102382,0,100206,3031,97175,0,96073,3066,93007
4241,60000,48000,0,0,0,0,0,1,0,855,900,-45,-1,111,0,111,2,411,300,111,2,261,0,261
4242,50000,40000,0,0,0,0,0,0,2,16889,1294,15595,0,19909,3314,16595,0,19291,0,19291,2,20675,1700,18975
4243,30000,24000,0,0,0,0,0,1,0,5754,1109,4645,0,5070,1000,4070,0,759,759,0,-1,2480,2480,0
4244,30000,24000,0,0,0,0,0,0,0,0,0,0,-2,0,0,0,-2,0,0,0,-2,0,0,0
4245,280000,224000,0,0,0,0,0,0,2,3868,4277,-409,-1,389,390,-1,-1,389,390,-1,-1,384,385,-1
4246,300000,240000,0,0,0,0,0,0,-1,0,0,0,-1,0,0,0,-2,0,0,0,-2,0,0,0
4247,50000,40000,0,1,1,1,1,0,0,51039,2500,48539,0,52079,4000,48079,0,49523,0,49523,2,49128,2000,47128
4248,50000,40000,0,0,0,0,0,0,0,28964,2091,26873,0,9522,1034,8488,0,2650,500,2150,0,-581,17,-598
4249,80000,64000,0,1,0,0,0,0,0,78453,3000,75453,0,48027,5027,43000,0,52378,8500,43878,0,49750,0,49750
4250,150000,120000,0,0,0,0,0,1,2,9173,9173,0,-1,296,0,296,2,148,0,148,0,446,446,0
4251,50000,40000,0,1,1,1,1,0,2,45085,3000,42085,0,48020,4000,44020,0,47120,0,47120,2,50319,4000,46319
4252,230000,184000,0,1,1,1,1,0,0,228653,10000,218653,0,225471,9000,216471,0,224853,8200,216653,0,230078,9000,221078
4253,210000,168000,0,0,0,0,0,1,-1,343,343,0,-1,3763,3763,0,-1,877,877,0,-1,0,0,0
4254,490000,392000,0,0,0,0,0,0,0,108590,3993,104597,0,109389,3831,105558,0,110491,4111,106380,0,111158,3939,107219
4255,160000,128000,0,0,0,0,0,0,2,-304,0,-304,2,-630,0,-630,-2,-956,0,-956,-2,476,1908,-1432
4256,110000,88000,0,1,0,0,0,0,0,103609,4276,99333,0,79421,2666,76755,0,78286,2811,75475,0,65875,2500,63375
4257,270000,216000,0,0,0,0,0,0,0,215056,9348,205708,0,10506,10600,-94,-1,10224,10300,-76,-1,9233,9300,-67
4258,50000,40000,0,0,0,0,0,1,-1,780,780,0,-1,390,0,390,0,390,390,0,-1,390,390,0
4259,10000,8000,0,0,0,0,0,0,2,6171,0,6171,2,1681,1681,0,-1,0,0,0,-1,0,0,0
4260,150000,120000,0,1,0,0,0,0,0,134887,6712,128175,0,105822,5500,100322,0,86341,3400,82941,0,88072,3201,84871
4261,100000,80000,0,0,0,0,0,0,0,65169,2500,62669,0,66501,2500,64001,0,66818,2500,64318,0,69335,3500,65835
4262,50000,40000,0,0,0,0,0,0,-1,6258,6307,-49,-1,1032,1035,-3,-1,2766,3164,-398,-1,1401,1405,-4
4263,210000,168000,0,1,1,1,1,0,0,205477,9000,196477,0,209754,9200,200554,0,212737,8000,204737,0,209083,8000,201083
4264,50000,40000,0,0,0,0,0,0,0,29908,1402,28506,0,28809,776,28033,0,27905,773,27132,0,13835,522,13313
4265,50000,40000,0,0,0,0,0,0,0,19758,1132,18626,0,5520,2138,3382,0,5204,172,5032,0,4703,200,4503
4266,220000,176000,0,0,0,0,0,1,-1,762,762,0,-1,5106,5806,-700,-1,700,0,700,0,1364,1364,0
4267,60000,48000,0,1,1,1,1,0,0,60335,3000,57335,0,59384,2300,57084,0,60861,2600,58261,0,59241,2200,57041
4268,70000,56000,0,0,0,0,1,0,0,0,0,0,-2,680,680,0,-1,69257,71867,-2610,-1,68557,9812,58745
4269,30000,24000,0,0,0,0,1,1,0,23860,3400,20460,0,24372,1200,23172,2,25776,2100,23676,2,25088,0,25088
4270,260000,208000,0,0,0,0,0,0,-1,416,416,0,-1,3541,3541,0,-1,416,416,0,-1,416,416,0
4271,400000,320000,0,0,0,0,0,0,-2,3884,3884,0,-2,0,0,0,-2,27703,27703,0,-2,0,0,0
4272,120000,96000,0,0,0,0,0,1,-1,390,390,0,-1,1480,1480,0,-1,0,0,0,-1,6477,6477,0
4273,350000,280000,0,0,0,0,0,0,0,247125,9205,237920,0,228229,6810,221419,0,202220,5706,196514,0,181860,6000,175860
4274,50000,40000,0,1,0,0,0,1,0,49437,1900,47537,0,40186,1800,38386,0,19179,700,18479,0,16043,1000,15043
4275,80000,64000,0,0,0,0,0,0,0,48395,1806,46589,0,49356,1767,47589,0,50560,2000,48560,0,51431,1767,49664
4276,20000,16000,0,0,0,0,0,0,0,688,688,0,-1,688,0,688,2,688,0,688,0,1320,650,670
4277,50000,40000,0,0,0,0,0,1,2,16545,2000,14545,2,16977,1000,15977,2,16563,0,16563,2,17688,1400,16288
4278,60000,48000,0,0,0,0,0,0,-1,32432,2119,30313,0,27976,3008,24968,0,25862,1006,24856,0,24571,1042,23529
4279,30000,24000,0,1,1,1,1,0,2,29086,1957,27129,0,25352,678,24674,0,25096,684,24412,0,24920,776,24144
4280,180000,144000,0,0,0,0,0,0,-1,1000,1000,0,-1,0,0,0,-1,0,0,0,-2,1245,1245,0
4281,180000,144000,0,0,0,0,0,1,2,125879,6000,119879,0,119283,3663,115620,0,117515,3700,113815,0,109499,3400,106099
4282,60000,48000,0,1,0,0,0,0,0,59674,1509,58165,0,29411,1000,28411,0,27730,1000,26730,0,26638,2000,24638
4283,100000,80000,0,1,0,1,1,0,4,81445,0,81445,3,82710,3200,79510,2,84242,3000,81242,2,82730,0,82730
4284,440000,352000,0,1,1,1,1,0,0,434015,17500,416515,0,434419,17000,417419,0,393135,14500,378635,0,385578,14500,371078
4285,80000,64000,0,0,0,0,0,0,0,10424,10759,-335,-2,4898,4995,-97,-2,847,847,0,-2,1342,1344,-2
4286,500000,400000,0,0,0,0,0,0,-2,79243,79243,0,-2,0,0,0,-2,4580,4580,0,-2,0,0,0
4287,330000,264000,0,0,0,0,0,0,0,15577,15579,-2,-1,89851,89851,0,-1,86005,5000,81005,0,121319,50000,71319
4288,210000,168000,0,0,0,0,0,0,-1,488,0,488,2,488,0,488,0,-260,0,-260,0,-506,0,-506
4289,300000,240000,0,0,0,0,0,0,-1,18911,19003,-92,-1,15982,16050,-68,-1,2665,2659,6,0,57096,54394,2702
4290,60000,48000,0,0,0,0,0,1,0,26447,3000,23447,0,28109,2100,26009,0,28720,1200,27520,2,28308,1200,27108
4291,80000,64000,0,0,0,0,0,0,-2,1612,1612,0,-1,16388,16415,-27,-1,0,0,0,-1,0,0,0
4292,110000,88000,0,0,0,0,0,0,0,8871,2500,6371,0,66482,58000,8482,0,59578,2000,57578,0,57961,3000,54961
4293,10000,8000,0,0,0,0,1,0,0,7715,1128,6587,0,7873,286,7587,0,8742,1000,7742,0,9551,955,8596
4294,150000,120000,0,0,0,0,0,0,0,41701,1462,40239,0,40699,2000,38699,0,25218,0,25218,2,9340,2000,7340
4295,20000,16000,0,0,0,0,0,0,0,10167,0,10167,2,10695,1000,9695,0,11365,1000,10365,0,12170,1000,11170
4296,220000,176000,0,0,0,0,0,0,-2,377,377,0,-2,5763,5763,0,-2,3952,3952,0,-2,412,412,0
4297,50000,40000,0,0,0,0,0,1,0,22102,1500,20602,0,22734,1000,21734,0,23217,1000,22217,0,23680,1000,22680
4298,220000,176000,0,0,0,0,0,0,-1,2267,2267,0,-1,1350,1350,0,-1,925,0,925,0,11597,11597,0
4299,330000,264000,0,0,0,0,0,0,-2,0,0,0,-2,0,0,0,-2,0,0,0,-2,1624,1624,0
4300,100000,80000,0,0,0,0,0,0,0,71958,2656,69302,0,68808,2372,66436,0,68769,2360,66409,0,68955,2574,66381
4301,430000,344000,0,0,0,0,0,0,-1,6591,6591,0,-1,854,1026,-172,-1,44275,50000,-5725,-1,32731,0,32731
4302,50000,40000,0,0,0,0,0,0,0,16862,1551,15311,0,16110,579,15531,0,18458,3000,15458,0,19112,954,18158
4303,150000,120000,0,0,0,0,0,0,0,38948,3125,35823,0,24707,2065,22642,0,304,307,-3,-1,635,635,0
4304,150000,120000,0,1,1,1,1,0,0,142139,5066,137073,2,137453,6000,131453,0,139827,5029,134798,0,136320,5016,131304
4305,300000,240000,0,1,0,0,0,0,0,300159,11311,288848,0,226705,7941,218764,0,229739,8412,221327,0,232942,9000,223942
4306,80000,64000,0,0,0,0,0,0,0,58992,2200,56792,0,62696,4700,57996,0,64148,2600,61548,2,62965,0,62965
4307,420000,336000,0,0,0,0,0,0,0,344364,15031,329333,0,202241,7011,195230,0,196082,7010,189072,0,189064,7013,182051
4308,120000,96000,0,0,0,0,0,0,0,0,0,0,0,0,0,0,-2,430,430,0,-2,1520,1520,0
4309,450000,360000,0,0,0,0,0,0,0,96013,6000,90013,0,34079,10000,24079,0,35629,15000,20629,0,59829,35000,24829
4310,170000,136000,0,0,0,0,0,0,-1,416,416,0,-1,416,416,0,-1,416,416,0,-1,416,416,0
4311,320000,256000,0,0,0,0,0,0,0,9398,1500,7898,0,10222,1000,9222,0,13791,3628,10163,0,13498,1041,12457
4312,50000,40000,0,1,1,0,0,0,0,49348,1997,47351,0,44932,1943,42989,0,19559,693,18866,0,18859,683,18176
4313,360000,288000,0,0,0,0,0,0,-1,0,0,0,-1,0,0,0,-2,0,0,0,-2,0,0,0
4314,20000,16000,0,0,0,0,0,0,0,10940,1188,9752,0,12825,2073,10752,0,12331,0,12331,2,12984,1000,11984
4315,100000,80000,0,0,0,0,0,0,0,49904,2130,47774,0,50774,2000,48774,0,51957,2000,49957,0,52991,1898,51093
4316,80000,64000,0,0,0,0,0,0,-1,0,0,0,-2,0,0,0,-2,0,0,0,-2,0,0,0
4317,230000,184000,0,0,0,0,0,0,0,18661,1241,17420,0,12157,1157,11000,0,13104,1104,12000,0,13314,814,12500
4318,200000,160000,0,0,0,0,0,0,0,-202,0,-202,0,1201,1302,-101,-2,1200,100,1100,-1,0,0,0
4319,90000,72000,0,0,0,0,0,1,2,45741,0,45741,2,48729,3755,44974,2,49628,2000,47628,2,50680,2000,48680
4320,180000,144000,0,0,0,0,0,1,-1,316,316,0,-1,316,316,0,-1,316,316,0,-1,316,316,0
4321,80000,64000,0,0,0,0,0,0,0,53599,24369,29230,0,52038,2500,49538,0,53175,2500,50675,0,55751,5000,50751
4322,420000,336000,0,0,0,0,0,0,-1,29042,29052,-10,-1,35000,35000,0,-1,292962,292962,0,-1,247622,0,247622
4323,50000,40000,0,0,0,0,0,0,0,23647,1393,22254,0,24118,864,23254,0,24729,1000,23729,0,25267,950,24317
4324,200000,160000,0,0,0,0,0,0,0,125731,30000,95731,0,120465,5809,114656,0,118759,4002,114757,0,119378,4500,114878
4325,60000,48000,0,1,0,1,1,0,2,48757,0,48757,2,52312,5000,47312,2,52960,2100,50860,2,51985,0,51985
4326,110000,88000,0,1,1,1,1,0,0,107414,5224,102190,0,108887,7641,101246,0,107145,0,107145,2,102075,3785,98290
4327,360000,288000,0,0,0,0,0,0,-2,0,0,0,-2,0,0,0,-2,0,0,0,-2,0,0,0
4328,160000,128000,0,0,0,0,0,1,2,118474,5500,112974,2,115127,0,115127,2,111864,3700,108164,0,102418,3200,99218
4329,160000,128000,0,1,1,1,1,0,2,143786,200,143586,2,151842,12000,139842,2,147962,0,147962,2,156921,11500,145421
4330,80000,64000,0,0,0,0,0,0,-1,3330,3399,-69,-1,2699,0,2699,2,1853,1853,0,-1,184,184,0
4331,180000,144000,0,0,0,0,0,0,-1,3700,3700,0,-1,0,0,0,-1,228,228,0,-1,-372,0,-372
4332,10000,8000,0,1,1,1,1,0,0,10309,1331,8978,0,10299,1321,8978,0,10295,517,9778,0,10306,528,9778
4333,110000,88000,0,1,1,0,0,0,0,98884,5000,93884,0,98501,3000,95501,0,34250,3000,31250,0,35874,3000,32874
4334,50000,40000,0,0,0,0,0,0,0,3642,15012,-11370,-1,12291,10000,2291,0,16674,8000,8674,0,17331,2000,15331
4335,20000,16000,0,0,0,0,0,0,-1,5625,5000,625,0,9625,4000,5625,0,12625,3000,9625,0,0,0,0
4336,220000,176000,0,0,0,0,0,0,-1,-125,0,-125,-1,-441,0,-441,-2,10243,11000,-757,-1,9927,10000,-73
4337,310000,248000,0,0,0,0,0,0,-2,-354,0,-354,-2,-354,0,-354,-2,-354,0,-354,-2,-354,0,-354
4338,260000,208000,0,0,0,0,0,1,0,135593,6067,129526,0,120909,10000,110909,0,102524,3000,99524,0,40157,40157,0
4339,50000,40000,0,0,0,1,0,0,2,38630,2000,36630,2,41774,4086,37688,2,40806,0,40806,4,41357,1500,39857
4340,10000,8000,0,0,1,1,1,1,2,9557,2819,6738,2,9269,0,9269,4,8836,0,8836,3,8548,0,8548
4341,500000,400000,0,0,0,0,0,0,-1,1715,1715,0,-1,-285,0,-285,-1,1715,2000,-285,-1,1395,0,1395
4342,300000,240000,0,0,0,0,0,0,-1,0,0,0,-1,0,0,0,-2,0,0,0,-2,0,0,0
4343,50000,40000,0,0,0,0,0,0,0,12711,2900,9811,0,12210,0,12210,2,12508,500,12008,0,13306,1000,12306
4344,280000,224000,0,0,0,0,0,0,-1,980,1078,-98,-1,3058,3058,0,-1,3158,3158,0,-1,9530,9530,0
4345,70000,56000,0,0,0,0,0,0,0,29776,0,29776,2,30148,1500,28648,0,29918,1057,28861,0,29399,2000,27399
4346,50000,40000,0,1,1,0,0,1,0,49861,2450,47411,0,48660,1510,47150,0,7698,409,7289,0,7463,415,7048
4347,60000,48000,0,1,0,0,0,0,0,54555,2500,52055,0,15177,2000,13177,0,16610,2000,14610,0,16821,628,16193
4348,340000,272000,0,0,0,0,0,1,-2,361,361,0,-2,301,301,0,-2,457,457,0,-2,297,297,0
4349,70000,56000,0,1,1,0,0,0,0,65303,3247,62056,0,63066,3500,59566,0,28291,837,27454,0,25258,1000,24258
4350,10000,8000,0,0,0,0,0,1,2,-677,0,-677,-2,-1067,0,-1067,-2,-747,1100,-1847,-2,71,818,-747
4351,20000,16000,0,1,0,0,1,0,-1,17840,1332,16508,0,16342,1134,15208,0,16428,1000,15428,0,18167,2000,16167
4352,20000,16000,1,1,1,1,0,0,-2,26849,0,26849,-2,23060,0,23060,-2,23060,0,23060,-2,-129,129,-258
4353,220000,176000,0,0,0,0,0,0,0,93091,3566,89525,0,91706,3394,88312,0,91748,3659,88089,0,93261,3700,89561
4354,60000,48000,0,1,1,0,0,0,0,54853,1887,52966,0,59509,1500,58009,0,30565,1500,29065,0,30031,1300,28731
4355,180000,144000,0,0,0,0,0,0,-1,28306,1210,27096,0,31578,10015,21563,0,21195,10009,11186,0,11776,11783,-7
4356,470000,376000,0,0,0,0,0,0,0,28019,5000,23019,0,27139,1408,25731,0,26923,2000,24923,0,28350,2000,26350
4357,50000,40000,0,1,0,0,0,1,2,48673,2310,46363,0,33270,1900,31370,0,7689,400,7289,0,15529,8000,7529
4358,170000,136000,0,0,0,0,0,1,0,97322,3533,93789,0,99419,3716,95703,0,101590,3934,97656,0,111679,12030,99649
4359,80000,64000,0,0,0,0,0,0,0,989,1225,-236,-1,2799,2799,0,-1,2818,2000,818,0,3638,2000,1638
4360,180000,144000,0,0,0,0,0,0,-2,0,0,0,-2,0,0,0,-2,0,0,0,-2,0,0,0
4361,400000,320000,0,0,0,0,0,0,0,61440,1500,59940,0,44590,0,44590,0,12270,0,12270,0,0,0,0
4362,90000,72000,0,0,0,0,1,1,0,73980,3350,70630,0,75036,3300,71736,0,77094,5500,71594,0,75708,1600,74108
4363,10000,8000,0,0,0,0,0,0,0,4634,1246,3388,0,5388,1000,4388,0,780,780,0,-1,0,0,0
4364,260000,208000,0,0,0,0,0,0,-2,0,0,0,-2,0,0,0,-2,0,0,0,-2,0,0,0
4365,320000,256000,0,0,0,0,0,0,-2,7997,8063,-66,-2,3115,3115,0,-2,1852,1852,0,-2,1347,1347,0
4366,50000,40000,0,1,1,0,0,0,0,49115,2000,47115,0,47991,1018,46973,0,0,0,0,0,0,0,0
4367,280000,224000,0,0,0,0,0,0,-1,9754,9754,0,-1,0,0,0,-1,8142,8142,0,-1,6997,6997,0
4368,20000,16000,0,0,0,0,0,1,0,0,0,0,0,0,20500,-20500,-2,0,0,0,-2,0,0,0
4369,170000,136000,0,0,0,0,0,0,2,7788,7788,0,-1,104556,100000,4556,0,141077,41077,100000,0,138790,5200,133590
4370,390000,312000,0,0,0,0,0,1,2,167317,0,167317,2,175283,12000,163283,2,179140,6500,172640,2,182864,6500,176364
4371,190000,152000,0,0,0,0,0,0,-1,18205,18295,-90,-1,14442,9900,4542,0,31465,31465,0,-1,2589,2589,0
4372,20000,16000,0,0,0,0,1,0,-1,20985,20985,0,-1,6932,6932,0,-1,37345,37845,-500,-1,28798,2000,26798
4373,150000,120000,0,0,0,0,0,1,-1,1012,1012,0,-1,0,0,0,-1,0,0,0,-2,0,0,0
4374,50000,40000,0,1,0,0,0,0,0,47561,3528,44033,0,39482,2002,37480,0,40066,2005,38061,0,38994,1398,37596
4375,470000,376000,0,0,0,0,0,0,0,43455,3457,39998,0,33039,1520,31519,0,18638,1659,16979,0,14202,2208,11994
4376,260000,208000,0,0,0,0,0,0,-1,203,204,-1,-1,2571,2582,-11,-1,187,1,186,0,5469,5496,-27
4377,50000,40000,0,1,1,0,0,0,0,49695,2198,47497,0,47862,1296,46566,0,18371,805,17566,0,18601,676,17925
4378,180000,144000,0,0,0,0,0,1,-1,1022,1022,0,-1,2004,2016,-12,-1,0,0,0,-1,2051,2051,0
4379,60000,48000,0,0,0,0,0,1,0,7612,2000,5612,0,8826,1500,7326,0,10113,1600,8513,0,11289,1500,9789
4380,80000,64000,0,0,0,0,0,0,0,39429,2000,37429,0,24600,1000,23600,0,10000,700,9300,0,0,0,0
4381,180000,144000,0,0,0,0,0,0,-1,0,0,0,-2,0,0,0,-2,0,0,0,-2,0,0,0
4382,60000,48000,0,0,0,0,0,0,-2,0,0,0,-2,0,0,0,-2,1040,1040,0,-1,0,0,0
4383,80000,64000,0,1,1,0,1,0,0,73966,3300,70666,0,71447,3050,68397,0,66994,5000,61994,0,66813,2700,64113
4384,360000,288000,0,0,0,0,0,0,-1,18748,18781,-33,-1,18694,6729,11965,0,11606,58,11548,0,7516,7553,-37
4385,200000,160000,0,0,0,0,0,0,0,18562,1310,17252,0,18965,713,18252,0,24424,5800,18624,0,23883,0,23883
4386,270000,216000,0,0,0,0,0,0,-2,2078,2078,0,-2,795,795,0,-2,828,828,0,-2,1251,1251,0
4387,110000,88000,0,0,0,0,0,0,-2,0,0,0,-2,0,0,0,-2,163,163,0,-2,63755,63755,0
4388,150000,120000,0,0,0,0,0,0,0,98481,4913,93568,0,98101,3929,94172,0,97178,2390,94788,0,97249,3052,94197
4389,20000,16000,0,1,1,0,0,1,0,19509,3081,16428,0,18828,0,18828,2,0,0,0,2,0,0,0
4390,230000,184000,0,0,0,0,0,1,0,1897,1897,0,-1,0,0,0,-1,89,89,0,-1,2398,2398,0
4391,240000,192000,0,0,0,0,0,0,-1,0,0,0,-1,473,473,0,-1,11483,11483,0,-1,11886,11886,0
4392,20000,16000,0,1,1,1,1,1,0,19008,2608,16400,0,18710,310,18400,2,20235,1835,18400,0,19483,707,18776
4393,240000,192000,0,1,1,0,0,1,0,227399,9000,218399,0,200357,7000,193357,0,197198,7000,190198,0,186551,6512,180039
4394,200000,160000,0,0,0,0,0,0,-1,0,0,0,-2,0,0,0,-2,0,0,0,-2,0,0,0
4395,20000,16000,0,0,0,0,0,1,0,8473,1500,6973,0,9769,1600,8169,0,10057,600,9457,0,10346,600,9746
4396,70000,56000,0,1,1,0,0,0,0,70985,2607,68378,0,64905,2137,62768,0,48542,1714,46828,0,48525,1751,46774
4397,80000,64000,0,1,1,0,0,0,0,79627,3000,76627,0,80610,3000,77610,0,62447,2324,60123,0,60850,2500,58350
4398,230000,184000,0,1,1,1,1,0,2,198707,7500,191207,2,201634,7500,194134,2,205949,7500,198449,2,210077,7500,202577
4399,210000,168000,0,0,0,0,0,0,0,86357,3134,83223,0,88149,3228,84921,0,93654,7000,86654,0,82166,0,82166
4400,30000,24000,0,1,0,0,0,1,2,28335,1542,26793,0,20946,1024,19922,0,15525,1000,14525,0,7422,7422,0
4401,220000,176000,0,0,0,0,0,0,-1,0,0,0,-2,0,0,0,-2,0,0,0,-2,612,612,0
4402,480000,384000,0,1,1,1,1,0,0,479432,55693,423739,0,487066,17000,470066,2,471145,0,471145,2,469961,18000,451961
4403,380000,304000,0,0,0,0,0,0,0,192624,8263,184361,0,149860,7127,142733,0,59256,4000,55256,0,61039,3000,58039
4404,160000,128000,0,0,0,1,1,0,0,131648,10000,121648,0,137902,10000,127902,0,145046,10000,135046,0,152551,10000,142551
4405,50000,40000,0,1,0,0,0,1,0,46777,2000,44777,0,39420,1530,37890,0,8824,1000,7824,0,9009,327,8682
4406,30000,24000,0,0,0,0,0,0,0,18191,1522,16669,0,9745,1200,8545,0,9545,0,9545,0,13964,6000,7964
4407,100000,80000,0,0,0,0,0,0,0,58610,2789,55821,0,9779,9779,0,-1,12273,12273,0,-1,2701,3105,-404
4408,100000,80000,0,0,0,0,0,0,0,9945,0,9945,2,14269,4500,9769,2,13743,0,13743,2,16011,2500,13511
4409,60000,48000,0,0,1,0,0,0,0,58536,12423,46113,0,56705,2000,54705,0,18352,2000,16352,0,18195,1000,17195
4410,50000,40000,0,1,0,0,0,1,0,50203,2289,47914,0,10042,483,9559,0,20085,350,19735,0,9578,334,9244
4411,150000,120000,0,1,0,0,0,0,-1,150000,5000,145000,-1,0,0,0,-2,-5000,0,-5000,-2,0,5000,-5000
4412,30000,24000,0,0,0,0,0,0,0,10715,1500,9215,0,13218,3000,10218,0,12709,0,12709,2,17463,5000,12463
4413,30000,24000,0,1,1,1,1,1,5,27090,0,27090,4,26361,0,26361,3,26831,1200,25631,2,27552,1300,26252
4414,200000,160000,0,0,0,0,0,0,2,4486,4486,0,-1,9790,10000,-210,-1,4944,0,4944,2,4696,4696,0
4415,280000,224000,0,0,0,0,0,0,-1,9360,9370,-10,-1,7480,7486,-6,-2,4402,4402,0,-2,3646,3646,0
4416,380000,304000,0,0,0,0,0,0,0,147940,5362,142578,0,151488,6000,145488,0,154975,6000,148975,0,159477,7000,152477
4417,100000,80000,0,0,0,0,0,0,-1,2772,2772,0,-1,0,0,0,-1,0,0,0,-2,0,0,0
4418,50000,40000,0,0,0,0,0,0,-1,2874,0,2874,2,759,759,0,-1,5328,5328,0,-1,2885,1,2884
4419,50000,40000,0,1,1,1,1,0,0,49124,2246,46878,0,48930,2000,46930,0,50316,3000,47316,0,62794,1725,61069
4420,290000,232000,0,0,0,0,0,0,-1,970,970,0,-1,0,0,0,-1,0,0,0,-2,2184,2184,0
4421,500000,400000,0,0,0,0,0,0,-1,71852,50290,21562,0,18155,5002,13153,0,32201,15001,17200,0,39668,17028,22640
4422,180000,144000,0,0,0,0,0,0,-1,969,1595,-626,-1,21365,21365,0,-1,9707,9707,0,-1,3837,3837,0
4423,60000,48000,0,0,0,0,0,0,2,25127,3761,21366,0,21111,1600,19511,0,15892,881,15011,0,16762,900,15862
4424,100000,80000,0,0,0,0,0,0,-2,0,0,0,-2,0,0,0,-2,0,0,0,-2,6179,6179,0
4425,20000,16000,0,1,1,0,0,0,0,19417,2004,17413,0,19159,1200,17959,0,15574,1000,14574,0,0,0,0
4426,30000,24000,0,0,1,0,0,1,0,27428,5000,22428,0,28720,2000,26720,0,780,780,0,-1,0,0,0
4427,150000,120000,0,0,0,0,0,0,0,99456,3404,96052,0,79956,2722,77234,0,78154,54788,23366,0,76634,2770,73864
4428,310000,248000,0,0,0,0,0,0,0,31140,4415,26725,0,27695,1084,26611,0,17338,491,16847,0,17731,540,17191
4429,20000,16000,0,0,0,0,0,1,2,13834,1600,12234,0,14894,1600,13294,0,15050,700,14350,0,16251,1601,14650
4430,70000,56000,0,1,0,0,0,0,-1,66087,2081,64006,0,50716,2000,48716,0,48862,2000,46862,0,49850,1828,48022
4431,180000,144000,0,0,0,0,0,1,-1,316,316,0,-1,316,316,0,-1,316,316,0,-1,316,316,0
4432,60000,48000,0,0,0,0,0,0,0,20732,3000,17732,0,21196,1000,20196,0,23175,3000,20175,0,22724,0,22724
4433,270000,216000,0,0,0,0,0,0,0,94362,3500,90862,0,86861,4000,82861,0,78538,3000,75538,0,70158,3000,67158
4434,280000,224000,0,0,0,0,0,0,0,85733,20014,65719,0,131138,50014,81124,0,131414,5015,126399,0,130758,4518,126240
4435,400000,320000,0,0,0,0,0,0,0,60984,0,60984,2,61034,500,60534,2,60881,39,60842,2,46569,707,45862
4436,20000,16000,0,0,0,0,0,0,0,8989,2000,6989,0,8436,0,8436,2,12016,4000,8016,2,11404,0,11404
4437,20000,16000,0,0,1,1,0,1,2,18411,3200,15211,2,17809,0,17809,2,18009,765,17244,0,16595,700,15895
4438,360000,288000,0,0,0,0,0,0,-2,0,0,0,-2,0,0,0,-2,0,0,0,-2,6920,6920,0
4439,100000,80000,0,0,0,0,1,0,-1,200,200,0,-1,2795,2795,0,-1,94722,92485,2237,0,96638,2519,94119
4440,420000,336000,0,1,1,1,0,0,2,425345,16100,409245,0,354852,13000,341852,0,353113,14064,339049,0,353720,111170,242550
4441,300000,240000,0,0,0,0,0,0,-2,264,264,0,-2,264,264,0,-2,414,414,0,-2,264,264,0
4442,20000,16000,0,0,0,0,0,0,0,4519,2008,2511,0,3520,1680,1840,0,1680,0,1680,2,5285,5285,0
4443,20000,16000,0,1,1,1,1,0,0,19486,1500,17986,0,19501,1600,17901,0,19274,900,18374,0,19703,900,18803
4444,50000,40000,0,0,0,0,0,0,0,5891,1500,4391,0,6595,1000,5595,2,8400,2000,6400,0,4041,1000,3041
4445,20000,16000,0,0,0,0,0,1,0,9024,2000,7024,0,10865,2000,8865,0,12677,2000,10677,0,14309,2000,12309
4446,50000,40000,0,1,1,1,1,0,0,42816,0,42816,2,43528,1723,41805,0,46258,3600,42658,0,47340,2000,45340
4447,150000,120000,0,1,1,1,1,0,0,146999,6740,140259,0,146277,6850,139427,0,147946,5664,142282,0,145846,5660,140186
4448,420000,336000,0,0,0,0,0,0,-2,-94,0,-94,-2,6300,6394,-94,-2,1047,1047,0,-1,67631,67643,-12
4449,50000,40000,0,0,0,0,0,0,0,2174,2500,-326,-1,3479,3000,479,0,3006,1000,2006,0,810,900,-90
4450,200000,160000,0,0,0,0,0,0,0,56073,2100,53973,0,57790,2659,55131,0,58356,2100,56256,0,60135,2700,57435
4451,70000,56000,0,0,0,0,0,0,-2,72772,72772,0,-1,39980,1400,38580,0,40126,1500,38626,0,39788,1500,38288
4452,50000,40000,0,0,0,0,0,0,0,12595,2651,9944,0,11449,500,10949,2,9914,500,9414,0,9875,500,9375
4453,60000,48000,0,1,0,0,0,0,0,59257,2227,57030,0,56229,14682,41547,0,46624,1634,44990,0,36594,2024,34570
4454,250000,200000,0,0,0,0,0,1,2,2500,0,2500,2,2500,0,2500,2,2500,0,2500,2,2500,0,2500
4455,170000,136000,0,0,0,0,0,0,-2,-200,0,-200,-2,0,200,-200,-2,2769,2769,0,-2,0,0,0
4456,210000,168000,0,0,0,0,0,0,0,87567,3808,83759,0,83716,4177,79539,0,69925,2594,67331,0,64108,2442,61666
4457,480000,384000,0,0,0,0,0,0,-1,71063,47003,24060,0,60155,30171,29984,0,66078,40282,25796,0,64958,115224,-50266
4458,50000,40000,0,1,0,0,0,0,0,49002,2399,46603,0,39422,1819,37603,0,15349,472,14877,0,15078,477,14601
4459,10000,8000,0,1,1,1,0,0,0,9644,1000,8644,0,9790,196,9594,0,9990,200,9790,0,0,0,0
4460,70000,56000,0,1,1,1,1,1,2,62740,2400,60340,2,63090,2000,61090,2,64470,3000,61470,2,65828,2508,63320
4461,230000,184000,0,0,0,0,0,0,0,0,0,0,-2,1255,1255,0,-1,80158,80158,0,-1,81775,3107,78668
4462,160000,128000,0,0,0,0,0,0,0,39787,1877,37910,0,40069,2000,38069,0,37647,3000,34647,0,38268,1400,36868
4463,50000,40000,0,1,0,0,0,1,0,48999,2602,46397,0,7470,349,7121,0,6406,706,5700,0,3679,500,3179
4464,440000,352000,0,0,0,0,0,0,0,11613,3000,8613,0,12651,3019,9632,0,13211,5011,8200,0,23600,23748,-148
4465,340000,272000,0,0,0,0,0,0,0,64478,0,64478,2,67271,5000,62271,0,62269,5000,57269,0,56502,0,56502
4466,20000,16000,0,0,0,0,0,0,0,15973,2000,13973,0,18773,3000,15773,0,0,0,0,0,0,0,0
4467,40000,32000,0,0,0,0,0,1,0,30421,4500,25921,0,29633,0,29633,2,31548,2400,29148,2,30889,0,30889
4468,20000,16000,0,1,1,1,1,1,2,20353,3309,17044,2,19966,381,19585,2,19056,0,19056,2,19445,389,19056
4469,360000,288000,0,0,0,0,0,0,0,211278,8000,203278,0,215020,8000,207020,0,218771,7766,211005,0,222172,7803,214369
4470,30000,24000,0,1,1,1,1,1,2,30604,1500,29104,3,29834,0,29834,3,29936,1100,28836,2,29862,1000,28862
4471,120000,96000,0,0,0,0,0,0,0,82837,3500,79337,0,73297,3500,69797,0,73084,3000,70084,0,68697,3000,65697
4472,50000,40000,0,0,0,0,0,0,2,22599,0,22599,2,24613,2700,21913,2,23922,0,23922,2,25481,2100,23381
4473,280000,224000,0,0,0,0,0,0,0,23926,3000,20926,0,23102,10000,13102,0,22734,10000,12734,0,29434,16934,12500
4474,20000,16000,0,0,0,0,0,1,-1,14059,14777,-718,-1,9140,9140,0,-1,1073,1073,0,-1,500,500,0
4475,360000,288000,0,0,0,0,0,0,0,12558,1028,11530,0,0,0,0,0,730,730,0,-1,500,500,0
4476,420000,336000,0,0,0,0,0,0,-1,6254,6404,-150,-1,6023,20,6003,2,0,0,0,2,0,0,0
4477,50000,40000,0,0,0,0,0,0,0,6793,1024,5769,0,13864,163,13701,0,5243,146,5097,0,5391,2000,3391
4478,130000,104000,0,0,0,0,0,0,0,76133,2750,73383,0,77648,2767,74881,0,79370,2961,76409,0,80071,2913,77158
4479,110000,88000,0,1,0,0,0,0,0,108015,4661,103354,0,88618,3560,85058,0,71865,4915,66950,0,65629,0,65629
4480,130000,104000,0,1,1,1,0,0,0,122440,4500,117940,0,125189,5100,120089,0,127644,5365,122279,0,74295,2846,71449
4481,100000,80000,0,0,0,0,0,0,0,71451,3200,68251,0,68530,3000,65530,0,66844,3500,63344,0,65820,2600,63220
4482,100000,80000,0,0,0,0,0,0,0,21300,1429,19871,0,20091,600,19491,0,19299,600,18699,0,9346,1000,8346
4483,200000,160000,0,0,0,0,0,0,-2,2124,2124,0,-2,6041,6063,-22,-2,2975,2975,0,-2,3441,3441,0
4484,50000,40000,0,0,0,0,0,0,0,24569,2000,22569,0,26244,2500,23744,0,11540,1000,10540,0,13348,2000,11348
4485,170000,136000,0,1,1,0,0,0,2,167796,6700,161096,0,168915,6000,162915,0,121713,4500,117213,0,120909,6000,114909
4486,150000,120000,0,0,0,0,0,1,-2,0,0,0,-2,0,0,0,-2,0,0,0,-2,0,0,0
4487,140000,112000,0,1,0,0,0,0,0,115038,0,115038,2,119696,8200,111496,2,87930,0,87930,2,96561,10000,86561
4488,50000,40000,0,0,0,0,0,0,-1,6964,6964,0,-1,7604,7604,0,-1,2173,2173,0,-1,6586,6586,0
4489,100000,80000,0,0,0,0,0,1,3,60486,2525,57961,2,58296,0,58296,2,33247,1206,32041,0,34118,1423,32695
4490,20000,16000,0,1,1,1,1,0,0,19551,1300,18251,0,18964,662,18302,0,19676,1000,18676,0,20116,747,19369
4491,120000,96000,0,0,0,0,0,0,0,28022,4200,23822,0,29249,2000,27249,0,29926,1300,28626,0,35357,6000,29357
4492,150000,120000,0,0,0,0,0,0,0,110237,2921,107316,0,46972,15000,31972,0,29045,1137,27908,0,20105,600,19505
4493,80000,64000,0,0,0,0,0,0,-1,388,388,0,-1,1187,1191,-4,-1,263,263,0,-1,1913,2259,-346
4494,70000,56000,0,0,0,0,0,0,0,35286,2500,32786,0,36889,2519,34370,0,34152,5090,29062,0,36694,3100,33594
4495,60000,48000,0,1,0,0,0,0,0,54673,1098,53575,0,2193,2193,0,-1,8258,8258,0,-1,0,0,0
4496,280000,224000,0,0,0,0,0,1,-1,37297,2000,35297,0,37154,1130,36024,0,32581,922,31659,0,33316,1011,32305
4497,210000,168000,0,0,1,1,1,0,0,171459,6500,164959,0,177590,9000,168590,0,180147,7000,173147,0,184084,7000,177084
4498,30000,24000,0,0,0,0,0,0,-1,12791,12591,200,0,12490,490,12000,0,13990,1500,12490,0,300,300,0
4499,110000,88000,0,0,1,0,0,0,0,109517,76000,33517,0,107403,5000,102403,0,81794,4000,77794,0,78463,3000,75463
4500,150000,120000,0,0,0,0,0,1,2,20304,0,20304,2,21585,2000,19585,2,20718,0,20718,2,22813,3000,19813
4501,240000,192000,0,0,0,0,0,0,0,127344,7000,120344,0,125050,6500,118550,0,126479,5000,121479,0,130266,6000,124266
4502,500000,400000,0,0,0,0,0,0,-2,9034,9041,-7,-2,64346,64988,-642,-2,5988,6000,-12,-2,16890,16899,-9
4503,50000,40000,0,0,0,0,0,1,0,19993,1500,18493,0,18852,700,18152,0,18020,651,17369,0,18537,1000,17537
4504,200000,160000,0,0,0,0,0,0,-2,723,723,0,-2,1038,1038,0,-2,2035,2035,0,-2,3664,3664,0
4505,200000,160000,0,1,1,1,1,0,0,194449,7000,187449,0,196814,7000,189814,0,200526,7128,193398,0,198717,8000,190717
4506,50000,40000,0,0,0,0,0,0,0,14354,1000,13354,0,8713,500,8213,0,1781,1781,0,-1,1615,0,1615
4507,150000,120000,0,0,0,0,0,0,0,41692,1558,40134,0,30936,1005,29931,0,31021,1162,29859,0,-1514,1408,-2922
4508,110000,88000,0,0,0,0,0,1,0,8504,1330,7174,0,7277,2500,4777,0,7774,1000,6774,0,8261,1000,7261
4509,60000,48000,0,0,0,0,0,0,0,34958,1400,33558,0,33760,675,33085,0,32946,659,32287,0,0,0,0
4510,110000,88000,0,1,1,1,1,0,0,113984,5500,108484,0,112510,4000,108510,0,112319,4000,108319,0,110730,4100,106630
4511,170000,136000,0,0,0,0,0,0,2,25674,3503,22171,2,24963,0,24963,2,25640,1078,24562,0,26278,1215,25063
4512,280000,224000,0,0,0,0,0,0,0,26667,1800,24867,0,26926,1000,25926,0,27492,1000,26492,0,28333,1300,27033
4513,110000,88000,0,0,0,0,0,0,0,61245,3000,58245,0,47316,1807,45509,0,47175,1698,45477,0,47141,1911,45230
4514,360000,288000,0,0,0,0,0,0,0,8605,4000,4605,0,28405,20000,8405,0,-105,5000,-5105,0,3895,4000,-105
4515,200000,160000,0,0,0,0,0,0,0,0,0,0,-2,0,0,0,-2,0,0,0,-2,0,0,0
4516,90000,72000,0,0,0,0,0,0,0,69482,4008,65474,0,60244,30055,30189,0,22640,15050,7590,0,3270,3270,0
4517,20000,16000,0,0,0,0,0,0,0,14065,3000,11065,0,16161,4000,12161,0,11106,2000,9106,0,12500,2000,10500
4518,100000,80000,0,1,1,0,0,0,0,99479,4252,95227,0,94028,2620,91408,0,14578,408,14170,0,33254,26130,7124
4519,500000,400000,0,0,0,0,0,0,2,64610,2787,61823,0,64133,1312,62821,0,264,264,0,-1,264,264,0
4520,20000,16000,0,0,0,0,0,0,0,16077,4011,12066,0,16389,5066,11323,0,11286,1003,10283,0,12833,7000,5833
4521,90000,72000,0,0,0,0,0,0,2,37539,4000,33539,2,36641,0,36641,2,37061,1326,35735,0,38011,1547,36464
4522,300000,240000,0,0,0,0,0,1,-1,504,600,-96,-1,-627,0,-627,-1,-918,0,-918,-2,-1209,0,-1209
4523,20000,16000,0,0,0,0,0,1,2,11562,0,11562,3,11080,0,11080,2,11700,800,10900,2,12357,1000,11357
4524,280000,224000,0,0,0,0,0,0,-1,5707,4795,912,-1,4795,0,4795,2,5328,4115,1213,2,4969,0,4969
4525,280000,224000,0,0,0,0,0,0,-1,14907,14907,0,-1,3008,0,3008,0,8988,8988,0,-1,11547,11547,0
4526,290000,232000,0,0,0,0,0,1,2,169476,0,169476,2,177186,12000,165186,2,161057,0,161057,2,163338,6818,156520
4527,150000,120000,0,0,0,0,0,1,0,78898,3160,75738,0,70886,2505,68381,0,65869,2500,63369,0,67805,3000,64805
4528,50000,40000,0,1,1,0,0,1,0,48887,2070,46817,0,49097,1280,47817,0,17203,616,16587,0,17562,636,16926
4529,60000,48000,0,1,0,0,0,0,0,54811,1857,52954,0,39960,1289,38671,0,40133,1615,38518,0,37607,1484,36123
4530,90000,72000,0,0,0,0,0,0,-1,0,0,0,-2,0,0,0,-2,0,0,0,-2,0,0,0
4531,200000,160000,0,0,0,0,0,0,0,69702,2513,67189,0,63210,1656,61554,0,57098,5000,52098,0,46455,20000,26455
4532,30000,24000,0,0,0,0,0,0,0,14452,2002,12450,0,13050,2000,11050,0,11083,900,10183,0,9249,1500,7749
4533,200000,160000,0,0,0,0,0,0,-1,-8,326,-334,-2,2315,2323,-8,-2,4255,4264,-9,-1,2010,2028,-18
4534,50000,40000,0,1,1,1,1,0,0,44384,2300,42084,0,45267,1618,43649,0,46215,1675,44540,0,47949,2500,45449
4535,360000,288000,0,0,0,0,0,0,0,39840,7000,32840,0,46130,7000,39130,0,50534,5000,45534,0,53897,4000,49897
4536,50000,40000,0,1,0,0,0,0,3,48935,1266,47669,2,18243,0,18243,2,20285,2301,17984,2,17175,0,17175
4537,130000,104000,0,1,1,1,1,1,2,130768,5000,125768,2,131858,4732,127126,2,125874,0,125874,2,127988,5000,122988
4538,50000,40000,0,0,0,0,0,0,0,22469,2442,20027,0,28197,28197,0,-1,18784,634,18150,0,17263,799,16464
4539,290000,232000,0,0,0,0,0,0,-2,0,0,0,-2,2700,2700,0,-1,1350,0,1350,0,1350,1350,0
4540,500000,400000,0,0,0,0,0,0,-2,81198,81938,-740,-2,40049,40060,-11,-1,54258,30000,24258,0,59569,20000,39569
4541,310000,248000,0,0,0,0,0,0,0,39579,3000,36579,0,40879,1500,39379,0,85,85,0,-1,4381,4381,0
4542,170000,136000,0,0,0,0,0,0,0,129898,6247,123651,0,124370,6375,117995,0,112589,4468,108121,0,26958,1000,25958
4543,500000,400000,0,0,0,0,0,0,-2,1656,1656,0,-2,1400,1400,0,-2,0,0,0,-2,0,0,0
4544,80000,64000,0,0,0,0,0,0,0,50071,1491,48580,0,47099,1099,46000,0,41063,1243,39820,0,6408,6408,0
4545,230000,184000,0,0,0,0,0,0,0,32166,3007,29159,0,79780,51780,28000,0,58886,2025,56861,0,42295,1560,40735
4546,440000,352000,0,0,0,0,0,0,0,255143,9102,246041,0,234395,10003,224392,0,216318,5000,211318,0,202530,5000,197530
4547,100000,80000,0,0,0,0,0,0,2,35464,2005,33459,0,30456,1700,28756,0,29420,976,28444,0,27102,2000,25102
4548,20000,16000,0,0,0,0,0,1,-1,6906,6906,0,-1,0,290,-290,-1,0,0,0,-2,0,0,0
4549,20000,16000,0,0,0,0,0,0,0,15200,1400,13800,0,14800,0,14800,0,17800,3000,14800,0,10000,200,9800
4550,80000,64000,0,1,1,1,1,0,2,68193,2500,65693,2,69465,3000,66465,2,70545,2500,68045,2,72233,3000,69233
4551,370000,296000,0,0,0,0,0,0,0,278781,14177,264604,0,256794,15118,241676,0,156583,15020,141563,0,17909,10000,7909
4552,20000,16000,0,1,1,1,0,0,0,19789,2393,17396,0,19985,1000,18985,0,19676,494,19182,0,6971,139,6832
4553,50000,40000,0,0,0,0,0,0,0,28857,1683,27174,0,27495,1064,26431,0,26344,900,25444,0,24879,862,24017
4554,380000,304000,0,0,0,0,0,0,0,58603,7000,51603,0,58359,7359,51000,0,59527,10000,49527,0,58482,7000,51482
4555,300000,240000,0,0,0,0,0,0,-2,0,0,0,-2,0,0,0,-2,150000,150000,0,-1,0,0,0
4556,30000,24000,0,1,0,0,0,1,0,27286,1388,25898,0,21919,1501,20418,0,19015,1001,18014,0,2732,2732,0
4557,20000,16000,0,1,0,0,0,0,0,18166,1000,17166,0,8190,3144,5046,0,8190,0,8190,0,0,0,0
4558,210000,168000,0,0,0,0,0,0,0,34395,2000,32395,0,35321,1500,33821,0,36249,1500,34749,0,37047,1400,35647
4559,180000,144000,0,0,0,0,0,0,-1,-632,0,-632,-2,-632,0,-632,-2,-632,0,-632,-2,-632,0,-632
4560,10000,8000,0,0,0,1,1,0,0,1651,1651,0,-1,9984,9984,0,-1,10096,415,9681,0,9847,358,9489
4561,30000,24000,0,1,1,1,0,0,0,29997,1469,28528,0,30067,929,29138,0,26709,1265,25444,0,13836,886,12950
4562,50000,40000,0,1,0,0,0,0,0,44626,2126,42500,0,40928,2104,38824,0,29367,990,28377,0,29156,1200,27956
4563,270000,216000,0,0,0,0,0,0,-1,11088,11586,-498,-1,6045,6013,32,0,750,750,0,-1,4003,4003,0
4564,50000,40000,0,1,1,1,0,0,0,47192,0,47192,2,50588,4000,46588,2,40009,0,40009,2,43685,5000,38685
4565,60000,48000,0,1,0,0,0,0,0,61017,2535,58482,0,30117,2331,27786,0,29526,0,29526,2,29201,1073,28128
4566,360000,288000,0,0,0,0,0,0,-2,0,0,0,-2,0,0,0,-2,0,0,0,-2,0,0,0
4567,30000,24000,0,0,0,0,0,0,0,23237,0,23237,2,0,0,0,2,0,0,0,-2,0,0,0
4568,290000,232000,0,1,1,1,1,0,0,295333,12500,282833,0,285867,11000,274867,0,240773,8000,232773,0,242655,9300,233355
4569,30000,24000,0,1,0,0,0,0,0,28115,1695,26420,0,23092,2000,21092,0,24829,2000,22829,0,10400,2000,8400
4570,140000,112000,0,0,0,0,0,0,0,13780,1200,12580,0,13710,2000,11710,0,488,500,-12,-1,-1450,0,-1450
4571,120000,96000,0,0,0,0,0,1,2,68405,2700,65705,2,69387,2700,66687,2,70727,2600,68127,2,72215,2800,69415
4572,30000,24000,0,0,0,0,1,0,2,22843,2003,20840,0,23044,2008,21036,0,25082,5000,20082,0,25648,1005,24643
4573,80000,64000,0,0,0,0,0,0,-2,1900,1900,0,-1,7411,7411,0,-1,1900,1900,0,-1,0,0,0
4574,110000,88000,0,1,1,0,0,0,0,111125,4238,106887,0,106828,4316,102512,0,84729,11190,73539,0,82910,0,82910
4575,190000,152000,0,0,0,0,0,0,0,72878,7600,65278,0,70731,0,70731,2,71285,2700,68585,0,72403,2800,69603
4576,50000,40000,0,0,0,0,0,0,2,0,0,0,2,0,0,0,-2,0,0,0,-2,0,0,0
4577,20000,16000,0,1,1,1,0,1,2,18028,0,18028,2,18200,1250,16950,0,16844,594,16250,0,18082,3000,15082
4578,50000,40000,0,0,0,0,0,0,0,20426,1600,18826,0,19894,1600,18294,0,20294,1000,19294,0,20145,900,19245
4579,70000,56000,0,0,1,0,0,0,0,56062,2322,53740,0,82305,1631,80674,0,42308,2942,39366,0,40507,1783,38724
4580,50000,40000,0,0,0,0,0,0,0,33751,1760,31991,0,22467,898,21569,0,19927,864,19063,0,20352,900,19452
4581,200000,160000,0,0,0,0,0,0,0,2577,2581,-4,-1,2652,1013,1639,0,-6,0,-6,0,1279,1285,-6
4582,280000,224000,0,0,0,0,0,0,-1,0,0,0,-2,0,0,0,-2,0,0,0,-2,0,0,0
4583,20000,16000,0,0,0,0,0,0,0,0,0,0,-2,0,0,0,-2,0,0,0,-2,0,0,0
4584,150000,120000,0,1,1,1,1,0,0,152228,5800,146428,0,141778,5300,136478,0,142694,5200,137494,0,145622,5300,140322
4585,200000,160000,0,0,0,0,0,0,0,120921,124500,-3579,-1,126429,8000,118429,0,85500,3500,82000,0,81305,4000,77305
4586,30000,24000,0,0,0,0,0,1,-1,0,0,0,-1,0,0,0,-2,0,0,0,-2,0,0,0
4587,80000,64000,0,1,0,0,0,0,0,80711,2500,78211,0,59119,2182,56937,0,62019,4700,57319,0,60955,0,60955
4588,300000,240000,0,0,0,0,0,0,0,3658,2700,958,0,658,658,0,-1,662,662,0,-1,0,0,0
4589,80000,64000,0,1,0,0,0,0,0,79196,2934,76262,0,25722,897,24825,0,26261,929,25332,0,26784,935,25849
4590,100000,80000,0,0,0,0,0,0,0,16120,2000,14120,0,18588,2786,15802,0,13272,0,13272,2,13549,639,12910
4591,140000,112000,0,0,0,0,0,0,-1,34050,34050,0,-1,3000,3000,0,-1,3000,3000,0,-1,49128,49128,0
4592,50000,40000,0,0,0,0,0,1,0,32821,2800,30021,0,34855,3732,31123,0,11776,750,11026,0,12088,500,11588
4593,440000,352000,0,0,0,0,0,0,-1,686,1383,-697,-1,-414,0,-414,-1,2736,3150,-414,-1,12586,13000,-414
4594,420000,336000,0,0,0,0,0,0,-2,47581,47581,0,-1,48070,1715,46355,0,47523,1700,45823,0,45834,1850,43984
4595,200000,160000,0,0,0,0,0,0,0,33275,2000,31275,0,33435,3435,30000,0,32778,3000,29778,0,3277,3277,0
4596,50000,40000,0,0,0,0,0,0,0,12104,1206,10898,0,12898,1000,11898,0,13687,1000,12687,0,14458,1000,13458
4597,20000,16000,0,0,0,0,0,1,2,10000,0,10000,2,0,0,0,2,0,0,0,-2,0,0,0
4598,260000,208000,0,0,0,0,0,0,0,133752,6307,127445,0,135053,5007,130046,0,133888,5015,128873,0,132486,4773,127713
4599,80000,64000,0,0,0,0,0,0,0,44410,2358,42052,0,22649,3123,19526,0,20650,1500,19150,0,0,0,0
4600,50000,40000,0,0,0,0,0,0,0,23702,1194,22508,0,18327,564,17763,0,17996,1500,16496,0,15938,1000,14938
4601,50000,40000,0,0,0,0,0,0,0,22800,1500,21300,0,21930,1000,20930,0,23183,2000,21183,0,17613,1000,16613
4602,20000,16000,0,0,0,0,0,0,2,3980,4000,-20,-1,9040,9040,0,-1,9040,0,9040,0,0,0,0
4603,110000,88000,0,0,0,0,0,1,2,51908,0,51908,2,48647,2000,46647,0,47862,2000,45862,0,47969,1854,46115
4604,260000,208000,0,0,0,0,0,0,-1,107139,107139,0,-1,105188,4000,101188,0,104418,4000,100418,0,106990,4696,102294
4605,30000,24000,1,1,1,1,1,0,0,32289,2000,30289,0,31276,1220,30056,0,30428,1232,29196,0,29371,1052,28319
4606,150000,120000,0,0,0,0,0,0,-1,0,0,0,-2,0,0,0,-2,0,0,0,-2,0,0,0
4607,260000,208000,0,0,0,0,0,0,0,177351,10000,167351,0,175130,10000,165130,0,182154,10000,172154,0,188264,10000,178264
4608,90000,72000,0,0,0,0,0,1,2,39674,39674,0,-1,38968,1200,37768,0,39853,1217,38636,0,8064,1025,7039
4609,150000,120000,0,0,0,0,0,0,-2,14279,14296,-17,-2,5985,5990,-5,-2,8333,8342,-9,-2,8241,8241,0
4610,90000,72000,0,0,0,0,0,0,0,7598,3500,4098,0,5036,4500,536,0,4750,4300,450,0,3007,0,3007
4611,360000,288000,0,0,0,0,0,0,-2,1874,1874,0,-2,6330,6330,0,-2,-200,0,-200,-2,-200,0,-200
4612,50000,40000,0,1,0,0,0,0,-1,48599,7060,41539,0,-250,112,-362,0,12122,32132,-20010,-1,3685,11304,-7619
4613,20000,16000,0,0,0,0,1,1,0,14946,2787,12159,0,14409,0,14409,2,16659,2500,14159,0,17887,1500,16387
4614,260000,208000,0,0,0,0,0,0,0,85128,3100,82028,0,86910,3200,83710,0,88637,3172,85465,0,90682,3473,87209
4615,50000,40000,0,1,1,0,0,0,0,48799,2352,46447,0,41286,1239,40047,0,16764,717,16047,0,16960,585,16375
4616,20000,16000,1,1,1,1,1,0,2,30013,2600,27413,2,25938,0,25938,2,28447,6500,21947,2,24288,0,24288
4617,110000,88000,0,1,1,0,0,0,0,100751,4000,96751,0,102496,3500,98996,0,80116,2500,77616,0,69391,2290,67101
4618,30000,24000,0,0,0,0,0,0,2,937,1000,-63,-1,0,398,-398,-1,1083,1083,0,-1,3395,3395,0
4619,260000,208000,0,0,0,0,0,0,0,27779,30150,-2371,-1,27738,2000,25738,0,27923,3000,24923,0,28143,2000,26143
4620,130000,104000,0,0,0,0,0,1,0,62370,1857,60513,0,63429,1681,61748,0,26779,971,25808,0,27521,1186,26335
4621,180000,144000,0,0,0,0,0,0,2,128491,4575,123916,2,124080,0,124080,2,126154,4600,121554,0,130064,6000,124064
4622,340000,272000,0,0,0,0,0,0,0,18784,6000,12784,0,26069,23000,3069,0,20007,400,19607,0,15857,5857,10000
4623,30000,24000,0,1,1,1,1,0,0,30945,1900,29045,0,31070,1776,29294,0,30969,1500,29469,0,30620,1100,29520
4624,310000,248000,0,0,0,0,0,1,0,156699,6699,150000,0,131276,11276,120000,0,118837,9695,109142,0,119402,19402,100000
4625,230000,184000,0,0,0,0,0,0,-1,8794,16000,-7206,-1,2095,9100,-7005,-1,129,7400,-7271,-1,303,7500,-7197
4626,180000,144000,0,0,0,0,0,0,0,57096,6000,51096,0,52694,3500,49194,0,50276,3500,46776,0,52945,3500,49445
4627,140000,112000,0,0,0,0,0,0,0,44552,3000,41552,0,46503,3000,43503,0,48418,3000,45418,0,49277,1790,47487
4628,50000,40000,0,0,0,0,0,0,0,27780,2000,25780,0,28585,1200,27385,0,28130,1000,27130,0,29005,1300,27705
4629,30000,24000,1,1,1,1,1,0,0,35714,3345,32369,0,32193,0,32193,2,29979,1000,28979,0,28191,1000,27191
4630,100000,80000,0,1,1,1,1,1,2,104365,8440,95925,2,101783,0,101783,2,101603,3873,97730,0,103457,7733,95724
4631,30000,24000,0,1,1,1,0,0,0,29467,1800,27667,0,28292,2000,26292,0,28819,2590,26229,0,28787,10000,18787
4632,20000,16000,0,1,1,1,1,0,0,20183,2000,18183,0,20036,1600,18436,0,19965,1000,18965,0,20061,1500,18561
4633,220000,176000,0,0,0,0,0,0,-1,5924,5924,0,-1,1759,1759,0,-1,1824,1824,0,-1,7022,7022,0
4634,310000,248000,0,0,0,0,0,0,-2,0,0,0,-2,0,0,0,-2,0,0,0,-2,0,0,0
4635,50000,40000,1,1,1,1,1,1,2,75322,3200,72122,2,71640,0,71640,2,71114,3000,68114,0,67519,5400,62119
4636,390000,312000,0,0,0,0,0,0,0,3386,1000,2386,0,3134,63,3071,0,259,259,0,-1,578,578,0
4637,80000,64000,0,0,0,0,0,1,2,3740,2191,1549,2,2000,0,2000,2,0,0,0,2,2096,2096,0
4638,80000,64000,0,0,0,0,0,0,0,31297,1000,30297,0,27679,730,26949,0,7689,2015,5674,0,8802,1000,7802
4639,240000,192000,0,0,0,0,0,0,0,3428,2000,1428,0,4634,2000,2634,0,4590,4590,0,-1,9675,9675,0
4640,50000,40000,0,0,0,0,0,0,0,14805,14805,0,-1,14699,294,14405,0,14999,300,14699,0,497,498,-1
4641,90000,72000,0,1,1,0,0,1,2,83674,4003,79671,2,80890,3000,77890,0,31565,3000,28565,0,33049,3000,30049
4642,20000,16000,0,0,0,0,0,0,0,20310,20310,0,-1,15617,1020,14597,0,219,219,0,-1,1205,1205,0
4643,360000,288000,0,0,0,0,0,0,-2,2766,2766,0,-2,2766,2766,0,-2,3373,3373,0,-1,5042,5042,0
4644,210000,168000,0,0,0,0,0,0,-1,10827,6018,4809,0,5385,5388,-3,-1,1187,1191,-4,-1,1552,1554,-2
4645,50000,40000,0,0,0,0,0,0,0,27906,1424,26482,0,23043,1315,21728,0,19167,1000,18167,0,19478,1000,18478
4646,30000,24000,0,1,1,0,0,0,0,29913,0,29913,2,30461,1300,29161,0,0,0,0,0,0,0,0
4647,200000,160000,0,0,0,0,0,0,0,55929,3600,52329,0,194441,141000,53441,0,146190,5100,141090,0,141550,5200,136350
4648,90000,72000,0,0,0,0,0,0,0,19809,1700,18109,0,20874,1700,19174,0,21228,1000,20228,0,21736,1000,20736
4649,30000,24000,0,0,0,0,0,1,-2,4070,4070,0,-1,3825,0,3825,2,3825,0,3825,0,0,0,0
4650,340000,272000,0,0,0,0,0,1,-1,595,595,0,-1,1193,1193,0,-1,25235,25235,0,-1,5868,5868,0
4651,20000,16000,0,1,1,1,0,0,-1,20237,1305,18932,0,19339,1258,18081,0,19450,1459,17991,0,19337,3457,15880
4652,30000,24000,0,0,0,0,0,0,0,5160,1000,4160,0,6160,1000,5160,0,5780,0,5780,0,4790,1000,3790
4653,170000,136000,0,0,0,0,0,1,-1,451,451,0,-1,0,0,0,-1,424,424,0,-1,1482,1482,0
4654,20000,16000,0,0,0,0,0,0,0,12949,1217,11732,0,13332,600,12732,0,13618,500,13118,0,14619,1230,13389
4655,210000,168000,0,0,1,0,0,0,0,117125,6000,111125,0,212656,6000,206656,0,107808,5000,102808,0,63049,3000,60049
4656,360000,288000,0,0,0,0,0,0,-1,3206,3537,-331,-1,291,291,0,-1,951,951,0,-1,2941,2941,0
4657,440000,352000,0,1,1,1,0,0,0,443407,30000,413407,0,431200,0,431200,2,440000,9000,431000,0,-6948,788,-7736
4658,20000,16000,0,0,0,0,0,0,2,380,380,0,-1,390,400,-10,-1,0,0,0,-1,780,780,0
4659,20000,16000,0,0,0,0,0,0,0,4941,1300,3641,0,4236,1246,2990,0,3200,264,2936,0,1375,375,1000
4660,80000,64000,0,0,0,0,0,0,-1,3305,3326,-21,-1,3287,3287,0,-1,630,630,0,-1,2436,2436,0
4661,350000,280000,0,0,0,0,0,1,0,82933,2970,79963,0,80501,2886,77615,0,79038,2824,76214,0,80694,2925,77769
4662,80000,64000,0,0,0,0,0,0,0,30712,1421,29291,0,29629,1001,28628,0,28241,1000,27241,0,28030,1008,27022
4663,390000,312000,0,0,0,0,0,0,-2,12578,12581,-3,-2,7650,7650,0,-2,48090,48090,0,-2,17013,28973,-11960
4664,240000,192000,0,0,0,0,0,0,0,130474,5000,125474,0,134296,6000,128296,0,139117,7000,132117,0,143634,7000,136634
4665,380000,304000,0,0,0,0,0,0,0,236316,10000,226316,0,224029,15000,209029,0,224022,30000,194022,0,225978,30251,195727
4666,130000,104000,0,0,0,0,0,0,-2,0,0,0,-2,0,0,0,-2,0,0,0,-2,0,0,0
4667,280000,224000,0,0,0,0,0,1,0,188411,9000,179411,0,191291,8000,183291,0,189029,6738,182291,0,192023,6974,185049
4668,120000,96000,0,0,0,0,0,0,0,68466,2884,65582,0,42941,2018,40923,0,40718,1411,39307,0,41613,1504,40109
4669,360000,288000,0,0,0,0,0,0,0,33788,3000,30788,0,36491,3000,33491,0,41179,5000,36179,0,45823,5000,40823
4670,20000,16000,0,1,0,0,0,0,0,17592,1295,16297,0,14588,1200,13388,0,624,624,0,-1,19945,19563,382
4671,50000,40000,0,0,0,0,0,1,0,40644,2900,37744,0,39731,0,39731,2,35657,1265,34392,0,27014,832,26182
4672,50000,40000,0,1,1,0,0,0,0,50401,2500,47901,0,49148,2040,47108,0,30036,2000,28036,0,29873,1037,28836
4673,220000,176000,0,0,0,0,0,0,-2,14510,14565,-55,-2,7229,7229,0,-2,12806,12806,0,-2,35433,35433,0
4674,20000,16000,0,0,1,1,0,0,2,20400,20400,0,-1,20000,0,20000,0,20000,0,20000,0,0,0,0
4675,260000,208000,0,0,0,0,0,1,2,0,0,0,2,0,0,0,-2,0,0,0,-2,0,0,0
4676,170000,136000,0,0,0,0,0,0,0,15788,3000,12788,0,4853,1156,3697,0,5697,1000,4697,0,47830,46793,1037
4677,150000,120000,0,0,0,0,0,0,0,11413,1500,9913,0,12418,1500,10918,0,12415,500,11915,0,13211,1000,12211
4678,380000,304000,0,0,0,0,0,1,-1,4174,4174,0,-1,-192,192,-384,-1,15011,16350,-1339,-1,12990,2000,10990
4679,120000,96000,0,1,0,0,0,0,0,102650,5000,97650,0,0,0,0,0,0,0,0,-2,30900,30900,0
4680,160000,128000,0,0,0,0,0,1,0,0,0,0,-2,0,0,0,-2,0,0,0,-2,0,0,0
4681,30000,24000,0,0,0,0,0,1,2,19270,1215,18055,0,19810,755,19055,0,19583,639,18944,0,20231,1200,19031
4682,50000,40000,0,1,1,1,1,1,2,48964,0,48964,2,49447,2000,47447,0,44067,2000,42067,0,44760,2000,42760
4683,20000,16000,0,0,1,1,1,0,0,18136,2600,15536,0,18258,701,17557,0,19478,1500,17978,0,19866,705,19161
4684,200000,160000,0,0,0,0,0,0,0,3720,1000,2720,0,7720,4000,3720,0,5030,1000,4030,0,2990,3020,-30
4685,30000,24000,0,0,0,0,0,0,0,21075,2400,18675,0,17257,1200,16057,0,15874,317,15557,0,9514,190,9324
4686,150000,120000,0,0,0,0,0,0,0,102490,3700,98790,0,103711,3700,100011,0,104153,3756,100397,0,103240,3800,99440
4687,100000,80000,0,0,0,0,0,1,-2,0,0,0,-2,0,0,0,-2,0,0,0,-2,0,0,0
4688,20000,16000,0,1,0,0,0,0,0,20650,1650,19000,0,0,0,0,0,0,0,0,-2,0,0,0
4689,260000,208000,0,0,0,0,0,0,-1,157,157,0,-1,1484,1484,0,-1,307,307,0,-1,157,157,0
4690,40000,32000,0,0,0,0,0,0,-1,-5187,4982,-10169,-2,-187,5000,-5187,-2,-187,0,-187,-2,113,3335,-3222
4691,100000,80000,0,0,0,0,0,1,-2,79618,7,79611,-2,4370,971,3399,-1,78453,79681,-1228,-1,80063,2861,77202
4692,220000,176000,0,0,0,0,0,0,0,62379,30176,32203,0,37137,10258,26879,0,-669,14000,-14669,0,14069,15070,-1001
4693,30000,24000,0,0,0,0,0,0,0,22178,1800,20378,2,21529,0,21529,2,23863,3000,20863,2,22357,0,22357
4694,240000,192000,0,0,0,0,0,0,-2,0,100000,-100000,-2,0,0,0,-2,0,0,0,-2,0,0,0
4695,200000,160000,0,0,0,0,0,0,-1,62433,42745,19688,0,-82,0,-82,0,16550,16632,-82,-1,5239,5265,-26
4696,150000,120000,0,0,0,0,0,0,-2,0,0,0,-2,0,0,0,-2,0,0,0,-2,0,0,0
4697,490000,392000,0,0,0,0,0,0,0,55597,0,55597,2,55040,5000,50040,0,51938,3000,48938,0,60606,10000,50606
4698,150000,120000,0,0,0,0,0,0,0,63653,2306,61347,0,64955,2356,62599,0,66249,2372,63877,0,67637,2456,65181
4699,290000,232000,0,0,0,0,0,0,0,0,0,0,-2,44777,44777,0,-1,26201,0,26201,0,2780,5560,-2780
4700,150000,120000,0,0,0,0,0,0,-1,0,0,0,-2,740,740,0,-1,740,0,740,0,545,545,0
4701,280000,224000,0,0,0,0,0,0,-2,12798,12805,-7,-2,3581,3587,-6,-2,10310,10361,-51,-2,11717,11734,-17
4702,160000,128000,0,0,0,0,0,0,-2,0,0,0,-2,0,0,0,-2,0,0,0,-2,0,0,0
4703,130000,104000,0,1,1,1,1,1,2,118491,0,118491,2,131444,15000,116444,2,133248,5327,127921,3,131001,22,130979
4704,50000,40000,0,0,0,0,0,1,-2,1473,1477,-4,-2,2517,2524,-7,-2,1217,1320,-103,-2,4459,4572,-113
4705,250000,200000,0,0,0,0,0,0,-1,3119,3119,0,-1,1860,1943,-83,-1,10094,10094,0,-1,4896,2896,2000
4706,70000,56000,0,0,0,0,0,0,0,52567,3000,49567,0,42743,3000,39743,0,43894,2000,41894,0,45051,2000,43051
4707,50000,40000,0,0,0,0,0,1,0,27078,1620,25458,0,19107,1000,18107,0,19506,707,18799,0,20024,841,19183
4708,240000,192000,0,0,0,0,0,0,0,136232,6000,130232,2,132569,0,132569,2,135007,5806,129201,0,34036,2198,31838
4709,350000,280000,0,0,0,0,0,0,-1,-3626,5,-3631,-1,6531,10971,-4440,-1,4440,0,4440,0,750,750,0
4710,490000,392000,0,0,0,0,0,0,0,18817,1397,17420,0,13424,3193,10231,0,162851,162856,-5,-1,151961,5461,146500
4711,200000,160000,0,0,0,0,0,1,-1,10902,0,10902,2,6309,6309,0,-1,4979,0,4979,0,2978,2986,-8
4712,420000,336000,0,0,0,0,0,0,-1,53697,55732,-2035,-1,50081,1563,48518,0,44875,1594,43281,0,42691,1454,41237
4713,110000,88000,0,1,1,1,1,0,0,111998,11500,100498,0,112290,3925,108365,2,106721,0,106721,2,107636,5000,102636
4714,50000,40000,0,1,0,0,0,0,0,49057,2409,46648,0,17426,769,16657,0,17789,792,16997,0,18003,659,17344
4715,280000,224000,0,0,0,0,0,0,-1,9432,9432,0,-1,3472,3472,0,-1,3472,3472,0,-1,10237,10237,0
4716,50000,40000,0,1,1,0,0,0,0,49550,2500,47050,0,48377,1135,47242,0,18727,497,18230,0,19116,514,18602
4717,170000,136000,0,1,0,0,0,0,0,169956,7333,162623,0,119844,4218,115626,0,117944,4269,113675,0,118163,4481,113682
4718,100000,80000,0,0,0,0,0,0,-1,977,977,0,-1,0,0,0,-2,0,0,0,-2,0,0,0
4719,260000,208000,0,0,0,0,0,0,-1,0,0,0,-1,3600,3600,0,-1,2250,2250,0,-1,1650,0,1650
4720,160000,128000,0,1,1,0,0,0,0,161076,6401,154675,0,156478,6384,150094,0,122441,4600,117841,0,120574,4800,115774
4721,500000,400000,0,0,0,0,0,0,0,55446,2599,52847,0,47208,1500,45708,0,32019,2019,30000,0,22318,1200,21118
4722,360000,288000,0,0,0,0,0,0,-1,2500,0,2500,2,0,0,0,2,0,0,0,-2,0,0,0
4723,70000,56000,0,0,0,0,0,1,2,40265,3500,36765,2,42306,3000,39306,3,41352,0,41352,3,44342,4000,40342
4724,90000,72000,0,1,1,1,1,0,0,83779,0,83779,2,88577,7200,81377,2,86365,0,86365,2,91105,6200,84905
4725,120000,96000,0,0,0,0,0,0,-2,316,316,0,-2,316,316,0,-2,316,316,0,-2,316,316,0
4726,200000,160000,0,0,0,0,0,0,-1,1916,1916,0,-1,0,0,0,-1,150,150,0,-1,1348,1348,0
4727,70000,56000,0,0,0,0,0,0,-1,390,390,0,-1,390,390,0,-1,1311,1311,0,-1,1933,1933,0
4728,180000,144000,0,0,0,0,0,0,-1,0,0,0,-2,0,0,0,-2,1972,1972,0,-1,0,0,0
4729,260000,208000,0,0,0,0,0,0,-2,0,0,0,-2,0,0,0,-2,3982,3982,0,-2,0,0,0
4730,500000,400000,0,0,0,0,0,0,0,67260,3334,63926,0,76145,15012,61133,0,74831,2822,72009,0,111826,40025,71801
4731,450000,360000,0,0,0,0,0,1,-2,0,200,-200,-2,42000,42000,0,-1,0,0,0,-1,0,0,0
4732,60000,48000,0,0,0,0,0,0,-2,0,0,0,-2,150,150,0,-1,1179,1179,0,-1,778,778,0
4733,80000,64000,0,1,1,0,0,0,0,79514,2874,76640,0,72712,2335,70377,0,42309,1600,40709,0,43227,1600,41627
4734,230000,184000,0,0,0,0,0,0,-1,1854,1854,0,-1,396,396,0,-1,1950,1950,0,-1,1099,1099,0
4735,140000,112000,0,0,0,0,0,0,0,83046,3000,80046,0,84034,3000,81034,0,77659,3000,74659,0,77180,3000,74180
4736,360000,288000,0,0,0,0,0,0,0,0,0,0,-2,0,0,0,-2,0,0,0,-2,0,0,0
4737,100000,80000,0,1,0,0,0,1,0,93420,3105,90315,0,73119,2700,70419,0,73642,2510,71132,0,71579,2703,68876
4738,10000,8000,0,0,0,0,0,1,0,8600,2000,6600,0,9470,1500,7970,0,6690,900,5790,0,9690,3000,6690
4739,80000,64000,0,0,0,0,0,0,0,49940,1780,48160,0,49460,1800,47660,0,50687,2000,48687,0,50288,2000,48288
4740,290000,232000,0,1,1,1,0,1,0,282508,10200,272308,0,284660,10265,274395,0,255892,8803,247089,0,238266,8300,229966
4741,210000,168000,0,0,0,0,0,0,0,44048,1326,42722,0,15398,400,14998,0,8657,230,8427,0,3180,100,3080
4742,30000,24000,0,0,0,0,0,0,0,23183,1700,21483,0,13273,750,12523,0,3027,200,2827,0,3177,200,2977
4743,260000,208000,0,0,0,0,0,0,0,0,0,0,-2,0,0,0,-2,58,58,0,-1,1058,1000,58
4744,120000,96000,0,0,0,0,0,0,-1,1870,1870,0,-1,652,652,0,-1,326,0,326,0,0,0,0
4745,170000,136000,0,0,0,0,0,0,-1,10121,10121,0,-1,12180,12180,0,-1,15667,5011,10656,0,9224,0,9224
4746,60000,48000,0,0,1,1,1,0,2,49476,2000,47476,2,50360,2000,48360,2,50509,1100,49409,2,52522,3000,49522
4747,120000,96000,0,0,0,0,0,1,-2,0,0,0,-2,0,0,0,-2,0,0,0,-2,0,0,0
4748,180000,144000,0,0,0,0,0,0,-2,10621,10628,-7,-2,3913,7826,-3913,-2,1707,1707,0,-2,15087,15087,0
4749,420000,336000,0,0,0,0,0,0,-1,15068,15087,-19,-1,37435,37435,0,-1,-1896,287,-2183,-1,18995,25087,-6092
4750,50000,40000,0,0,0,0,0,0,0,16391,2500,13891,0,17804,2050,15754,0,10868,0,10868,2,12151,2000,10151
4751,50000,40000,0,0,0,0,0,0,0,33597,1693,31904,0,29105,1106,27999,0,26154,1473,24681,0,27699,3000,24699
4752,20000,16000,0,0,1,1,1,0,0,17222,1300,15922,0,18045,1500,16545,0,18083,700,17383,0,18123,700,17423
4753,90000,72000,0,0,0,0,0,0,-1,0,0,0,-1,0,0,0,-2,0,0,0,-2,501,501,0
4754,50000,40000,0,0,0,0,0,0,-1,780,1000,-220,-1,390,0,390,2,780,780,0,-1,40418,40418,0
4755,260000,208000,0,0,0,0,0,0,-1,-73,0,-73,-1,-73,0,-73,-2,-73,0,-73,-2,-73,0,-73
4756,500000,400000,0,0,0,0,0,0,0,10176,5019,5157,0,20719,15027,5692,0,15665,639,15026,0,8074,547,7527
4757,130000,104000,0,0,0,0,0,0,-1,989,991,-2,-1,989,991,-2,-1,990,992,-2,-1,702,703,-1
4758,20000,16000,1,1,1,1,1,0,7,23353,0,23353,6,22719,0,22719,5,21796,0,21796,4,21162,0,21162
4759,330000,264000,0,0,0,0,0,0,-2,2184,2184,0,-2,2184,2184,0,-2,2184,2184,0,-2,2184,2184,0
4760,40000,32000,0,0,0,0,0,0,-1,4059,4385,-326,-1,13522,10000,3522,0,16416,5000,11416,0,807,807,0
4761,200000,160000,0,0,0,0,0,0,0,121473,4408,117065,0,123943,4489,119454,0,127552,5660,121892,0,130380,6000,124380
4762,130000,104000,0,0,0,0,0,0,0,62599,3022,59577,0,51950,2000,49950,0,44189,2000,42189,0,38034,2000,36034
4763,60000,48000,0,0,0,0,0,0,0,46576,3010,43566,0,41376,3004,38372,0,36959,3000,33959,0,35508,3000,32508
4764,90000,72000,0,0,0,0,0,1,0,18037,5035,13002,0,1696,6700,-5004,-1,-4,0,-4,-1,2889,2893,-4
4765,260000,208000,0,0,0,0,0,0,0,190152,7200,182952,0,186696,6800,179896,0,188632,7100,181532,0,190948,7200,183748
4766,80000,64000,0,0,0,0,0,0,0,22478,22478,0,-1,5011,5011,0,-1,4674,4674,0,-1,0,0,0
4767,50000,40000,0,0,0,0,0,0,0,28813,2000,26813,0,29550,1500,28050,0,29106,1100,28006,0,29718,1096,28622
4768,30000,24000,0,1,1,0,1,1,0,27951,1476,26475,0,28475,1000,27475,0,29085,31000,-1915,-1,26810,1000,25810
4769,500000,400000,0,0,0,0,0,0,-2,8041,8081,-40,-2,68595,68595,0,-2,72011,72011,0,-2,77931,77931,0
4770,210000,168000,0,0,0,0,0,0,-1,9396,10455,-1059,-1,16992,16992,0,-1,9506,9509,-3,-1,4837,4837,0
4771,80000,64000,0,0,0,0,0,0,0,10982,1157,9825,0,11325,500,10825,0,11569,400,11169,0,10303,500,9803
4772,260000,208000,0,1,0,0,0,1,0,234214,9800,224414,0,169096,6000,163096,0,117873,4088,113785,0,79782,3000,76782
4773,240000,192000,0,0,0,0,0,0,0,186885,8246,178639,0,187756,6806,180950,0,188520,5112,183408,0,189908,5291,184617
4774,300000,240000,0,0,0,0,0,0,0,16425,11236,5189,0,11976,1032,10944,0,3012,9,3003,0,0,0,0
4775,80000,64000,0,0,0,0,0,0,0,49642,3000,46642,0,52052,3000,49052,0,40505,3000,37505,0,41471,1637,39834
4776,420000,336000,0,0,0,0,0,0,0,15926,17570,-1644,-1,4169,1000,3169,0,158062,158556,-494,-1,156341,5000,151341
4777,180000,144000,0,0,0,0,0,0,0,9893,3968,5925,0,2690,2690,0,-1,0,0,0,-1,0,0,0
4778,360000,288000,0,0,0,0,0,0,0,14898,2000,12898,0,7524,150,7374,0,7524,0,7524,0,0,0,0
4779,30000,24000,0,1,0,0,1,1,0,26755,2000,24755,0,23235,2000,21235,0,25008,2000,23008,0,26761,2000,24761
4780,400000,320000,0,0,0,0,0,0,0,7558,1500,6058,0,6877,1000,5877,0,4880,1000,3880,0,6728,3000,3728
4781,500000,400000,0,0,0,0,0,0,-1,2339,4401,-2062,-1,4333,3150,1183,-1,1285,0,1285,2,1969,1000,969
4782,200000,160000,0,0,0,0,0,0,-1,200,200,0,-1,15845,15845,0,-1,15845,0,15845,0,-39,0,-39
4783,270000,216000,0,0,0,0,0,0,0,35638,2638,33000,0,41704,6704,35000,0,43869,2869,41000,0,45160,2000,43160
4784,240000,192000,0,0,0,0,0,0,0,189095,7506,181589,0,190481,6501,183980,0,194215,6501,187714,0,198313,7001,191312
4785,210000,168000,0,0,0,0,0,0,0,40291,5013,35278,0,31869,4000,27869,0,32186,5000,27186,0,25554,5000,20554
4786,40000,32000,0,0,0,0,0,0,0,28055,3000,25055,0,15199,3000,12199,0,17331,3000,14331,0,19428,3000,16428
4787,110000,88000,0,1,1,1,1,0,0,107325,5361,101964,0,108545,4500,104045,0,105341,4000,101341,0,106822,4500,102322
4788,30000,24000,0,0,0,0,0,0,2,20831,1000,19831,2,21231,1000,20231,2,20589,0,20589,2,31018,13000,18018
4789,110000,88000,0,0,0,0,0,0,0,87820,2885,84935,0,67259,2212,65047,0,50007,1789,48218,0,51202,2000,49202
4790,150000,120000,0,0,0,0,0,0,-1,3023,3500,-477,-1,2914,3025,-111,-1,3529,3600,-71,-1,2989,0,2989
4791,270000,216000,0,0,0,0,0,0,0,91426,2969,88457,0,93262,3000,90262,0,96104,4000,92104,0,98374,3500,94874
4792,50000,40000,0,1,1,1,1,0,2,43673,0,43673,2,44659,2000,42659,0,49512,6000,43512,0,48454,300,48154
4793,360000,288000,0,0,0,0,0,1,-2,0,0,0,-2,0,0,0,-2,0,0,0,-2,0,0,0
4794,70000,56000,0,0,0,0,0,0,0,30570,2000,28570,0,31367,2000,29367,0,32163,2000,30163,0,32975,2000,30975
4795,20000,16000,0,1,1,1,1,1,0,19745,1386,18359,0,19943,1189,18754,0,19235,570,18665,0,19245,589,18656
4796,10000,8000,0,0,0,0,0,0,2,9839,4000,5839,2,6998,0,6998,2,3183,0,3183,0,1151,0,1151
4797,210000,168000,0,0,0,0,0,0,0,85001,3500,81501,0,83811,3113,80698,0,82399,3000,79399,0,81434,3331,78103
4798,210000,168000,0,0,0,0,0,0,0,17694,1500,16194,0,18892,1500,17392,0,20566,2000,18566,0,23226,3000,20226
4799,100000,80000,0,0,0,0,0,0,0,75452,3350,72102,0,69257,3000,66257,0,62005,2400,59605,0,60882,2500,58382
4800,150000,120000,0,0,0,0,0,0,0,72182,6000,66182,0,61014,3000,58014,0,49502,2000,47502,0,46055,10000,36055
4801,80000,64000,0,0,1,1,1,0,0,69261,5631,63630,0,67551,0,67551,2,71282,5000,66282,0,72942,3000,69942
4802,70000,56000,0,0,0,0,0,0,0,56718,2200,54518,0,47191,1700,45491,0,45959,1700,44259,0,47635,2441,45194
4803,290000,232000,0,0,0,0,0,0,0,100000,3000,97000,0,3015,3015,0,-1,23473,23473,0,-1,1448,1148,300
4804,20000,16000,0,0,0,0,0,1,0,13940,3250,10690,0,14755,1340,13415,2,14223,0,14223,2,15337,1500,13837
4805,210000,168000,0,0,0,0,0,0,2,380,380,0,-1,705,705,0,-1,705,705,0,-1,705,705,0
4806,50000,40000,0,0,0,0,0,0,0,17496,1500,15996,0,17907,1000,16907,0,18375,1000,17375,0,11400,1600,9800
4807,350000,280000,0,0,0,0,0,0,2,27036,27036,0,-1,1559,1559,0,-1,1962,1962,0,-1,3683,3683,0
4808,360000,288000,0,0,0,0,0,0,0,131328,10000,121328,0,137605,10000,127605,0,140729,5500,135229,0,146194,8000,138194
4809,20000,16000,0,0,0,0,0,0,0,8992,500,8492,2,9452,1000,8452,0,10520,2000,8520,0,11320,800,10520
4810,200000,160000,0,0,0,0,0,1,0,28509,3000,25509,0,27381,0,27381,2,29054,2500,26554,2,28052,0,28052
4811,50000,40000,0,0,0,0,0,0,0,29241,1500,27741,0,28513,1200,27313,0,29106,1203,27903,0,29638,1166,28472
4812,150000,120000,1,1,0,0,0,0,0,245393,8000,237393,0,29526,5000,24526,0,6990,6800,190,0,0,0,0
4813,30000,24000,0,0,0,0,1,0,0,22537,1500,21037,0,24161,2000,22161,0,25128,1500,23628,2,24576,0,24576
4814,170000,136000,0,0,0,0,0,0,-1,200,200,0,-1,41467,41467,0,-1,1028,1328,-300,-1,2643,2643,0
4815,30000,24000,0,0,0,0,0,1,0,0,0,0,0,0,0,0,-2,0,0,0,-2,0,0,0
4816,130000,104000,0,0,0,0,0,1,2,5978,6000,-22,-1,2750,2750,0,-1,3641,3641,0,-1,1735,1735,0
4817,30000,24000,0,0,1,1,1,0,0,25382,1440,23942,0,26351,1409,24942,0,25165,1048,24117,0,25536,927,24609
4818,260000,208000,0,0,0,0,0,0,2,29423,29423,0,-1,37900,10000,27900,-1,-3400,0,-3400,-1,-4000,0,-4000
4819,20000,16000,0,0,0,1,1,1,0,13188,1600,11588,0,18318,5700,12618,0,18419,700,17719,2,18978,1000,17978
4820,190000,152000,0,1,0,1,1,0,0,165858,6031,159827,0,159374,20036,139338,0,158040,5732,152308,0,159833,5648,154185
4821,50000,40000,0,1,0,0,0,1,2,46945,2052,44893,0,21260,1800,19460,0,70,0,70,0,29575,29935,-360
4822,380000,304000,0,0,0,0,0,0,0,100599,4074,96525,0,81087,2592,78495,0,82793,2696,80097,0,85301,3569,81732
4823,50000,40000,0,0,0,0,0,1,0,18027,759,17268,2,13836,500,13336,0,14966,6326,8640,0,13220,3259,9961
4824,280000,224000,0,0,0,0,0,0,0,25048,1647,23401,0,24116,1004,23112,0,50483,41551,8932,0,47056,2056,45000
4825,80000,64000,0,0,0,0,0,1,-2,-12,0,-12,-2,17691,17703,-12,-1,4599,4599,0,-1,4134,4134,0
4826,220000,176000,0,0,0,0,0,0,0,117567,4500,113067,0,153069,37486,115583,0,153045,6000,147045,0,144529,5200,139329
4827,60000,48000,0,0,0,0,0,0,0,47413,2050,45363,0,36527,2011,34516,0,28170,1200,26970,0,28963,1400,27563
4828,150000,120000,0,0,0,0,0,0,-2,12853,12904,-51,-2,12531,12541,-10,-2,5325,5330,-5,-2,2086,2086,0
4829,340000,272000,0,0,0,0,0,0,-2,84050,50024,34026,-1,172925,100108,72817,-1,140040,4933,135107,0,95230,10114,85116
4830,170000,136000,0,0,0,0,0,0,-2,0,0,0,-2,1340,1340,0,-2,0,0,0,-2,0,0,0
4831,50000,40000,0,1,0,0,0,0,2,46892,2343,44549,0,33936,1548,32388,0,9225,476,8749,0,9264,336,8928
4832,200000,160000,0,0,0,0,0,0,-2,3724,3742,-18,-2,445,447,-2,-2,8963,9007,-44,-2,482,484,-2
4833,20000,16000,0,1,1,1,1,1,0,17618,1600,16018,0,17365,347,17018,0,17719,354,17365,0,17740,355,17385
4834,180000,144000,0,0,0,0,0,0,-1,11279,1133,10146,0,5698,1000,4698,0,5993,1000,4993,0,-73895,0,-73895
4835,200000,160000,0,0,0,0,0,0,-2,0,0,0,-2,1115,1115,0,-2,0,0,0,-2,0,0,0
4836,20000,16000,0,1,1,1,0,1,2,20526,2976,17550,2,19360,0,19360,2,19660,500,19160,0,6000,120,5880
4837,290000,232000,0,0,0,0,0,0,-1,0,0,0,-1,0,0,0,-2,0,0,0,-2,0,0,0
4838,200000,160000,0,0,0,0,0,0,0,102998,3800,99198,0,105090,3802,101288,0,107718,4363,103355,0,88964,3500,85464
4839,200000,160000,0,0,0,0,0,1,3,94772,5000,89772,2,92368,0,92368,2,101837,12000,89837,2,103764,3700,100064
4840,200000,160000,0,1,1,1,1,0,0,195535,15500,180035,0,190960,0,190960,2,202139,14184,187955,2,194326,0,194326
4841,150000,120000,0,0,0,0,0,0,0,27810,1810,26000,0,172,172,0,-1,0,0,0,-1,0,0,0
4842,200000,160000,0,1,1,1,1,1,2,180260,0,180260,2,192260,15000,177260,2,187714,0,187714,2,195702,11013,184689
4843,150000,120000,0,0,0,0,0,0,0,17051,2008,15043,0,15109,1004,14105,0,13895,505,13390,0,14236,573,13663
4844,20000,16000,0,0,0,1,0,1,2,-3744,0,-3744,2,17105,21200,-4095,-1,17250,345,16905,0,0,0,0
4845,50000,40000,0,0,0,0,0,0,0,20084,2004,18080,0,18088,7497,10591,0,18476,671,17805,0,20168,2000,18168
4846,280000,224000,0,0,0,0,0,0,0,47069,2144,44925,0,40939,1666,39273,0,44290,5015,39275,0,70573,32013,38560
4847,50000,40000,0,0,0,0,0,0,0,9649,1500,8149,0,10975,1500,9475,0,11292,500,10792,0,11610,500,11110
4848,130000,104000,0,0,0,0,0,0,-1,11249,11249,0,-1,7816,1200,6616,0,16578,16578,0,-1,16129,0,16129
4849,80000,64000,0,0,0,0,0,0,2,42592,3000,39592,2,43296,1700,41596,2,43892,1600,42292,2,43060,0,43060
4850,210000,168000,0,0,0,0,0,0,0,90533,4000,86533,0,93027,4000,89027,0,96524,5000,91524,0,100765,6000,94765
4851,210000,168000,0,1,1,0,0,0,0,199963,10000,189963,0,205137,10000,195137,0,84877,84890,-13,-1,83899,2948,80951
4852,50000,40000,0,0,0,0,0,0,-2,0,0,0,-2,831,831,0,-1,138,138,0,-1,658,658,0
4853,200000,160000,0,0,0,0,0,1,-1,6360,7096,-736,-1,2620,2620,0,-1,5900,6000,-100,-1,37084,17703,19381
4854,50000,40000,0,0,0,0,0,1,2,38617,1906,36711,0,8999,500,8499,0,8870,500,8370,0,5876,300,5576
4855,200000,160000,0,0,0,0,0,0,0,140844,6550,134294,0,144245,7200,137045,0,135946,5300,130646,0,135736,5400,130336
4856,290000,232000,0,0,0,0,0,0,-1,5029,5054,-25,-1,3103,3109,-6,-1,1838,9,1829,0,690,693,-3
4857,20000,16000,0,0,0,0,0,1,2,15212,3100,12112,2,14675,0,14675,2,14835,700,14135,0,15047,600,14447
4858,220000,176000,0,0,0,0,0,0,2,6478,2000,4478,0,7412,1200,6212,0,7886,600,7286,0,8358,600,7758
4859,210000,168000,0,0,0,0,0,0,-2,947,947,0,-2,500,500,0,-2,1283,1283,0,-2,500,500,0
4860,30000,24000,0,1,1,0,0,0,0,28089,1451,26638,2,25805,9,25796,2,21356,1003,20353,0,15158,905,14253
4861,380000,304000,0,0,0,0,0,0,-2,0,0,0,-2,0,0,0,-2,0,0,0,-2,0,0,0
4862,20000,16000,0,0,0,0,0,1,2,1560,1000,560,0,1170,0,1170,0,780,0,780,0,780,0,780
4863,500000,400000,0,0,0,0,0,0,-2,-33,0,-33,-2,6454,6487,-33,-1,842,842,0,-1,8031,8111,-80
4864,100000,80000,0,0,0,0,0,0,0,62959,5003,57956,0,61796,1723,60073,0,62602,3115,59487,0,64983,3000,61983
4865,60000,48000,0,0,0,0,0,0,0,22388,2000,20388,0,22431,1000,21431,0,22324,1000,21324,0,22601,2000,20601
4866,80000,64000,0,0,0,0,0,0,-1,0,0,0,-1,0,0,0,-2,19688,19688,0,-1,5800,5800,0
4867,240000,192000,0,0,0,0,0,1,2,0,0,0,2,0,0,0,-2,0,0,0,-2,0,0,0
4868,380000,304000,0,0,0,0,0,0,-2,990,990,0,-2,2086,2086,0,-1,0,0,0,-1,4069,4069,0
4869,280000,224000,0,0,0,0,0,0,-1,314042,117698,196344,0,116480,3884,112596,0,118270,3376,114894,0,124742,7503,117239
4870,90000,72000,0,0,0,0,0,0,0,50663,2018,48645,0,45515,2033,43482,0,42599,2016,40583,0,38559,2010,36549
4871,50000,40000,0,1,0,0,0,0,0,50136,2000,48136,0,20287,730,19557,0,20281,800,19481,0,20027,900,19127
4872,220000,176000,0,0,0,0,0,0,-1,396,396,0,-1,316,316,0,-1,32816,32816,0,-1,316,316,0
4873,20000,16000,1,1,1,1,1,0,4,20440,0,20440,3,19709,0,19709,2,20113,900,19213,2,19840,0,19840
4874,280000,224000,0,0,0,0,0,0,-2,15288,15364,-76,-2,4923,9948,-5025,-2,19616,19693,-77,-2,5191,5216,-25
4875,50000,40000,0,1,0,0,0,0,2,50245,300,49945,2,9246,332,8914,0,18992,400,18592,0,9697,358,9339
4876,240000,192000,0,0,0,0,0,0,0,176990,7000,169990,0,169198,6000,163198,0,166131,5200,160931,0,169245,5400,163845
4877,80000,64000,0,0,0,0,0,0,-1,-6042,0,-6042,-1,-6867,0,-6867,-2,-8692,0,-8692,-2,54375,150000,-95625
4878,150000,120000,0,0,0,0,0,0,-2,17877,17914,-37,-2,25172,25349,-177,-2,4694,4694,0,-2,6292,6324,-32
4879,250000,200000,0,0,0,0,0,0,-2,186394,186398,-4,-2,9458,9467,-9,-2,6620,6620,0,-2,10040,10040,0
4880,160000,128000,0,0,0,0,0,1,3,168,0,168,2,1449,1449,0,-1,916,0,916,2,2133,2133,0
4881,80000,64000,0,0,0,0,0,0,-1,390,390,0,-1,390,390,0,-1,780,780,0,-1,390,0,390
4882,120000,96000,0,0,0,0,0,0,0,16607,600,16007,2,16043,0,16043,2,16379,595,15784,0,16706,599,16107
4883,220000,176000,0,1,1,1,1,1,2,189680,7100,182580,0,193561,7203,186358,0,205161,15000,190161,0,205477,3500,201977
4884,30000,24000,0,1,1,1,1,0,0,28158,1503,26655,0,29385,1730,27655,0,29665,1010,28655,0,30446,1206,29240
4885,80000,64000,0,0,0,0,0,0,-1,0,0,0,-1,0,0,0,-2,0,0,0,-2,0,0,0
4886,50000,40000,0,0,0,0,0,0,-1,13890,13914,-24,-1,2545,2545,0,-1,15688,16508,-820,-1,3088,3088,0
4887,430000,344000,0,0,0,0,0,0,0,74806,10806,64000,0,82241,12241,70000,0,80298,1606,78692,0,53289,1119,52170
4888,80000,64000,0,0,0,0,0,0,0,39681,2490,37191,0,29213,1522,27691,0,25356,1100,24256,0,22723,960,21763
4889,30000,24000,0,0,0,0,0,0,0,23071,4000,19071,0,23496,3000,20496,0,26562,5000,21562,0,27346,5000,22346
4890,60000,48000,0,0,0,0,0,0,0,38551,5000,33551,0,42922,5000,37922,0,47245,5000,42245,0,44208,0,44208
4891,110000,88000,0,0,0,0,0,0,2,16809,1000,15809,2,8682,0,8682,2,8861,602,8259,2,8623,0,8623
4892,220000,176000,0,0,0,0,0,0,0,39494,3000,36494,0,16842,1160,15682,0,0,1000,-1000,0,8419,0,8419
4893,80000,64000,0,0,0,0,0,1,2,56657,6000,50657,2,57340,2200,55140,2,55823,0,55823,2,58260,3500,54760
4894,230000,184000,0,0,0,0,0,0,2,120988,4500,116488,2,121464,3800,117664,2,123740,5000,118740,2,120937,0,120937
4895,200000,160000,0,0,0,0,0,0,-2,1684,1689,-5,-2,1581,1581,0,-1,2381,800,1581,0,2381,0,2381
4896,80000,64000,0,0,0,0,0,0,-1,4374,0,4374,2,5495,1200,4295,0,5902,500,5402,0,6804,1000,5804
4897,30000,24000,0,1,1,1,1,1,2,28234,2000,26234,0,28272,2483,25789,0,28494,1003,27491,0,28182,969,27213
4898,70000,56000,0,0,0,0,0,0,0,11203,1600,9603,0,11320,600,10720,0,11487,500,10987,0,11895,600,11295
4899,300000,240000,0,1,1,1,1,1,2,256178,11000,245178,2,260434,10000,250434,2,264114,9500,254614,2,269733,10000,259733
4900,210000,168000,0,0,0,0,0,0,-2,38013,38013,0,-1,40555,3000,37555,0,45075,5000,40075,0,37056,3000,34056
4901,360000,288000,0,0,0,0,0,0,-2,0,0,0,-2,0,0,0,-2,0,0,0,-2,0,0,0
4902,360000,288000,0,0,0,0,0,0,-1,6037,6041,-4,-1,1560,1560,0,-1,0,0,0,-1,275,275,0
4903,310000,248000,0,0,0,0,0,0,0,46979,2000,44979,0,42045,2000,40045,0,40334,2000,38334,0,49542,13000,36542
4904,150000,120000,0,0,0,0,0,0,-2,102598,4044,98554,-2,3039,309,2730,-2,-309,0,-309,-2,-309,0,-309
4905,200000,160000,0,0,0,0,0,1,2,150,0,150,2,150,0,150,2,2500,2500,0,-1,0,0,0
4906,70000,56000,0,0,0,0,0,0,-1,1885,1885,0,-1,2216,2216,0,-1,1348,1348,0,-1,29873,29873,0
4907,230000,184000,0,0,0,0,0,0,2,10277,1000,9277,2,13148,3000,10148,2,12834,0,12834,2,13861,1200,12661
4908,200000,160000,0,0,0,0,0,1,0,153856,5701,148155,0,156401,5576,150825,0,159300,6009,153291,0,160571,5811,154760
4909,420000,336000,0,0,0,0,0,0,0,16024,1067,14957,0,9603,3061,6542,0,2131,2210,-79,-1,64507,64524,-17
4910,50000,40000,1,1,1,1,1,0,0,57335,2356,54979,0,59595,3494,56101,0,55949,2000,53949,2,51225,0,51225
4911,50000,40000,0,0,1,1,1,1,2,41526,1800,39726,2,42045,1500,40545,2,42822,1600,41222,2,43962,2000,41962
4912,20000,16000,0,0,0,0,0,1,2,300,0,300,2,300,0,300,2,300,0,300,2,300,0,300
4913,180000,144000,0,0,0,0,0,0,-2,0,0,0,-2,0,0,0,-2,0,0,0,-2,0,0,0
4914,260000,208000,0,0,0,0,0,0,0,90857,5020,85837,0,-81334,81569,-162903,0,142645,331788,-189143,-1,149655,10002,139653
4915,360000,288000,0,0,0,0,0,0,0,18875,4564,14311,0,7742,2200,5542,0,5572,1000,4572,0,131869,131869,0
4916,200000,160000,0,0,0,0,0,0,0,125205,4371,120834,0,113304,4037,109267,0,114667,6613,108054,0,110138,4055,106083
4917,50000,40000,0,0,0,0,0,0,0,4207,4207,0,-1,694,694,0,-1,238,238,0,-1,0,0,0
4918,200000,160000,0,0,0,0,0,0,0,95836,2441,93395,0,85635,1854,83781,0,66137,1567,64570,0,30410,5000,25410
4919,260000,208000,0,0,0,0,0,0,-2,450,450,0,-2,773,773,0,-2,268,268,0,-2,402,402,0
4920,120000,96000,0,0,0,0,0,1,2,49653,4000,45653,2,48571,0,48571,3,47664,0,47664,2,48720,2000,46720
4921,250000,200000,0,0,0,0,0,0,-1,6942,6955,-13,-1,2779,2517,262,0,2497,2497,0,-1,2830,2830,0
4922,250000,200000,0,0,0,0,0,0,-1,3600,3618,-18,-1,-10,0,-10,-1,2022,2032,-10,-1,3809,3827,-18
4923,190000,152000,0,0,1,1,1,1,2,160000,13000,147000,2,155932,0,155932,2,166414,13000,153414,2,169625,6100,163525
4924,120000,96000,0,0,0,0,0,0,0,38746,1640,37106,0,40107,2000,38107,0,41464,2000,39464,0,42680,2000,40680
4925,20000,16000,0,0,0,0,0,0,0,6997,0,6997,2,8028,3000,5028,0,9510,2000,7510,0,8815,0,8815
4926,60000,48000,0,0,0,0,0,0,-1,32122,0,32122,2,31423,0,31423,0,2914,0,2914,0,1470,1470,0
4927,160000,128000,0,0,0,0,0,0,0,111807,4000,107807,0,107418,3500,103918,0,90471,3300,87171,0,86363,3500,82863
4928,20000,16000,0,0,0,0,0,1,2,13169,1900,11269,2,13656,1000,12656,2,14430,1000,13430,0,14200,0,14200
4929,110000,88000,0,0,0,0,0,0,0,74647,3066,71581,0,49021,2033,46988,0,34594,2021,32573,0,23116,1024,22092
4930,280000,224000,0,0,0,0,0,0,-1,1160,1160,0,-1,985,985,0,-1,0,0,0,-1,65862,65862,0
4931,50000,40000,0,0,0,0,0,1,0,956,956,0,-1,976,20,956,0,1976,1000,976,0,2939,1000,1939
4932,320000,256000,0,0,0,0,0,0,2,948,1200,-252,-1,632,0,632,0,316,0,316,0,316,316,0
4933,180000,144000,0,0,0,0,0,0,0,26310,1800,24510,0,26662,1500,25162,0,26166,1056,25110,0,26176,950,25226
4934,110000,88000,0,0,0,0,0,0,0,62425,2100,60325,0,59118,2000,57118,0,49449,2000,47449,0,38047,1500,36547
4935,450000,360000,0,0,0,0,0,0,0,5266,5000,266,0,4425,4425,0,-1,15091,15091,0,-1,6341,0,6341
4936,20000,16000,0,0,0,0,0,0,-1,4956,4956,0,-1,10148,200,9948,0,6979,2000,4979,0,8353,1500,6853
4937,350000,280000,0,0,0,0,0,0,-2,12228,12228,0,-2,19850,19850,0,-2,8800,8800,0,-2,4260,4260,0
4938,480000,384000,0,0,0,0,0,0,0,20116,5000,15116,0,10060,500,9560,0,9301,500,8801,0,923,500,423
4939,500000,400000,0,0,0,0,0,1,-1,198,0,198,-1,198,0,198,2,115397,115399,-2,-1,120250,6211,114039
4940,150000,120000,0,0,0,0,0,0,4,75841,0,75841,3,73678,0,73678,2,77273,4874,72399,2,56577,1000,55577
4941,30000,24000,0,0,0,0,0,0,2,15514,600,14914,2,14968,0,14968,2,16026,1300,14726,2,15619,0,15619
4942,70000,56000,0,1,1,1,0,0,2,72192,6516,65676,2,70444,0,70444,2,71900,3300,68600,0,0,0,0
4943,200000,160000,0,0,0,0,0,0,-2,1818,1818,0,-2,4192,4192,0,-1,6066,6066,0,-1,1616,1616,0
4944,230000,184000,0,0,0,0,0,0,0,5305,3116,2189,0,5661,1000,4661,0,3935,2000,1935,0,4460,2000,2460
4945,110000,88000,0,0,0,0,0,0,0,37689,2000,35689,0,37750,2000,35750,0,33281,1300,31981,0,30968,1500,29468
4946,70000,56000,0,0,0,0,0,0,0,26694,1759,24935,0,28935,3000,25935,0,28174,0,28174,2,30061,2500,27561
4947,130000,104000,0,1,0,0,0,0,0,118909,4871,114038,0,84865,3500,81365,0,86846,3500,83346,0,88069,3500,84569
4948,50000,40000,0,1,1,1,1,1,2,46294,2000,44294,2,47147,1900,45247,2,46272,0,46272,2,49050,3700,45350
4949,300000,240000,0,0,0,0,0,0,0,131968,8000,123968,0,113866,5000,108866,0,10811,1342,9469,0,158664,150000,8664
4950,80000,64000,0,0,0,0,0,1,0,26189,1388,24801,0,26801,1000,25801,0,28593,2180,26413,0,26020,0,26020
4951,420000,336000,0,0,0,0,0,0,-1,1985,1985,0,-1,6850,6860,-10,-1,1822,1822,0,-1,4249,4249,0
4952,150000,120000,0,0,0,0,0,0,-2,2997,1006,1991,-2,735,50000,-49265,-2,1104,1104,0,-2,0,0,0
4953,360000,288000,0,0,0,0,0,1,2,112157,0,112157,2,114690,5900,108790,0,117845,5000,112845,0,120238,4500,115738
4954,360000,288000,0,0,0,0,0,0,-1,22637,22751,-114,-1,101497,101691,-194,-1,68960,2233,66727,0,28399,6138,22261
4955,50000,40000,0,1,0,0,0,0,0,49054,3125,45929,0,7378,417,6961,0,8103,1000,7103,0,8963,1000,7963
4956,60000,48000,0,0,0,0,0,1,0,29538,1737,27801,0,29971,1170,28801,0,29798,1189,28609,0,28679,1230,27449
4957,20000,16000,0,1,1,1,1,1,3,19248,1000,18248,2,18648,0,18648,2,20040,2000,18040,2,19464,0,19464
4958,160000,128000,0,0,0,0,0,0,-2,5215,5300,-85,-1,4115,1000,3115,-1,3921,22200,-18279,-1,3421,2000,1421
4959,80000,64000,0,0,0,0,0,0,-1,6603,6622,-19,-1,1483,1483,0,-1,1485,2,1483,0,4665,4683,-18
4960,240000,192000,0,0,0,0,0,0,-1,326,326,0,-1,326,326,0,-1,476,476,0,-1,326,326,0
4961,50000,40000,0,1,0,0,0,0,0,48968,1700,47268,0,18949,1600,17349,0,19181,811,18370,0,20245,2000,18245
4962,20000,16000,0,1,1,1,1,0,3,16940,0,16940,2,19621,3300,16321,2,18646,0,18646,2,19022,1200,17822
4963,440000,352000,0,0,0,0,0,0,0,158520,9021,149499,0,156977,7013,149964,0,157963,6013,151950,0,151936,6028,145908
4964,50000,40000,0,1,1,0,0,0,2,48052,0,48052,2,48573,2033,46540,0,28902,1119,27783,0,28205,985,27220
4965,200000,160000,0,0,0,0,0,0,2,157633,6908,150725,0,145423,5200,140223,0,146202,5400,140802,0,144685,5700,138985
4966,160000,128000,0,0,0,0,0,0,-1,0,0,0,-1,0,0,0,-2,0,0,0,-2,0,0,0
4967,60000,48000,0,0,0,0,0,0,0,24877,1750,23127,0,21465,1338,20127,0,21218,761,20457,0,21300,925,20375
4968,360000,288000,0,0,0,0,0,1,2,0,0,0,-2,0,0,0,-2,0,0,0,-2,0,0,0
4969,50000,40000,0,1,1,0,0,1,2,49140,2065,47075,0,49451,1376,48075,0,20921,701,20220,0,20058,705,19353
4970,150000,120000,0,0,0,0,0,0,-2,0,0,0,-2,283,283,0,-2,0,0,0,-2,0,0,0
4971,100000,80000,0,1,1,1,1,0,0,87289,4037,83252,0,91451,6500,84951,0,93381,3500,89881,2,89522,0,89522
4972,80000,64000,0,0,0,0,0,0,-1,6881,6881,0,-1,7697,5003,2694,0,3333,3000,333,0,3063,3063,0
4973,80000,64000,0,0,0,0,0,0,0,33071,4000,29071,0,33531,1300,32231,2,34184,1500,32684,2,33503,0,33503
4974,100000,80000,0,0,0,0,0,0,-1,574,574,0,-1,556,556,0,-1,2306,2306,0,-1,2562,2562,0
4975,80000,64000,0,1,1,0,0,1,2,75688,8600,67088,2,73563,0,73563,2,43255,1600,41655,0,35852,1300,34552
4976,20000,16000,0,1,1,0,0,1,2,17522,1400,16122,2,17055,0,17055,3,10400,0,10400,2,0,0,0
4977,90000,72000,0,0,0,0,0,1,0,3053,1213,1840,0,3537,1087,2450,0,46816,47698,-882,-1,47398,1740,45658
4978,40000,32000,0,0,0,0,0,0,-2,0,0,0,-2,0,0,0,-2,0,0,0,-2,0,0,0
4979,170000,136000,0,0,0,0,0,0,2,69518,3800,65718,0,70616,2800,67816,0,79267,10000,69267,0,84140,6129,78011
4980,270000,216000,0,0,0,0,0,0,0,168837,6200,162637,0,172281,6254,166027,0,175705,6290,169415,0,179582,6710,172872
4981,250000,200000,0,0,0,0,0,0,0,148597,19888,128709,0,135715,2500,133215,2,76113,10302,65811,2,26366,17500,8866
4982,180000,144000,0,0,0,0,0,0,-1,4685,4699,-14,-1,238,238,0,-1,218,218,0,-1,6690,6710,-20
4983,20000,16000,0,0,0,0,0,0,0,9799,1000,8799,0,9999,200,9799,0,0,0,0,0,0,0,0
4984,190000,152000,0,1,1,1,1,0,0,192232,7071,185161,0,186472,6744,179728,0,190262,6866,183396,0,193403,7203,186200
4985,180000,144000,0,0,0,0,0,0,2,2703,2703,0,-1,1650,0,1650,2,0,0,0,2,0,0,0
4986,50000,40000,0,1,0,0,0,0,0,43448,1500,41948,0,15075,700,14375,0,16534,1700,14834,0,16809,700,16109
4987,130000,104000,0,0,0,0,0,0,0,44841,1700,43141,0,45451,1300,44151,0,46564,1500,45064,0,47516,1500,46016
4988,240000,192000,0,0,0,0,0,0,-2,0,0,0,-2,0,0,0,-2,0,0,0,-2,0,0,0
4989,160000,128000,0,0,0,0,0,0,2,1698,1005,693,0,-51,7,-58,0,-51,0,-51,-2,-51,0,-51
4990,120000,96000,0,1,1,1,1,0,0,120629,4300,116329,0,116316,4200,112116,0,117358,4219,113139,0,118560,4500,114060
4991,390000,312000,0,0,0,0,0,0,0,82963,4000,78963,0,84236,3500,80736,0,84971,4000,80971,0,87112,3500,83612
4992,20000,16000,0,1,1,1,1,0,0,18181,0,18181,2,18156,514,17642,0,19102,2000,17102,0,17363,1000,16363
4993,50000,40000,0,0,0,0,0,0,0,36453,1564,34889,0,29700,1170,28530,0,30167,1055,29112,0,29613,1052,28561
4994,400000,320000,0,0,0,0,0,0,0,37115,15000,22115,0,39907,10000,29907,0,35061,15000,20061,0,35969,20000,15969
4995,150000,120000,0,0,0,0,0,0,0,92456,3610,88846,0,80532,2377,78155,0,59866,1714,58152,0,49472,828,48644
4996,320000,256000,0,0,0,0,0,0,0,235917,10049,225868,0,227714,10015,217699,0,154939,14939,140000,0,102338,4338,98000
4997,120000,96000,0,0,0,0,0,0,0,91442,20000,71442,0,88476,3500,84976,0,72666,2512,70154,0,74561,7500,67061
4998,110000,88000,0,1,1,0,0,0,2,108455,0,108455,2,109392,4012,105380,0,78524,3120,75404,0,75745,2800,72945
4999,20000,16000,0,0,0,0,0,0,0,11227,1500,9727,0,11145,400,10745,0,11381,416,10965,0,12191,1002,11189
5000,90000,72000,0,1,1,0,0,0,0,91001,3908,87093,0,90661,4328,86333,0,51620,2100,49520,0,52668,2500,50168
5001,360000,288000,0,0,0,0,0,0,-1,7656,7656,0,-1,56397,56397,0,-1,43882,0,43882,0,21818,0,21818
5002,20000,16000,0,0,0,0,0,0,0,15467,2000,13467,0,15863,1000,14863,0,0,0,0,0,0,0,0
5003,50000,40000,0,0,0,0,0,0,0,33998,2500,31498,0,34852,2000,32852,0,14163,1000,13163,0,14362,1000,13362
5004,20000,16000,0,0,0,0,0,1,2,10110,1500,8610,0,10817,1180,9637,0,11637,1000,10637,0,11307,0,11307
5005,180000,144000,0,0,0,0,0,0,0,23194,12057,11137,0,44070,30035,14035,0,39003,863,38140,0,26424,72,26352
5006,20000,16000,0,0,0,0,0,0,-1,390,390,0,-1,390,390,0,-1,390,390,0,-1,12190,12190,0
5007,80000,64000,0,0,0,0,0,0,-1,34651,20000,14651,0,26569,5000,21569,0,20082,10000,10082,0,25535,10000,15535
5008,290000,232000,0,0,0,0,0,0,-1,652,652,0,-1,326,0,326,0,326,326,0,-1,11757,11757,0
5009,250000,200000,0,0,0,0,0,0,-1,3100,3112,-12,-1,2560,2950,-390,-1,2580,2580,0,-1,3699,3699,0
5010,310000,248000,0,0,0,0,0,0,0,140911,3758,137153,0,111881,3901,107980,0,78759,2206,76553,0,78877,3089,75788
5011,80000,64000,0,0,0,0,0,0,0,0,0,0,-2,0,0,0,-2,2345,2345,0,-1,2330,2330,0
5012,40000,32000,0,0,0,0,1,1,2,32515,3206,29309,2,31698,0,31698,3,33581,2700,30881,2,32772,0,32772
5013,240000,192000,0,0,0,0,0,0,-1,0,0,0,-2,0,0,0,-2,0,0,0,-2,0,0,0
5014,50000,40000,0,1,1,0,0,0,0,51131,2374,48757,0,49099,1130,47969,0,19739,523,19216,0,19905,537,19368
5015,60000,48000,0,0,0,0,0,0,0,26000,1450,24550,0,26545,965,25580,0,30966,4864,26102,0,30330,0,30330
5016,180000,144000,0,0,0,0,0,0,0,99267,7038,92229,0,74324,7000,67324,0,47642,6000,41642,0,37957,5000,32957
5017,30000,24000,0,0,0,0,0,0,0,0,18000,-18000,0,0,0,0,-2,0,0,0,-2,0,0,0
5018,80000,64000,0,0,0,0,0,1,0,22320,1364,20956,0,22765,809,21956,0,23393,989,22404,0,23470,930,22540
5019,70000,56000,0,0,0,0,0,1,2,45166,102,45064,2,36283,2400,33883,0,20861,894,19967,0,21374,1000,20374
5020,300000,240000,0,0,0,0,0,0,-2,0,0,0,-2,0,0,0,-2,0,0,0,-2,0,0,0
5021,90000,72000,0,0,0,0,0,0,0,56266,112,56154,2,47804,1779,46025,0,44230,1786,42444,0,48144,5414,42730
5022,300000,240000,0,0,0,0,0,0,0,66156,5017,61139,0,66621,5000,61621,0,68030,2000,66030,0,70101,2500,67601
5023,180000,144000,0,0,0,0,0,0,0,16765,1500,15265,0,14611,1000,13611,0,16209,2000,14209,0,25653,10000,15653
5024,100000,80000,0,0,0,0,0,0,-1,0,0,0,-2,0,0,0,-2,0,0,0,-2,0,0,0
5025,60000,48000,0,0,0,0,0,0,0,18408,1600,16808,0,18393,1000,17393,0,18238,1000,17238,0,18345,1000,17345
5026,100000,80000,0,0,0,0,0,1,2,19944,0,19944,2,22915,3260,19655,2,23472,1000,22472,2,23016,0,23016
5027,310000,248000,0,0,0,0,0,0,0,76404,3022,73382,0,76133,5208,70925,0,53065,15734,37331,0,17529,1607,15922
5028,290000,232000,0,0,0,0,0,1,-1,-20,0,-20,-2,-20,0,-20,-2,2663,2800,-137,-1,-677,0,-677
5029,120000,96000,0,0,0,0,0,0,0,38083,1816,36267,0,36728,1381,35347,0,36952,1264,35688,0,35475,1228,34247
5030,260000,208000,0,0,0,0,0,0,-1,920,920,0,-1,37686,37686,0,-1,36523,0,36523,0,574,574,0
5031,60000,48000,0,0,0,0,0,0,0,45728,2000,43728,0,36441,1700,34741,0,37336,1500,35836,0,38138,1400,36738
5032,150000,120000,0,0,0,0,0,0,-1,0,0,0,-2,14515,14515,0,-1,8758,8758,0,-1,6882,6880,2
5033,80000,64000,0,0,0,0,0,0,2,0,0,0,-2,0,0,0,-2,1005,1005,0,-1,5,0,5
5034,30000,24000,0,0,0,0,0,0,-2,2109,2115,-6,-2,5930,5933,-3,-2,4192,4192,0,-2,0,0,0
5035,290000,232000,0,1,1,1,0,0,0,262786,11000,251786,0,254495,7900,246595,0,247060,9050,238010,0,220298,6900,213398
5036,240000,192000,0,0,0,0,0,0,0,137645,4931,132714,0,140388,4966,135422,0,142521,5000,137521,0,143736,4771,138965
5037,50000,40000,0,1,0,0,0,0,0,50476,2237,48239,0,23319,975,22344,0,23171,1000,22171,0,24774,2000,22774
5038,50000,40000,0,0,0,0,0,0,0,510,510,0,-1,16121,16121,0,-1,17539,2000,15539,0,19088,2000,17088
5039,50000,40000,0,0,0,0,0,0,0,27637,1718,25919,0,22521,1210,21311,0,20533,1018,19515,0,14659,539,14120
5040,150000,120000,0,1,1,1,0,0,-1,145900,10000,135900,0,146168,3119,143049,0,149712,3744,145968,0,-288,0,-288
5041,140000,112000,0,0,0,0,0,0,0,21945,1952,19993,0,23581,2000,21581,0,23066,0,23066,2,23531,1000,22531
5042,10000,8000,0,0,0,0,0,0,2,4148,0,4148,2,4579,500,4079,2,4360,0,4360,2,4787,500,4287
5043,220000,176000,0,1,0,0,0,0,0,227153,9200,217953,0,174717,6300,168417,0,171145,6200,164945,0,174076,6600,167476
5044,180000,144000,0,0,0,0,0,0,0,84940,13000,71940,0,65613,3000,62613,0,67256,2700,64556,0,71934,6000,65934
5045,110000,88000,0,0,0,0,0,1,2,75231,3313,71918,0,76265,2879,73386,0,77860,2976,74884,0,79251,2839,76412
5046,100000,80000,0,0,0,1,1,0,0,80914,10737,70177,0,86403,6849,79554,0,88972,4000,84972,0,91554,4000,87554
5047,320000,256000,0,0,0,0,0,1,2,211323,9500,201823,2,202240,0,202240,2,122963,4253,118710,0,125465,4332,121133
5048,60000,48000,0,0,0,0,0,0,0,4102,4102,0,-1,3891,0,3891,2,4669,1000,3669,0,6083,1500,4583
5049,150000,120000,0,0,0,0,0,0,-1,5570,5606,-36,-1,10516,10568,-52,-1,-3,0,-3,-1,-3,0,-3
5050,210000,168000,0,0,0,0,0,0,0,93208,4200,89008,0,88223,3100,85123,0,84175,3000,81175,0,80305,3100,77205
5051,230000,184000,0,0,0,0,0,1,2,0,0,0,-2,0,0,0,-2,0,0,0,-2,0,0,0
5052,150000,120000,0,0,0,0,0,1,-2,0,0,0,-2,0,0,0,-2,0,0,0,-2,0,0,0
5053,220000,176000,0,0,0,0,0,1,2,171669,0,171669,2,167294,5500,161794,0,172042,7250,164792,0,162565,6500,156065
5054,110000,88000,0,0,0,0,0,0,0,63100,3000,60100,0,70391,9000,61391,0,68661,0,68661,2,77511,10000,67511
5055,200000,160000,0,0,0,0,0,0,-1,99,99,0,-1,99,99,0,-1,99,99,0,-1,348,348,0
5056,50000,40000,0,0,0,0,0,1,0,22691,1100,21591,0,8807,1000,7807,0,7143,500,6643,0,6967,500,6467
5057,20000,16000,0,1,1,1,1,1,2,20192,2505,17687,0,19459,2000,17459,0,36290,3000,33290,0,19774,1203,18571
5058,70000,56000,0,1,1,0,0,1,0,62196,0,62196,2,62809,2315,60494,0,48047,1718,46329,0,49110,2000,47110
5059,80000,64000,0,0,0,0,0,0,-1,6187,5,6182,2,7757,7761,-4,-1,8451,8460,-9,-1,6625,6630,-5
5060,260000,208000,0,0,0,0,0,0,-2,-200,0,-200,-2,6682,6882,-200,-2,1718,1734,-16,-2,1512,1512,0
5061,80000,64000,0,1,0,0,0,0,0,77448,4000,73448,0,48108,2000,46108,0,39104,2000,37104,0,39526,1423,38103
5062,200000,160000,0,0,0,0,0,0,0,119122,4500,114622,0,121402,4300,117102,0,115419,6000,109419,0,116749,4400,112349
5063,500000,400000,0,0,0,0,0,1,-1,10410,10457,-47,-1,30016,30026,-10,-1,8014,26,7988,0,2630,13,2617
5064,210000,168000,0,0,0,0,0,0,-1,33515,33515,0,-1,78075,48075,30000,0,109374,39374,70000,0,108869,1000,107869
5065,20000,16000,0,0,1,1,1,1,2,18067,2874,15193,2,17469,0,17469,2,19905,2712,17193,2,19763,1566,18197
5066,20000,16000,0,0,0,0,0,0,2,8753,0,8753,2,9916,1316,8600,0,10793,1193,9600,0,10400,0,10400
5067,420000,336000,0,0,0,0,0,0,0,190689,7000,183689,0,173547,6000,167547,0,176980,6500,170480,0,180109,6500,173609
5068,50000,40000,0,1,1,0,0,0,0,51415,3600,47815,0,48977,7,48970,2,10082,345,9737,0,9936,1000,8936
5069,240000,192000,0,0,0,0,0,0,0,176674,6161,170513,0,160551,5730,154821,0,150735,5486,145249,0,154200,5987,148213
5070,450000,360000,0,0,0,0,0,0,-2,200,200,0,-1,0,0,0,-1,0,0,0,-2,0,0,0
5071,220000,176000,0,1,1,0,0,0,0,220680,8397,212283,0,219459,7349,212110,0,177765,6518,171247,0,175238,7000,168238
5072,10000,8000,0,0,1,0,1,0,0,8432,2573,5859,0,8150,0,8150,2,8945,1086,7859,2,8657,0,8657
5073,100000,80000,0,1,0,0,0,0,0,101859,3533,98326,0,79519,2673,76846,0,74368,3500,70868,0,58481,4303,54178
5074,30000,24000,0,1,1,0,0,1,0,27048,1356,25692,0,26592,900,25692,0,23874,1000,22874,0,23293,1100,22193
5075,120000,96000,0,0,0,0,0,0,-1,396,396,0,-1,2707,2707,0,-1,3247,3247,0,-1,396,396,0
5076,360000,288000,0,0,0,0,0,1,-2,0,0,0,-2,0,0,0,-2,0,0,0,-2,0,0,0
5077,360000,288000,0,0,0,0,0,0,-2,-233,0,-233,-2,-233,0,-233,-2,-233,0,-233,-2,-233,0,-233
5078,350000,280000,0,0,0,0,0,0,-2,0,0,0,-2,0,0,0,-2,11525,11525,0,-1,11760,235,11525
5079,90000,72000,0,1,1,1,1,0,0,88433,4300,84133,0,88010,3500,84510,0,87814,3500,84314,0,87831,3700,84131
5080,150000,120000,0,0,0,0,0,0,-1,0,0,0,-2,11310,11310,0,-1,11310,0,11310,0,0,0,0
5081,30000,24000,0,0,0,0,0,1,2,390,390,0,-1,390,390,0,-1,390,390,0,-1,0,0,0
5082,500000,400000,0,0,0,0,0,0,0,50969,2447,48522,0,52182,2660,49522,0,52821,2100,50721,0,53927,2109,51818
5083,210000,168000,0,0,0,0,0,0,0,116845,5000,111845,0,113571,4009,109562,0,105052,3500,101552,0,104167,4000,100167
5084,130000,104000,0,1,0,0,0,1,0,131332,5400,125932,0,97878,3446,94432,0,99594,3561,96033,0,98667,4000,94667
5085,20000,16000,0,0,1,0,0,0,0,19674,3875,15799,0,19258,759,18499,0,9546,10000,-454,-1,12051,19126,-7075
5086,50000,40000,0,0,0,0,0,0,0,28481,1800,26681,0,27634,1400,26234,0,26691,915,25776,0,26329,1500,24829
5087,50000,40000,0,0,0,0,0,0,2,16820,4500,12320,2,15860,800,15060,2,16179,582,15597,0,16915,1000,15915
5088,360000,288000,0,0,0,0,0,1,-2,0,0,0,-2,0,0,0,-2,0,0,0,-2,0,0,0
5089,110000,88000,0,0,0,0,0,0,0,37448,5000,32448,0,34963,3000,31963,0,28197,3150,25047,0,30331,3000,27331
5090,70000,56000,0,1,1,0,0,0,0,67454,2600,64854,0,67592,2613,64979,0,36515,1500,35015,0,37426,1500,35926
5091,50000,40000,0,1,0,0,0,0,2,45079,2177,42902,0,30783,1702,29081,0,1727,2000,-273,-1,150,350,-200
5092,180000,144000,0,0,0,0,0,1,-1,18247,1000,17247,2,33230,0,33230,2,5168,103,5065,0,0,0,0
5093,420000,336000,0,0,0,0,0,0,0,17493,1275,16218,0,17215,1281,15934,0,17248,617,16631,0,17763,793,16970
5094,500000,400000,0,0,0,0,0,0,0,124240,20029,104211,0,131006,20058,110948,0,137911,20127,117784,0,119343,10000,109343
5095,20000,16000,0,1,0,0,0,0,0,18186,2000,16186,0,16524,2000,14524,0,19026,5000,14026,0,16309,1000,15309
5096,50000,40000,0,0,0,0,0,1,0,22133,2871,19262,0,12882,1000,11882,0,8131,163,7968,0,3983,3983,0
5097,180000,144000,0,0,0,0,0,0,-1,288,288,0,-2,837,837,0,-2,467,467,0,-2,15868,15868,0
5098,200000,160000,0,0,0,0,0,0,-1,5815,5815,0,-1,851,854,-3,-1,2029,2029,0,-1,1997,1997,0
5099,120000,96000,0,0,0,0,0,0,0,33632,4000,29632,0,36574,3500,33074,0,38985,3000,35985,0,40339,2000,38339
5100,490000,392000,0,0,0,0,0,0,2,24307,24307,0,-1,21136,12396,8740,0,24758,13000,11758,0,21817,10000,11817
5101,330000,264000,0,0,0,0,0,0,-2,166722,166744,-22,-1,215506,60057,155449,0,138371,560,137811,0,21757,17921,3836
5102,220000,176000,0,0,0,0,0,0,-1,0,0,0,-1,50510,50510,0,-1,2202,0,2202,0,4533,5131,-598
5103,160000,128000,0,1,1,1,1,0,0,155976,7500,148476,0,157793,6008,151785,0,158652,5516,153136,0,157163,6011,151152
5104,180000,144000,0,0,0,0,0,1,-1,0,0,0,-2,0,0,0,-2,600,600,0,-1,0,0,0
5105,50000,40000,0,1,0,0,0,0,0,49009,1344,47665,0,14275,505,13770,0,17251,5585,11666,0,15077,556,14521
5106,160000,128000,0,0,0,0,0,0,0,16280,1000,15280,0,0,0,0,0,0,0,0,-2,0,0,0
5107,80000,64000,0,0,0,0,0,0,0,26890,1500,25390,0,27450,1000,26450,0,27634,1100,26534,0,28216,1041,27175
5108,140000,112000,0,1,1,1,1,0,0,118310,5756,112554,0,120719,5868,114851,0,126470,9275,117195,0,124342,0,124342
5109,630000,504000,0,0,0,0,0,0,-2,4679,1000,3679,-2,5679,1000,4679,-2,6679,1000,5679,-2,6850,171,6679
5110,420000,336000,0,0,0,0,0,0,0,60376,30253,30123,0,30099,20016,10083,0,66049,40015,26034,0,61043,30004,31039
5111,350000,280000,0,0,0,0,0,0,-2,1298,1298,0,-2,500,500,0,-2,2398,2398,0,-2,0,0,0
5112,500000,400000,0,0,0,0,0,0,0,56116,50018,6098,0,31924,30023,1901,0,33255,30013,3242,0,27668,18019,9649
5113,360000,288000,0,0,0,0,0,1,-2,0,0,0,-2,0,0,0,-2,0,0,0,-2,0,0,0
5114,160000,128000,0,0,0,0,0,0,-1,390,390,0,-1,780,780,0,-1,390,0,390,0,390,390,0
5115,340000,272000,0,0,0,0,0,0,-1,4794,5343,-549,-1,7819,7819,0,-1,332,332,0,-1,16516,16516,0
5116,30000,24000,0,0,0,0,0,0,2,12568,0,12568,2,13880,1528,12352,0,13849,497,13352,0,14816,1192,13624
5117,100000,80000,0,0,1,0,0,0,0,47160,1722,45438,0,98775,3214,95561,0,49513,2119,47394,0,53433,5064,48369
5118,30000,24000,0,0,0,0,0,1,2,17080,1600,15480,2,17302,800,16502,2,17521,800,16721,2,17893,800,17093
5119,20000,16000,0,0,0,0,0,1,2,6958,0,6958,3,7496,800,6696,2,7231,0,7231,3,7269,300,6969
5120,450000,360000,0,0,0,1,0,0,2,365723,90000,275723,0,370496,14011,356485,0,374405,14029,360376,0,373155,14052,359103
5121,200000,160000,0,0,0,0,0,0,0,80096,4195,75901,0,82269,4300,77969,0,85093,5000,80093,0,86870,3196,83674
5122,150000,120000,0,0,0,0,0,0,0,22050,1200,20850,0,17360,0,17360,0,17360,0,17360,0,12000,0,12000
5123,370000,296000,0,0,0,0,0,0,0,160885,6000,154885,0,162368,6000,156368,0,165591,8000,157591,0,121614,4500,117114
5124,280000,224000,0,1,1,0,0,0,0,273951,11075,262876,0,262720,8972,253748,0,130384,5182,125202,0,102181,10000,92181
5125,50000,40000,0,0,0,0,0,0,-1,4893,4893,0,-1,390,390,0,-1,390,390,0,-1,1670,1670,0
5126,340000,272000,0,0,0,0,0,0,0,252656,9300,243356,0,257535,9200,248335,0,262670,9226,253444,0,266351,9530,256821
5127,260000,208000,0,0,0,0,0,0,-2,4331,4353,-22,-2,13860,13929,-69,-2,1987,1997,-10,-2,5626,5654,-28
5128,50000,40000,0,1,0,0,0,0,2,48402,1800,46602,0,28331,1100,27231,0,29174,1300,27874,0,29739,1200,28539
5129,50000,40000,0,1,0,0,0,0,0,44993,4000,40993,0,36782,0,36782,2,30442,1200,29242,0,29636,1250,28386
5130,230000,184000,0,0,0,0,0,0,0,20474,5000,15474,0,26492,16492,10000,0,326,0,326,0,1056,1056,0
5131,170000,136000,0,0,0,0,0,0,0,8522,1298,7224,0,9380,1156,8224,0,9566,342,9224,0,9917,505,9412
5132,190000,152000,0,0,0,0,0,0,0,108770,5491,103279,0,115325,9800,105525,0,112063,0,112063,2,114484,4300,110184
5133,120000,96000,0,0,0,0,0,1,2,5696,5696,0,-1,1762,0,1762,0,1381,1381,0,-1,1061,1061,0
5134,50000,40000,0,0,0,0,0,1,2,7487,1550,5937,2,7218,0,7218,2,7800,700,7100,2,7526,0,7526
5135,300000,240000,0,0,0,0,0,1,0,33843,5000,28843,0,5045,5045,0,-1,10288,10288,0,-1,12565,5000,7565
5136,360000,288000,0,0,0,0,0,0,2,390,390,0,-1,540,540,0,-1,540,390,150,0,390,390,0
5137,500000,400000,0,0,0,0,0,0,-2,12953,13023,-70,-2,9019,9070,-51,-2,4236,4257,-21,-2,-31,0,-31
5138,60000,48000,0,0,0,0,0,0,2,47536,5021,42515,0,17079,5000,12079,0,18219,2000,16219,0,19542,2000,17542
5139,580000,464000,0,0,0,1,1,0,2,471175,9464,461711,3,486776,25065,461711,3,503914,25703,478211,4,527711,33000,494711
5140,80000,64000,0,0,0,0,0,0,-1,0,0,0,-2,0,0,0,-2,0,0,0,-2,0,0,0
5141,340000,272000,0,0,0,0,0,0,-1,3002,3002,0,-1,2613,2613,0,-1,1806,1806,0,-1,1989,1989,0
5142,140000,112000,0,0,0,0,0,0,0,90785,0,90785,2,95736,10000,85736,0,95912,5000,90912,0,97070,6000,91070
5143,20000,16000,0,0,0,0,0,0,-1,2197,2200,-3,-1,3047,6050,-3003,-1,4262,5000,-738,-1,7163,3000,4163
5144,370000,296000,0,1,1,1,1,0,0,370605,13603,357002,0,366054,13500,352554,0,310869,11014,299855,0,311284,12024,299260
5145,210000,168000,0,1,1,1,1,0,2,199393,10000,189393,0,194538,7000,187538,0,195990,8000,187990,0,194136,8000,186136
5146,150000,120000,0,0,0,0,0,1,2,18608,1000,17608,2,20294,2000,18294,2,19828,0,19828,2,20396,900,19496
5147,170000,136000,0,0,0,0,0,0,0,49946,49008,938,0,49464,1000,48464,0,46476,949,45527,0,19417,1143,18274
5148,160000,128000,0,0,0,0,0,0,-1,312,312,0,-1,7736,7736,0,-1,7278,0,7278,0,7278,0,7278
5149,150000,120000,0,0,0,0,0,0,-1,4102,4137,-35,-1,713,719,-6,-1,810,817,-7,-1,5438,5467,-29
5150,200000,160000,0,0,0,0,0,1,2,45858,1500,44358,2,45781,1000,44781,2,47401,2540,44861,2,40536,2000,38536
5151,280000,224000,0,0,0,0,0,0,-1,2295,2295,0,-1,3105,3105,0,-1,582,582,0,-1,14013,14013,0
5152,60000,48000,0,0,0,0,0,1,-1,8422,9683,-1261,-1,4377,4377,0,-1,3910,3918,-8,-1,2431,2431,0
5153,230000,184000,0,0,0,0,0,0,0,16884,1300,15584,0,17620,1001,16619,0,18353,1000,17353,0,18901,1000,17901
5154,390000,312000,0,0,0,0,0,0,-1,18119,18119,0,-1,15220,304,14916,0,7658,416,7242,0,7547,7547,0
5155,100000,80000,0,0,0,0,0,1,-1,326,326,0,-1,326,326,0,-1,652,652,0,-1,326,0,326
5156,30000,24000,1,1,1,1,0,1,3,30358,0,30358,2,29758,0,29758,0,29758,0,29758,0,23036,1000,22036
5157,500000,400000,0,0,0,0,0,1,2,76463,3400,73063,2,77611,3000,74611,2,78735,3000,75735,2,80430,3100,77330
5158,500000,400000,0,0,0,0,0,1,-2,2479,4958,-2479,-2,2479,0,2479,-2,763,763,0,-2,288,0,288
5159,80000,64000,0,0,0,0,0,1,0,22275,2000,20275,0,21631,1000,20631,0,22961,3000,19961,0,19269,1000,18269
5160,20000,16000,0,1,1,1,1,0,0,21529,2200,19329,0,19542,0,19542,2,18547,686,17861,0,17519,705,16814
5161,130000,104000,0,0,0,0,0,0,0,93576,5000,88576,0,95121,4500,90621,0,64712,2400,62312,0,66016,2600,63416
5162,50000,40000,0,0,0,0,1,0,-1,7700,7700,0,-1,42038,42038,0,-1,42610,42096,514,-1,42096,587,41509
5163,20000,16000,0,1,1,0,0,0,0,19090,0,19090,2,18500,0,18500,0,4860,0,4860,0,4080,0,4080
5164,260000,208000,0,0,0,0,0,0,0,143580,6012,137568,0,133477,6000,127477,0,122545,5000,117545,0,120772,5000,115772
5165,170000,136000,0,0,0,0,0,0,0,52651,2000,50651,0,53851,2048,51803,0,53095,1927,51168,0,54316,2104,52212
5166,20000,16000,0,1,1,1,0,0,0,18266,1141,17125,0,18637,512,18125,0,19028,533,18495,0,14924,1000,13924
5167,180000,144000,0,0,0,0,0,0,0,75659,3350,72309,0,72046,3111,68935,0,70355,2615,67740,0,71208,2689,68519
5168,80000,64000,0,0,0,0,0,0,-2,0,0,0,-2,0,0,0,-2,0,0,0,-2,0,0,0
5169,220000,176000,0,0,0,0,0,0,-1,7681,7681,0,-1,11642,20000,-8358,-1,23030,20000,3030,0,22449,0,22449
5170,290000,232000,0,1,1,0,0,0,0,265077,15089,249988,0,241284,8801,232483,0,102450,7450,95000,0,104544,4544,100000
5171,170000,136000,0,0,0,0,0,0,0,138779,4584,134195,0,129548,4002,125546,0,121625,4093,117532,0,108462,4187,104275
5172,130000,104000,0,0,0,0,0,0,-1,101424,101726,-302,-1,-1175,1228,-2403,-1,111715,114488,-2773,-1,52337,2000,50337
5173,140000,112000,0,0,0,0,0,0,0,120176,9120,111056,0,101065,3000,98065,0,64570,2117,62453,0,51521,2000,49521
5174,50000,40000,0,0,0,0,0,0,0,11097,4200,6897,0,10596,0,10596,2,12421,1958,10463,2,12129,0,12129
5175,100000,80000,0,1,1,1,1,0,0,89245,4114,85131,0,90247,3379,86868,0,91979,3338,88641,0,94450,4000,90450
5176,220000,176000,0,0,0,0,0,0,0,102667,5000,97667,0,108998,9604,99394,0,117186,10000,107186,0,121062,6000,115062
5177,80000,64000,0,0,0,0,0,0,-2,556,556,0,-2,2904,2904,0,-2,556,556,0,-2,4226,4226,0
5178,80000,64000,0,0,0,0,0,0,-1,35369,35369,0,-1,18351,18351,0,-1,14249,14249,0,-1,10637,10637,0
5179,170000,136000,0,0,0,0,0,0,0,60324,3500,56824,0,88057,30000,58057,0,89040,3300,85740,0,90716,3200,87516
5180,180000,144000,0,0,0,0,0,0,0,25427,3000,22427,0,21230,892,20338,0,17357,1000,16357,0,13303,620,12683
5181,230000,184000,0,0,0,0,0,0,0,0,0,0,0,0,0,0,-2,0,0,0,-2,915,915,0
5182,30000,24000,0,1,1,1,0,0,0,28585,1503,27082,0,29007,1315,27692,0,29195,893,28302,0,21335,1000,20335
5183,200000,160000,0,0,0,0,0,0,-1,2000,2000,0,-1,1000,1000,0,-1,3000,2000,1000,0,2000,0,2000
5184,100000,80000,0,0,0,0,0,0,0,9417,1164,8253,0,10002,1139,8863,0,9804,331,9473,0,9626,350,9276
5185,80000,64000,0,0,0,0,0,1,-1,316,316,0,-1,514,514,0,-1,316,316,0,-1,1605,1605,0
5186,150000,120000,0,0,0,0,0,1,2,6643,2400,4243,2,2831,0,2831,2,1745,1500,245,0,3212,1500,1712
5187,290000,232000,0,0,0,0,0,0,-2,0,0,0,-2,0,0,0,-2,0,0,0,-2,0,0,0
5188,160000,128000,0,0,0,0,0,0,-2,0,0,0,-2,0,0,0,-2,0,0,0,-2,0,0,0
5189,220000,176000,0,0,0,0,0,1,-2,2128,2128,0,-1,4071,2000,2071,0,5640,2000,3640,0,7078,2000,5078
5190,180000,144000,0,1,1,1,1,0,0,165923,6100,159823,0,169038,6200,162838,0,172388,6543,165845,0,165165,6251,158914
5191,50000,40000,0,1,1,0,0,0,0,48381,2060,46321,0,44113,1014,43099,0,8522,170,8352,0,17948,17948,0
5192,250000,200000,0,0,0,0,0,0,0,8535,0,8535,2,10647,3000,7647,2,10352,0,10352,2,12788,3000,9788
5193,50000,40000,0,1,0,0,0,0,0,50370,2406,47964,0,29862,1278,28584,0,29275,1036,28239,0,29535,1115,28420
5194,20000,16000,0,1,1,1,1,1,0,18376,2316,16060,0,18253,1256,16997,0,18458,1000,17458,0,19197,1000,18197
5195,50000,40000,0,1,1,0,0,0,0,50323,1845,48478,0,48902,1746,47156,0,20012,691,19321,0,19915,1000,18915
5196,240000,192000,0,0,0,0,0,0,0,87475,2768,84707,0,89253,2817,86436,0,91128,2928,88200,0,127950,37950,90000
5197,340000,272000,0,0,0,0,0,0,0,38192,2000,36192,0,39234,2000,37234,0,20960,3000,17960,0,360,360,0
5198,80000,64000,0,0,0,0,0,0,-2,0,0,0,-2,200,200,0,-1,0,0,0,-1,0,0,0
5199,80000,64000,0,0,0,0,0,0,-1,3602,3602,0,-1,5495,5495,0,-1,10059,10109,-50,-1,5700,5700,0
5200,50000,40000,0,0,0,0,0,0,0,31155,4300,26855,0,30124,0,30124,2,29984,1100,28884,0,29629,1500,28129
5201,90000,72000,0,0,0,0,0,1,0,42197,2000,40197,0,42726,1502,41224,0,43802,1737,42065,0,42761,1500,41261
5202,340000,272000,0,0,0,0,0,1,0,146682,5500,141182,0,150407,6027,144380,0,147868,5328,142540,0,149349,5390,143959
5203,260000,208000,0,0,0,0,0,0,-1,503,503,0,-1,503,0,503,2,503,0,503,2,503,0,503
5204,50000,40000,0,1,1,0,0,0,0,47010,2000,45010,0,47277,1267,46010,0,17410,1000,16410,0,17002,620,16382
5205,80000,64000,0,0,0,0,0,0,0,20782,1000,19782,0,11632,11632,0,-1,64989,64989,0,-1,62392,1470,60922
5206,210000,168000,0,0,0,0,0,1,-2,106669,106669,0,-1,13333,13333,0,-1,12780,12780,0,-1,18472,19136,-664
5207,50000,40000,0,1,1,0,0,0,0,48731,2200,46531,0,48934,1400,47534,0,29116,582,28534,0,28999,580,28419
5208,80000,64000,0,0,0,0,0,0,0,12407,1047,11360,0,14360,2000,12360,0,14657,359,14298,0,4129,175,3954
5209,60000,48000,0,0,0,0,0,0,-1,13172,13000,172,0,8717,2000,6717,0,8552,3000,5552,0,9902,2000,7902
5210,50000,40000,0,0,0,0,0,0,-1,264,0,264,2,264,264,0,-1,264,264,0,-1,264,264,0
5211,120000,96000,0,0,0,0,0,0,-2,110688,120055,-9367,-1,100552,5073,95479,0,89147,3508,85639,0,88388,3707,84681
5212,180000,144000,0,0,0,0,0,0,0,20546,2690,17856,0,24956,5100,19856,0,24262,0,24262,2,24782,1058,23724
5213,310000,248000,0,0,0,0,0,0,0,166900,50120,116780,0,154297,30000,124297,0,146844,20000,126844,0,146883,5807,141076
5214,50000,40000,0,0,0,0,0,0,2,2182,1000,1182,0,0,0,0,0,2092,2092,0,-1,-2272,0,-2272
5215,30000,24000,0,1,1,1,1,1,0,30477,1800,28677,0,30651,1300,29351,0,30107,1560,28547,0,26304,1000,25304
5216,50000,40000,0,0,0,0,0,1,0,8743,2000,6743,0,1000,0,1000,2,5557,5557,0,-1,5027,470,4557
5217,230000,184000,0,0,0,0,0,0,0,0,0,0,-2,0,0,0,-2,0,0,0,-2,0,0,0
5218,80000,64000,0,0,0,0,0,0,0,39562,2135,37427,0,40427,2000,38427,0,43417,3500,39917,0,46878,4000,42878
5219,340000,272000,0,0,0,0,0,1,3,149627,8,149619,2,150733,5117,145616,0,140171,5008,135163,0,134203,5021,129182
5220,130000,104000,0,0,0,0,0,0,-2,0,0,0,-2,0,0,0,-2,0,0,0,-2,0,0,0
5221,320000,256000,0,0,0,0,0,0,0,23926,3000,20926,0,31161,8000,23161,0,32234,1900,30334,0,35688,4000,31688
5222,80000,64000,0,0,0,0,0,1,0,49428,1699,47729,0,34024,1712,32312,0,46073,22965,23108,0,47038,1706,45332
5223,80000,64000,0,0,0,0,0,0,0,41495,1701,39794,0,36733,1439,35294,0,27692,980,26712,0,27872,1005,26867
5224,180000,144000,0,1,0,0,0,0,0,184389,8500,175889,0,-261,174,-435,0,-261,0,-261,-2,-261,0,-261
5225,130000,104000,0,1,0,0,1,0,0,118032,6950,111082,0,95953,4600,91353,0,73970,4000,69970,0,107785,2000,105785
5226,360000,288000,0,0,0,0,0,0,-1,1000,0,1000,2,0,0,0,2,0,0,0,-2,0,0,0
5227,230000,184000,0,0,0,0,0,0,0,102074,5000,97074,0,94225,4000,90225,0,96616,4000,92616,0,95849,5000,90849
5228,220000,176000,0,0,0,0,0,0,0,56148,2407,53741,0,35642,2000,33642,0,33516,2000,31516,0,30177,1100,29077
5229,230000,184000,0,0,0,0,0,0,0,20039,10000,10039,0,29045,10000,19045,0,74551,1681,72870,0,92182,103197,-11015
5230,320000,256000,0,0,0,0,0,1,-1,1060,1060,0,-1,4070,4070,0,-1,2695,2700,-5,-1,7544,7544,0
5231,50000,40000,0,0,0,0,0,0,0,13094,2000,11094,0,12434,0,12434,2,12429,600,11829,0,12505,594,11911
5232,220000,176000,0,0,0,0,0,0,-2,-4620,0,-4620,-2,-4620,0,-4620,-2,-5820,0,-5820,-2,-5820,0,-5820
5233,80000,64000,0,1,0,0,0,1,0,80668,3211,77457,0,49233,1691,47542,0,48737,1721,47016,0,48280,1800,46480
5234,240000,192000,0,0,0,0,0,1,2,45268,0,45268,2,46295,1900,44395,0,48903,3500,45403,0,49763,1600,48163
5235,290000,232000,0,0,0,0,0,0,-2,2057,2066,-9,-2,2278,2287,-9,-2,1224,1242,-18,-2,-57060,1827,-58887
5236,140000,112000,0,0,0,0,0,1,0,32808,1866,30942,0,35342,3400,31942,0,35965,1500,34465,2,36741,1500,35241
5237,180000,144000,0,0,0,0,0,0,0,0,0,0,0,0,0,0,-2,0,0,0,-2,0,0,0
5238,50000,40000,0,1,0,0,0,0,0,46693,1949,44744,0,31040,1482,29558,0,30669,1040,29629,0,30218,913,29305
5239,330000,264000,0,0,0,0,0,1,-1,-27,0,-27,-1,5344,5371,-27,-1,16566,16648,-82,-1,995,1000,-5
5240,50000,40000,0,1,1,1,1,1,2,43264,2000,41264,2,43751,1500,42251,2,44731,2000,42731,2,45770,1900,43870
5241,60000,48000,0,0,0,0,0,0,0,33434,2000,31434,0,34935,3000,31935,0,36344,4000,32344,0,37803,3000,34803
5242,310000,248000,0,0,0,0,0,0,-1,17152,17248,-96,-1,6540,6559,-19,-1,6834,10000,-3166,-1,6890,6890,0
5243,200000,160000,0,0,0,0,0,0,-1,5144,5144,0,-1,6807,2000,4807,0,51013,44406,6607,0,54416,54725,-309
5244,460000,368000,0,0,0,0,0,0,0,168279,9000,159279,0,171579,8154,163425,0,163450,6000,157450,0,160547,6000,154547
5245,130000,104000,0,1,1,1,1,0,2,131045,5115,125930,0,128104,4527,123577,0,121641,4500,117141,0,123470,8908,114562
5246,120000,96000,0,0,0,0,0,0,0,45025,2000,43025,0,43834,1700,42134,0,43449,2000,41449,0,44675,2100,42575
5247,180000,144000,0,0,0,0,0,1,-2,-193,1000,-1193,-2,-688,0,-688,-2,817,2000,-1183,-1,1157,1000,157
5248,50000,40000,0,0,0,0,0,0,0,27396,1500,25896,0,23584,1282,22302,0,17272,618,16654,0,17634,640,16994
5249,320000,256000,0,0,0,0,0,0,0,7788,8000,-212,-1,6751,7000,-249,-1,8354,8500,-146,-1,12271,13000,-729
5250,200000,160000,0,0,0,0,0,0,0,26349,1427,24922,0,26925,1003,25922,0,27841,2000,25841,0,29368,2000,27368
5251,240000,192000,0,0,0,0,0,0,-2,0,0,0,-2,0,0,0,-2,2780,2780,0,-1,20034,20034,0
5252,100000,80000,0,1,1,1,1,0,0,99744,5000,94744,0,101882,7900,93982,0,101116,4000,97116,0,97283,4000,93283
5253,160000,128000,0,1,1,1,1,1,2,163567,5600,157967,2,163617,5822,157795,2,156554,14,156540,2,156557,5700,150857
5254,30000,24000,0,0,0,0,1,1,0,12082,1201,10881,0,12473,592,11881,0,12623,500,12123,0,27460,1500,25960
5255,150000,120000,0,0,0,0,0,0,0,8336,1074,7262,0,6462,1000,5462,0,5872,1000,4872,0,1242,1000,242
5256,50000,40000,0,0,0,0,0,0,-2,0,0,0,-2,0,0,0,-2,20650,20650,0,-2,0,0,0
5257,220000,176000,0,0,0,0,0,0,0,8500,8500,0,-1,0,0,0,-1,8500,8500,0,-1,8535,8535,0
5258,400000,320000,0,0,0,0,0,1,-2,0,0,0,-2,0,0,0,-2,0,0,0,-2,0,0,0
5259,400000,320000,0,0,0,0,0,0,-1,8102,8501,-399,-1,8585,9003,-418,-1,12633,13000,-367,-1,20338,20500,-162
5260,80000,64000,0,1,0,0,0,0,0,74525,2747,71778,0,61360,2344,59016,0,49359,1756,47603,0,48253,1758,46495
5261,110000,88000,0,0,0,0,0,0,0,84849,14298,70551,0,84362,2519,81843,0,59391,6616,52775,0,59129,1953,57176
5262,260000,208000,0,0,0,0,0,0,-2,0,0,0,-2,0,0,0,-2,0,0,0,-2,0,0,0
5263,70000,56000,0,1,1,1,1,0,0,71509,3600,67909,0,70695,2694,68001,0,71189,2800,68389,0,70554,2743,67811
5264,360000,288000,0,0,0,0,0,0,0,259097,9519,249578,0,259999,9367,250632,0,265746,10001,255745,0,259299,9513,249786
5265,160000,128000,0,0,0,0,0,0,0,83764,4214,79550,0,75088,4014,71074,0,69753,2500,67253,0,66574,3000,63574
5266,50000,40000,0,0,0,0,0,0,0,21746,1300,20446,0,18082,700,17382,0,18461,670,17791,0,18830,676,18154
5267,220000,176000,0,0,0,0,0,0,-1,35718,20600,15118,-1,24288,24288,0,-1,25720,25720,0,-1,48759,48759,0
5268,150000,120000,0,0,0,0,0,0,0,47449,6000,41449,0,47987,3000,44987,0,48051,1700,46351,0,48410,2000,46410
5269,40000,32000,0,1,1,1,1,1,0,41217,4000,37217,0,40255,0,40255,2,39135,1700,37435,0,37235,3000,34235
5270,360000,288000,0,0,0,0,0,1,-2,0,0,0,-2,0,0,0,-2,0,0,0,-2,0,0,0
5271,70000,56000,0,0,0,0,0,0,0,28125,1000,27125,2,28364,1000,27364,2,29586,2000,27586,0,30110,1000,29110
5272,50000,40000,0,1,0,0,0,1,0,46895,1775,45120,0,49161,51209,-2048,-1,6690,428,6262,0,5665,5665,0
5273,200000,160000,0,0,0,0,0,0,-2,3774,3782,-8,-2,836,836,0,-2,1325,1325,0,-2,1440,1440,0
5274,70000,56000,0,0,0,0,0,0,0,24046,2000,22046,0,19194,2000,17194,0,16621,3000,13621,0,10797,2500,8297
5275,210000,168000,0,0,0,0,0,0,-2,0,0,0,-2,0,0,0,-2,0,0,0,-2,0,0,0
5276,150000,120000,0,0,0,0,0,0,0,4956,1068,3888,0,6692,1977,4715,0,14418,9118,5300,0,25825,12625,13200
5277,10000,8000,0,0,1,1,1,0,2,8528,1200,7328,0,9319,1142,8177,0,9477,300,9177,0,9736,400,9336
5278,120000,96000,0,1,0,0,0,1,0,108720,3710,105010,0,92649,3184,89465,0,89533,3200,86333,0,89204,3200,86004
5279,60000,48000,0,0,0,0,0,0,0,20939,1648,19291,0,21291,1000,20291,0,21734,936,20798,0,22184,962,21222
5280,300000,240000,0,0,0,0,0,0,-1,1496,1500,-4,-1,2490,2494,-4,-1,1996,1006,990,0,1494,1498,-4
5281,20000,16000,0,1,1,1,1,1,2,19658,0,19658,2,20086,1600,18486,0,19630,400,19230,0,19627,393,19234
5282,210000,168000,0,0,0,0,0,0,-1,3771,3771,0,-1,5474,5474,0,-1,69536,69536,0,-1,76188,10000,66188
5283,150000,120000,0,0,0,0,0,0,-2,17154,27654,-10500,-2,2729,2729,0,-2,32550,32550,0,-2,8509,11467,-2958
5284,190000,152000,0,0,0,0,0,1,0,53691,2000,51691,0,56997,4200,52797,0,55956,0,55956,2,58020,3000,55020
5285,350000,280000,0,0,0,0,0,0,0,257944,7700,250244,0,149040,5162,143878,0,144639,5025,139614,0,139558,5041,134517
5286,120000,96000,0,0,0,0,0,0,-1,0,0,0,-1,6440,6440,0,-1,0,0,0,-1,5930,5930,0
5287,310000,248000,0,0,0,0,0,0,0,5565,5565,0,-1,4050,4050,0,-1,4922,4922,0,-1,15362,15362,0
5288,20000,16000,0,0,0,0,0,0,0,9086,1270,7816,0,5096,1200,3896,0,5096,0,5096,0,5200,104,5096
5289,80000,64000,0,0,0,0,0,0,0,18361,1011,17350,0,10434,8,10426,0,7387,111,7276,0,3300,3509,-209
5290,140000,112000,0,0,0,0,0,0,0,54597,3011,51586,0,31734,0,31734,2,27211,3000,24211,2,23784,0,23784
5291,180000,144000,0,0,0,0,0,0,-2,0,0,0,-2,0,0,0,-2,0,0,0,-2,0,0,0
5292,240000,192000,0,0,0,0,0,0,0,129479,4486,124993,0,125584,3557,122027,0,128752,4235,124517,0,130651,3593,127058
5293,360000,288000,0,0,0,0,0,1,2,2009,2000,9,0,1029,0,1029,0,0,0,0,0,0,0,0
5294,450000,360000,0,0,0,0,0,0,-1,6576,0,6576,2,9133,6918,2215,0,6918,4351,2567,0,12382,8161,4221
5295,50000,40000,0,1,0,0,0,0,0,47770,1700,46070,0,37239,2151,35088,0,20526,687,19839,0,19771,2000,17771
5296,260000,208000,0,0,0,0,0,1,-2,-86,0,-86,-2,-86,0,-86,-2,17315,17401,-86,-2,14961,15036,-75
5297,20000,16000,0,1,1,1,1,1,0,18962,1476,17486,0,19886,1400,18486,0,18978,380,18598,0,17124,342,16782
5298,160000,128000,0,0,0,0,0,0,-1,1080,1080,0,-1,0,0,0,-1,40100,40100,0,-1,18899,18899,0
5299,440000,352000,0,0,0,0,0,0,-1,16786,16786,0,-1,396,396,0,-1,600,600,0,-1,3596,3596,0
5300,500000,400000,0,0,0,0,0,0,0,223989,13989,210000,0,223232,33232,190000,0,219158,29695,189463,0,212237,32838,179399
5301,100000,80000,0,0,0,0,0,0,-1,291,291,0,-1,291,291,0,-1,291,291,0,-1,291,291,0
5302,20000,16000,0,1,1,1,1,0,2,18414,1576,16838,0,20234,2396,17838,0,18438,0,18438,2,18225,1200,17025
5303,220000,176000,0,1,0,0,0,1,0,196510,6100,190410,0,120570,6000,114570,0,121664,4600,117064,0,122971,5500,117471
5304,330000,264000,0,0,0,0,0,1,-2,0,0,0,-2,0,0,0,-2,0,0,0,-2,0,0,0
5305,50000,40000,0,0,0,0,0,0,0,18250,1000,17250,0,-14,2000,-2014,0,72,500,-428,-1,658,1000,-342
5306,200000,160000,0,0,0,0,0,0,2,760,760,0,-1,380,0,380,2,380,380,0,-1,0,0,0
5307,80000,64000,0,1,1,1,1,0,0,80822,3000,77822,0,79207,4000,75207,0,79652,3100,76552,0,81165,3000,78165
5308,20000,16000,0,1,1,1,1,0,0,19286,1321,17965,0,19637,1400,18237,0,18826,1000,17826,0,19522,1000,18522
5309,70000,56000,0,1,1,0,0,1,2,69248,0,69248,2,69366,2109,67257,0,48998,1500,47498,0,27863,3769,24094
5310,20000,16000,0,0,0,0,0,0,0,9084,1076,8008,0,8667,249,8418,0,8848,258,8590,0,5328,500,4828
5311,50000,40000,0,0,0,0,0,0,0,40002,5040,34962,0,38008,8034,29974,0,31898,3029,28869,0,20154,5000,15154
5312,430000,344000,0,0,0,0,0,0,-1,8833,8840,-7,-1,9906,9954,-48,-1,14239,14285,-46,-1,9562,9584,-22
5313,30000,24000,0,0,0,0,0,0,0,13744,1300,12444,0,14712,1200,13512,0,14334,0,14334,2,15593,1500,14093
5314,210000,168000,0,0,0,0,0,0,-1,13920,12797,1123,-1,10284,0,10284,2,3813,3829,-16,-1,1154,1154,0
5315,80000,64000,0,0,0,0,0,0,-1,207,207,0,-1,0,0,0,-1,0,0,0,-2,0,0,0
5316,70000,56000,0,0,0,0,0,0,2,48505,4000,44505,2,47427,0,47427,2,48447,2000,46447,0,45145,1700,43445
5317,140000,112000,0,1,1,1,1,0,0,140262,6000,134262,0,138958,7000,131958,0,136898,5000,131898,0,141634,10700,130934
5318,210000,168000,0,0,0,0,0,0,-2,0,0,0,-2,820,820,0,-2,0,0,0,-2,0,0,0
5319,120000,96000,0,0,0,0,0,1,-2,0,0,0,-2,0,0,0,-2,0,0,0,-2,0,0,0
5320,50000,40000,0,0,0,0,0,1,2,34522,1300,33222,2,33668,0,33668,2,35323,2200,33123,2,36588,2000,34588
5321,360000,288000,0,0,0,0,0,0,-1,2875,2879,-4,-1,6918,6918,0,-1,10014,10014,0,-1,6478,6478,0
5322,150000,120000,0,0,0,0,0,0,0,14945,2020,12925,0,12966,2000,10966,0,14882,2000,12882,0,8105,2000,6105
5323,500000,400000,0,0,0,0,0,1,-1,1924,0,1924,2,1924,0,1924,2,8924,7000,1924,0,6729,36,6693
5324,140000,112000,0,0,0,0,0,0,-1,13126,13126,0,-1,3454,3456,-2,-1,1747,89,1658,0,1240,156,1084
5325,140000,112000,0,1,1,1,1,0,0,138696,6600,132096,0,139673,5500,134173,0,141573,4821,136752,0,140474,5188,135286
5326,70000,56000,0,1,0,0,0,0,0,66404,2127,64277,0,31688,618,31070,0,17317,738,16579,0,6270,125,6145
5327,300000,240000,0,0,0,0,0,0,0,225295,11000,214295,0,236540,17000,219540,0,168519,0,168519,2,172674,7000,165674
5328,90000,72000,0,1,1,0,0,0,0,89711,0,89711,2,91165,4086,87079,0,72263,2600,69663,0,72569,3000,69569
5329,310000,248000,0,0,0,0,0,0,-1,152141,100042,52099,0,125325,4017,121308,0,109142,9184,99958,0,103020,4081,98939
5330,50000,40000,0,0,0,0,0,0,0,30455,2000,28455,0,28955,1000,27955,0,25959,600,25359,0,26144,3000,23144
5331,230000,184000,0,0,0,0,0,0,0,11825,2000,9825,0,14765,5000,9765,0,12383,1000,11383,0,10008,2000,8008
5332,10000,8000,0,0,0,0,0,0,0,0,0,0,0,0,0,0,-2,0,0,0,-2,0,0,0
5333,130000,104000,0,0,0,0,0,0,-1,0,0,0,-1,0,0,0,-2,0,0,0,-2,297,297,0
5334,500000,400000,0,0,0,0,0,0,-2,0,0,0,-2,1535,1535,0,-2,1100,1100,0,-2,800,800,0
5335,170000,136000,0,0,0,0,0,0,-1,5641,5641,0,-1,2194,2194,0,-1,18601,18601,0,-1,2557,2557,0
5336,500000,400000,0,0,0,0,0,1,-1,1920,1920,0,-1,21734,21734,0,-1,1837,1837,0,-1,96,0,96
5337,20000,16000,0,0,0,0,0,0,2,6283,1107,5176,0,7454,1278,6176,0,8181,1005,7176,0,7905,0,7905
5338,50000,40000,0,1,1,1,0,0,0,49517,2501,47016,0,49528,2005,47523,0,44768,1312,43456,0,40295,1614,38681
5339,360000,288000,0,0,0,0,0,0,-1,10549,10580,-31,-1,4409,110,4299,0,2567,2578,-11,-1,6234,6265,-31
5340,250000,200000,0,0,0,0,0,1,0,31488,2500,28988,0,34060,3100,30960,0,33213,0,33213,2,34670,2000,32670
5341,250000,200000,0,0,0,0,0,0,-1,3572,3597,-25,-1,76552,76552,0,-1,100566,100566,0,-1,0,0,0
5342,30000,24000,0,0,0,0,0,0,0,13511,1223,12288,0,13781,493,13288,0,14070,511,13559,0,14350,514,13836
5343,230000,184000,0,0,0,0,0,0,0,77063,5010,72053,0,40102,5,40097,0,52454,45000,7454,0,12314,8000,4314
5344,30000,24000,0,0,0,0,0,1,2,11462,0,11462,2,13263,2300,10963,2,12758,0,12758,2,13545,1300,12245
5345,290000,232000,0,0,0,0,0,0,0,81301,4000,77301,0,84033,5000,79033,0,86513,4000,82513,0,90056,5000,85056
5346,400000,320000,0,0,0,0,0,1,0,98274,3532,94742,0,84698,4005,80693,0,58612,1482,57130,0,55610,1452,54158
5347,500000,400000,0,0,0,0,0,0,-1,11727,11807,-80,-1,10850,10904,-54,-1,9061,9106,-45,-1,13017,13081,-64
5348,160000,128000,0,1,0,0,0,0,2,159322,7661,151661,0,124363,4607,119756,0,126802,4602,122200,0,129365,4671,124694
5349,20000,16000,0,1,1,1,1,1,2,18718,1718,17000,0,17009,900,16109,0,18721,2000,16721,0,20209,1800,18409
5350,410000,328000,0,0,0,0,0,0,0,321091,13014,308077,0,274957,30000,244957,0,268891,12000,256891,0,262570,10000,252570
5351,180000,144000,0,1,1,1,1,0,0,184097,8500,175597,0,177870,8500,169370,0,169767,8000,161767,0,175867,14250,161617
5352,430000,344000,0,0,0,0,0,0,-2,5930,5960,-30,-2,33736,39507,-5771,-2,23558,11838,11720,-2,8118,8158,-40
5353,70000,56000,0,0,0,0,0,0,0,0,0,0,0,21280,21280,0,-1,21625,1000,20625,0,22275,1000,21275
5354,390000,312000,0,0,0,0,0,0,-1,695,699,-4,-1,-448,115,-563,-1,-1228,712,-1940,-2,-1228,0,-1228
5355,50000,40000,0,0,0,0,0,0,0,18973,1301,17672,0,19369,700,18669,0,19769,700,19069,0,19385,700,18685
5356,290000,232000,0,0,0,0,0,0,0,652,978,-326,0,0,0,0,-2,652,652,0,-2,92775,92775,0
5357,300000,240000,0,0,0,0,0,0,0,181780,14500,167280,0,177363,0,177363,2,189423,15150,174273,2,188567,7700,180867
5358,230000,184000,0,0,0,0,0,0,-2,0,0,0,-2,0,0,0,-2,0,0,0,-2,0,0,0
5359,50000,40000,0,0,0,0,0,0,0,38318,20070,18248,0,17331,3006,14325,0,14916,6002,8914,0,18459,5000,13459
5360,40000,32000,0,1,1,0,1,0,2,33002,0,33002,3,32173,0,32173,2,34629,3000,31629,2,33940,0,33940
5361,360000,288000,0,0,0,0,0,0,-2,-2,0,-2,-2,-2,0,-2,-2,-2,0,-2,-2,-2,0,-2
5362,360000,288000,0,0,0,0,0,0,-1,68214,170000,-101786,-1,168014,100000,68014,0,16209,3000,13209,0,18918,3000,15918
5363,20000,16000,0,0,0,0,0,0,0,2059,1100,959,0,2576,1500,1076,0,1834,200,1634,0,1092,200,892
5364,210000,168000,0,0,0,0,0,1,3,129847,10478,119369,4,137277,11078,126199,4,145533,11078,134455,5,154105,11678,142427
5365,80000,64000,0,0,0,0,0,0,0,49339,2000,47339,0,50415,2000,48415,0,45859,2007,43852,0,43152,1600,41552
5366,140000,112000,0,0,0,0,0,0,0,47397,3000,44397,0,45860,1356,44504,0,46264,2000,44264,0,41870,2000,39870
5367,100000,80000,0,0,0,0,0,0,0,26608,2000,24608,0,24689,2000,22689,0,25699,1700,23999,0,26809,1500,25309
5368,150000,120000,0,0,0,0,0,0,-1,10292,11000,-708,-1,3141,3141,0,-1,7522,7531,-9,-1,3929,3929,0
5369,50000,40000,0,1,0,0,0,0,0,47445,1289,46156,0,17945,789,17156,0,18165,659,17506,0,18557,694,17863
5370,50000,40000,0,0,0,0,0,0,0,19520,5000,14520,0,21103,2300,18803,0,20101,0,20101,2,20402,1000,19402
5371,30000,24000,0,0,0,0,0,0,0,21554,2000,19554,0,22280,2000,20280,0,18330,1000,17330,0,780,0,780
5372,100000,80000,0,1,1,0,0,0,0,99520,4000,95520,0,102650,5000,97650,0,0,0,0,0,0,0,0
5373,50000,40000,0,0,0,0,0,1,0,29259,1552,27707,0,9442,334,9108,0,9792,498,9294,0,9684,500,9184
5374,50000,40000,0,0,0,0,0,1,0,9858,1118,8740,0,8536,285,8251,0,9674,299,9375,0,9591,1110,8481
5375,50000,40000,0,0,0,0,0,0,0,31161,1300,29861,0,25294,1629,23665,0,24843,0,24843,2,19576,1000,18576
5376,130000,104000,0,1,1,1,1,1,0,112064,4030,108034,0,130239,20000,110239,0,127980,0,127980,3,130305,4500,125805
5377,60000,48000,1,1,1,1,1,0,2,71219,2000,69219,2,67687,3000,64687,2,61691,0,61691,2,57626,3000,54626
5378,130000,104000,0,0,0,0,0,1,2,51531,2500,49031,0,52076,2000,50076,0,55432,4200,51232,0,56571,2200,54371
5379,100000,80000,0,0,0,0,0,0,0,20183,2000,18183,0,21540,2000,19540,0,25775,5000,20775,0,0,0,0
5380,20000,16000,0,1,1,1,0,1,0,17541,900,16641,2,18300,1200,17100,0,19100,1000,18100,0,2200,100,2100
5381,160000,128000,0,0,0,0,0,0,-2,0,0,0,-2,0,0,0,-2,0,0,0,-2,0,0,0
5382,210000,168000,0,0,0,0,0,0,-2,7422,7422,0,-2,893,893,0,-2,6082,6082,0,-1,2293,2293,0
5383,20000,16000,0,1,1,1,1,0,2,19888,1300,18588,0,20318,1000,19318,0,20364,1000,19364,0,20134,1000,19134
5384,160000,128000,0,0,0,0,0,0,-1,240,240,0,-1,236,236,0,-1,4022,4026,-4,-1,4245,1000,3245
5385,50000,40000,0,0,0,0,0,0,0,26077,0,26077,2,27898,2257,25641,2,27315,0,27315,2,27709,1000,26709
5386,300000,240000,0,0,0,0,0,1,-2,4962,4962,0,-2,13634,13634,0,-2,41510,41510,0,-2,-1087,0,-1087
5387,500000,400000,0,0,0,0,0,0,0,37528,37550,-22,-1,83629,83642,-13,-1,20894,20894,0,-1,27217,24038,3179
5388,260000,208000,0,0,0,0,0,0,0,11333,1000,10333,0,11651,1000,10651,0,12651,1000,11651,0,9247,205,9042
5389,280000,224000,0,0,0,0,0,0,-2,500,500,0,-2,55176,55176,0,-2,5950,5950,0,-2,289,289,0
5390,290000,232000,0,0,0,0,0,0,-1,0,0,0,-2,9194,9194,0,-1,9194,0,9194,0,399,399,0
5391,100000,80000,0,0,0,0,0,1,-1,0,0,0,-2,0,0,0,-2,0,0,0,-2,0,0,0
5392,100000,80000,0,0,0,0,0,0,0,48677,3000,45677,0,49496,2000,47496,0,51010,2000,49010,0,32630,2000,30630
5393,360000,288000,0,0,0,0,0,0,0,149903,7294,142609,0,138091,6135,131956,0,138123,4504,133619,0,140324,4669,135655
5394,50000,40000,0,0,0,0,0,0,0,48909,15412,33497,0,15033,870,14163,0,3198,3198,0,-1,0,0,0
5395,290000,232000,0,0,0,0,0,0,-1,100,100,0,-1,0,0,0,-1,100,100,0,-1,0,0,0
5396,250000,200000,0,0,0,0,0,0,-1,27548,27548,0,-1,1800,1800,0,-1,11942,11942,0,-1,4680,4680,0
5397,30000,24000,0,1,0,0,0,1,3,26860,0,26860,2,21165,1646,19519,0,21281,762,20519,0,22938,2000,20938
5398,110000,88000,0,0,0,0,0,0,0,63389,2255,61134,0,60021,2139,57882,0,58660,2097,56563,0,59891,2174,57717
5399,150000,120000,0,0,0,0,0,0,0,66692,4000,62692,0,67518,2258,65260,0,64210,2500,61710,0,60747,2500,58247
5400,150000,120000,0,0,0,0,0,0,-1,2056,2056,0,-1,7756,7756,0,-1,4993,0,4993,0,918,918,0
5401,160000,128000,0,0,0,0,0,0,-1,416,416,0,-1,416,416,0,-1,416,416,0,-1,2606,2606,0
5402,470000,376000,0,0,0,0,0,0,0,88892,5000,83892,0,90944,5000,85944,0,93739,5000,88739,0,96428,5000,91428
5403,230000,184000,0,0,0,0,0,0,0,180786,14105,166681,0,95445,21124,74321,0,63048,2520,60528,0,99961,50961,49000
5404,90000,72000,0,1,0,0,0,0,0,91097,3868,87229,0,52285,1960,50325,0,46430,1658,44772,0,47404,1718,45686
5405,10000,8000,0,1,1,1,1,0,-1,9644,1200,8444,0,9541,400,9141,0,8971,323,8648,0,9645,1600,8045
5406,140000,112000,0,0,0,0,0,0,0,141301,140000,1301,0,99115,4000,95115,0,101597,4000,97597,0,101290,4000,97290
5407,210000,168000,0,0,0,0,0,0,0,89173,3789,85384,0,91489,3811,87678,0,93463,3465,89998,0,95021,3186,91835
5408,450000,360000,0,0,0,0,0,0,-2,-1318,40,-1358,-2,-9157,258,-9415,-2,-20753,9,-20762,-2,-22680,23,-22703
5409,140000,112000,0,0,0,0,0,0,-1,5477,5491,-14,-1,4490,2013,2477,0,1500,1510,-10,-1,-51183,18,-51201
5410,50000,40000,0,0,0,0,0,0,0,46665,26390,20275,0,390,390,0,-1,430,430,0,-1,390,350,40
5411,10000,8000,0,0,1,1,1,0,0,9310,2800,6510,0,9500,190,9310,0,9700,200,9500,0,10000,300,9700
5412,180000,144000,0,0,0,0,0,0,3,390,0,390,2,390,390,0,-1,390,390,0,-1,540,540,0
5413,200000,160000,0,0,0,0,0,0,0,115836,0,115836,2,122359,10000,112359,2,122588,5000,117588,2,119266,0,119266
5414,490000,392000,0,0,0,0,0,0,-1,361,361,0,-1,7530,7600,-70,-1,396,396,0,-1,396,396,0
5415,140000,112000,0,1,1,1,1,0,2,131671,0,131671,2,138771,10800,127971,2,141146,4800,136346,2,127184,0,127184
5416,270000,216000,0,0,0,0,0,0,-2,-330,0,-330,-2,-330,0,-330,-2,-330,0,-330,-2,-330,0,-330
5417,440000,352000,0,0,0,0,0,0,-1,15869,16031,-162,-1,20849,23613,-2764,0,331985,320008,11977,0,185315,5721,179594
5418,30000,24000,0,1,1,0,0,1,0,27032,1804,25228,0,26723,2014,24709,0,23143,1521,21622,0,17106,1204,15902
5419,280000,224000,0,0,0,0,0,0,-2,183,0,183,-2,2568,4953,-2385,-2,2371,12,2359,0,7610,7647,-37
5420,110000,88000,0,1,0,0,0,0,0,93894,4075,89819,0,85723,3144,82579,0,86443,3238,83205,0,84011,3167,80844
5421,20000,16000,0,0,0,0,0,1,-1,987,987,0,-1,1119,1200,-81,-1,-222,0,-222,-1,-222,0,-222
5422,250000,200000,0,1,0,0,0,0,0,245429,8146,237283,0,186620,6000,180620,0,193003,13003,180000,0,191867,11867,180000
5423,360000,288000,0,0,0,0,0,0,0,112746,6079,106667,0,102611,6091,96520,0,92290,6227,86063,0,51489,5055,46434
5424,170000,136000,0,0,0,0,0,0,0,109136,4037,105099,0,106882,10019,96863,0,99917,9,99908,2,97133,3480,93653
5425,20000,16000,0,1,0,0,0,0,0,19294,1448,17846,0,14092,1328,12764,0,6826,500,6326,0,10090,10986,-896
5426,400000,320000,0,0,0,0,0,0,-2,15000,15000,0,-2,492,492,0,-2,14926,15000,-74,-2,7626,7725,-99
5427,310000,248000,0,0,0,0,0,0,-2,589,589,0,-2,1594,1594,0,-2,28252,28252,0,-2,15081,18381,-3300
5428,20000,16000,0,0,0,0,0,1,3,11926,2100,9826,2,11448,0,11448,3,10970,0,10970,2,11636,1000,10636
5429,120000,96000,0,0,0,0,0,0,0,890,890,0,-1,890,890,0,-1,3040,3040,0,-1,1000,0,1000
5430,110000,88000,0,0,0,0,0,0,2,2373,2373,0,-1,1475,1475,0,-1,3102,4000,-898,-1,3151,3000,151
5431,110000,88000,0,1,1,1,1,1,2,108464,4000,104464,0,110737,4000,106737,0,114581,8500,106081,0,111219,0,111219
5432,330000,264000,0,0,0,0,0,0,0,40560,4000,36560,0,41978,2000,39978,0,46728,5039,41689,0,40502,2164,38338
5433,390000,312000,0,0,0,0,0,0,-2,0,0,0,-2,0,0,0,-2,0,0,0,-2,0,0,0
5434,120000,96000,0,0,0,0,0,1,-1,316,316,0,-1,0,0,0,-1,632,632,0,-1,316,316,0
5435,220000,176000,0,0,0,0,0,0,-1,147,147,0,-1,0,0,0,-1,0,0,0,-2,0,0,0
5436,110000,88000,0,1,1,0,0,0,2,111805,6000,105805,0,108207,4380,103827,0,75808,3000,72808,0,78490,5000,73490
5437,80000,64000,0,0,0,0,0,0,-1,2954,2957,-3,-1,24243,24277,-34,-1,7043,7046,-3,-1,13531,13671,-140
5438,50000,40000,0,1,1,1,1,0,2,50866,3600,47266,2,48194,0,48194,2,47233,3000,44233,0,50224,5001,45223
5439,440000,352000,0,0,0,0,0,0,-1,241,241,0,-1,8544,8598,-54,-1,1361,857,504,0,855,4,851
5440,500000,400000,0,0,0,0,0,0,0,81210,10000,71210,0,88888,10000,78888,0,107072,20000,87072,0,115264,10000,105264
5441,410000,328000,0,0,0,0,0,0,-1,19975,8944,11031,-1,8906,7,8899,2,10491,10491,0,-1,9347,9347,0
5442,20000,16000,0,1,1,1,1,1,0,19945,1363,18582,0,20051,1249,18802,0,19472,1000,18472,0,19830,2000,17830
5443,180000,144000,0,0,0,0,0,0,0,12200,1200,11000,0,9531,1531,8000,0,10131,3500,6631,0,0,0,0
5444,30000,24000,0,0,0,0,0,0,0,-202,0,-202,-2,-202,0,-202,-2,-202,0,-202,-2,7571,7844,-273
5445,50000,40000,0,0,0,0,0,0,0,4510,1000,3510,0,2893,300,2593,0,2000,400,1600,0,2800,800,2000
5446,210000,168000,0,0,0,0,0,0,0,46870,1800,45070,0,48089,2000,46089,0,49311,2000,47311,0,50296,1803,48493
5447,60000,48000,0,1,0,0,0,0,0,55009,1459,53550,0,30181,914,29267,0,41528,1900,39628,0,21069,800,20269
5448,90000,72000,0,0,0,0,0,1,2,12193,2000,10193,2,12986,1300,11686,2,11831,700,11131,0,12488,1000,11488
5449,200000,160000,0,0,0,0,0,0,2,15439,5000,10439,0,14757,1000,13757,0,14275,0,14275,2,13680,2000,11680
5450,20000,16000,0,1,1,1,0,1,0,20087,1530,18557,0,19874,700,19174,0,19963,700,19263,0,14879,600,14279
5451,220000,176000,0,0,0,0,0,0,-2,1497,1497,0,-2,0,0,0,-2,0,0,0,-2,7625,7625,0
5452,100000,80000,0,0,0,0,0,0,-1,197,197,0,-1,245,245,0,-1,3210,3210,0,-1,318,318,0
5453,300000,240000,0,0,0,0,0,0,0,0,0,0,-2,0,0,0,-2,0,0,0,-2,0,0,0
5454,360000,288000,0,0,0,0,0,0,-1,1937,1937,0,-1,944,944,0,-1,1219,1219,0,-1,2216,2216,0
5455,140000,112000,0,0,0,0,0,0,0,96820,4790,92030,0,97000,3092,93908,0,97467,3148,94319,0,79872,2981,76891
5456,300000,240000,0,0,0,0,0,0,-2,585,585,0,-2,207,207,0,-2,0,0,0,-2,0,0,0
5457,300000,240000,0,0,0,0,0,0,0,124802,6001,118801,0,80088,3500,76588,0,25283,705,24578,0,12358,3000,9358
5458,70000,56000,0,1,1,1,1,0,0,62958,2190,60768,0,64209,2201,62008,0,59482,2181,57301,0,60883,2413,58470
5459,50000,40000,0,0,0,0,0,1,-1,8263,8276,-13,-1,14054,14075,-21,-1,22071,15022,7049,0,20506,3012,17494
5460,50000,40000,0,0,0,0,0,1,0,27850,3400,24450,0,27038,0,27038,2,27465,1000,26465,0,20943,900,20043
5461,230000,184000,0,0,0,0,0,0,-1,4410,4851,-441,-1,0,0,0,-1,711,711,0,-1,5650,5650,0
5462,230000,184000,0,0,0,0,0,0,-1,4805,4819,-14,-1,1600,1600,0,-1,4712,4712,0,-1,3466,3466,0
5463,50000,40000,0,1,0,0,0,0,0,50389,2109,48280,0,30410,1100,29310,0,30364,1100,29264,0,30063,1100,28963
5464,200000,160000,0,1,1,1,0,0,2,188391,6784,181607,0,199101,13788,185313,0,185247,14,185233,2,165232,6021,159211
5465,10000,8000,0,0,0,0,0,1,2,1050,0,1050,3,1050,0,1050,3,1050,0,1050,3,1050,0,1050
5466,30000,24000,0,0,0,0,0,0,2,1914,0,1914,2,2182,300,1882,2,2000,0,2000,2,2566,600,1966
5467,360000,288000,0,0,0,0,0,1,0,454,456,-2,-1,-2,0,-2,-1,-2,0,-2,-2,-2,0,-2
5468,300000,240000,0,0,0,0,0,1,-1,390,390,0,-1,390,390,0,-1,390,390,0,-1,390,390,0
5469,20000,16000,0,0,0,1,1,1,0,15732,2000,13732,0,17330,2000,15330,0,17150,1000,16150,0,18150,1000,17150
5470,360000,288000,0,0,0,0,0,0,-2,0,0,0,-2,0,0,0,-2,0,0,0,-2,0,0,0
5471,280000,224000,0,1,1,1,1,0,0,254735,9300,245435,0,270486,20000,250486,0,276026,10000,266026,2,271408,0,271408
5472,160000,128000,0,0,0,0,0,0,-1,768,768,0,-1,10488,10488,0,-1,4724,2049,2675,0,104205,104205,0
5473,150000,120000,0,0,0,0,0,0,-2,4839,6095,-1256,-2,807,807,0,-2,28023,28023,0,-2,7613,7613,0
5474,70000,56000,0,0,0,0,0,0,0,19948,19948,0,-1,20231,3000,17231,0,20757,3002,17755,0,18357,1002,17355
5475,300000,240000,0,1,0,0,0,0,0,268531,7668,260863,0,157953,4429,153524,0,161183,4821,156362,0,163942,4684,159258
5476,190000,152000,0,0,0,0,0,0,-1,1655,1655,0,-1,1213,1213,0,-1,344,344,0,-1,221,221,0
5477,50000,40000,0,0,0,0,0,0,0,8127,1364,6763,0,8763,1000,7763,0,8956,193,8763,0,4224,89,4135
5478,230000,184000,0,0,0,0,0,0,-1,1350,1350,0,-1,371,371,0,-1,2980,2980,0,-1,0,0,0
5479,260000,208000,0,0,0,0,0,1,-2,-124,0,-124,-2,1599,1723,-124,-2,360,366,-6,-1,882,882,0
5480,180000,144000,0,0,0,0,0,0,0,38394,3170,35224,0,30332,2000,28332,0,110824,100000,10824,0,99661,5000,94661
5481,180000,144000,0,0,0,0,0,0,0,68709,4657,64052,0,70465,3500,66965,0,72335,3650,68685,0,74807,3800,71007
5482,270000,216000,0,0,0,0,0,0,2,14692,0,14692,2,13907,1000,12907,2,10660,0,10660,2,10683,2000,8683
5483,200000,160000,0,0,0,0,0,0,-2,430,430,0,-2,5241,5241,0,-2,430,439,-9,-2,59415,59415,0
5484,360000,288000,0,0,0,0,0,0,-2,4480,7740,-3260,-2,3260,3260,0,-2,3884,3884,0,-2,4352,4352,0
5485,30000,24000,0,1,1,1,1,1,2,29906,1831,28075,0,30524,1449,29075,0,28915,1100,27815,0,29524,1051,28473
5486,150000,120000,0,0,0,1,1,0,0,120002,4500,115502,0,122013,4000,118013,0,131426,11000,120426,0,134676,5000,129676
5487,80000,64000,0,0,0,0,0,0,0,12718,1600,11118,0,8808,1088,7720,0,7952,245,7707,0,7925,636,7289
5488,240000,192000,0,0,0,0,0,0,-1,2206,2455,-249,-1,62507,64395,-1888,-1,63226,1917,61309,0,63517,4160,59357
5489,380000,304000,0,0,0,0,0,1,0,224420,8420,216000,0,136324,46777,89547,0,137929,4929,133000,0,114249,4249,110000
5490,500000,400000,0,0,0,0,0,1,2,77611,3000,74611,2,78735,3000,75735,2,80430,3100,77330,2,82068,3110,78958
5491,230000,184000,0,0,0,0,0,0,-1,326,326,0,-1,326,326,0,-1,677,677,0,-1,351,0,351
5492,30000,24000,0,0,0,0,0,0,0,17725,3286,14439,0,20320,2881,17439,0,19480,1,19479,2,19222,632,18590
5493,60000,48000,0,0,0,1,1,0,0,48696,2500,46196,0,50385,2500,47885,0,52045,2500,49545,0,52661,1600,51061
5494,40000,32000,0,0,0,0,0,0,0,15065,1256,13809,0,16077,1268,14809,0,16396,587,15809,0,16739,607,16132
5495,370000,296000,0,0,0,0,0,1,-2,0,0,0,-2,0,0,0,-2,0,0,0,-2,0,0,0
5496,300000,240000,0,0,0,0,0,0,-1,0,0,0,-1,290,290,0,-1,707,1209,-502,-1,161,0,161
5497,50000,40000,0,1,1,0,0,0,0,51365,2388,48977,0,50579,1602,48977,0,20413,900,19513,0,20452,838,19614
5498,230000,184000,0,0,0,0,0,0,0,54176,1941,52235,0,42944,1534,41410,0,40391,1532,38859,0,35820,1565,34255
5499,230000,184000,0,0,0,0,0,0,0,10644,2000,8644,0,12414,2000,10414,0,15982,4000,11982,0,13324,2300,11024
5500,410000,328000,0,0,0,0,0,0,-1,36465,16000,20465,0,44310,8700,35610,0,62408,18775,43633,0,61420,15000,46420
5501,150000,120000,0,1,1,0,0,0,0,134573,0,134573,2,136026,5399,130627,0,97517,4224,93293,0,47027,1830,45197
5502,480000,384000,0,0,0,0,0,0,0,400693,20000,380693,0,393892,20005,373887,0,348733,15000,333733,0,331930,15000,316930
5503,320000,256000,0,0,0,0,0,0,0,29368,2240,27128,0,160578,160578,0,-1,129187,4600,124587,0,124967,5000,119967
5504,60000,48000,0,0,0,0,0,0,0,28894,2000,26894,0,21556,1600,19956,0,21494,3000,18494,0,21838,2800,19038
5505,20000,16000,0,0,0,0,0,0,0,6140,1000,5140,0,6140,0,6140,0,0,0,0,0,0,0,0
5506,390000,312000,0,0,0,0,0,0,0,96446,4000,92446,0,87912,3200,84712,0,89991,3500,86491,0,91470,3100,88370
5507,360000,288000,0,0,0,0,0,0,-1,624,624,0,-1,0,0,0,-1,1000,1000,0,-1,1866,1866,0
5508,30000,24000,0,0,0,0,0,1,2,20808,0,20808,2,21761,1300,20461,2,22762,1500,21262,2,23139,900,22239
5509,290000,232000,0,0,0,0,0,0,0,65814,3814,62000,0,60861,2861,58000,0,60901,1901,59000,0,53023,2023,51000
5510,150000,120000,0,0,0,0,0,0,-2,8362,8403,-41,-2,882,886,-4,-2,1594,1602,-8,-2,1385,1391,-6
5511,400000,320000,0,0,0,0,0,0,0,1354,1354,0,-1,5322,5322,0,-1,5103,6,5097,0,2077,2386,-309
5512,150000,120000,0,0,0,0,0,0,0,91721,4218,87503,0,93063,4204,88859,0,92758,3296,89462,0,93876,3408,90468
5513,50000,40000,0,0,0,0,0,0,0,27315,1000,26315,0,-60,0,-60,0,28890,30070,-1180,-1,29168,1180,27988
5514,180000,144000,0,0,0,0,0,0,0,20027,1104,18923,0,15000,15000,0,-1,14958,14958,0,-1,-42,0,-42
5515,380000,304000,0,0,0,0,0,0,0,43758,2014,41744,0,39106,1004,38102,0,37978,3000,34978,0,33428,2000,31428
5516,300000,240000,0,0,0,0,0,0,-1,36667,36679,-12,-1,34252,34263,-11,-1,25583,25583,0,-1,28676,28676,0
5517,90000,72000,0,0,0,0,0,1,2,33776,0,33776,2,34767,1563,33204,0,35504,1300,34204,0,36249,1300,34949
5518,110000,88000,0,1,1,1,1,0,0,110078,5454,104624,0,112466,5707,106759,0,111094,4156,106938,0,109243,4123,105120
5519,210000,168000,0,0,0,0,0,0,0,364,17864,-17500,-1,-649,569,-1218,-1,-649,0,-649,-2,-649,0,-649
5520,210000,168000,0,1,1,1,1,0,0,219122,20000,199122,0,223267,8200,215067,0,227841,7100,220741,0,228377,6800,221577
5521,50000,40000,0,0,0,0,0,1,2,21128,5000,16128,2,20492,0,20492,2,30079,10000,20079,2,29460,0,29460
5522,40000,32000,0,0,0,0,0,0,0,22807,1384,21423,0,24993,2570,22423,0,24292,0,24292,2,24800,899,23901
5523,130000,104000,0,1,1,1,1,1,0,126347,5000,121347,0,129249,5000,124249,0,132093,5000,127093,0,129155,4700,124455
5524,180000,144000,0,0,0,0,0,0,0,117428,5000,112428,0,104153,9000,95153,0,100148,0,100148,2,98165,5000,93165
5525,260000,208000,0,0,0,0,0,0,-1,100,100,0,-1,100,0,100,2,499,499,0,-1,499,0,499
5526,250000,200000,0,0,0,0,0,0,-1,600,0,600,2,9375,9375,0,-1,8765,8765,0,-1,3649,3649,0
5527,20000,16000,0,0,0,1,1,1,0,15290,1260,14030,0,16300,1270,15030,0,16624,594,16030,0,16974,617,16357
5528,180000,144000,0,0,0,0,0,0,-2,1300,1300,0,-2,0,0,0,-2,2000,2000,0,-1,0,0,0
5529,260000,208000,0,0,0,0,0,1,2,2497,0,2497,2,2497,0,2497,2,2497,0,2497,2,2497,0,2497
5530,120000,96000,0,0,0,0,0,0,0,12440,10218,2222,0,10218,0,10218,2,3516,4500,-984,-1,4321,4321,0
5531,180000,144000,0,0,0,0,0,0,0,2079,2083,-4,0,792,792,0,-2,1645,1645,0,-2,1645,0,1645
5532,60000,48000,0,0,0,0,0,0,-1,1047,1047,0,-1,-239,0,-239,-1,1475,3000,-1525,-1,1289,0,1289
5533,30000,24000,0,0,0,0,0,0,0,6714,2000,4714,0,8714,2000,6714,0,9514,5000,4514,0,3300,0,3300
5534,270000,216000,0,0,0,0,0,0,-1,0,0,0,-1,0,0,0,-2,0,0,0,-2,0,0,0
5535,100000,80000,0,0,0,0,0,1,2,13255,1529,11726,0,13959,1233,12726,0,14921,1195,13726,0,14539,0,14539
5536,80000,64000,0,1,0,0,0,0,0,79919,3500,76419,0,64237,2500,61737,0,47890,2000,45890,0,48036,2500,45536
5537,340000,272000,0,0,0,0,0,0,0,24810,2000,22810,0,27502,5000,22502,0,3490,3490,0,-1,99514,99000,514
5538,350000,280000,0,0,0,0,0,1,2,2400,0,2400,2,2400,0,2400,7,2400,0,2400,7,2400,0,2400
5539,50000,40000,0,0,0,0,0,0,2,5241,1103,4138,0,6238,1100,5138,0,5979,215,5764,0,7492,2000,5492
5540,50000,40000,0,1,0,0,0,0,0,47010,6000,41010,0,20661,1000,19661,0,14528,2000,12528,0,15544,2500,13044
5541,500000,400000,0,0,0,0,0,0,-1,21138,21138,0,-1,49305,49775,-470,-1,39095,39095,0,-1,15826,0,15826
5542,180000,144000,0,0,0,0,0,0,2,117004,10000,107004,0,119542,6000,113542,0,122452,5000,117452,0,130293,10000,120293
5543,450000,360000,1,1,1,0,1,1,0,497132,18000,479132,0,514249,25135,489114,0,462666,432130,30536,0,472480,17000,455480
5544,360000,288000,0,0,0,0,0,0,-1,38497,38610,-113,-1,14342,14350,-8,-1,17098,17098,0,-1,4546,4546,0
5545,30000,24000,0,0,0,0,0,0,0,21291,5000,16291,0,21939,1000,20939,0,22435,1000,21435,0,23160,1100,22060
5546,230000,184000,0,0,0,0,0,1,-1,436,586,-150,-1,12488,12511,-23,-1,932,1249,-317,-1,317,0,317
5547,100000,80000,0,1,1,0,0,0,0,98054,5000,93054,0,92466,4000,88466,0,67337,5000,62337,0,67093,3000,64093
5548,30000,24000,0,1,1,1,1,1,0,27929,1482,26447,0,28920,1703,27217,0,27997,1001,26996,0,28378,1500,26878
5549,200000,160000,0,0,0,0,0,0,-2,0,0,0,-2,0,0,0,-2,0,0,0,-2,0,0,0
5550,20000,16000,0,0,0,0,0,0,0,16262,1550,14712,0,16749,1000,15749,0,13764,1000,12764,0,18732,5283,13449
5551,60000,48000,0,0,0,0,0,0,-1,39511,39511,0,-1,39654,1866,37788,0,38168,1400,36768,0,36526,2000,34526
5552,270000,216000,0,0,0,0,0,1,-1,2958,2983,-25,-1,4154,4172,-18,-1,5885,5912,-27,-1,3129,3143,-14
5553,240000,192000,0,0,0,0,0,0,0,111397,5000,106397,0,61650,3000,58650,0,0,0,0,0,0,0,0
5554,10000,8000,0,0,0,0,0,0,0,9385,2000,7385,0,5163,2009,3154,0,780,0,780,0,0,0,0
5555,220000,176000,0,0,0,0,0,0,-1,632,632,0,-1,632,316,316,0,316,0,316,0,316,316,0
5556,70000,56000,0,0,0,0,0,0,0,19998,1689,18309,0,22919,4000,18919,0,23128,958,22170,0,23030,1036,21994
5557,20000,16000,0,1,1,1,1,0,0,17494,1300,16194,2,16916,0,16916,2,18135,1500,16635,2,17703,0,17703
5558,260000,208000,0,0,0,0,0,0,-1,326,326,0,-1,326,326,0,-1,326,326,0,-1,476,476,0
5559,50000,40000,0,0,0,0,0,1,-1,1616,1616,0,-1,780,0,780,0,390,0,390,0,540,540,0
5560,210000,168000,0,0,0,0,0,1,0,44826,2046,42780,0,45544,1764,43780,0,48497,3717,44780,0,47591,0,47591
5561,180000,144000,0,0,0,0,0,0,0,8763,1135,7628,0,8938,310,8628,0,8568,378,8190,0,9357,1000,8357
5562,30000,24000,0,0,0,0,0,1,2,14547,1000,13547,2,15304,1000,14304,0,16056,1000,15056,0,20196,4600,15596
5563,230000,184000,0,0,0,0,0,0,2,185074,8000,177074,2,187053,6500,180553,2,176805,0,176805,2,180826,7000,173826
5564,230000,184000,0,0,0,0,0,0,-2,20176,20176,0,-2,10000,200,9800,-2,10000,10000,0,-2,10000,10000,0
5565,270000,216000,0,0,0,0,0,1,0,171865,7900,163965,0,176167,8800,167367,0,105523,4700,100823,0,45258,2100,43158
5566,90000,72000,0,0,0,0,0,0,2,40567,5539,35028,2,41604,2000,39604,2,40637,0,40637,2,41824,2000,39824
5567,130000,104000,0,0,0,0,0,0,2,23647,3500,20147,2,22984,0,22984,2,24315,2000,22315,2,23155,0,23155
5568,50000,40000,0,0,1,1,1,0,0,40717,2000,38717,0,41682,1642,40040,0,42857,2000,40857,0,45581,3600,41981
5569,120000,96000,0,0,0,0,0,0,-1,1682,1682,0,-1,1682,1682,0,-1,1682,1682,0,-1,1682,1682,0
5570,200000,160000,0,0,0,0,0,0,-2,19583,25120,-5537,-2,20632,25118,-4486,-2,3142,36,3106,-2,21253,27107,-5854
5571,440000,352000,0,0,0,0,0,0,-1,5252,5252,0,-1,13192,13192,0,-1,29029,20000,9029,0,27812,1179,26633
5572,50000,40000,0,0,0,0,0,0,-1,566,566,0,-1,5243,5243,0,-1,0,0,0,-1,0,0,0
5573,130000,104000,0,0,0,0,0,0,0,91715,7700,84015,0,89245,0,89245,2,90827,3001,87826,0,87779,3011,84768
5574,30000,24000,0,0,0,0,0,1,2,7064,3192,3872,2,2890,0,2890,2,2500,2500,0,-1,3280,3280,0
5575,300000,240000,0,0,0,0,0,0,0,152882,6000,146882,0,113347,4084,109263,0,114554,4056,110498,0,116357,4300,112057
5576,20000,16000,0,0,0,0,0,0,0,10858,2000,8858,0,12670,2000,10670,0,13157,1000,12157,0,13742,800,12942
5577,50000,40000,0,0,0,0,0,1,2,21133,2500,18633,2,19121,0,19121,2,19663,1000,18663,0,20235,1050,19185
5578,460000,368000,0,0,0,0,0,0,0,257836,7524,250312,0,388058,324097,63961,0,324478,12039,312439,0,313547,12006,301541
5579,170000,136000,0,0,0,0,0,1,2,46365,2000,44365,2,47304,2000,45304,2,47727,1500,46227,2,49315,2500,46815
5580,20000,16000,0,0,0,0,0,0,0,200,200,0,-1,0,0,0,-1,18844,18844,0,-1,12052,241,11811
5581,190000,152000,0,1,1,1,1,0,0,189950,8400,181550,0,194092,8800,185292,0,192638,7500,185138,0,189113,7100,182013
5582,190000,152000,0,0,0,0,0,1,0,39410,2000,37410,0,38288,1500,36788,0,39276,1500,37776,0,36885,1300,35585
5583,160000,128000,0,0,0,0,0,1,2,68554,3064,65490,2,66841,0,66841,2,74763,10000,64763,0,87692,15000,72692
5584,150000,120000,0,1,1,1,1,1,0,138887,3400,135487,0,144170,5883,138287,0,149970,5800,144170,0,145262,2905,142357
5585,70000,56000,0,0,0,0,0,0,2,12251,3000,9251,2,12358,600,11758,2,11865,0,11865,2,11975,450,11525
5586,20000,16000,0,1,1,1,1,0,0,17800,1630,16170,0,18699,1529,17170,0,17770,1200,16570,0,48321,2000,46321
5587,200000,160000,0,0,0,0,0,0,-2,1257,1257,0,-2,0,0,0,-2,0,0,0,-2,0,0,0
5588,140000,112000,0,0,0,0,0,0,0,92446,3814,88632,0,65774,2333,63441,0,65076,2340,62736,0,64295,2279,62016
5589,50000,40000,0,1,0,0,0,0,0,47397,2500,44897,0,40345,3017,37328,0,31003,1060,29943,0,29693,1300,28393
5590,180000,144000,0,1,1,1,1,0,0,156334,8000,148334,0,165696,13500,152196,0,165582,4110,161472,2,168952,6200,162752
5591,50000,40000,0,0,0,0,0,0,-2,0,0,0,-2,0,0,0,-2,0,0,0,-2,0,0,0
5592,20000,16000,0,1,1,1,1,0,0,18686,800,17886,2,18983,900,18083,2,18540,0,18540,2,19775,1700,18075
5593,120000,96000,0,0,0,0,0,0,0,24879,6000,18879,0,29479,5000,24479,0,27553,7553,20000,0,14587,14587,0
5594,390000,312000,0,0,0,0,0,0,0,29530,5000,24530,0,27620,5000,22620,0,32364,5000,27364,0,34041,5000,29041
5595,200000,160000,0,0,0,0,0,0,0,117802,5000,112802,0,116296,6000,110296,0,60792,3000,57792,0,30808,1611,29197
5596,50000,40000,0,0,0,0,0,0,0,6645,1246,5399,0,7009,1000,6009,0,6869,500,6369,0,7268,1000,6268
5597,140000,112000,0,0,0,0,0,1,0,97978,3539,94439,0,98857,3538,95319,0,101264,4000,97264,0,103524,4097,99427
5598,130000,104000,0,1,0,0,0,1,2,114344,17,114327,2,96995,4000,92995,0,100086,5000,95086,0,92344,4000,88344
5599,130000,104000,0,0,0,0,0,1,2,68392,0,68392,2,69435,2798,66637,0,67790,3500,64290,0,69248,2627,66621
5600,50000,40000,0,0,0,0,0,1,0,0,0,0,-2,0,0,0,-2,0,0,0,-2,0,0,0
5601,230000,184000,0,0,0,0,0,0,0,3239,3239,0,-1,3029,0,3029,2,3029,0,3029,0,800,0,800
5602,170000,136000,0,0,0,0,0,0,-2,-21,0,-21,-2,-21,0,-21,-2,-21,0,-21,-2,-21,0,-21
5603,260000,208000,0,0,0,0,0,0,-2,0,0,0,-2,0,0,0,-2,0,0,0,-2,0,0,0
5604,60000,48000,0,0,0,0,0,0,0,11068,1518,9550,0,6026,2043,3983,0,-28335,0,-28335,0,18660,47671,-29011
5605,700000,560000,0,0,0,0,0,0,-2,5810,7105,-1295,-2,7684,7721,-37,-2,168,168,0,-2,5836,5836,0
5606,240000,192000,0,0,0,0,0,0,0,29718,1683,28035,0,22828,1500,21328,0,19808,5000,14808,0,12606,2606,10000
5607,200000,160000,0,0,0,0,0,0,-2,0,0,0,-2,0,0,0,-2,0,0,0,-2,688,688,0
5608,170000,136000,0,0,0,0,0,0,0,119552,6000,113552,0,111404,6000,105404,0,113635,3854,109781,0,98411,5000,93411
5609,480000,384000,0,0,0,0,0,0,-1,9731,9731,0,-1,9272,9272,0,-1,2718,2718,0,-1,1498,1498,0
5610,30000,24000,0,1,0,1,0,1,2,31889,2326,29563,0,30278,11406,18872,0,26220,524,25696,0,29968,6284,23684
5611,30000,24000,0,0,0,0,0,0,-1,780,780,0,-1,780,0,780,0,0,0,0,0,0,0,0
5612,210000,168000,0,0,0,0,0,0,0,52148,10000,42148,0,50723,5012,45711,0,43200,1251,41949,0,17556,2007,15549
5613,310000,248000,0,0,0,0,0,0,0,170288,12398,157890,0,175252,7814,167438,0,177855,7000,170855,0,181846,7000,174846
5614,20000,16000,0,0,0,1,1,1,-2,431,431,0,-1,20786,20355,431,-1,20355,0,20355,2,18752,2732,16020
5615,100000,80000,0,0,0,0,0,0,2,77044,3475,73569,0,78333,3263,75070,0,78130,2805,75325,0,77761,2888,74873
5616,30000,24000,1,1,1,1,0,1,2,42397,1800,40597,0,38569,2200,36369,0,33570,1400,32170,0,19895,2000,17895
5617,360000,288000,0,0,0,0,0,0,-1,590,2,588,2,-9,0,-9,2,-9,0,-9,-2,-9,0,-9
5618,360000,288000,0,0,0,0,0,0,-2,0,0,0,-2,0,0,0,-2,0,0,0,-2,1131,1131,0
5619,20000,16000,0,0,0,0,0,0,0,8999,1200,7799,0,8810,1600,7210,0,10167,1500,8667,0,11710,1700,10010
5620,170000,136000,0,0,0,0,0,0,0,45529,2105,43424,0,42805,2447,40358,0,38017,1200,36817,0,39239,3000,36239
5621,30000,24000,0,1,1,1,0,0,2,28879,0,28879,2,30892,2500,28392,2,30500,0,30500,2,0,0,0
5622,360000,288000,0,1,1,1,1,0,0,364081,15861,348220,0,365927,13600,352327,0,363629,12057,351572,0,303097,9340,293757
5623,380000,304000,0,0,0,0,0,0,0,0,0,0,0,0,0,0,-2,0,0,0,-2,0,0,0
5624,200000,160000,0,0,0,0,0,0,0,47952,2100,45852,0,49052,2200,46852,0,49936,2000,47936,0,50977,2000,48977
5625,390000,312000,0,0,0,0,0,0,-1,53157,7183,45974,0,73183,66000,7183,0,69592,0,69592,0,24629,24629,0
5626,80000,64000,0,1,0,0,0,0,0,68255,2000,66255,2,55983,2,55981,2,59823,6278,53545,2,51519,0,51519
5627,210000,168000,0,0,0,0,0,0,0,2085,2085,0,-1,3000,3000,0,-1,6634,3634,3000,0,1298,1300,-2
5628,610000,488000,0,0,0,0,0,0,0,6245,1210,5035,0,7089,2000,5089,0,8059,2000,6059,0,8666,1666,7000
5629,20000,16000,0,0,0,0,0,1,-2,10887,11000,-113,-1,10413,0,10413,2,-245,0,-245,2,-245,0,-245
5630,50000,40000,0,0,0,0,0,1,2,29124,3500,25624,2,28357,0,28357,2,28984,1100,27884,0,30012,1500,28512
5631,50000,40000,0,0,0,0,0,0,0,18028,1711,16317,0,38126,20809,17317,0,18690,668,18022,0,19082,692,18390
5632,80000,64000,0,1,1,1,1,1,0,79080,3000,76080,0,77850,5390,72460,0,80330,4106,76224,0,80000,3000,77000
5633,150000,120000,0,0,0,0,0,0,0,29332,13003,16329,0,36796,15000,21796,0,19912,11000,8912,0,23126,10000,13126
5634,50000,40000,0,0,0,0,0,0,0,30260,8820,21440,0,19187,1293,17894,0,19324,820,18504,0,19192,700,18492
5635,230000,184000,0,0,0,0,0,0,0,149338,5500,143838,0,152555,5700,146855,0,155934,6000,149934,0,159332,6000,153332
5636,260000,208000,0,0,0,0,0,0,0,163036,0,163036,2,159348,5000,154348,0,160198,5000,155198,0,104389,6000,98389
5637,400000,320000,0,0,0,0,0,0,0,126819,3,126816,2,104430,3050,101380,0,104990,3000,101990,0,94058,3200,90858
5638,290000,232000,0,0,0,0,0,0,0,13505,13505,0,-1,13386,6000,7386,0,12536,5000,7536,0,5850,6000,-150
5639,60000,48000,0,0,0,0,0,0,0,25656,3008,22648,0,16907,3000,13907,0,15837,6000,9837,0,11195,2000,9195
5640,200000,160000,0,0,0,0,0,0,-1,344,0,344,3,344,0,344,2,0,0,0,2,0,0,0
5641,300000,240000,0,0,0,0,0,0,-1,338,338,0,-1,0,0,0,-1,0,0,0,-2,0,0,0
5642,30000,24000,0,0,1,1,1,1,2,26789,5000,21789,2,26065,0,26065,2,27408,2084,25324,2,26831,0,26831
5643,30000,24000,0,0,0,0,0,0,-1,0,0,0,-1,0,0,0,-2,0,0,0,-2,0,0,0
5644,80000,64000,0,0,0,0,0,0,0,22411,1679,20732,0,23624,1892,21732,0,23964,870,23094,0,25661,2096,23565
5645,230000,184000,0,0,0,0,0,0,-2,2371,2371,0,-2,4524,4524,0,-2,299,299,0,-2,395,395,0
5646,80000,64000,0,0,0,0,0,1,2,390,390,0,-1,390,390,0,-1,721,721,0,-1,331,0,331
5647,280000,224000,0,0,0,0,0,0,-1,0,0,0,-1,1265,1265,0,-1,1627,1638,-11,-1,204,204,0
5648,200000,160000,0,0,0,0,0,1,-1,19200,20891,-1691,-1,18856,7377,11479,0,14301,2000,12301,0,913,0,913
5649,30000,24000,0,0,0,0,0,0,0,13829,1518,12311,0,10898,1074,9824,0,9217,500,8717,0,9048,300,8748
5650,300000,240000,0,0,0,0,0,0,-1,4040,4040,0,-1,0,0,0,-1,1092,1092,0,-1,1681,1681,0
5651,60000,48000,0,0,0,0,0,0,0,32136,1881,30255,0,31204,1422,29782,0,30330,1021,29309,0,29934,1500,28434
5652,500000,400000,0,0,0,0,0,1,-2,0,0,0,-2,0,0,0,-2,0,0,0,-2,0,0,0
5653,140000,112000,0,0,0,0,0,0,0,101376,4412,96964,0,80840,3000,77840,0,75462,3000,72462,0,75957,3000,72957
5654,330000,264000,0,0,0,0,0,0,0,5731,2000,3731,0,5186,1222,3964,0,6522,2400,4122,0,8995,3000,5995
5655,300000,240000,0,0,0,0,0,0,-1,390,390,0,-1,374,374,0,-1,284,300,-16,-1,1064,1170,-106
5656,10000,8000,0,0,0,0,0,0,0,4158,1104,3054,0,4654,1000,3654,0,3080,31,3049,0,0,0,0
5657,320000,256000,0,0,0,0,0,0,-2,9422,9422,0,-2,0,0,0,-2,1200,1200,0,-2,1150,1150,0
5658,50000,40000,0,1,1,0,0,1,0,45452,2000,43452,0,45450,1500,43950,0,41154,2000,39154,0,39034,4000,35034
5659,30000,24000,0,1,1,1,1,1,2,26758,1751,25007,0,27462,1455,26007,0,28014,1007,27007,0,29826,2268,27558
5660,20000,16000,0,0,0,0,0,1,2,9885,0,9885,2,11398,2000,9398,0,12208,1000,11208,0,11869,0,11869
5661,140000,112000,0,0,0,0,0,0,0,52678,1913,50765,0,53753,1952,51801,0,54821,1963,52858,0,56145,2208,53937
5662,420000,336000,0,0,0,0,0,0,-1,1237,1237,0,-1,24712,24712,0,-1,11912,0,11912,0,12647,2647,10000
5663,260000,208000,0,0,0,0,0,0,0,46957,48058,-1101,-1,45114,46000,-886,-1,26114,26000,114,0,46750,48000,-1250
5664,50000,40000,0,0,0,0,0,0,0,31282,2000,29282,0,33350,2900,30450,0,32682,0,32682,2,33385,1400,31985
5665,10000,8000,0,0,1,1,1,0,0,8375,1350,7025,0,9268,1200,8068,0,10630,1500,9130,0,10188,0,10188
5666,140000,112000,0,1,1,1,1,0,0,143475,5000,138475,2,136331,0,136331,2,135778,5100,130678,0,135910,5000,130910
5667,260000,208000,0,0,0,0,0,0,-2,0,0,0,-2,0,0,0,-2,1980,1980,0,-1,2500,2500,0
5668,340000,272000,0,0,0,0,0,0,0,148694,6500,142194,0,150872,6000,144872,0,149218,6000,143218,0,152598,6000,146598
5669,360000,288000,0,0,0,0,0,0,2,-40,0,-40,-2,-40,0,-40,-2,-40,0,-40,-2,1153,1193,-40
5670,500000,400000,0,0,0,0,0,0,0,36861,36861,0,-1,23200,10000,13200,0,34255,20055,14200,0,18554,1000,17554
5671,50000,40000,0,0,0,0,0,1,0,29458,2857,26601,0,29737,1058,28679,2,29123,0,29123,2,29854,1216,28638
5672,80000,64000,0,0,0,0,0,1,2,43018,1300,41718,2,44013,2000,42013,2,45058,1900,43158,2,46068,1900,44168
5673,200000,160000,0,0,0,0,0,0,-1,6205,6225,-20,-1,37658,38150,-492,-1,696,2,694,0,1430,1434,-4
5674,30000,24000,1,1,1,1,1,1,2,35100,1500,33600,2,32859,0,32859,2,32041,1112,30929,0,31262,1175,30087
5675,330000,264000,0,0,0,0,0,0,0,135631,10600,125031,0,138036,5000,133036,0,141330,5000,136330,0,144529,5000,139529
5676,160000,128000,0,0,0,0,0,0,0,47690,2769,44921,0,48712,1791,46921,0,49525,1928,47597,0,50389,1960,48429
5677,70000,56000,0,0,0,0,0,0,0,50822,3012,47810,0,31179,5000,26179,0,28686,2000,26686,0,10806,3000,7806
5678,230000,184000,0,1,1,1,1,0,2,236702,10000,226702,2,236309,9000,227309,2,237399,9000,228399,2,229421,0,229421
5679,150000,120000,0,0,0,0,0,0,-1,3502,3526,-24,-1,8979,8998,-19,-1,5190,129,5061,0,0,0,0
5680,220000,176000,0,0,0,0,0,0,0,151098,7000,144098,0,153094,6000,147094,0,156295,6000,150295,0,151840,10000,141840
5681,70000,56000,0,1,0,0,1,0,0,66566,3002,63564,0,56942,2500,54442,0,58986,3000,55986,0,61031,3000,58031
5682,250000,200000,0,0,0,0,0,0,0,59328,3003,56325,0,57692,2800,54892,0,52811,1834,50977,0,49067,1850,47217
5683,60000,48000,0,1,1,1,1,0,0,59750,3000,56750,0,60602,2800,57802,0,53838,2100,51738,0,54609,2123,52486
5684,140000,112000,0,1,1,1,1,1,0,142802,5400,137402,0,140103,5100,135003,0,142750,5300,137450,0,142855,5500,137355
5685,20000,16000,0,0,0,0,1,0,-1,5346,0,5346,2,9984,5000,4984,0,19089,10089,9000,0,18356,0,18356
5686,30000,24000,0,0,0,0,0,0,0,25775,2000,23775,0,18585,2000,16585,0,0,0,0,0,0,0,0
5687,280000,224000,0,0,0,0,0,0,-2,3863,3863,0,-2,5740,5740,0,-2,0,0,0,-2,1170,1170,0
5688,320000,256000,0,0,0,0,0,0,-2,0,0,0,-2,0,0,0,-2,5210,5210,0,-2,0,0,0
5689,20000,16000,0,0,0,0,0,0,2,15498,535,14963,2,14952,0,14952,2,15983,1272,14711,2,15576,0,15576
5690,10000,8000,0,0,0,0,0,1,2,5640,2200,3440,2,5401,0,5401,2,6811,1500,5311,2,6567,0,6567
5691,20000,16000,0,0,0,0,0,0,-1,390,390,0,-1,390,390,0,-1,390,390,0,-1,0,0,0
5692,100000,80000,1,1,1,1,0,0,0,192080,3842,188238,0,196000,3920,192080,0,200000,4000,196000,0,0,0,0
5693,210000,168000,0,0,0,0,0,0,0,41616,21067,20549,0,34833,14492,20341,0,17628,17680,-52,-1,2400,2407,-7
5694,230000,184000,0,0,0,0,0,0,0,53470,1551,51919,0,137734,95022,42712,0,135386,3015,132371,0,14718,3003,11715
5695,30000,24000,0,0,0,0,0,1,2,13523,0,13523,2,14498,1200,13298,2,14123,0,14123,2,15184,1300,13884
5696,330000,264000,0,0,0,0,0,0,-1,780,780,0,-1,150,150,0,-1,320,320,0,-1,780,1000,-220
5697,130000,104000,0,0,0,0,0,0,-1,59904,59904,0,-1,81838,30000,51838,0,37422,10000,27422,0,15365,15365,0
5698,120000,96000,0,1,1,1,1,1,2,114496,1500,112996,2,120538,9975,110563,2,115975,0,115975,2,116937,8000,108937
5699,180000,144000,0,0,0,0,0,1,2,126899,5200,121699,2,127336,4000,123336,2,125273,1500,123773,2,134210,11000,123210
5700,50000,40000,0,0,0,0,0,0,0,23590,3000,20590,0,24896,2000,22896,2,24200,0,24200,2,26630,3000,23630
5701,460000,368000,0,0,0,0,0,0,-1,22551,10000,12551,-1,21851,0,21851,2,22214,10000,12214,0,80132,80132,0
5702,250000,200000,0,0,0,0,0,0,0,194659,7350,187309,0,196481,7231,189250,0,196256,6603,189653,0,195370,6797,188573
5703,200000,160000,0,0,0,0,0,0,0,3438,3438,0,-1,2102,50,2052,0,38,38,0,-1,0,0,0
5704,80000,64000,0,0,0,0,0,0,0,0,0,0,0,0,0,0,-2,0,0,0,-2,0,0,0
5705,70000,56000,0,0,0,0,0,0,0,50926,45000,5926,0,48588,3000,45588,0,49323,2000,47323,0,50685,2500,48185
5706,50000,40000,0,0,0,0,0,0,0,0,0,0,0,0,0,0,-2,0,0,0,-2,0,0,0
5707,150000,120000,0,0,0,0,1,0,-1,46824,2300,44524,0,-2176,2176,-4352,0,143824,146000,-2176,-2,151500,9500,142000
5708,50000,40000,0,0,0,0,0,0,-1,0,0,0,-2,6085,6085,0,-1,6085,0,6085,0,5605,0,5605
5709,50000,40000,0,0,0,0,0,0,0,6515,1012,5503,0,2315,46,2269,0,1817,36,1781,0,2081,2081,0
5710,400000,320000,0,1,1,1,1,1,6,389903,0,389903,5,384981,0,384981,4,381863,106,381757,3,359314,2281,357033
5711,80000,64000,0,1,0,0,0,0,0,67382,2100,65282,0,51958,2000,49958,0,55196,4000,51196,0,54235,0,54235
5712,500000,400000,0,0,0,0,0,0,0,323841,28000,295841,0,319331,15000,304331,0,316208,9494,306714,0,304388,108914,195474
5713,100000,80000,0,1,1,0,0,0,0,101827,4100,97727,0,100055,4510,95545,0,80923,3186,77737,0,81249,2886,78363
5714,20000,16000,0,0,0,0,0,1,2,9097,1200,7897,0,10935,2000,8935,0,10463,0,10463,2,11295,1000,10295
5715,160000,128000,0,0,0,0,0,0,-1,1172,1172,0,-1,380,380,0,-1,776,776,0,-1,1172,1172,0
5716,230000,184000,0,1,1,0,0,0,0,210778,10002,200776,0,211132,15037,196095,0,179564,6500,173064,0,176949,16002,160947
5717,50000,40000,0,0,0,0,0,1,0,15843,1400,14443,0,16825,2000,14825,0,14637,5000,9637,0,15397,1000,14397
5718,120000,96000,0,0,0,0,0,1,2,61849,8800,53049,0,57737,2700,55037,0,59174,3000,56174,0,60651,2600,58051
5719,50000,40000,0,0,0,0,0,0,-1,0,0,0,-2,0,0,0,-2,0,0,0,-2,0,0,0
5720,110000,88000,0,0,0,0,0,0,0,56676,6000,50676,0,47332,2000,45332,0,45171,2000,43171,0,47092,3000,44092
5721,20000,16000,0,1,1,1,1,0,2,19040,1594,17446,0,19446,1000,18446,0,20759,1606,19153,0,20241,0,20241
5722,150000,120000,0,0,0,0,0,0,-1,2365,2378,-13,-1,5004,5019,-15,-1,5531,5547,-16,-1,3567,3576,-9
5723,170000,136000,0,0,0,0,0,0,-1,1562,1562,0,-1,844,844,0,-1,484,0,484,0,0,0,0
5724,130000,104000,0,1,0,0,0,0,0,131524,5946,125578,0,46445,1620,44825,0,44973,1623,43350,0,45578,1659,43919
5725,450000,360000,0,0,0,0,0,1,-1,97,97,0,-1,1749,1749,0,-1,0,0,0,-1,0,0,0
5726,290000,232000,0,0,0,0,0,1,-2,0,0,0,-2,0,0,0,-2,0,0,0,-2,0,0,0
5727,290000,232000,0,0,0,0,0,0,0,197076,7000,190076,0,197488,8400,189088,0,196976,7000,189976,0,196579,7500,189079
5728,210000,168000,0,0,0,0,0,0,0,25064,20000,5064,0,30684,6071,24613,0,29892,0,29892,2,30516,1107,29409
5729,240000,192000,0,0,0,0,0,0,-1,10000,10000,0,-1,10200,10200,0,-1,30000,30000,0,-1,24000,4000,20000
5730,100000,80000,0,1,1,1,1,0,0,98893,3952,94941,0,101044,3611,97433,0,96045,3298,92747,0,97227,3401,93826
5731,60000,48000,0,1,0,0,0,1,0,53377,2000,51377,0,37418,1900,35518,0,37543,1500,36043,0,35447,1300,34147
5732,220000,176000,0,0,0,0,0,0,0,80361,4000,76361,0,82199,4000,78199,0,84782,4000,80782,0,87284,4000,83284
5733,20000,16000,0,1,1,0,0,0,0,19539,1380,18159,0,19396,1181,18215,0,11643,1000,10643,0,11578,500,11078
5734,30000,24000,0,1,1,1,1,1,0,28724,2169,26555,0,29357,1000,28357,0,30188,1200,28988,0,26316,2000,24316
5735,170000,136000,0,0,0,0,0,0,-1,316,316,0,-1,316,316,0,-1,316,316,0,-1,316,316,0
5736,180000,144000,0,0,0,0,0,0,0,47542,2000,45542,0,44952,1500,43452,0,24904,2000,22904,0,26825,3000,23825
5737,360000,288000,0,0,0,0,0,0,0,73406,3009,70397,0,74397,3509,70888,0,75467,3500,71967,0,79841,5000,74841
5738,440000,352000,0,0,0,0,0,1,2,812,1300,-488,-1,168,0,168,2,2653,2777,-124,-1,2203,0,2203
5739,120000,96000,0,0,0,0,0,0,0,73652,2816,70836,0,75482,3200,72282,0,76686,2911,73775,0,47781,1800,45981
5740,200000,160000,0,0,0,0,0,0,-1,5755,5860,-105,-1,2255,2282,-27,-1,8014,8042,-28,-1,3635,3640,-5
5741,20000,16000,0,1,1,1,1,0,2,18406,2000,16406,3,20795,3000,17795,3,20175,0,20175,5,21265,2000,19265
5742,20000,16000,0,0,0,0,0,0,0,11450,1193,10257,0,12257,1000,11257,0,12685,625,12060,0,13306,1000,12306
5743,120000,96000,0,0,0,0,0,1,0,19747,6400,13347,0,1201,1500,-299,-1,2333,2700,-367,-1,2250,0,2250
5744,420000,336000,0,0,0,0,0,1,2,57503,2000,55503,0,56467,1892,54575,0,53995,1979,52016,0,55304,2226,53078
5745,40000,32000,0,1,1,1,1,0,2,39475,2143,37332,0,39078,1606,37472,0,38339,1500,36839,0,38665,1410,37255
5746,200000,160000,0,0,0,0,0,1,-2,0,0,0,-2,0,0,0,-2,0,0,0,-2,0,0,0
5747,200000,160000,0,0,0,0,0,0,-1,3372,3380,-8,-1,1081,1085,-4,-1,2384,2394,-10,-1,6595,6601,-6
5748,30000,24000,0,0,1,1,1,0,-1,31840,33000,-1160,2,37075,5810,31265,2,37662,1325,36337,2,36904,0,36904
5749,190000,152000,0,0,0,0,0,0,0,104047,5009,99038,0,88269,5750,82519,0,90264,3500,86764,0,88823,3500,85323
5750,160000,128000,0,0,0,0,0,0,0,31818,5000,26818,0,34270,3000,31270,0,35698,2000,33698,0,37122,2000,35122
5751,10000,8000,0,1,1,1,0,0,0,9319,1218,8101,0,18202,1000,17202,0,9287,372,8915,0,0,0,0
5752,360000,288000,0,0,0,0,0,0,-1,1943,2000,-57,-1,2640,2700,-60,-1,1741,2000,-259,-1,4120,4120,0
5753,70000,56000,0,0,0,0,0,0,0,24348,1704,22644,0,24744,1100,23644,0,25195,1000,24195,0,25777,1000,24777
5754,30000,24000,0,0,0,0,0,0,0,18031,1200,16831,0,13127,263,12864,0,0,0,0,0,0,0,0
5755,180000,144000,0,0,0,0,0,0,-2,0,0,0,-2,1430,1430,0,-2,0,0,0,-2,0,0,0
5756,200000,160000,0,0,0,0,0,0,-2,0,0,0,-2,-5,0,-5,-2,-5,0,-5,-2,-5,0,-5
5757,410000,328000,0,0,0,0,0,1,-1,4120,4120,0,-1,4120,0,4120,0,0,0,0,0,3086,3086,0
5758,30000,24000,0,1,1,1,0,0,2,30082,1000,29082,2,28933,7,28926,2,25255,880,24375,0,25344,3028,22316
5759,390000,312000,0,0,0,0,0,0,0,59328,2506,56822,0,57852,3000,54852,0,55903,2500,53403,0,53516,2000,51516
5760,290000,232000,0,0,0,0,0,1,0,4029,1500,2529,0,5451,1500,3951,0,6357,1000,5357,0,7246,1000,6246
5761,50000,40000,0,0,0,0,0,0,0,26823,1500,25323,0,27454,1500,25954,0,27286,1000,26286,0,27858,956,26902
5762,360000,288000,0,0,0,0,0,1,-1,3762,3785,-23,-1,7483,7527,-44,-1,6399,6418,-19,-1,9145,9187,-42
5763,120000,96000,0,1,1,0,0,0,0,121004,6513,114491,0,118774,3740,115034,0,91369,3215,88154,0,88015,3300,84715
5764,370000,296000,0,0,0,0,0,1,0,307734,12015,295719,0,225974,7035,218939,0,231720,15037,216683,0,222733,7066,215667
5765,160000,128000,0,0,0,0,0,0,-1,4353,4353,0,-1,3746,3835,-89,-1,5487,6934,-1447,-1,2702,3370,-668
5766,20000,16000,0,1,1,0,1,0,0,19662,1300,18362,0,20001,600,19401,0,16448,600,15848,0,16774,600,16174
5767,230000,184000,0,0,0,0,0,0,0,145550,7000,138550,0,135626,5065,130561,0,103789,5000,98789,0,108348,10000,98348
5768,100000,80000,0,1,1,0,0,0,0,97647,5000,92647,0,91998,3500,88498,0,69915,3000,66915,0,72044,3000,69044
5769,50000,40000,0,1,0,1,0,0,0,44346,3000,41346,0,44098,5000,39098,0,48698,5000,43698,0,26955,5000,21955
5770,50000,40000,0,0,0,0,0,0,0,48600,21019,27581,0,7514,1500,6014,0,9336,3000,6336,0,-177,1210,-1387
5771,140000,112000,0,0,0,0,0,0,-1,0,0,0,-1,0,0,0,-2,0,0,0,-2,510,510,0
5772,20000,16000,0,0,1,1,1,0,2,18417,3000,15417,2,17802,0,17802,2,19543,2000,17543,2,18442,0,18442
5773,400000,320000,0,0,0,0,0,0,-2,7062,7135,-73,-2,8833,8891,-58,-2,7659,7704,-45,-2,5676,5728,-52
5774,60000,48000,0,0,0,0,0,0,-1,1013,1013,0,-1,5254,5254,0,-1,2932,2932,0,-1,2248,2248,0
5775,230000,184000,0,0,0,0,0,0,-1,0,0,0,-1,0,0,0,-2,0,0,0,-2,0,0,0
5776,30000,24000,0,0,0,0,0,0,-1,1871,1871,0,-1,337,337,0,-1,1846,1996,-150,-1,333,0,333
5777,360000,288000,0,0,0,0,0,0,-2,-68,0,-68,-2,-68,0,-68,-2,4132,4200,-68,-2,-2,48,-50
5778,110000,88000,0,1,1,1,1,0,0,105275,0,105275,2,107561,4000,103561,0,105502,3765,101737,0,103813,4000,99813
5779,310000,248000,0,0,0,0,0,0,0,96835,4252,92583,0,89223,5000,84223,0,80462,2780,77682,0,73899,4881,69018
5780,400000,320000,0,0,0,0,0,0,-1,120338,120407,-69,-1,8318,0,8318,0,8488,170,8318,0,130,130,0
5781,50000,40000,0,0,0,0,0,0,0,32088,2037,30051,0,20100,592,19508,0,15117,5003,10114,0,18501,5012,13489
5782,230000,184000,0,0,0,0,0,0,0,92396,5000,87396,0,84297,4000,80297,0,49681,2029,47652,0,46224,2000,44224
5783,270000,216000,0,0,0,0,0,0,2,164866,13900,150966,2,160821,0,160821,2,164010,5760,158250,0,167446,5967,161479
5784,420000,336000,0,0,0,0,0,0,-1,-2953,0,-2953,-2,-2953,0,-2953,-2,-2953,0,-2953,-2,-2953,0,-2953
5785,180000,144000,0,0,0,0,0,0,0,11153,11153,0,-1,3889,3924,-35,-1,800,800,0,-1,0,0,0
5786,190000,152000,0,0,0,0,0,0,-2,918,918,0,-2,859,864,-5,-2,1300,1300,0,-2,514,514,0
5787,200000,160000,0,0,0,0,0,1,2,56205,6000,50205,2,54723,0,54723,2,58657,5000,53657,0,59983,2286,57697
5788,290000,232000,0,0,0,0,0,1,-2,2369,2369,0,-2,1298,1298,0,-2,1298,1298,0,-2,1623,1623,0
5789,210000,168000,0,0,0,0,0,0,-2,971,972,-1,-2,0,0,0,-2,386,386,0,-2,0,0,0
5790,100000,80000,0,0,0,0,0,0,0,40870,2220,38650,0,10726,1400,9326,0,1121,1121,0,-1,61067,61067,0
5791,50000,40000,0,1,1,1,1,0,0,50955,3878,47077,0,49813,3000,46813,0,49290,2500,46790,0,50603,2000,48603
5792,280000,224000,0,1,1,0,0,0,0,261595,12500,249095,0,267359,13106,254253,0,236734,231064,5670,0,231064,15004,216060
5793,10000,8000,0,0,0,0,0,0,2,7183,0,7183,2,7814,1000,6814,0,7814,0,7814,0,7190,0,7190
5794,510000,408000,0,0,0,0,0,0,0,62320,3000,59320,0,61012,2400,58612,0,60519,2500,58019,0,58856,1800,57056
5795,20000,16000,0,1,1,0,0,0,2,18756,0,18756,2,19968,2403,17565,0,15333,0,15333,0,10056,6000,4056
5796,450000,360000,0,0,0,0,0,1,-1,2663,2663,0,-1,783,783,0,-1,1730,1730,0,-1,-51443,0,-51443
5797,90000,72000,0,0,0,0,0,0,2,45287,2055,43232,0,46332,2100,44232,0,49715,4476,45239,0,48788,0,48788
5798,170000,136000,0,0,0,0,0,0,-1,2863,2863,0,-1,0,0,0,-1,949,949,0,-1,0,0,0
5799,110000,88000,0,0,0,0,0,0,0,66495,2395,64100,0,67415,2397,65018,0,68538,2583,65955,0,78911,12000,66911
5800,110000,88000,0,0,0,0,0,0,0,43495,1667,41828,0,43504,1525,41979,0,45987,4000,41987,0,44274,0,44274
5801,170000,136000,0,0,0,0,0,0,-1,1,9,-8,-1,2739,3897,-1158,-1,1158,0,1158,0,685,685,0
5802,50000,40000,0,0,0,0,0,1,0,29003,1454,27549,0,28911,1019,27892,0,28601,1039,27562,0,29215,1091,28124
5803,80000,64000,0,1,1,0,0,0,2,79548,4500,75048,2,80280,3000,77280,2,53034,0,53034,2,54027,2000,52027
5804,30000,24000,0,0,0,0,0,0,0,17003,1300,15703,0,17420,700,16720,0,17790,650,17140,0,18993,1500,17493
5805,30000,24000,0,0,0,0,0,1,2,24034,1500,22534,0,21155,1150,20005,0,18413,900,17513,0,0,0,0
5806,50000,40000,0,0,0,0,0,0,0,19214,1211,18003,0,15519,516,15003,0,15129,520,14609,0,13747,622,13125
5807,260000,208000,0,0,0,0,0,0,-1,0,0,0,-1,0,0,0,-2,5055,5055,0,-1,5996,5996,0
5808,360000,288000,0,0,0,0,0,0,-2,70010,70010,0,-1,71610,2000,69610,0,73610,2000,71610,0,317,317,0
5809,50000,40000,0,0,0,0,0,0,0,40859,1500,39359,0,20706,1206,19500,0,-1166,0,-1166,0,19133,20689,-1556
5810,230000,184000,0,0,0,0,0,0,-1,2252,2266,-14,-1,4932,7338,-2406,-1,2783,2791,-8,-1,7411,7433,-22
5811,240000,192000,0,0,0,0,0,1,-1,2500,0,2500,2,2500,0,2500,2,2500,0,2500,2,0,0,0
5812,90000,72000,0,0,0,0,0,1,2,28015,3000,25015,2,28262,1000,27262,2,27509,0,27509,2,28082,1017,27065
5813,170000,136000,0,0,0,0,0,0,-2,826,826,0,-2,500,550,-50,-2,0,0,0,-2,487,487,0
5814,230000,184000,0,0,0,0,0,0,-1,0,0,0,-2,1100,1100,0,-1,0,0,0,-1,1383,1383,0
5815,160000,128000,0,0,0,0,0,0,-2,3454,3458,-4,-1,0,0,0,-1,3312,3312,0,-1,0,0,0
5816,190000,152000,0,0,0,0,0,0,0,36064,2000,34064,0,37160,2000,35160,0,38237,2000,36237,0,39464,2000,37464
5817,70000,56000,0,0,0,0,0,1,0,45674,3700,41974,0,44639,0,44639,2,47624,3707,43917,2,48592,1900,46692
5818,60000,48000,0,0,0,0,0,0,-1,2840,2840,0,-1,390,390,0,-1,390,390,0,-1,769,769,0
5819,140000,112000,0,0,0,0,0,0,-2,-176,0,-176,-2,-176,0,-176,-2,-176,0,-176,-2,-176,0,-176
5820,100000,80000,0,0,0,0,0,0,0,36218,2625,33593,0,38044,2451,35593,0,37222,890,36332,0,37740,1056,36684
5821,260000,208000,0,0,0,0,0,0,0,-83,0,-83,-2,458,541,-83,-1,-7941,4538,-12479,-1,156600,166000,-9400
5822,480000,384000,0,0,0,0,0,0,-2,38929,39149,-220,-2,339176,344261,-5085,-2,33146,33312,-166,-2,37337,37511,-174
5823,170000,136000,0,0,0,0,0,0,0,34570,2006,32564,0,33153,1000,32153,0,24969,1000,23969,0,22893,1000,21893
5824,50000,40000,0,0,0,0,0,0,0,5921,1000,4921,0,6042,121,5921,0,4012,0,4012,0,0,0,0
5825,300000,240000,0,0,0,0,0,0,-1,0,0,0,-1,0,0,0,-2,706,706,0,-1,0,0,0
5826,130000,104000,0,0,0,0,0,0,-1,5890,5890,0,-1,1113,1113,0,-1,1283,1283,0,-1,3000,3000,0
5827,50000,40000,0,1,1,0,0,0,0,46538,2106,44432,0,45465,2048,43417,0,18654,783,17871,0,19042,806,18236
5828,50000,40000,0,0,0,0,0,0,2,3106,2000,1106,0,2721,5,2716,0,780,0,780,0,0,0,0
5829,80000,64000,0,0,0,0,0,1,2,43671,0,43671,2,49683,6768,42915,2,48757,0,48757,2,49782,1834,47948
5830,170000,136000,0,0,0,1,0,1,2,129761,0,129761,2,138604,11000,127604,2,136283,0,136283,2,145012,11000,134012
5831,360000,288000,0,0,0,0,0,0,-2,2668,3000,-332,-2,-7,7,-14,-2,-7,0,-7,-2,3500,3507,-7
5832,120000,96000,0,0,0,0,0,1,2,39211,0,39211,2,39917,1500,38417,0,42268,3000,39268,0,43192,1600,41592
5833,10000,8000,0,0,0,0,0,0,0,381,381,0,-1,390,399,-9,-1,0,0,0,-1,780,780,0
5834,460000,368000,0,0,0,0,0,0,0,5115,6000,-885,-1,5714,5714,0,-1,1530,1530,0,-1,1868,1868,0
5835,20000,16000,0,0,0,0,0,1,0,7143,1200,5943,0,6044,1004,5040,0,780,780,0,-1,116,116,0
5836,200000,160000,0,0,0,0,0,0,-2,0,0,0,-2,0,0,0,-2,0,0,0,-2,0,0,0
5837,200000,160000,0,0,0,0,0,0,-1,13918,13918,0,-1,22836,12836,10000,0,20105,8000,12105,0,4415,1000,3415
5838,210000,168000,0,0,0,0,0,0,-2,-18,0,-18,-2,-18,0,-18,-2,-18,0,-18,-2,-18,0,-18
5839,230000,184000,0,0,0,0,0,0,0,178409,5500,172909,0,175091,5125,169966,0,171800,5031,166769,0,168476,4969,163507
5840,280000,224000,0,0,0,0,0,0,0,130286,10282,120004,0,130705,3006,127699,0,132964,2659,130305,0,136400,3436,132964
5841,200000,160000,0,1,1,1,1,0,0,191673,7019,184654,0,192051,7000,185051,0,193348,7200,186148,0,193337,7200,186137
5842,30000,24000,0,1,1,1,1,0,0,31071,3300,27771,0,30248,0,30248,2,30354,1500,28854,0,29088,1500,27588
5843,50000,40000,0,1,0,0,0,0,0,49520,2210,47310,0,18990,680,18310,0,19539,855,18684,0,19791,726,19065
5844,350000,280000,0,1,0,0,0,1,0,299797,11000,288797,0,218973,8232,210741,0,146326,7000,139326,0,107205,6000,101205
5845,240000,192000,0,0,0,0,0,0,0,101542,4707,96835,0,30284,1862,28422,0,168674,140061,28613,0,171825,5262,166563
5846,60000,48000,0,1,1,1,1,0,0,58311,3000,55311,0,58828,2500,56328,0,58945,2100,56845,0,57918,4000,53918
5847,80000,64000,0,0,0,0,0,0,1,10000,10000,0,-1,18150,18150,0,-1,7490,7490,0,-1,7490,7490,0
5848,290000,232000,0,0,0,0,0,0,2,76983,12000,64983,2,74891,0,74891,2,78100,5000,73100,0,83325,6000,77325
5849,20000,16000,0,0,0,1,1,1,0,15967,4500,11467,0,17576,2187,15389,0,16996,0,16996,2,18223,1500,16723
5850,360000,288000,0,0,0,0,0,1,-2,0,0,0,-2,0,0,0,-2,0,0,0,-2,0,0,0
5851,180000,144000,0,0,0,0,0,0,-2,2860,2860,0,-2,4216,4216,0,-2,2609,2609,0,-2,9609,9700,-91
5852,160000,128000,0,0,0,0,0,0,0,115874,5014,110860,0,111346,4500,106846,0,111553,11781,99772,0,108434,0,108434
5853,120000,96000,0,0,0,0,0,1,2,0,0,0,-2,0,0,0,-2,0,0,0,-2,0,0,0
5854,100000,80000,0,0,0,0,0,0,0,48443,3000,45443,0,50352,3000,47352,0,51399,3000,48399,0,53078,3000,50078
5855,50000,40000,0,1,0,0,0,1,0,49099,1300,47799,0,19125,669,18456,0,18504,671,17833,0,19197,1000,18197
5856,150000,120000,0,0,0,0,0,0,2,12022,1000,11022,2,12524,1000,11524,0,13868,1700,12168,0,13502,0,13502
5857,10000,8000,0,1,1,1,1,1,-1,9307,0,9307,2,9665,500,9165,0,10470,1100,9370,0,10169,0,10169
5858,50000,40000,0,0,0,0,0,1,-1,9673,4000,5673,-1,7755,8,7747,2,6701,3000,3701,2,15567,19000,-3433
5859,30000,24000,0,1,1,0,0,0,0,29400,1000,28400,0,30000,600,29400,0,0,0,0,0,0,0,0
5860,350000,280000,0,0,0,0,0,0,-1,8686,8722,-36,-1,3061,72,2989,0,396,0,396,0,391,391,0
5861,100000,80000,0,1,1,0,0,0,0,99226,6000,93226,0,99838,4000,95838,0,21435,5000,16435,0,0,0,0
5862,300000,240000,0,1,0,0,0,0,0,261216,20035,241181,0,156521,6610,149911,0,120769,20000,100769,0,110093,4000,106093
5863,50000,40000,0,0,0,0,0,1,0,37502,3455,34047,0,34653,1007,33646,2,31352,8,31344,2,29605,2002,27603
5864,120000,96000,0,0,0,0,0,0,-2,0,0,0,-2,222,222,0,-1,836,836,0,-1,1259,1259,0
5865,20000,16000,0,0,0,0,0,0,-1,789,789,0,-1,0,0,0,-1,728,728,0,-1,169,169,0
5866,160000,128000,0,0,0,0,0,0,0,0,0,0,-2,0,0,0,-2,0,0,0,-2,0,0,0
5867,150000,120000,0,0,0,0,0,0,0,9124,1300,7824,0,9356,1000,8356,0,8572,1572,7000,0,9541,1000,8541
5868,400000,320000,0,0,0,0,0,0,-2,9322,9368,-46,-2,15693,15771,-78,-2,5588,5616,-28,-2,10161,10173,-12
5869,50000,40000,0,0,0,0,0,0,-1,812,500,312,2,4012,4100,-88,-1,28672,28800,-128,-1,28875,1011,27864
5870,360000,288000,0,0,0,0,0,0,-1,6672,6712,-40,-1,11201,11244,-43,-1,9718,9747,-29,-1,8781,8806,-25
5871,210000,168000,0,0,0,0,0,0,-1,2776,2776,0,-1,526,526,0,-1,4880,4880,0,-1,1315,0,1315
5872,500000,400000,0,0,0,0,0,0,-1,41027,41027,0,-1,36073,36073,0,-1,46096,46096,0,-1,103065,103065,0
5873,80000,64000,0,1,1,0,0,1,0,78520,3000,75520,0,69750,3000,66750,0,48707,3600,45107,0,47418,0,47418
5874,150000,120000,0,0,0,0,0,0,-1,240,240,0,-1,683,683,0,-1,3486,3486,0,-1,5390,5390,0
5875,120000,96000,0,0,0,0,0,1,3,44872,3400,41472,2,45636,1800,43836,2,46388,1800,44588,2,47398,1900,45498
5876,300000,240000,0,0,0,0,0,0,0,13408,2000,11408,0,12714,1452,11262,0,12437,1000,11437,0,11166,649,10517
5877,600000,480000,0,0,0,0,0,0,2,39635,4000,35635,2,35130,0,35130,2,33229,1500,31729,0,32171,2000,30171
5878,200000,160000,0,0,0,0,0,1,-1,316,316,0,-1,316,316,0,-1,316,316,0,-1,316,316,0
5879,180000,144000,0,0,0,0,0,0,0,0,0,0,0,0,0,0,-2,36565,36565,0,-1,37353,1548,35805
5880,50000,40000,0,1,1,1,1,0,2,49914,2200,47714,2,48382,0,48382,2,50693,3800,46893,2,50364,1000,49364
5881,90000,72000,0,0,0,0,0,0,0,36858,2000,34858,0,35447,2000,33447,0,33465,1400,32065,0,31680,1400,30280
5882,170000,136000,0,1,1,1,1,1,0,173490,7666,165824,2,165645,0,165645,2,165605,7792,157813,0,163432,6248,157184
5883,300000,240000,0,0,0,0,0,0,0,34979,2600,32379,0,510,510,0,-1,2166,903,1263,-1,765,765,0
5884,60000,48000,0,0,0,0,0,0,0,22685,2000,20685,0,24938,2950,21988,0,25085,926,24159,0,28862,4600,24262
5885,50000,40000,0,0,0,0,0,0,0,23986,2079,21907,0,-17250,2177,-19427,0,20129,41608,-21479,-1,20502,713,19789
5886,230000,184000,0,0,0,0,0,0,0,134272,5007,129265,0,136281,5000,131281,0,138687,5008,133679,0,118873,5000,113873
5887,20000,16000,0,0,0,0,0,0,-1,3274,3282,-8,-1,7028,7055,-27,-1,1839,1839,0,-1,2985,2985,0
5888,10000,8000,0,0,0,0,0,1,-1,654,700,-46,-1,5954,5954,0,-1,0,0,0,-1,1308,1308,0
5889,110000,88000,0,0,0,0,0,0,2,6242,0,6242,2,6712,1000,5712,2,871,0,871,2,16391,16391,0
5890,270000,216000,0,0,0,0,0,0,0,25617,1423,24194,0,25434,910,24524,0,25966,942,25024,0,26486,951,25535
5891,50000,40000,0,0,0,0,0,0,0,12969,1000,11969,2,13758,1000,12758,0,14390,1000,13390,0,16571,3000,13571
5892,50000,40000,0,0,0,0,0,1,3,27529,1000,26529,2,28280,1500,26780,2,27691,0,27691,2,28278,1200,27078
5893,20000,16000,0,0,0,0,0,1,2,322,0,322,2,322,0,322,2,322,0,322,2,322,0,322
5894,180000,144000,0,0,0,0,0,0,-1,6709,6709,0,-1,6366,0,6366,2,1950,1950,0,-1,1931,1931,0
5895,160000,128000,0,1,1,1,1,0,2,147184,0,147184,2,149053,5790,143263,0,136809,4825,131984,0,140678,6000,134678
5896,90000,72000,0,0,0,0,0,1,0,61640,3043,58597,0,62793,3000,59793,0,63493,2300,61193,0,67204,4506,62698
5897,90000,72000,0,0,0,0,0,0,-1,5740,5743,-3,-1,27384,27391,-7,-1,3665,3667,-2,-1,26721,26724,-3
5898,150000,120000,0,0,0,0,0,0,-1,-4,0,-4,-2,6340,6344,-4,-1,4998,4998,0,-1,5710,5712,-2
5899,80000,64000,0,0,0,0,0,0,0,47655,4300,43355,0,43182,2000,41182,0,44332,2000,42332,0,45440,2000,43440
5900,50000,40000,0,0,0,0,0,1,2,760,760,0,-1,1360,600,760,-1,518,0,518,2,3518,3000,518
5901,330000,264000,0,0,0,0,0,0,-2,1803,1894,-91,-2,909,911,-2,-2,3854,3865,-11,-2,1509,1513,-4
5902,20000,16000,0,0,0,0,0,0,-1,390,390,0,-1,390,390,0,-1,780,780,0,-1,780,0,780
5903,50000,40000,0,0,0,0,0,0,0,23425,23425,0,-1,19040,1500,17540,0,19624,900,18724,0,20152,993,19159
5904,200000,160000,0,1,0,1,0,0,0,169860,6112,163748,0,165713,6000,159713,0,168199,6000,162199,0,160769,5838,154931
5905,520000,416000,0,0,0,0,0,1,0,413019,18300,394719,0,168770,26500,142270,0,168964,30000,138964,0,191188,27000,164188
5906,70000,56000,0,1,0,0,0,0,2,64182,1809,62373,0,30351,2500,27851,0,29826,0,29826,2,29699,2000,27699
5907,500000,400000,0,0,0,0,0,0,0,-3634,3634,-7268,-2,-3634,0,-3634,-2,-3634,1907,-5541,-2,-3634,0,-3634
5908,20000,16000,0,0,0,0,0,0,0,798,798,0,-1,798,798,0,-1,798,798,0,-1,408,408,0
5909,390000,312000,0,0,0,0,0,0,-1,0,0,0,-2,2582,2582,0,-1,128,128,0,-1,6273,6273,0
5910,170000,136000,0,0,0,0,0,1,2,1399,1399,0,-1,6548,6548,0,-1,1399,0,1399,0,0,0,0
5911,200000,160000,0,0,0,0,0,0,2,137983,4075,133908,0,82191,3000,79191,0,83964,3100,80864,0,86067,4400,81667
5912,220000,176000,0,0,0,0,0,0,0,47679,3021,44658,0,37788,1400,36388,0,23293,3000,20293,0,7288,2000,5288
5913,90000,72000,0,1,1,0,0,1,2,91898,4000,87898,2,91334,2090,89244,2,59253,0,59253,2,58519,2078,56441
5914,30000,24000,0,1,1,1,1,0,0,28201,0,28201,2,28763,994,27769,0,29383,1047,28336,0,28987,1412,27575
5915,150000,120000,0,0,0,0,0,1,0,73822,3114,70708,0,35706,2000,33706,0,28178,2000,26178,0,20782,2000,18782
5916,40000,32000,0,1,0,0,0,1,2,36757,3078,33679,0,20650,21650,-1000,-1,0,0,0,-1,0,0,0
5917,120000,96000,0,0,0,0,0,1,0,55282,4000,51282,0,56878,3500,53378,0,57948,2500,55448,0,59179,2200,56979
5918,390000,312000,0,0,0,0,0,0,-1,197534,185059,12475,0,179690,9137,170553,0,170173,6513,163660,0,164339,5058,159281
5919,230000,184000,0,0,0,0,0,0,-1,19690,19878,-188,-1,25681,25681,0,-1,0,0,0,-1,0,0,0
5920,150000,120000,0,0,0,0,0,0,0,45132,2500,42632,0,39180,3300,35880,0,31422,2150,29272,0,32410,1500,30910
5921,50000,40000,0,1,1,0,1,0,0,43122,2056,41066,0,43803,1737,42066,0,41425,1501,39924,0,42536,1797,40739
5922,50000,40000,0,0,0,0,0,1,2,39441,0,39441,2,41318,3003,38315,2,13996,0,13996,2,14974,1206,13768
5923,50000,40000,0,0,0,0,0,0,-1,1226,1226,0,-1,1226,1226,0,-1,1765,1765,0,-1,1066,1066,0
5924,260000,208000,0,0,0,0,0,0,-1,189,189,0,-1,192,192,0,-1,188,188,0,-1,0,0,0
5925,240000,192000,0,0,0,0,0,0,-1,3513,3513,0,-2,11380,11794,-414,-1,1777,1785,-8,-1,190,190,0
5926,180000,144000,0,0,0,0,0,0,-2,0,0,0,-2,5436,5436,0,-2,100,100,0,-2,9330,9330,0
5927,60000,48000,0,0,0,0,0,0,2,8104,1131,6973,2,7825,0,7825,2,8580,886,7694,2,8300,0,8300
5928,250000,200000,0,0,0,0,0,0,-1,-38,0,-38,-1,-38,0,-38,-2,7581,7619,-38,-1,5625,5653,-28
5929,140000,112000,0,0,0,0,1,1,0,101863,4000,97863,0,105575,5445,100130,0,122173,20000,102173,0,116266,0,116266
5930,180000,144000,0,0,0,0,0,1,-2,9333,9333,0,-2,26656,26656,0,-2,274,274,0,-2,1624,1624,0
5931,20000,16000,0,0,0,0,0,0,0,9574,4574,5000,0,12101,5101,7000,0,17128,5128,12000,0,13395,3395,10000
5932,10000,8000,0,0,0,0,0,0,-1,9436,9436,0,-1,8057,1000,7057,0,8891,1500,7391,0,-873,0,-873
5933,260000,208000,0,0,0,0,0,0,0,2740,2740,0,-1,107139,107139,0,-1,105188,4000,101188,0,104418,4000,100418
5934,320000,256000,0,0,0,0,0,1,-1,0,0,0,-2,0,0,0,-2,0,0,0,-2,13439,13439,0
5935,440000,352000,0,0,0,0,0,0,-2,0,0,0,-2,0,0,0,-2,0,0,0,-2,100,100,0
5936,460000,368000,0,0,0,0,0,0,-2,7398,7409,-11,-2,6143,12286,-6143,-2,9634,9634,0,-2,9581,9581,0
5937,20000,16000,0,1,1,0,0,0,3,17105,0,17105,2,18335,2001,16334,0,10415,3000,7415,0,8526,3000,5526
5938,500000,400000,0,0,0,0,0,1,-1,3373,3527,-154,-1,14071,14133,-62,-1,2915,2928,-13,-1,157,2,155
5939,280000,224000,0,0,0,0,0,0,-1,4641,0,4641,2,9976,9976,0,-1,17976,8000,9976,0,9477,9525,-48
5940,460000,368000,0,0,0,0,0,0,0,273414,10084,263330,0,250033,9025,241008,0,238734,9036,229698,0,226905,8526,218379
5941,500000,400000,0,0,0,0,0,0,-1,967,972,-5,-1,16638,16671,-33,-1,15721,5749,9972,0,17349,7376,9973
5942,300000,240000,0,0,0,0,0,1,-1,2960,2964,-4,-1,579,579,0,-1,0,0,0,-1,0,0,0
5943,150000,120000,0,0,0,0,0,0,-1,-5132,3038,-8170,-1,20710,42429,-21719,-1,0,0,0,-1,0,0,0
5944,80000,64000,0,0,0,0,0,0,-2,0,0,0,-2,0,0,0,-2,0,0,0,-2,390,390,0
5945,250000,200000,0,0,0,0,0,0,-1,1054,1057,-3,-1,1708,1708,0,-1,3014,3014,0,-1,3037,3037,0
5946,100000,80000,0,0,0,0,0,1,2,17629,0,17629,2,18036,700,17336,0,18446,700,17746,0,18840,700,18140
5947,150000,120000,0,0,0,0,0,0,-1,5901,5901,0,-1,671,671,0,-1,37082,37082,0,-1,34725,5000,29725
5948,110000,88000,0,0,0,0,0,0,0,84485,4015,80470,0,81057,4012,77045,0,43113,3000,40113,0,40805,2164,38641
5949,80000,64000,0,0,0,0,0,0,0,50845,2548,48297,0,36207,2500,33707,0,32515,1100,31415,0,15128,1000,14128
5950,90000,72000,0,1,1,0,0,1,0,87036,3700,83336,0,88742,3374,85368,0,49148,1543,47605,0,48396,1405,46991
5951,80000,64000,0,0,0,0,0,0,0,26128,15,26113,2,29137,5003,24134,0,30283,3003,27280,0,30523,2007,28516
5952,160000,128000,0,0,0,0,0,0,-2,796,796,0,-2,5740,5768,-28,-2,0,0,0,-2,447,447,0
5953,120000,96000,0,0,0,0,0,1,0,10687,1400,9287,2,11905,1700,10205,2,11420,0,11420,2,12081,1000,11081
5954,100000,80000,0,0,0,0,0,0,0,58161,2116,56045,0,41414,1400,40014,0,28835,1165,27670,0,29423,588,28835
5955,50000,40000,0,0,0,0,0,0,0,5008,1091,3917,0,5627,1100,4527,0,6159,1000,5159,0,6677,1000,5677
5956,200000,160000,0,0,0,0,0,0,-1,7843,7852,-9,-1,6335,6336,-1,-1,4616,4622,-6,-1,7956,7956,0
5957,420000,336000,0,0,0,0,0,0,0,304702,12000,292702,0,311889,13302,298587,0,182087,7002,175085,0,185152,6500,178652
5958,30000,24000,0,1,1,0,0,0,0,27097,2000,25097,0,27930,1700,26230,0,16288,1000,15288,0,17023,1000,16023
5959,80000,64000,0,0,0,0,0,0,0,22243,5091,17152,0,8524,3528,4996,0,819,0,819,0,-181,0,-181
5960,30000,24000,1,1,0,1,1,1,2,58384,2000,56384,0,29553,30000,-447,-1,29933,1000,28933,2,30000,1000,29000
5961,190000,152000,0,0,0,0,0,1,0,4085,1004,3081,0,4742,1500,3242,0,5875,1500,4375,0,7037,1267,5770
5962,50000,40000,0,0,0,0,0,0,2,5570,1200,4370,0,6676,1308,5368,0,5235,0,5235,2,3728,500,3228
5963,150000,120000,0,0,0,0,0,0,0,74494,10000,64494,0,74204,2554,71650,0,75678,2566,73112,0,74235,2600,71635
5964,80000,64000,0,0,0,0,0,1,2,1200,0,1200,5,1200,0,1200,5,600,0,600,4,300,0,300
5965,500000,400000,0,0,0,0,0,0,-1,122750,123000,-250,-1,4599,10052,-5453,-1,10094,10105,-11,-1,43150,43168,-18
5966,50000,40000,0,1,1,1,1,0,0,43751,1729,42022,0,44619,1597,43022,0,45900,2000,43900,0,46845,1709,45136
5967,20000,16000,0,0,0,0,0,0,-2,790,790,0,-2,1590,1590,0,-2,2359,2359,0,-2,2780,2780,0
5968,200000,160000,0,0,0,0,0,0,-2,0,0,0,-2,0,0,0,-2,0,0,0,-2,35979,35979,0
5969,60000,48000,0,1,0,0,0,0,0,59388,3000,56388,0,29941,3000,26941,0,1341,1000,341,0,1876,2000,-124
5970,260000,208000,0,0,0,0,0,1,2,0,0,0,2,0,0,0,-2,5987,5987,0,-1,5837,0,5837
5971,160000,128000,0,0,0,0,0,0,-1,0,0,0,-2,0,0,0,-2,0,0,0,-2,0,0,0
5972,140000,112000,0,0,0,0,0,0,-1,13524,13566,-42,-1,94419,94422,-3,-1,93295,3100,90195,0,94599,3600,90999
5973,150000,120000,0,0,0,0,0,0,0,17563,2000,15563,0,10122,2000,8122,0,11622,1500,10122,0,8622,1000,7622
5974,180000,144000,0,0,0,0,0,0,0,999,1003,-4,0,495,496,-1,-2,1776,1781,-5,-2,79785,81032,-1247
5975,50000,40000,0,0,0,0,0,0,-2,0,0,0,-2,0,0,0,-2,0,0,0,-2,0,0,0
5976,350000,280000,0,0,0,0,0,0,0,31802,6000,25802,0,30895,0,30895,2,27158,1000,26158,0,27927,1000,26927
5977,50000,40000,0,1,1,0,0,0,0,49773,2208,47565,0,48398,1513,46885,0,32584,1149,31435,0,33322,1245,32077
5978,310000,248000,0,0,0,0,0,0,0,96218,4370,91848,0,97722,4000,93722,0,101082,5000,96082,0,103202,3899,99303
5979,30000,24000,0,1,1,1,1,0,0,26784,0,26784,3,28123,2100,26023,2,27994,1000,26994,2,27029,0,27029
5980,60000,48000,0,0,0,0,0,1,2,10957,0,10957,2,11480,1000,10480,2,10851,0,10851,2,11365,1000,10365
5981,100000,80000,0,0,0,0,0,0,-2,-7292,0,-7292,-2,-10938,0,-10938,-2,5887,16825,-10938,-1,3882,0,3882
5982,360000,288000,0,0,0,0,0,1,-2,0,0,0,-2,0,0,0,-2,0,0,0,-2,0,0,0
5983,150000,120000,0,0,0,0,0,0,0,44309,1200,43109,0,27428,2618,24810,0,2013,2013,0,-1,4724,4724,0
5984,200000,160000,0,0,0,0,0,1,0,174501,15000,159501,0,155355,0,155355,2,129942,10000,119942,2,118202,0,118202
5985,150000,120000,0,0,0,0,0,0,-1,65063,30000,35063,0,69046,10000,59046,0,60619,10030,50589,0,61096,5000,56096
5986,180000,144000,0,0,0,0,0,0,0,87773,3201,84572,0,89547,3200,86347,0,91639,3500,88139,0,93991,4000,89991
5987,180000,144000,0,0,0,0,0,0,-1,148,148,0,-1,296,296,0,-1,148,0,148,0,148,148,0
5988,230000,184000,0,0,0,0,0,0,0,36652,4767,31885,0,38421,3000,35421,0,37459,3092,34367,0,54778,17411,37367
5989,240000,192000,0,0,0,0,0,0,-2,0,0,0,-2,0,0,0,-2,0,0,0,-2,0,0,0
5990,50000,40000,0,0,0,0,0,0,0,32777,1500,31277,0,32081,1226,30855,0,29598,1059,28539,0,29648,2000,27648
5991,230000,184000,0,0,0,0,0,0,0,184466,10135,174331,0,157857,6034,151823,0,131706,10000,121706,0,62237,3000,59237
5992,180000,144000,0,0,0,0,0,0,-2,2115,4444,-2329,-1,2329,214,2115,0,850,0,850,0,0,0,0
5993,60000,48000,0,0,0,0,0,0,2,38067,1632,36435,0,38823,1388,37435,0,39638,1439,38199,0,40424,1445,38979
5994,90000,72000,0,1,1,1,1,0,2,90311,4100,86211,2,91431,3500,87931,2,92840,3800,89040,2,91205,0,91205
5995,240000,192000,0,0,0,0,0,0,-2,0,0,0,-2,0,0,0,-2,0,0,0,-2,0,0,0
5996,380000,304000,0,0,0,0,0,0,0,175028,10000,165028,0,162699,5849,156850,0,138158,4570,133588,0,135920,5447,130473
5997,60000,48000,0,1,1,0,0,0,0,59503,2267,57236,0,49305,1000,48305,0,28903,1100,27803,0,28577,1300,27277
5998,100000,80000,0,0,0,0,0,0,0,30900,1900,29000,0,0,0,0,0,0,0,0,-2,0,0,0
5999,350000,280000,0,0,0,0,0,0,-1,3301,3306,-5,-1,4301,4301,0,-1,15,15,0,-1,684,684,0
6000,50000,40000,0,1,0,0,0,0,0,48416,2000,46416,0,20098,702,19396,0,20130,718,19412,0,20158,730,19428
6001,680000,544000,0,0,0,0,0,0,0,190076,9000,181076,0,181957,7000,174957,0,182226,7000,175226,0,177731,7000,170731
6002,330000,264000,0,0,0,0,0,0,-1,125755,125755,0,-1,128671,5000,123671,0,132598,6000,126598,0,136229,6000,130229
6003,40000,32000,1,1,1,1,1,1,2,53415,0,53415,3,51259,2000,49259,2,47151,0,47151,2,46934,3520,43414
6004,290000,232000,0,1,0,0,0,0,0,246740,10126,236614,0,224260,7095,217165,0,233251,30227,203024,0,226100,40213,185887
6005,120000,96000,0,0,0,0,0,0,0,13325,1265,12060,0,14185,1125,13060,0,13329,1329,12000,0,10237,500,9737
6006,30000,24000,0,0,0,0,0,0,-1,0,0,0,-1,0,8000,-8000,-2,0,0,0,-2,0,0,0
6007,180000,144000,0,0,0,0,0,0,-1,26680,26703,-23,-1,27988,27988,0,-1,1480,1480,0,-1,22133,22133,0
6008,60000,48000,0,1,0,0,0,0,0,53054,2600,50454,0,47933,2000,45933,0,29254,1200,28054,0,29981,1200,28781
6009,130000,104000,0,0,0,0,0,0,0,63163,3174,59989,0,386,386,0,-1,1770,1778,-8,-1,384,384,0
6010,210000,168000,0,0,0,0,0,0,-2,0,0,0,-2,0,0,0,-2,0,0,0,-2,0,0,0
6011,400000,320000,0,0,0,0,0,0,-1,11340,11340,0,-1,10390,10390,0,-1,620,620,0,-1,10390,10390,0
6012,120000,96000,0,0,0,0,0,0,-2,0,0,0,-2,7000,7000,0,-2,0,0,0,-2,0,0,0
6013,20000,16000,0,0,0,0,0,1,2,14459,2955,11504,2,14498,597,13901,2,14029,0,14029,2,15179,1473,13706
6014,460000,368000,0,0,0,0,0,0,-1,531,531,0,-1,522,500,22,0,4434,4434,0,-1,9767,9767,0
6015,120000,96000,0,0,0,0,0,1,2,74675,0,74675,2,79629,6200,73429,2,77748,0,77748,2,82497,6000,76497
6016,200000,160000,0,0,0,0,0,0,-2,0,0,0,-2,0,0,0,-2,0,0,0,-2,0,0,0
6017,20000,16000,0,0,0,0,0,1,2,12459,200,12259,2,12957,1000,11957,2,13104,500,12604,2,12744,0,12744
6018,250000,200000,0,0,0,0,0,0,0,24063,2000,22063,0,24886,1500,23386,0,26446,2000,24446,0,20301,2000,18301
6019,50000,40000,0,0,1,1,1,0,3,42413,3000,39413,2,41434,0,41434,2,45567,5000,40567,0,61595,20000,41595
6020,380000,304000,0,0,0,0,0,0,0,62350,2263,60087,0,63623,2310,61313,0,64846,2282,62564,0,66204,2363,63841
6021,430000,344000,0,0,0,0,0,0,-2,0,0,0,-2,0,0,0,-2,0,0,0,-2,2178,2178,0
6022,20000,16000,0,0,0,0,0,1,0,10909,2000,8909,0,10440,0,10440,2,10803,680,10123,0,11330,1000,10330
6023,330000,264000,0,0,0,0,0,0,0,35406,1470,33936,0,34770,1374,33396,0,35468,1072,34396,0,36211,1113,35098
6024,400000,320000,0,0,0,0,0,1,-2,-770,0,-770,-2,-761,9,-770,-2,-2710,11,-2721,-2,187552,194541,-6989
6025,200000,160000,0,0,0,0,0,0,0,73928,3815,70113,0,72060,3004,69056,0,72393,3006,69387,0,72969,4012,68957
6026,350000,280000,0,0,0,0,0,0,-2,36553,36698,-145,-2,8997,9124,-127,-2,13074,13074,0,-2,5107,5107,0
6027,60000,48000,0,1,0,0,0,0,-1,55839,5011,50828,0,47797,5000,42797,0,8062,2500,5562,0,8284,1000,7284
6028,180000,144000,0,0,0,0,0,0,0,26662,1500,25162,0,26166,1056,25110,0,26176,950,25226,0,25442,1000,24442
6029,240000,192000,0,0,0,0,0,0,0,105086,5014,100072,0,0,0,0,0,0,0,0,-2,0,0,0
6030,180000,144000,0,0,0,0,0,0,3,1196,0,1196,2,870,0,870,0,3028,3028,0,-1,2508,0,2508
6031,170000,136000,0,0,0,0,0,0,-1,0,0,0,-1,638,638,0,-1,0,0,0,-1,362,362,0
6032,300000,240000,0,0,0,0,0,0,0,12893,1513,11380,0,10841,1000,9841,0,11900,1059,10841,0,0,0,0
6033,200000,160000,0,0,0,0,0,0,2,9282,2000,7282,0,10155,1155,9000,0,12470,2470,10000,0,13571,1265,12306
6034,180000,144000,0,0,0,0,0,0,0,0,0,0,-2,0,0,0,-2,0,0,0,-2,0,0,0
6035,360000,288000,0,0,0,0,0,0,-1,390,390,0,-1,390,390,0,-1,390,390,0,-1,390,390,0
6036,180000,144000,0,0,0,0,0,1,-1,2544,2544,0,-1,1134,1134,0,-1,1313,1313,0,-1,1332,1332,0
6037,100000,80000,0,1,0,0,0,0,0,86360,3000,83360,0,77594,3000,74594,0,78030,3000,75030,0,78506,3000,75506
6038,30000,24000,0,0,0,0,0,0,-1,14860,3000,11860,0,14260,1000,13260,0,8864,1000,7864,0,2578,1990,588
6039,500000,400000,0,0,0,0,0,0,-2,14611,14643,-32,-2,23169,23169,0,-2,6738,6738,0,-2,0,2159,-2159
6040,360000,288000,0,0,0,0,0,0,0,252603,8948,243655,0,253759,8727,245032,0,255424,9118,246306,0,253826,9026,244800
6041,360000,288000,0,0,0,0,0,1,-2,0,0,0,-2,0,0,0,-2,0,0,0,-2,0,0,0
6042,230000,184000,0,0,0,0,0,0,-1,1336,1598,-262,-1,255,0,255,2,5425,5425,0,-1,4838,4838,0
6043,160000,128000,0,0,0,0,0,0,-1,5850,5850,0,-1,150,0,150,0,1240,1240,0,-1,0,0,0
6044,50000,40000,0,1,1,1,1,0,0,45120,2100,43020,0,45870,1800,44070,0,46975,2000,44975,0,49284,3100,46184
6045,130000,104000,0,0,0,0,0,0,-1,7533,7533,0,-1,4656,4689,-33,-1,840,840,0,-1,390,390,0
6046,20000,16000,0,0,0,1,1,1,2,15773,1269,14504,0,17102,1598,15504,0,18704,2200,16504,0,18263,0,18263
6047,120000,96000,0,0,0,0,0,0,0,18013,1126,16887,0,18197,636,17561,0,9032,650,8382,0,11951,4000,7951
6048,20000,16000,0,0,0,0,0,0,0,11280,1005,10275,0,3680,1000,2680,0,4480,3000,1480,0,1650,1650,0
6049,180000,144000,0,0,0,0,0,0,0,148961,6502,142459,0,78024,3022,75002,0,72989,3000,69989,0,75454,3022,72432
6050,180000,144000,0,0,0,0,0,0,-1,1140,1140,0,-1,2144,2144,0,-1,1180,1180,0,-1,1382,1382,0
6051,360000,288000,0,0,0,0,0,0,-1,91502,91679,-177,-1,100125,45086,55039,-1,84773,2223,82550,0,76951,2091,74860
6052,120000,96000,0,0,0,0,0,0,0,14256,3000,11256,0,16859,4000,12859,0,17477,4000,13477,0,21588,5000,16588
6053,20000,16000,0,0,0,0,0,1,0,7615,1284,6331,0,8472,1141,7331,0,8640,309,8331,0,8971,470,8501
6054,360000,288000,0,0,0,0,0,0,-1,4719,4719,0,-1,1577,1577,0,-1,1577,1577,0,-1,21220,21220,0
6055,470000,376000,0,0,0,0,0,0,0,46429,2600,43829,0,43405,1500,41905,0,42796,1500,41296,0,44171,2000,42171
6056,210000,168000,0,0,0,0,0,0,-1,199,199,0,-1,0,200,-200,-1,10024,10024,0,-1,-18,0,-18
6057,60000,48000,0,0,0,0,0,0,0,42009,2000,40009,0,43804,2500,41304,0,44473,1700,42773,0,45752,2000,43752
6058,90000,72000,0,0,0,0,0,0,0,7870,1000,6870,0,0,0,0,0,0,0,0,-2,0,3000,-3000
6059,50000,40000,0,0,0,0,0,0,2,4580,1050,3530,0,0,0,0,0,0,0,0,-2,0,0,0
6060,100000,80000,0,0,0,0,0,0,0,10489,3018,7471,0,16146,10002,6144,0,25053,10007,15046,0,27671,5018,22653
6061,230000,184000,0,0,0,0,0,0,0,150844,10010,140834,0,151623,10000,141623,0,148261,7000,141261,0,153161,10000,143161
6062,240000,192000,0,0,0,0,0,0,-1,3503,6430,-2927,-1,1003,1003,0,-1,1003,1003,0,-1,1003,1003,0
6063,360000,288000,0,0,0,0,0,1,-2,8510,8510,0,-2,7831,4000,3831,-2,8864,5000,3864,-2,10845,5000,5845
6064,290000,232000,0,0,0,0,0,0,0,144672,7443,137229,0,146116,35215,110901,0,109672,5011,104661,0,60439,5079,55360
6065,220000,176000,0,0,0,0,0,0,-1,-1350,0,-1350,-1,18150,20000,-1850,-1,350,350,0,-1,200,0,200
6066,100000,80000,0,1,0,0,0,0,2,80748,709,80039,2,80708,6077,74631,2,75366,2805,72561,2,76590,2906,73684
6067,500000,400000,0,0,0,0,0,0,0,138945,8500,130445,0,142235,7000,135235,2,144959,7000,137959,0,148697,6000,142697
6068,150000,120000,0,0,0,0,0,0,0,69232,3000,66232,0,71089,3067,68022,0,65793,2344,63449,0,66651,2419,64232
6069,550000,440000,0,0,0,0,0,0,0,36111,1520,34591,0,32723,1131,31592,0,26946,1005,25941,0,26439,1107,25332
6070,400000,320000,0,0,0,0,0,0,-1,12621,1500,11121,0,13983,13983,0,-1,3378,3378,0,-1,3770,2000,1770
6071,350000,280000,0,0,0,0,0,0,-1,7241,7289,-48,-1,6800,8495,-1695,-1,5163,5184,-21,-1,942,1,941
6072,20000,16000,0,1,1,1,0,0,0,19489,1400,18089,0,19479,390,19089,0,19705,394,19311,0,8440,629,7811
6073,50000,40000,1,1,0,0,0,0,0,59509,2600,56909,0,31495,6000,25495,0,30552,1300,29252,2,29556,0,29556
6074,160000,128000,0,0,0,0,0,1,2,2190,2190,0,-1,0,0,0,-1,0,0,0,-2,0,0,0
6075,280000,224000,0,0,0,0,0,0,-1,1207,1207,0,-1,1207,1207,0,-1,1207,1207,0,-1,1207,1207,0
6076,180000,144000,0,0,0,0,0,0,0,78064,5000,73064,0,73437,5005,68432,0,108072,42500,65572,0,49206,3000,46206
6077,230000,184000,0,0,0,0,0,0,0,180117,5000,175117,0,179717,0,179717,0,124117,5000,119117,0,182717,189600,-6883
6078,240000,192000,0,0,0,0,0,1,2,111948,5500,106448,2,112626,4000,108626,2,113988,4700,109288,2,116315,4300,112015
6079,50000,40000,0,0,0,0,0,0,-1,780,0,780,2,0,0,0,2,390,390,0,-1,1320,1320,0
6080,160000,128000,0,0,0,0,0,0,-1,1066,1066,0,-1,1760,1760,0,-1,880,0,880,0,5510,5510,0
6081,20000,16000,0,0,1,0,0,1,2,16892,1696,15196,0,17396,1200,16196,0,14017,22,13995,0,0,0,0
6082,50000,40000,0,0,0,0,0,0,-2,16248,16248,0,-1,17105,1600,15505,0,16842,337,16505,0,21842,5000,16842
6083,180000,144000,0,0,0,0,0,0,0,0,0,0,-2,0,0,0,-2,0,0,0,-2,0,9000,-9000
6084,20000,16000,0,0,0,0,0,1,0,0,0,0,-2,0,0,0,-2,0,0,0,-2,0,0,0
6085,200000,160000,0,0,0,0,0,0,-1,418,0,418,2,424,424,0,-1,424,424,0,-1,424,424,0
6086,160000,128000,0,0,0,0,0,1,2,68311,2483,65828,0,48875,900,47975,0,37261,20000,17261,0,4267,4267,0
6087,300000,240000,0,0,0,0,0,0,-1,3565,3583,-18,-1,19869,19969,-100,-1,26249,26380,-131,-1,1332,1338,-6
6088,190000,152000,0,0,0,0,0,0,0,135885,4305,131580,0,102718,2800,99918,0,68604,2366,66238,0,45976,2066,43910
6089,50000,40000,0,0,0,0,0,0,0,16052,1223,14829,0,15993,1000,14993,0,15780,1000,14780,0,15549,1000,14549
6090,50000,40000,0,0,0,0,0,0,0,7313,2000,5313,0,8036,1200,6836,0,3949,100,3849,0,26984,26984,0
6091,310000,248000,0,1,1,0,0,1,0,306314,11128,295186,0,258610,8407,250203,0,246491,8599,237892,0,198889,6833,192056
6092,360000,288000,0,0,0,1,0,1,0,-17706,1393,-19099,-2,301085,319494,-18409,-1,307035,13079,293956,0,63451,2438,61013
6093,50000,40000,0,0,0,0,0,0,0,18830,1318,17512,0,19425,1303,18122,0,19414,682,18732,0,19427,703,18724
6094,100000,80000,0,0,0,0,0,1,-1,5250,1119,4131,0,9360,7110,2250,0,4098,110,3988,0,800,102,698
6095,30000,24000,0,0,0,1,1,0,0,2142,2000,142,0,29288,28000,1288,0,26579,800,25779,0,25972,501,25471
6096,290000,232000,0,0,0,0,0,0,0,49188,2002,47186,0,68168,19982,48186,0,67465,1799,65666,0,44593,7,44586
6097,150000,120000,0,0,0,0,0,0,-2,1600,1800,-200,-1,5431,5431,0,-1,0,0,0,-1,0,0,0
6098,10000,8000,0,0,0,0,0,1,4,6988,0,6988,3,6730,0,6730,2,7463,1000,6463,2,7199,0,7199
6099,20000,16000,0,0,0,0,0,0,2,0,0,0,2,0,0,0,-2,0,0,0,-2,0,0,0
6100,240000,192000,0,0,0,0,0,0,-1,92496,90000,2496,0,95057,3346,91711,0,96974,2717,94257,0,98977,2796,96181
6101,30000,24000,0,0,0,0,0,0,-2,836,836,0,-2,390,390,0,-2,390,390,0,-2,390,390,0
6102,200000,160000,0,0,0,0,0,1,0,83290,2952,80338,0,85085,3107,81978,0,89707,6056,83651,0,63787,0,63787
6103,90000,72000,0,0,0,0,0,1,-2,0,0,0,-2,0,0,0,-2,0,0,0,-2,0,0,0
6104,200000,160000,0,0,0,0,0,0,-2,1192,1192,0,-2,1599,1599,0,-2,0,0,0,-2,0,0,0
6105,450000,360000,0,1,1,0,0,0,0,403891,16701,387190,0,415193,20101,395092,0,145198,7000,138198,0,138389,5750,132639
6106,110000,88000,0,1,1,0,0,0,0,104780,4000,100780,0,98139,4100,94039,0,72176,3000,69176,0,74011,3000,71011
6107,20000,16000,0,1,1,1,1,1,0,19424,1600,17824,0,19208,384,18824,0,19600,392,19208,0,20000,400,19600
6108,150000,120000,0,1,0,0,0,0,0,152208,5440,146768,0,116763,4000,112763,0,72325,3000,69325,0,73273,3000,70273
6109,150000,120000,0,0,0,0,0,0,0,87852,3218,84634,0,88692,3196,85496,0,90211,3360,86851,0,91543,3310,88233
6110,20000,16000,0,0,1,1,1,0,0,17451,1600,15851,0,18141,1600,16541,0,18239,1000,17239,0,18302,663,17639
6111,30000,24000,0,1,1,1,1,0,0,27383,1500,25883,0,29061,2100,26961,0,28492,0,28492,2,29850,1800,28050
6112,50000,40000,0,0,0,0,0,0,0,39478,1358,38120,0,19865,680,19185,0,19388,845,18543,0,19792,871,18921
6113,300000,240000,0,1,0,0,0,0,-1,296931,331,296600,2,30355,1070,29285,0,26771,17771,9000,0,23737,18000,5737
6114,180000,144000,0,0,0,0,0,0,-2,900,900,0,-2,0,0,0,-2,0,0,0,-2,0,0,0
6115,20000,16000,0,0,0,0,0,0,0,15421,1600,13821,0,13895,2000,11895,0,11592,1000,10592,0,11433,1500,9933
6116,110000,88000,0,0,0,0,0,0,0,87374,9860,77514,0,49525,1741,47784,0,49225,1702,47523,0,48968,1736,47232
6117,330000,264000,0,0,0,0,0,1,-2,0,0,0,-2,0,0,0,-2,0,0,0,-2,0,0,0
6118,30000,24000,0,1,0,1,1,1,0,24031,0,24031,2,25579,1949,23630,2,25030,0,25030,2,25526,912,24614
6119,230000,184000,0,0,0,0,0,0,-1,0,0,0,-2,0,0,0,-2,0,0,0,-2,0,0,0
6120,90000,72000,0,0,0,0,0,0,-2,176,176,0,-2,21601,21665,-64,-2,7423,8213,-790,-2,9252,9279,-27
6121,30000,24000,0,1,1,1,1,0,2,25761,0,25761,2,25964,928,25036,0,26507,960,25547,0,27249,1181,26068
6122,50000,40000,0,0,0,0,0,0,-1,1246,1246,0,-1,1111,1111,0,-1,3018,3018,0,-1,5847,5847,0
6123,20000,16000,0,0,0,0,0,0,0,14786,1329,13457,0,16457,2000,14457,0,15423,2000,13423,0,14837,700,14137
6124,340000,272000,1,1,1,0,0,1,3,384060,0,384060,2,304508,1000,303508,-1,247178,4320,242858,-1,228349,287982,-59633
6125,320000,256000,0,0,0,0,0,0,0,238196,10000,228196,0,231580,10000,221580,0,229683,19000,210683,0,235837,13000,222837
6126,110000,88000,0,0,0,0,0,1,0,-28,0,-28,0,-28,0,-28,-2,-28,0,-28,-2,-28,0,-28
6127,180000,144000,0,0,0,0,0,0,0,66668,10000,56668,0,83568,17500,66068,0,90418,7000,83418,0,88898,25000,63898
6128,500000,400000,0,0,0,0,0,0,0,203696,7414,196282,0,201655,6940,194715,0,202938,7299,195639,0,202136,8021,194115
6129,180000,144000,0,0,0,0,0,0,-1,396,396,0,-1,396,396,0,-1,396,396,0,-1,396,396,0
6130,260000,208000,0,0,0,0,0,0,0,50175,30000,20175,0,46516,1590,44926,0,42815,1472,41343,0,39004,1317,37687
6131,50000,40000,0,0,0,0,0,0,-1,1173,1173,0,-1,1473,1773,-300,-1,1473,1473,0,-1,1623,1623,0
6132,150000,120000,0,0,0,0,0,0,-1,11609,11609,0,-1,3234,3623,-389,-1,1414,1414,0,-1,5281,5281,0
6133,150000,120000,0,0,0,0,0,0,-2,3189,3220,-31,-2,0,0,0,-2,150,150,0,-1,880,880,0
6134,250000,200000,0,0,0,0,0,0,2,12738,12738,0,-1,2310,2310,0,-1,0,0,0,-1,0,0,0
6135,10000,8000,0,0,0,0,0,1,5,3800,0,3800,4,3597,0,3597,3,3395,0,3395,2,4187,1000,3187
6136,50000,40000,0,1,0,0,0,0,0,42687,2047,40640,0,40614,3246,37368,0,29356,1164,28192,0,29815,1048,28767
6137,230000,184000,0,0,0,0,0,0,-2,2233,2244,-11,-2,1410,1421,-11,-2,0,0,0,-2,0,0,0
6138,50000,40000,0,0,0,0,0,0,0,20769,1283,19486,0,21339,853,20486,0,19382,1000,18382,0,18577,758,17819
6139,280000,224000,0,0,0,0,0,0,0,155568,5700,149868,0,158775,5800,152975,0,162035,5900,156135,0,165522,6100,159422
6140,100000,80000,0,0,0,0,0,1,-1,687,687,0,-1,620,620,0,-1,0,0,0,-1,627,627,0
6141,20000,16000,0,1,1,0,0,0,0,18742,1404,17338,0,19738,1400,18338,0,15627,399,15228,0,15753,604,15149
6142,50000,40000,0,1,1,0,0,0,0,49603,3001,46602,0,49222,1558,47664,0,30421,1045,29376,0,30352,1074,29278
6143,20000,16000,0,0,0,0,0,0,0,20649,10000,10649,0,-1001,0,-1001,0,-1,1000,-1001,-2,-1,0,-1
6144,250000,200000,0,0,0,0,0,1,-2,0,0,0,-2,0,0,0,-2,0,0,0,-2,0,0,0
6145,30000,24000,0,0,0,0,0,0,-2,0,0,0,-2,0,0,0,-2,0,0,0,-2,0,0,0
6146,30000,24000,0,1,0,0,0,1,2,28919,159,28760,2,28000,28426,-426,2,13393,24682,-11289,-1,10539,12,10527
6147,310000,248000,0,0,0,0,0,0,-2,8805,8805,0,-2,3024,3087,-63,-2,0,0,0,-2,0,0,0
6148,60000,48000,0,1,1,1,1,1,2,51255,0,51255,2,52119,2313,49806,0,52866,2044,50822,0,53969,2110,51859
6149,50000,40000,0,1,0,0,0,0,2,45469,2079,43390,0,20228,693,19535,0,18900,1080,17820,0,19066,700,18366
6150,50000,40000,0,0,0,0,0,0,0,22493,1650,20843,0,660,0,660,0,1979,1979,0,-1,836,0,836
6151,360000,288000,0,0,0,0,0,0,0,17231,17454,-223,-1,1770,1775,-5,-1,0,0,0,-1,0,0,0
6152,240000,192000,0,0,0,0,0,0,0,93689,3711,89978,0,81226,3100,78126,0,71547,2500,69047,0,72794,3019,69775
6153,230000,184000,0,0,0,0,0,0,-1,390,390,0,-1,390,390,0,-1,240,240,0,-1,930,1080,-150
6154,80000,64000,0,1,1,0,0,1,0,77980,3075,74905,0,79938,5000,74938,0,50209,1750,48459,0,49762,1810,47952
6155,130000,104000,0,0,0,0,0,0,0,67061,2500,64561,0,64154,2000,62154,0,15903,1500,14403,0,16493,1000,15493
6156,170000,136000,0,0,0,0,0,0,-2,2687,2700,-13,-2,2885,2899,-14,-2,2092,2102,-10,-2,36612,101556,-64944
6157,200000,160000,0,0,0,0,0,0,0,8107,2700,5407,0,7523,0,7523,2,8345,1000,7345,0,19030,11000,8030
6158,110000,88000,0,1,0,0,0,0,0,110399,4379,106020,0,48532,12466,36066,0,44703,5000,39703,0,47869,5307,42562
6159,320000,256000,0,0,0,0,0,0,-1,82271,82271,0,-1,5315,5315,0,-1,33059,33059,0,-1,908,908,0
6160,220000,176000,0,0,0,0,0,0,0,22901,2015,20886,0,23815,5000,18815,0,37748,20000,17748,0,16657,3000,13657
6161,220000,176000,0,0,0,0,0,0,-2,2337,2337,0,-2,-602,58,-660,-2,-1184,0,-1184,-2,-2047,0,-2047
6162,20000,16000,0,0,0,0,0,0,2,5914,99,5815,2,13385,13401,-16,-1,5490,5490,0,-1,0,0,0
6163,260000,208000,0,0,0,0,0,0,-1,62361,50000,12361,0,67057,11500,55557,0,17024,17024,0,-1,18659,18659,0
6164,180000,144000,0,0,0,0,0,0,-2,0,0,0,-2,0,0,0,-2,0,0,0,-2,0,0,0
6165,50000,40000,0,1,0,0,0,0,0,50218,2152,48066,0,18983,800,18183,0,17435,610,16825,0,17057,620,16437
6166,100000,80000,0,0,0,0,0,1,2,24122,3600,20522,2,23440,0,23440,2,28843,6000,22843,0,31353,3000,28353
6167,450000,360000,0,0,0,0,0,0,-2,17471,17566,-95,-2,10342,10401,-59,-2,51786,52045,-259,-2,45747,45812,-65
6168,340000,272000,0,0,0,0,0,0,0,137255,5008,132247,0,137180,6367,130813,0,135783,4800,130983,0,135201,4941,130260
6169,360000,288000,0,0,0,0,0,0,-2,396,396,0,-2,396,396,0,-2,396,396,0,-2,396,396,0
6170,20000,16000,0,1,0,1,1,0,2,20126,2019,18107,0,18928,11309,7619,0,18761,2000,16761,0,18787,700,18087
6171,300000,240000,0,0,0,0,0,0,-1,8903,8974,-71,-1,12445,12457,-12,-1,24650,15113,9537,0,8339,8369,-30
6172,10000,8000,0,0,0,0,0,0,0,8244,300,7944,2,7963,0,7963,2,8134,299,7835,0,9995,2000,7995
6173,220000,176000,0,0,0,0,0,0,-1,7113,7540,-427,-1,9574,9571,3,0,1727,1739,-12,-1,4201,4918,-717
6174,110000,88000,0,0,0,0,0,1,0,46997,1769,45228,0,50740,4512,46228,0,49115,0,49115,2,49529,1930,47599
6175,80000,64000,0,0,0,0,0,0,-1,2587,2587,0,-1,2108,2108,0,-1,1921,1936,-15,-1,2071,2071,0
6176,180000,144000,0,0,0,0,0,0,-1,9877,9962,-85,-1,4383,3485,898,-1,3482,2,3480,2,4479,4479,0
6177,120000,96000,0,0,0,0,0,0,0,4746,1000,3746,0,0,0,0,0,0,0,0,-2,0,0,0
6178,360000,288000,0,0,0,0,0,0,0,166445,6200,160245,0,168301,4768,163533,0,171870,5000,166870,0,175458,5000,170458
6179,240000,192000,0,1,1,1,1,0,0,235982,10200,225782,0,239281,8725,230556,0,244329,9068,235261,0,249130,9068,240062
6180,30000,24000,0,0,0,0,0,1,2,20004,1700,18304,0,21063,1700,19363,0,21416,1000,20416,0,22667,1749,20918
6181,30000,24000,0,1,1,1,1,0,0,25098,1000,24098,2,24396,0,24396,2,24907,903,24004,0,25555,1061,24494
6182,30000,24000,0,1,1,0,0,0,0,28327,1938,26389,0,27831,2000,25831,0,14215,505,13710,0,32635,25000,7635
6183,110000,88000,0,0,0,0,0,0,0,9283,1000,8283,0,8950,0,8950,0,8943,326,8617,0,333,333,0
6184,80000,64000,0,0,0,0,0,0,0,70,500,-430,-1,180,500,-320,-1,-210,0,-210,-1,220,820,-600
6185,500000,400000,0,0,0,0,0,1,-1,5792,5792,0,-1,396,0,396,2,792,792,0,-1,396,0,396
6186,300000,240000,0,0,0,0,0,0,-2,0,0,0,-2,800,800,0,-1,800,0,800,0,180,180,0
6187,10000,8000,0,0,0,0,0,0,0,8036,1000,7036,0,8099,162,7937,0,0,0,0,0,0,0,0
6188,10000,8000,0,0,0,0,0,1,0,4730,1500,3230,0,5649,1000,4649,0,7304,1751,5553,0,8252,1073,7179
6189,300000,240000,0,0,0,0,0,0,-1,390,390,0,-1,390,390,0,-1,390,390,0,-1,390,390,0
6190,20000,16000,0,1,1,1,1,1,2,19355,2344,17011,2,19554,800,18754,2,19795,683,19112,2,19342,0,19342
6191,110000,88000,0,0,0,0,0,0,0,65753,15753,50000,0,65379,5379,60000,0,65467,5467,60000,0,64596,4596,60000
6192,100000,80000,0,1,1,1,1,1,0,98188,0,98188,2,97189,3600,93589,0,97013,3500,93513,0,96950,3700,93250
6193,100000,80000,0,0,0,0,0,0,-2,0,0,0,-2,7700,7700,0,-2,0,0,0,-2,0,0,0
6194,50000,40000,0,0,0,0,0,0,0,19204,1272,17932,0,19588,656,18932,0,20024,706,19318,0,18694,954,17740
6195,130000,104000,0,0,0,0,0,0,2,55055,2000,53055,0,54804,6844,47960,0,52439,0,52439,2,52609,2071,50538
6196,310000,248000,0,0,0,0,0,0,-2,61756,61816,-60,-2,88416,39022,49394,-2,59964,10041,49923,-2,44873,15080,29793
6197,50000,40000,0,1,0,0,0,1,0,43528,1500,42028,0,29606,1009,28597,0,30305,1124,29181,0,28895,1100,27795
6198,50000,40000,0,0,0,0,0,0,0,20090,2664,17426,0,19052,1261,17791,2,19601,782,18819,0,16460,606,15854
6199,130000,104000,0,0,0,0,0,0,-1,2811,2811,0,-1,3589,3589,0,-1,11151,11351,-200,-1,1543,1543,0
6200,140000,112000,0,0,0,0,0,1,-2,0,0,0,-2,3794,3794,0,-2,0,0,0,-2,865,865,0
6201,230000,184000,0,0,0,0,0,0,0,92195,5000,87195,0,94814,5000,89814,0,98182,5000,93182,0,98457,4000,94457
6202,100000,80000,0,1,0,0,0,1,0,98969,0,98969,2,70352,2500,67852,0,68186,2700,65486,0,68538,2700,65838
6203,140000,112000,0,0,0,0,0,0,0,84516,2822,81694,0,72391,2336,70055,0,61298,2588,58710,0,62193,2250,59943
6204,170000,136000,0,0,0,0,0,0,0,7301,1200,6101,0,10342,10342,0,-1,14295,14295,0,-1,20471,20471,0
6205,490000,392000,0,0,0,0,0,0,2,19173,9173,10000,0,20400,5400,15000,0,27979,7979,20000,0,27622,7622,20000
6206,300000,240000,0,0,0,0,0,0,-2,0,0,0,-2,0,0,0,-2,0,0,0,-2,0,0,0
6207,80000,64000,0,1,1,1,1,1,2,75075,2563,72512,0,76348,2356,73992,0,77798,2296,75502,0,79843,2800,77043
6208,30000,24000,0,0,0,0,0,1,2,14190,1300,12890,0,16218,2273,13945,0,15663,0,15663,2,17250,2000,15250
6209,140000,112000,0,0,0,0,0,0,-2,0,0,0,-2,0,0,0,-2,0,0,0,-2,0,0,0
6210,360000,288000,0,0,0,0,0,0,0,29686,1799,27887,0,23724,1008,22716,0,5576,120,5456,0,2273,2289,-16
6211,240000,192000,0,0,0,0,0,0,-2,437,437,0,-2,11624,11705,-81,-2,9411,9473,-62,-2,-3316,1405,-4721
6212,90000,72000,0,0,0,0,0,0,-1,3909,3916,-7,-1,3506,3506,0,-1,4128,4128,0,-1,4254,4254,0
6213,30000,24000,0,1,0,0,0,1,2,28404,2000,26404,0,24865,1100,23765,0,24528,1100,23428,0,25011,1042,23969
6214,100000,80000,0,1,1,1,1,1,2,99560,4700,94860,0,95952,4400,91552,0,98744,6000,92744,0,97896,2000,95896
6215,50000,40000,0,1,1,0,0,0,2,51334,3200,48134,0,49312,3110,46202,0,8027,32356,-24329,-1,8603,700,7903
6216,280000,224000,0,0,0,0,0,0,-1,2973,0,2973,2,0,0,0,2,962,962,0,-1,3481,3481,0
6217,350000,280000,0,0,0,0,0,0,-2,850,850,0,-2,7980,3990,3990,-2,22703,45406,-22703,-2,2093,2093,0
6218,220000,176000,0,0,0,0,0,1,-1,12370,12373,-3,-1,12095,12099,-4,-1,1832,1832,0,-1,4691,5001,-310
6219,410000,328000,0,0,0,0,0,0,-1,0,0,0,-1,11900,11900,0,-1,478,478,0,-1,387,387,0
6220,90000,72000,0,0,0,0,0,0,0,57990,2168,55822,0,51537,1686,49851,0,52486,1878,50608,0,48483,1611,46872
6221,80000,64000,0,0,0,0,0,0,0,44022,2100,41922,0,44792,1800,42992,0,45915,2000,43915,0,46998,2000,44998
6222,310000,248000,0,0,0,0,0,0,0,51531,1500,50031,2,51375,1000,50375,0,29069,1200,27869,0,29895,1200,28695
6223,10000,8000,0,0,0,0,0,0,-1,5794,5794,0,-1,9576,9585,-9,-1,7818,7580,238,0,7580,152,7428
6224,50000,40000,0,1,1,0,0,0,0,49479,2075,47404,0,49704,1300,48404,0,19380,700,18680,0,18653,677,17976
6225,180000,144000,0,1,0,0,0,0,0,176711,10264,166447,0,127004,4598,122406,0,114179,9600,104579,0,129622,20000,109622
6226,500000,400000,0,0,0,0,0,0,-1,23721,24112,-391,-1,20799,20886,-87,-1,34132,28032,6100,0,56917,57196,-279
6227,100000,80000,0,1,0,0,0,0,0,91531,3664,87867,0,82398,3157,79241,0,73011,2572,70439,0,73711,3048,70663
6228,400000,320000,0,0,0,0,0,0,-1,21153,21153,0,-1,15631,15948,-317,-1,14417,10000,4417,0,12228,10000,2228
6229,100000,80000,0,0,0,0,0,1,-1,123,123,0,-1,123,123,0,-1,123,123,0,-1,123,123,0
6230,50000,40000,0,0,0,0,0,0,0,8312,6000,2312,0,11451,8000,3451,0,9312,186,9126,0,7239,0,7239
6231,160000,128000,0,0,0,0,0,0,0,45688,2767,42921,0,47690,2769,44921,0,48712,1791,46921,0,49525,1928,47597
6232,120000,96000,0,0,0,0,0,0,-2,326,326,0,-2,326,326,0,-2,326,326,0,-2,652,652,0
6233,500000,400000,0,0,0,0,0,0,-1,0,0,0,-1,0,0,0,-2,0,0,0,-2,0,0,0
6234,210000,168000,0,0,0,0,0,0,0,66612,4043,62569,0,65799,10329,55470,0,-41,0,-41,0,8208,8249,-41
6235,170000,136000,0,0,0,0,0,0,0,34289,1606,32683,0,31518,1325,30193,0,31338,1015,30323,0,31838,10000,21838
6236,50000,40000,0,0,0,0,0,0,3,28950,1000,27950,2,29684,1500,28184,2,29078,0,29078,2,29944,1500,28444
6237,80000,64000,0,1,1,1,1,1,2,80388,3001,77387,2,78128,0,78128,2,75762,2703,73059,0,73873,3100,70773
6238,150000,120000,0,1,1,0,0,0,0,151713,20000,131713,0,130107,5000,125107,0,78623,2000,76623,0,79743,7000,72743
6239,230000,184000,1,1,1,1,1,1,0,242378,10057,232321,0,235163,19000,216163,0,234032,9100,224932,2,225822,0,225822
6240,40000,32000,0,0,0,0,0,0,0,21151,1356,19795,0,21884,1380,20504,0,26213,5000,21213,0,30480,5000,25480
6241,50000,40000,0,1,1,0,0,1,2,50151,2463,47688,0,50496,2300,48196,0,2759,55,2704,0,-442,0,-442
6242,140000,112000,0,1,0,0,0,0,0,142292,6982,135310,0,99399,3500,95899,0,101677,3800,97877,0,100867,3700,97167
6243,310000,248000,0,0,0,0,0,0,0,39572,10773,28799,0,44598,10819,33779,0,50570,15766,34804,0,64916,20645,44271
6244,50000,40000,0,0,0,0,0,0,-1,0,0,0,-2,0,0,0,-2,0,0,0,-2,3702,3702,0
6245,20000,16000,0,0,0,0,0,1,-1,2110,2200,-90,-1,300,600,-300,-1,150,0,150,2,650,500,150
6246,20000,16000,0,0,1,1,1,1,3,17325,1600,15725,2,17542,800,16742,2,17756,800,16956,2,18023,700,17323
6247,120000,96000,0,0,0,0,0,0,0,25949,1967,23982,0,25619,1650,23969,0,4456,500,3956,0,2714,0,2714
6248,50000,40000,0,0,0,0,0,0,0,28650,1679,26971,0,19659,688,18971,0,19802,713,19089,0,19699,858,18841
6249,20000,16000,0,0,0,0,0,1,-2,0,0,0,-2,0,0,0,-2,0,0,0,-2,1000,1000,0
6250,20000,16000,0,1,1,1,1,0,0,17478,0,17478,2,18224,1500,16724,0,18926,1000,17926,0,19627,1000,18627
6251,500000,400000,0,0,0,0,0,0,-1,0,0,0,-1,8500,8500,0,-1,4590,4590,0,-1,0,0,0
6252,80000,64000,0,0,0,0,0,0,-2,862,862,0,-1,41300,41300,0,-1,0,0,0,-1,0,0,0
6253,120000,96000,0,0,0,0,0,0,-2,2216,2216,0,-2,2550,2557,-7,-2,9246,9246,0,-2,8307,8307,0
6254,140000,112000,0,0,0,0,0,0,-1,696,696,0,-1,696,696,0,-1,696,696,0,-1,696,696,0
6255,310000,248000,0,1,1,1,0,0,0,299162,13000,286162,0,305251,13208,292043,0,262368,10000,252368,0,254340,9506,244834
6256,60000,48000,0,0,0,0,0,0,0,24665,1500,23165,0,26305,2000,24305,0,23756,1500,22256,0,25353,2000,23353
6257,50000,40000,0,0,0,0,0,0,0,27114,7232,19882,0,29625,11000,18625,0,32788,15788,17000,0,28668,13668,15000
6258,50000,40000,1,1,0,0,0,0,0,54707,3000,51707,0,29250,2100,27150,0,29905,1500,28405,0,29519,1300,28219
6259,160000,128000,0,0,0,0,0,0,0,47242,1800,45442,0,48355,1900,46455,0,49552,2000,47552,0,50655,1900,48755
6260,500000,400000,0,0,0,0,0,1,2,265433,0,265433,2,270868,9932,260936,0,285667,19502,266165,0,290318,9600,280718
6261,120000,96000,0,0,0,0,0,1,-2,1100,1100,0,-1,0,0,0,-1,0,0,0,-2,0,0,0
6262,70000,56000,0,0,0,0,0,0,0,18171,4000,14171,0,20861,3000,17861,0,20231,0,20231,2,22831,3100,19731
6263,50000,40000,0,0,0,0,0,0,2,16693,1586,15107,0,17407,1300,16107,0,18660,1546,17114,0,19115,900,18215
6264,50000,40000,0,0,0,0,0,0,0,48845,47166,1679,0,43129,12064,31065,0,28385,12176,16209,0,23876,780,23096
6265,80000,64000,0,0,0,0,0,0,0,56626,2300,54326,0,56387,1352,55035,0,15980,700,15280,0,1134,1134,0
6266,70000,56000,0,0,1,0,1,1,0,59529,5800,53729,0,57571,0,57571,2,57871,2250,55621,0,60872,4500,56372
6267,320000,256000,0,0,0,0,0,0,0,81130,12000,69130,0,103543,25000,78543,0,105623,3208,102415,0,107549,4031,103518
6268,50000,40000,0,0,0,0,0,1,2,4166,1000,3166,0,0,0,0,0,0,0,0,-2,0,0,0
6269,130000,104000,0,0,0,0,0,0,0,6627,2227,4400,0,3300,200,3100,2,0,0,0,2,18300,18300,0
6270,50000,40000,0,0,0,0,0,0,0,8741,1294,7447,0,8911,464,8447,0,8943,324,8619,0,9140,345,8795
6271,280000,224000,0,0,0,0,0,0,-2,1345,1351,-6,-2,-5,0,-5,-2,-5,0,-5,-2,985,990,-5
6272,20000,16000,0,0,0,1,1,0,0,16730,1800,14930,0,17930,2000,15930,0,18267,1000,17267,0,18604,1000,17604
6273,150000,120000,0,0,0,0,0,0,0,15919,2000,13919,0,10177,1000,9177,0,7954,0,7954,0,8049,8049,0
6274,120000,96000,0,0,0,0,0,0,0,28878,2000,26878,0,30428,2000,28428,0,31818,2000,29818,0,34293,3000,31293
6275,200000,160000,0,0,0,0,0,0,0,129415,4872,124543,0,88682,2894,85788,0,74132,2637,71495,0,71281,2591,68690
6276,510000,408000,0,0,0,0,0,0,-1,9891,9922,-31,-1,8600,8600,0,-1,3365,3365,0,-1,6011,6011,0
6277,100000,80000,0,0,0,0,0,0,-1,0,0,0,-1,0,0,0,-2,0,0,0,-2,150,150,0
6278,200000,160000,0,0,0,0,0,0,0,110405,5000,105405,0,90226,10000,80226,0,88789,5000,83789,0,92188,5000,87188
6279,50000,40000,0,1,1,1,0,0,0,43409,2000,41409,0,45919,3000,42919,0,48530,3000,45530,0,0,0,0
6280,220000,176000,0,0,0,0,0,1,0,126311,0,126311,2,151588,27500,124088,2,147656,0,147656,2,157276,12000,145276
6281,300000,240000,0,0,0,0,0,0,-2,0,0,0,-2,0,0,0,-2,0,0,0,-2,0,0,0
6282,20000,16000,0,0,0,0,0,0,2,13474,2000,11474,2,13006,0,13006,2,13743,1055,12688,2,11167,0,11167
6283,40000,32000,0,0,0,1,1,1,-1,1716,1716,0,-1,41710,41710,0,-1,42219,2800,39419,-1,39774,0,39774
6284,140000,112000,0,0,0,0,0,0,-2,5472,5472,0,-2,0,0,0,-2,544,544,0,-1,0,0,0
6285,50000,40000,0,1,1,0,0,0,0,50116,2100,48016,0,49184,1500,47684,0,19184,1000,18184,0,18021,1000,17021
6286,150000,120000,0,1,1,1,1,0,0,128709,3647,125062,0,131292,3678,127614,0,134011,3793,130218,0,136711,3835,132876
6287,20000,16000,0,1,1,1,1,0,0,18067,1301,16766,0,18666,900,17766,0,19115,900,18215,0,19547,900,18647
6288,230000,184000,0,0,0,0,0,0,0,93143,4114,89029,0,87654,3500,84154,0,90172,4000,86172,0,86850,3000,83850
6289,140000,112000,0,0,0,0,0,0,-2,0,0,0,-2,0,0,0,-2,0,0,0,-2,0,0,0
6290,20000,16000,0,0,0,0,0,0,2,12380,2000,10380,2,11884,0,11884,2,12894,1203,11691,2,12540,0,12540
6291,180000,144000,0,0,0,0,0,0,0,19126,2000,17126,0,12939,1042,11897,0,6939,0,6939,0,3439,0,3439
6292,500000,400000,0,0,0,0,0,0,0,288835,36500,252335,0,281810,20000,261810,0,273700,36000,237700,0,269552,20000,249552
6293,80000,64000,0,0,0,0,0,0,0,8941,2287,6654,0,8564,2287,6277,0,6281,281,6000,0,6965,965,6000
6294,80000,64000,0,0,0,0,0,0,0,34662,2000,32662,2,35784,2000,33784,2,37065,2000,35065,2,36320,0,36320
6295,140000,112000,0,0,0,0,0,0,0,41878,2001,39877,0,42977,2100,40877,0,43960,2000,41960,0,45093,2000,43093
6296,230000,184000,0,0,0,0,0,0,0,36574,2100,34474,0,36985,1500,35485,0,37701,1000,36701,0,30735,1000,29735
6297,100000,80000,0,0,0,0,0,0,-1,15477,10035,5442,0,23472,23500,-28,-1,12500,12500,0,-1,14666,14666,0
6298,100000,80000,0,0,0,0,0,1,-1,0,0,0,-1,0,0,0,-2,63562,63562,0,-1,66520,4000,62520
6299,390000,312000,0,0,0,0,0,0,0,27235,1329,25906,0,9895,1025,8870,0,3707,1010,2697,0,62320,67842,-5522
6300,110000,88000,0,0,0,0,0,0,2,29003,2000,27003,2,29447,1000,28447,2,27701,0,27701,2,28285,1000,27285
6301,170000,136000,0,1,0,0,0,0,0,148564,7000,141564,0,105858,4000,101858,0,105075,4000,101075,0,107358,4000,103358
6302,360000,288000,0,0,0,0,0,0,2,165,0,165,2,5773,5773,0,-1,3598,3598,0,-1,3598,3598,0
6303,360000,288000,0,0,0,0,0,0,-2,-5,0,-5,-2,4232,4237,-5,-1,3189,16,3173,0,7511,7548,-37
6304,100000,80000,0,0,0,0,0,1,-1,1226,1226,0,-1,330,330,0,-1,0,0,0,-1,0,0,0
6305,60000,48000,0,1,1,0,0,0,0,57815,2488,55327,0,50054,2000,48054,0,27535,1000,26535,0,22962,2000,20962
6306,360000,288000,0,0,0,0,0,0,-2,0,0,0,-2,0,0,0,-2,0,0,0,-2,0,0,0
6307,10000,8000,0,1,1,1,1,1,2,9964,0,9964,3,9327,0,9327,2,9512,332,9180,0,9200,333,8867
6308,100000,80000,0,1,1,1,1,0,0,92840,3400,89440,0,99296,8000,91296,0,101872,4300,97572,2,99555,0,99555
6309,80000,64000,0,0,0,0,0,1,0,34721,2086,32635,0,5544,19,5525,0,9318,9346,-28,-1,7298,7319,-21
6310,80000,64000,0,0,0,0,0,0,-1,2446,2458,-12,-1,834,834,0,-1,1596,1600,-4,-1,855,855,0
6311,80000,64000,0,0,0,0,0,0,0,53897,2000,51897,0,54292,2000,52292,0,55430,2010,53420,0,57011,2500,54511
6312,120000,96000,0,1,0,0,0,0,0,113245,2657,110588,0,48888,978,47910,0,40241,805,39436,0,49923,52169,-2246
6313,360000,288000,0,0,0,0,0,0,0,236139,8500,227639,0,241056,8750,232306,0,246297,9200,237097,0,246072,9800,236272
6314,90000,72000,0,1,0,0,0,1,0,85807,3000,82807,0,68186,3000,65186,0,69011,3000,66011,0,70341,2600,67741
6315,280000,224000,0,0,0,0,0,0,-1,8220,8283,-63,-1,2287,2287,0,-1,10969,10969,0,-1,5395,0,5395
6316,330000,264000,0,0,0,0,0,0,2,0,0,0,2,4009,4009,0,-1,0,0,0,-1,2307,2307,0
6317,180000,144000,0,1,0,0,0,0,2,182641,15000,167641,2,135892,0,135892,2,135411,4500,130911,0,126808,5000,121808
6318,30000,24000,0,1,1,1,1,0,2,30369,1750,28619,0,29787,1025,28762,0,30284,1100,29184,0,29057,1500,27557
6319,50000,40000,0,1,0,0,0,0,0,49218,2200,47018,0,18937,824,18113,0,19183,700,18483,0,19761,900,18861
6320,20000,16000,0,0,0,0,0,0,0,17924,3006,14918,0,18674,3007,15667,0,15452,489,14963,0,15882,2110,13772
6321,170000,136000,0,0,0,0,0,0,-2,107946,108323,-377,-1,13608,13608,0,-1,110667,112876,-2209,-1,6878,3998,2880
6322,170000,136000,0,0,0,0,0,0,-1,0,0,0,-2,0,0,0,-2,0,0,0,-2,3001,3001,0
6323,30000,24000,0,1,1,1,1,0,0,28631,1786,26845,0,28935,1486,27449,0,28954,1170,27784,0,29155,1200,27955
6324,400000,320000,0,0,0,0,0,0,0,81864,4000,77864,0,83747,3000,80747,0,85487,3000,82487,0,88315,4000,84315
6325,130000,104000,0,0,0,0,0,0,-2,1487,1487,0,-2,1279,1279,0,-2,749,749,0,-2,440,440,0
6326,150000,120000,1,1,1,1,1,0,0,188864,7000,181864,0,188547,5000,183547,0,193087,8000,185087,0,196559,7000,189559
6327,60000,48000,0,0,0,0,0,1,0,41087,1511,39576,0,25518,1200,24318,0,26276,1300,24976,0,27012,1300,25712
6328,20000,16000,0,0,0,1,0,0,-1,1100,1103,-3,-1,17982,17982,0,-1,18166,384,17782,0,0,8,-8
6329,140000,112000,0,0,0,0,0,0,0,87188,4100,83088,0,86973,4000,82973,0,85854,3162,82692,0,85839,3500,82339
6330,420000,336000,0,1,0,0,0,0,0,417086,16078,401008,0,348345,12638,335707,0,287150,50700,236450,0,261219,20014,241205
6331,300000,240000,0,0,0,0,0,0,-1,3737,3753,-16,-1,1433,1433,0,-1,5522,5522,0,-1,3233,0,3233
6332,280000,224000,0,0,0,0,0,0,-2,11966,12042,-76,-2,5844,5844,0,-2,8994,4672,4322,-2,14631,14724,-93
6333,110000,88000,0,0,0,0,0,0,-1,50815,1501,49314,0,46147,1100,45047,0,39769,1000,38769,0,9353,2000,7353
6334,150000,120000,0,1,1,1,1,1,2,146648,13000,133648,2,147865,5200,142665,2,149356,5300,144056,2,145262,400,144862
6335,10000,8000,0,1,1,0,0,0,0,9450,1337,8113,0,9414,1081,8333,0,5354,191,5163,0,5275,375,4900
6336,80000,64000,0,0,0,0,0,0,0,14382,1500,12882,0,15631,1500,14131,0,16080,1000,15080,0,17327,1500,15827
6337,200000,160000,0,0,0,0,0,0,-1,250,0,250,2,7250,7000,250,2,2639,0,2639,2,10207,10500,-293
6338,160000,128000,0,0,0,0,0,0,-2,5345,5345,0,-2,396,396,0,-2,396,396,0,-2,6396,6396,0
6339,170000,136000,0,1,1,0,0,0,0,161921,6500,155421,0,165863,7000,158863,0,128038,5000,123038,0,130931,5000,125931
6340,250000,200000,0,0,0,0,0,1,-2,19449,19449,0,-1,20623,1500,19123,0,21283,1000,20283,0,21943,1000,20943
6341,60000,48000,0,1,1,1,1,0,0,57614,3000,54614,0,58699,2700,55999,0,57302,3000,54302,0,51812,3000,48812
6342,620000,496000,0,0,0,0,0,0,0,90493,5400,85093,0,90025,3173,86852,0,88406,3200,85206,0,89111,3500,85611
6343,160000,128000,0,0,0,0,0,1,-1,399,399,0,-1,690,690,0,-1,590,590,0,-1,0,0,0
6344,80000,64000,0,0,0,0,0,1,-1,390,390,0,-1,390,390,0,-1,390,390,0,-1,390,390,0
6345,150000,120000,0,0,0,0,0,0,-1,2842,2866,-24,-1,3910,4082,-172,-1,4697,4697,0,-1,1719,1735,-16
6346,390000,312000,0,0,0,0,0,0,0,28139,5000,23139,0,32711,5000,27711,0,36215,4000,32215,0,40650,5000,35650
6347,300000,240000,0,0,0,0,0,0,0,80813,5000,75813,0,111116,30303,80813,0,13534,2011,11523,0,10379,856,9523
6348,500000,400000,0,0,0,0,0,0,0,286959,13500,273459,0,278420,10000,268420,0,291642,30000,261642,0,286666,12000,274666
6349,280000,224000,0,0,0,0,0,0,0,5520,1200,4320,0,0,0,0,0,0,0,0,-2,0,0,0
6350,240000,192000,0,0,0,0,1,0,0,184976,8000,176976,0,188934,7000,181934,0,196884,11000,185884,0,199267,7181,192086
6351,290000,232000,0,0,0,0,0,0,-1,200,201,-1,-1,1956,1961,-5,-1,910,4,906,0,0,0,0
6352,200000,160000,0,0,0,0,0,0,0,76726,4005,72721,0,72487,2800,69687,0,74108,3300,70808,0,67036,3000,64036
6353,220000,176000,0,0,0,0,0,0,0,177720,7500,170220,0,131874,4500,127374,0,118918,5000,113918,0,110338,5000,105338
6354,150000,120000,0,1,1,1,1,1,0,137525,4926,132599,2,133431,0,133431,2,135837,5122,130715,0,143319,10349,132970
6355,290000,232000,0,0,0,0,0,0,0,15315,1212,14103,0,14199,284,13915,0,9681,5000,4681,0,162,162,0
6356,260000,208000,0,0,0,0,0,0,-1,476,0,476,2,2856,2880,-24,-1,814,814,0,-1,605,605,0
6357,200000,160000,0,0,0,0,0,0,-2,933,938,-5,-2,21227,21380,-153,-2,55272,58007,-2735,-1,58587,51413,7174
6358,50000,40000,0,0,0,0,0,0,0,15020,1256,13764,0,16335,1571,14764,0,17040,1276,15764,0,16625,0,16625
6359,30000,24000,1,1,1,1,1,0,2,71904,4000,67904,0,62630,5000,57630,0,57406,8000,49406,0,46231,1460,44771
6360,30000,24000,0,1,0,0,0,0,0,28170,1000,27170,0,9515,1190,8325,0,780,0,780,0,0,0,0
6361,60000,48000,0,1,1,1,1,1,2,63821,9400,54421,0,63719,2271,61448,0,63807,2425,61382,0,57482,2087,55395
6362,80000,64000,0,0,0,0,0,1,0,7930,1000,6930,0,6674,133,6541,0,6810,136,6674,0,0,0,0
6363,350000,280000,0,1,0,0,0,0,0,301114,10728,290386,0,285750,9812,275938,0,289399,10397,279002,0,284597,10099,274498
6364,20000,16000,0,0,0,0,0,0,-1,390,390,0,-1,870,870,0,-1,480,0,480,0,780,300,480
6365,160000,128000,0,0,0,0,0,0,-1,430,430,0,-1,850,850,0,-1,3350,3350,0,-1,4874,4874,0
6366,200000,160000,0,0,0,0,0,0,0,44716,2029,42687,0,42073,2073,40000,0,42867,2867,40000,0,33876,3876,30000
6367,20000,16000,0,0,1,1,1,1,2,16928,1000,15928,2,17354,1000,16354,2,16934,0,16934,2,18347,1700,16647
6368,370000,296000,0,0,0,0,0,0,2,3677,3677,0,-1,1746,0,1746,2,1746,1746,0,-1,1746,1746,0
6369,280000,224000,0,0,0,0,0,0,-2,940,940,0,-2,0,0,0,-2,699,699,0,-2,0,0,0
6370,150000,120000,0,0,0,0,0,0,0,48194,5175,43019,0,32264,3000,29264,0,25579,10000,15579,0,0,0,0
6371,50000,40000,0,0,0,0,0,0,0,15750,2000,13750,0,17434,2000,15434,0,19220,2000,17220,0,17822,605,17217
6372,100000,80000,0,0,0,0,0,0,2,71910,3515,68395,0,65693,6300,59393,0,63835,13,63822,2,18660,765,17895
6373,50000,40000,0,0,0,0,0,0,2,22219,4042,18177,2,21520,0,21520,3,20108,648,19460,2,18207,0,18207
6374,160000,128000,0,0,0,0,0,0,-1,3003,3740,-737,-1,737,0,737,0,0,0,0,0,894,894,0
6375,50000,40000,0,1,1,0,0,0,0,51463,4800,46663,0,49952,0,49952,2,19584,837,18747,0,19080,700,18380
6376,20000,16000,0,0,0,1,1,0,0,444,444,0,-1,20444,20000,444,0,18976,600,18376,0,19802,1000,18802
6377,310000,248000,0,0,0,0,0,0,0,210583,8311,202272,0,210982,6928,204054,0,126502,3539,122963,0,102999,2991,100008
6378,90000,72000,0,0,0,0,0,0,0,0,0,0,-2,0,0,0,-2,0,0,0,-2,0,0,0
6379,50000,40000,0,1,1,1,1,1,3,47517,2000,45517,2,48439,2000,46439,2,49418,1900,47518,2,50326,1900,48426
6380,300000,240000,0,0,0,0,0,0,-1,342,342,0,-1,25022,25081,-59,-1,0,0,0,-1,0,0,0
6381,300000,240000,0,1,0,0,0,0,0,298378,15056,283322,0,131103,5027,126076,0,128742,5007,123735,0,124882,5063,119819
6382,150000,120000,0,0,0,0,0,0,-1,4996,4996,0,-1,4998,5000,-2,-1,4998,4998,0,-1,49398,49398,0
6383,500000,400000,0,0,0,0,0,0,0,201715,7412,194303,0,141177,4721,136456,0,130352,3854,126498,0,126422,3622,122800
6384,150000,120000,0,1,1,1,1,0,0,130080,4723,125357,0,131238,3323,127915,0,141612,11086,130526,0,140868,0,140868
6385,200000,160000,0,1,1,1,1,0,0,194045,8000,186045,0,189557,7011,182546,0,177185,8500,168685,0,171010,6010,165000
6386,180000,144000,0,0,0,0,0,0,-1,2821,0,2821,2,0,0,0,2,2821,2821,0,-1,0,0,0
6387,80000,64000,0,1,1,1,1,0,2,81380,3299,78081,0,75374,2699,72675,0,77158,3000,74158,0,78710,2987,75723
6388,210000,168000,0,0,0,0,0,1,-1,0,0,0,-1,0,0,0,-2,5916,5916,0,-1,0,0,0
6389,10000,8000,0,0,1,1,1,1,2,8882,2400,6482,2,8520,0,8520,2,8694,174,8520,0,8871,177,8694
6390,140000,112000,0,0,0,0,0,0,0,55232,4600,50632,0,55932,2200,53732,2,54910,0,54910,2,57344,3513,53831
6391,100000,80000,0,0,0,0,0,1,4,54083,0,54083,3,54601,2000,52601,2,55585,2000,53585,2,57027,2500,54527
6392,10000,8000,0,0,1,1,1,0,0,8833,2229,6604,0,9604,1000,8604,0,9800,196,9604,0,10000,200,9800
6393,260000,208000,0,0,0,0,0,0,0,2551,2551,0,-1,-139,0,-139,-1,2311,2450,-139,-1,47,0,47
6394,50000,40000,0,1,1,0,0,0,0,51053,4100,46953,0,43611,0,43611,2,19785,900,18885,0,20104,2000,18104
6395,220000,176000,0,0,0,0,0,0,-1,743,0,743,3,43,0,43,2,-657,0,-657,2,-1357,0,-1357
6396,230000,184000,0,0,0,0,0,0,0,33477,3000,30477,0,34914,2000,32914,0,36352,2000,34352,0,37745,2000,35745
6397,80000,64000,0,0,0,0,0,0,0,0,0,0,0,0,0,0,-2,0,0,0,-2,0,0,0
6398,340000,272000,0,1,0,0,0,0,0,318616,10631,307985,0,243586,8900,234686,0,248766,9200,239566,0,254056,9525,244531
6399,340000,272000,0,0,0,0,0,0,0,74983,2047,72936,0,43557,766,42791,0,15559,77,15482,0,0,0,0
6400,50000,40000,0,1,1,1,1,0,2,45596,1900,43696,0,48089,3300,44789,0,46790,0,46790,2,46982,1558,45424
6401,70000,56000,0,1,0,0,0,0,0,66447,2730,63717,0,49103,1936,47167,0,45830,1700,44130,0,46769,1700,45069
6402,20000,16000,0,0,0,0,0,0,0,9489,3000,6489,0,11349,2000,9349,0,14176,3000,11176,0,15616,3000,12616
6403,200000,160000,0,1,1,0,0,0,0,180357,6500,173857,0,168935,6146,162789,0,88883,3300,85583,0,88973,2476,86497
6404,170000,136000,0,1,1,1,1,0,0,168142,7540,160602,0,169821,6301,163520,0,173014,6517,166497,0,163570,6035,157535
6405,30000,24000,0,1,1,1,0,0,0,30107,3000,27107,0,29923,4000,25923,0,29472,2000,27472,0,27729,4000,23729
6406,230000,184000,0,0,0,0,0,0,-2,0,0,0,-2,147,147,0,-2,0,0,0,-2,0,0,0
6407,80000,64000,0,0,0,0,0,0,-1,0,0,0,-1,0,0,0,-2,0,0,0,-2,0,0,0
6408,80000,64000,0,0,0,0,0,0,0,31023,14016,17007,0,-2639,0,-2639,0,-2787,2000,-4787,-2,34732,38000,-3268
6409,130000,104000,0,0,0,0,0,1,0,12394,3000,9394,0,11883,0,11883,2,9826,500,9326,0,10167,500,9667
6410,360000,288000,0,0,0,0,0,0,-1,26510,26510,0,-1,50810,51109,-299,-1,20800,2080,18720,0,0,0,0
6411,20000,16000,0,0,0,0,0,0,0,13484,1535,11949,0,7612,1000,6612,0,8612,1000,7612,0,5007,1000,4007
6412,110000,88000,0,0,0,0,0,1,0,16412,1102,15310,2,16809,1000,15809,2,8682,0,8682,2,8861,602,8259
6413,210000,168000,0,0,0,0,0,1,-1,23816,1816,22000,0,24303,1303,23000,0,16742,0,16742,0,3187,0,3187
6414,30000,24000,0,1,1,1,1,0,0,29312,2632,26680,0,29680,1000,28680,0,29689,1176,28513,0,31050,830,30220
6415,180000,144000,0,0,0,0,0,0,0,11718,1000,10718,0,5265,105,5160,0,3950,79,3871,0,270,270,0
6416,290000,232000,0,0,0,0,0,0,-2,3155,3155,0,-1,0,0,0,-1,2359,2359,0,-1,0,0,0
6417,20000,16000,0,1,1,1,1,0,2,17302,1000,16302,2,18029,1000,17029,0,18362,1000,17362,0,18669,1000,17669
6418,160000,128000,0,0,0,0,0,1,-1,0,0,0,-2,0,0,0,-2,0,0,0,-2,0,0,0
6419,360000,288000,0,0,0,0,0,0,-1,14697,14697,0,-1,10687,0,10687,0,1968,2141,-173,-1,1272,1272,0
6420,220000,176000,0,1,0,0,0,0,0,189016,7261,181755,0,137788,5170,132618,0,106713,4054,102659,0,96588,4500,92088
6421,130000,104000,0,0,0,0,0,0,0,-829,0,-829,-2,-829,0,-829,-2,-829,0,-829,-2,-829,0,-829
6422,70000,56000,0,1,0,0,0,0,0,73831,4231,69600,0,46898,8000,38898,0,48686,2500,46186,0,47171,1675,45496
6423,360000,288000,0,0,0,0,0,0,-1,2500,0,2500,2,0,0,0,2,0,0,0,-2,0,0,0
6424,200000,160000,0,0,0,0,0,0,-1,1707,8,1699,2,617,617,0,-1,620,3,617,0,0,0,0
6425,440000,352000,0,0,0,0,0,0,-1,19669,19669,0,-1,18613,33152,-14539,-1,13669,0,13669,0,24849,20000,4849
6426,170000,136000,0,0,0,0,0,0,-2,0,0,0,-2,0,0,0,-2,200,200,0,-1,0,0,0
6427,160000,128000,0,0,0,0,0,0,-1,0,0,0,-1,0,0,0,-2,0,0,0,-2,660,660,0
6428,220000,176000,0,0,0,0,0,0,-2,0,0,0,-2,0,0,0,-2,0,0,0,-2,0,0,0
6429,20000,16000,0,1,1,0,0,0,0,20025,4000,16025,0,28806,300,28506,2,14463,10000,4463,0,18668,5000,13668
6430,290000,232000,0,0,0,0,0,1,0,152434,11430,141004,0,156413,6900,149513,0,156189,5320,150869,0,144318,5232,139086
6431,150000,120000,0,1,0,0,0,0,0,132677,5300,127377,0,86265,3500,82765,0,88390,5000,83390,0,90599,4000,86599
6432,180000,144000,0,0,0,0,0,0,2,390,390,0,-1,1726,1726,0,-1,390,390,0,-1,2240,2240,0
6433,70000,56000,0,0,0,0,0,1,2,32855,2531,30324,2,33316,1300,32016,2,34137,1500,32637,2,33439,0,33439
6434,180000,144000,0,0,0,0,0,1,2,8414,3000,5414,2,8062,0,8062,2,5052,200,4852,0,2806,0,2806
6435,160000,128000,0,0,0,0,0,0,-2,5608,5608,0,-2,1851,1851,0,-2,2801,2801,0,-2,3268,3268,0
6436,100000,80000,0,0,0,0,0,0,0,57529,3155,54374,0,58070,1696,56374,0,58615,1889,56726,0,58760,1764,56996
6437,140000,112000,0,1,1,1,1,0,0,134487,6487,128000,0,135945,5025,130920,0,131296,6101,125195,0,139207,10601,128606
6438,150000,120000,0,0,0,1,1,1,2,122881,3000,119881,2,123954,4600,119354,0,131543,9800,121743,0,134319,5100,129219
6439,100000,80000,0,0,0,0,0,0,0,70000,2600,67400,0,70298,3000,67298,0,69677,2500,67177,0,69672,2500,67172
6440,100000,80000,0,0,0,0,0,0,0,42417,0,42417,2,40287,1500,38787,0,42938,3300,39638,0,42095,0,42095
6441,420000,336000,0,0,0,0,0,1,0,277447,40000,237447,0,287781,15000,272781,0,294010,11000,283010,0,319257,30000,289257
6442,20000,16000,0,1,1,1,1,0,2,18327,2200,16127,2,17735,0,17735,2,19446,2000,17446,2,18988,0,18988
6443,50000,40000,0,0,0,0,0,0,2,2262,2262,0,-1,2185,2185,0,-1,0,0,0,-1,5918,5918,0
6444,20000,16000,0,0,0,0,0,0,-1,628,700,-72,-1,2198,2500,-302,-1,365,0,365,0,-34,0,-34
6445,230000,184000,0,0,0,0,0,1,-1,5776,5816,-40,-1,1332,1340,-8,-1,5342,5342,0,-1,3162,4,3158
6446,200000,160000,0,0,0,0,0,0,0,73534,3000,70534,0,74785,2000,72785,0,79985,5400,74585,0,3065,3080,-15
6447,30000,24000,0,1,1,1,1,1,3,24728,0,24728,2,26041,1730,24311,0,26511,1200,25311,0,27034,1100,25934
6448,60000,48000,0,1,1,1,0,0,2,60943,3250,57693,2,60716,1767,58949,2,58458,0,58458,2,49529,3654,45875
6449,20000,16000,0,0,0,0,0,1,0,10015,2000,8015,2,9195,329,8866,0,9539,492,9047,0,9574,342,9232
6450,350000,280000,0,0,0,0,0,0,0,70244,3371,66873,0,64839,2089,62750,0,57583,3008,54575,0,45554,1300,44254
6451,150000,120000,0,0,0,0,0,0,2,3964,1000,2964,0,0,0,0,0,0,0,0,-2,2322,2322,0
6452,180000,144000,0,1,1,1,1,0,0,182533,14010,168523,0,176099,4,176095,2,178391,6431,171960,0,181986,6600,175386
6453,80000,64000,0,1,0,0,0,0,0,68602,3300,65302,0,54617,2000,52617,0,55987,2200,53787,0,53895,2100,51795
6454,580000,464000,0,0,0,1,1,1,2,437254,38001,399253,0,477809,50000,427809,0,486721,16881,469840,0,498316,18887,479429
6455,150000,120000,0,0,0,0,0,0,0,3305,3310,-5,-1,11164,11164,0,-1,18803,18800,3,0,22891,10000,12891
6456,300000,240000,0,0,0,0,0,0,-1,63982,45153,18829,0,124493,102749,21744,0,16367,186,16181,0,41338,45079,-3741
6457,60000,48000,0,1,1,1,1,0,0,59225,2800,56425,0,59947,2300,57647,0,60107,2250,57857,0,57338,2081,55257
6458,490000,392000,0,0,0,0,0,0,-1,57426,57428,-2,-1,35554,1068,34486,0,15858,3000,12858,0,23033,23033,0
6459,70000,56000,0,0,0,0,0,0,0,16105,1534,14571,0,17571,2000,15571,0,18330,1000,17330,0,16268,1000,15268
6460,270000,216000,0,0,0,0,0,0,0,172281,6254,166027,0,175705,6290,169415,0,179582,6710,172872,0,184650,8250,176400
6461,290000,232000,0,0,0,0,0,0,0,102180,48345,53835,0,58554,1689,56865,0,59358,1516,57842,0,45266,1240,44026
6462,320000,256000,0,0,0,0,0,0,2,232702,232702,0,-1,3529,3529,0,-1,14212,14212,0,-1,1166,1200,-34
6463,260000,208000,0,0,0,0,0,0,-1,75036,75038,-2,-1,96787,96793,-6,-1,16576,16576,0,-1,6844,6844,0
6464,200000,160000,0,0,0,0,0,0,-1,-4,0,-4,-1,-4,0,-4,-2,1565,1569,-4,-1,1686,1691,-5
6465,460000,368000,0,0,0,0,0,0,-2,0,0,0,-2,0,0,0,-2,630,630,0,-2,0,0,0
6466,100000,80000,0,0,0,0,0,0,0,47885,7000,40885,0,46817,0,46817,2,48400,2500,45900,0,51588,4000,47588
6467,200000,160000,0,0,0,0,0,0,-2,3519,3554,-35,-2,1846,1855,-9,-2,1330,1337,-7,-2,14470,14542,-72
6468,300000,240000,0,0,0,0,0,1,-2,0,0,0,-2,0,0,0,-2,0,0,0,-2,0,0,0
6469,70000,56000,0,0,0,0,0,0,0,40476,3000,37476,0,43687,7000,36687,0,43858,10000,33858,0,48127,15000,33127
6470,260000,208000,0,0,0,0,0,0,-2,0,0,0,-2,0,0,0,-2,0,0,0,-2,36150,36150,0
6471,30000,24000,0,1,1,0,0,1,0,29710,3623,26087,0,29452,2000,27452,0,11124,1038,10086,0,0,0,0
6472,160000,128000,0,0,0,0,0,0,-1,5923,5939,-16,-1,158,158,0,-1,11030,11030,0,-1,158,158,0
6473,200000,160000,0,0,0,0,0,0,0,119691,14269,105422,0,116278,0,116278,2,128087,13808,114279,2,125931,0,125931
6474,20000,16000,0,0,0,0,0,1,-1,1170,0,1170,2,780,0,780,0,780,0,780,0,0,0,0
6475,50000,40000,0,1,0,0,0,0,0,49903,1801,48102,0,41083,1468,39615,0,29635,1043,28592,0,30261,1085,29176
6476,260000,208000,0,0,0,0,0,0,0,143240,5000,138240,0,150000,10000,140000,0,14098,14098,0,-1,28736,15000,13736
6477,190000,152000,0,0,0,0,0,1,-2,-2650,1941,-4591,-2,-5036,0,-5036,-2,-5036,0,-5036,-2,93493,98529,-5036
6478,80000,64000,0,0,0,0,0,0,-1,-600,0,-600,-1,-600,0,-600,-2,-600,0,-600,-2,-600,0,-600
6479,320000,256000,0,0,0,0,0,0,0,20011,4100,15911,0,17918,1000,16918,0,18627,1000,17627,0,19167,1000,18167
6480,80000,64000,0,0,0,0,0,0,-1,8673,3683,4990,0,11590,5034,6556,0,5973,5981,-8,-1,5878,2895,2983
6481,170000,136000,0,0,0,0,0,0,-1,2986,2986,0,-1,0,0,0,-1,0,0,0,-2,0,0,0
6482,160000,128000,0,0,0,0,0,0,-1,3062,3062,0,-1,6117,6119,-2,-1,4781,4781,0,-1,1450,0,1450
6483,60000,48000,0,1,0,0,0,1,0,56550,1593,54957,0,43279,1348,41931,0,28289,1012,27277,0,28013,1016,26997
6484,70000,56000,0,0,0,0,0,0,-1,13411,2000,11411,0,14470,1400,13070,0,18070,5000,13070,0,15000,300,14700
6485,50000,40000,0,0,0,0,0,0,0,30897,3000,27897,0,14693,5000,9693,0,247,0,247,0,0,0,0
6486,100000,80000,0,0,0,0,0,0,0,17841,2500,15341,0,15317,3000,12317,0,12630,6000,6630,0,11750,2500,9250
6487,420000,336000,0,0,0,0,0,0,0,36569,28000,8569,0,28994,1210,27784,0,15159,303,14856,0,9379,2000,7379
6488,350000,280000,0,0,0,0,0,0,0,76156,4000,72156,0,51500,2500,49000,0,150,150,0,-1,500,500,0
6489,50000,40000,0,0,0,0,0,0,0,23595,1400,22195,0,22590,800,21790,0,21788,1000,20788,0,21949,900,21049
6490,80000,64000,0,1,1,1,0,1,6,76767,0,76767,5,75393,0,75393,4,74731,0,74731,3,23207,0,23207
6491,70000,56000,0,0,0,0,0,1,0,26103,5106,20997,0,28342,4026,24316,0,24894,755,24139,0,25272,1029,24243
6492,50000,40000,0,0,0,0,0,1,0,34212,1861,32351,0,33886,2004,31882,0,32929,1324,31605,0,34549,3768,30781
6493,70000,56000,0,1,1,1,1,0,2,70640,2600,68040,0,71298,3000,68298,0,70930,3000,67930,0,72491,6000,66491
6494,30000,24000,0,1,0,1,1,0,3,24989,0,24989,2,25068,1500,23568,0,26145,1500,24645,0,27219,1500,25719
6495,450000,360000,0,0,0,0,0,1,-2,5226,5241,-15,-2,4715,4729,-14,-2,3275,3284,-9,-2,6422,6441,-19
6496,200000,160000,0,0,0,0,0,0,-1,5171,5171,0,-1,4598,4598,0,-1,-95,0,-95,-1,-2175,0,-2175
6497,260000,208000,0,1,0,0,0,1,0,252615,24799,227816,0,186443,0,186443,2,190345,7035,183310,0,193739,7078,186661
6498,400000,320000,0,0,0,0,0,0,-2,11649,11713,-64,-2,24140,24265,-125,-2,5803,7832,-2029,-2,5937,5966,-29
6499,420000,336000,0,0,0,0,0,0,0,31233,1401,29832,0,22768,804,21964,0,22588,852,21736,0,22172,0,22172
6500,110000,88000,0,1,1,1,1,1,2,92351,0,92351,2,101140,11300,89840,2,99260,0,99260,3,101577,4100,97477
6501,230000,184000,0,0,0,0,0,1,-2,33,33,0,-1,33,0,33,2,33,0,33,2,1133,1100,33
6502,140000,112000,0,0,0,0,0,0,0,57088,5000,52088,0,62868,6500,56368,0,65284,3000,62284,0,69663,5000,64663
6503,30000,24000,0,0,0,0,0,1,-1,390,390,0,-1,390,390,0,-1,390,390,0,-1,0,0,0
6504,240000,192000,0,0,0,0,0,0,-2,0,0,0,-2,0,0,0,-2,620,620,0,-2,0,0,0
6505,140000,112000,0,0,0,0,0,0,-1,14910,14910,0,-1,44967,44967,0,-1,11669,11669,0,-1,5169,5169,0
6506,20000,16000,0,0,0,0,0,1,3,10015,1200,8815,2,9705,0,9705,2,10540,1000,9540,2,10825,600,10225
6507,140000,112000,0,1,1,1,1,0,2,140185,5000,135185,2,136438,0,136438,2,144979,10800,134179,2,139314,0,139314
6508,240000,192000,0,0,0,0,0,0,-2,343,343,0,-2,315,315,0,-2,6000,6000,0,-2,0,0,0
6509,100000,80000,0,0,0,0,0,0,0,560,560,0,-1,480,500,-20,-1,480,480,0,-1,390,390,0
6510,80000,64000,0,1,0,0,0,0,0,78078,4613,73465,0,28868,1100,27768,0,29174,1500,27674,0,29444,1500,27944
6511,180000,144000,0,0,0,0,0,0,0,77720,2900,74820,0,79430,3000,76430,0,81098,3100,77998,0,82791,3200,79591
6512,240000,192000,0,1,0,0,1,0,0,192140,0,192140,2,194357,6947,187410,0,205637,14402,191235,0,202417,33,202384
6513,310000,248000,0,0,0,0,0,0,0,179260,7809,171451,0,116798,10000,106798,0,109647,10000,99647,0,114745,10334,104411
6514,390000,312000,0,0,0,0,0,0,-1,78686,78772,-86,-1,63021,1371,61650,0,41653,919,40734,0,24679,13770,10909
6515,200000,160000,0,0,0,0,0,1,0,76945,4000,72945,0,82914,8000,74914,0,83733,2900,80833,2,80498,0,80498
6516,80000,64000,0,0,0,0,0,0,2,0,0,0,2,3521,3521,0,-1,0,0,0,-1,14206,14206,0
6517,130000,104000,0,0,0,0,0,1,-1,321,321,0,-1,0,0,0,-1,321,321,0,-1,0,0,0
6518,60000,48000,0,0,0,0,0,0,2,8113,0,8113,2,8971,1000,7971,0,10824,2000,8824,0,11646,1000,10646
6519,440000,352000,0,0,0,0,0,0,-2,4697,4697,0,-2,7502,7502,0,-2,2249,2249,0,-2,4532,4532,0
6520,300000,240000,0,0,0,0,0,0,-1,0,0,0,-2,0,0,0,-2,0,0,0,-2,0,0,0
6521,160000,128000,0,0,0,0,0,0,0,17561,0,17561,2,17094,17098,-4,-1,4353,4353,0,-1,4906,2500,2406
6522,50000,40000,0,0,0,0,0,0,0,41150,2150,39000,0,0,0,0,0,0,0,0,-2,0,0,0
6523,50000,40000,0,1,1,0,0,1,0,50409,2000,48409,0,45545,2000,43545,0,39963,2000,37963,0,41145,2000,39145
6524,300000,240000,0,0,0,0,0,0,-1,3351,3357,-6,-1,1961,1965,-4,-1,4409,4419,-10,-1,2503,2509,-6
6525,50000,40000,0,1,0,0,0,0,0,50447,1703,48744,0,34608,1406,33202,0,22658,721,21937,0,18503,645,17858
6526,260000,208000,0,0,0,0,0,0,-2,1058,1058,0,-2,2106,2106,0,-2,2282,2282,0,-2,2531,2531,0
6527,200000,160000,1,1,1,1,1,1,0,201714,157,201557,2,177469,10000,167469,0,184502,10000,174502,0,191529,10000,181529
6528,380000,304000,0,0,0,0,0,0,2,966,966,0,-1,1258,1500,-242,-1,1121,1121,0,-1,1362,1362,0
6529,130000,104000,0,0,0,0,0,1,2,99330,5000,94330,0,94501,3358,91143,0,91503,3500,88003,0,91064,6000,85064
6530,200000,160000,0,0,0,0,0,0,-2,324,324,0,-2,3741,3741,0,-1,1374,0,1374,0,2932,3118,-186
6531,60000,48000,0,1,1,0,0,1,2,58025,9000,49025,0,59724,3000,56724,0,28575,1200,27375,0,39402,11500,27902
6532,170000,136000,0,0,0,0,0,0,-1,978,978,0,-1,1009,1009,0,-1,1101,1101,0,-1,0,0,0
6533,250000,200000,0,0,0,0,0,0,0,151841,0,151841,2,152803,5469,147334,0,155997,5656,150341,0,160220,6811,153409
6534,50000,40000,0,0,0,0,0,0,0,658,658,0,-1,1473,1000,473,0,1473,1473,0,-1,1473,1473,0
6535,360000,288000,0,0,0,0,0,0,0,279728,10212,269516,0,264189,8000,256189,0,271688,10000,261688,0,288740,20000,268740
6536,170000,136000,0,0,0,0,0,1,0,20852,1200,19652,0,17560,351,17209,0,17918,358,17560,0,9100,182,8918
6537,80000,64000,0,0,0,0,0,0,-2,0,0,0,-2,0,0,0,-2,0,0,0,-2,0,0,0
6538,110000,88000,0,0,0,0,0,0,0,56779,2100,54679,0,56580,2100,54480,0,57509,2076,55433,0,58715,2400,56315
6539,30000,24000,0,1,1,1,1,1,2,30571,2670,27901,2,31011,2000,29011,2,30389,0,30389,2,30115,1000,29115
6540,200000,160000,0,0,0,0,0,0,0,179964,100000,79964,0,-36,0,-36,0,5654,5690,-36,-1,804,0,804
6541,30000,24000,0,1,1,1,1,1,2,30603,3569,27034,2,29802,0,29802,2,30134,1100,29034,0,30410,1100,29310
6542,30000,24000,0,0,0,0,0,0,0,11427,1500,9927,0,11935,1000,10935,0,13084,1500,11584,0,14206,1500,12706
6543,170000,136000,0,0,0,0,0,0,0,118111,5000,113111,0,92592,10000,82592,0,96114,5000,91114,0,99628,5000,94628
6544,50000,40000,1,1,1,0,0,0,3,51173,7,51166,2,50033,1104,48929,0,9779,445,9334,0,9924,400,9524
6545,50000,40000,0,0,0,0,0,0,0,23740,3014,20726,0,19448,684,18764,0,19594,1000,18594,0,19762,713,19049
6546,220000,176000,0,0,0,0,0,0,0,43462,16992,26470,0,36222,5225,30997,0,19055,2000,17055,0,3098,1000,2098
6547,240000,192000,0,0,0,0,0,0,0,51171,3000,48171,0,52716,3000,49716,0,54229,3000,51229,0,56191,3000,53191
6548,160000,128000,0,1,1,1,1,0,2,155301,6085,149216,2,155152,12534,142618,2,144602,0,144602,2,148199,6000,142199
6549,50000,40000,0,0,0,0,0,0,0,20024,1561,18463,0,18830,628,18202,0,18087,775,17312,0,17616,1602,16014
6550,90000,72000,0,0,0,0,0,0,0,10549,2012,8537,0,9421,3022,6399,0,6851,2020,4831,0,2133,2139,-6
6551,100000,80000,0,0,0,0,0,1,0,39185,1888,37297,0,39867,1500,38367,0,39696,96,39600,2,7594,300,7294
6552,90000,72000,0,0,0,0,0,0,0,41498,2406,39092,0,36492,1400,35092,0,24636,493,24143,0,5298,106,5192
6553,500000,400000,0,0,0,0,0,0,-2,4338,4338,0,-2,1080,1100,-20,-1,2576,2576,0,-1,6200,1024,5176
6554,150000,120000,0,0,0,0,0,0,-2,36490,36672,-182,-2,3125,3232,-107,-2,7603,7641,-38,-2,2995,3010,-15
6555,130000,104000,0,0,0,0,0,0,-1,390,390,0,-1,390,390,0,-1,390,390,0,-1,390,390,0
6556,200000,160000,0,0,0,0,0,0,0,44095,3000,41095,0,25454,3000,22454,0,17651,2000,15651,0,18994,3000,15994
6557,360000,288000,0,0,0,0,0,0,-1,3935,3946,-11,-1,2437,2444,-7,-1,2797,2805,-8,-1,256,258,-2
6558,310000,248000,0,0,0,0,0,0,0,9507,4507,5000,0,8894,1000,7894,0,7418,283,7135,0,12154,7482,4672
6559,50000,40000,0,1,1,1,1,0,0,45393,10,45383,2,49351,8212,41139,2,45473,1200,44273,2,48595,4008,44587
6560,50000,40000,0,1,0,0,0,0,0,48916,2000,46916,0,19894,1000,18894,0,20572,1000,19572,0,21230,1000,20230
6561,30000,24000,0,1,1,1,1,0,2,28781,3600,25181,2,28000,0,28000,2,29779,2524,27255,2,27343,0,27343
6562,300000,240000,0,0,0,0,0,0,-1,1656,1656,0,-1,1756,1756,0,-2,1776,1776,0,-2,3414,3414,0
6563,20000,16000,0,0,0,0,0,0,0,998,1101,-103,-2,734,736,-2,-2,1698,1799,-101,-1,500,601,-101
6564,10000,8000,0,0,0,0,0,0,0,5732,3000,2732,0,6576,1104,5472,0,7472,1000,6472,0,8359,1000,7359
6565,210000,168000,0,0,0,0,0,0,-1,3584,5800,-2216,-1,1756,6256,-4500,-1,732,732,0,-1,730,730,0
6566,120000,96000,0,0,0,0,0,0,-2,0,0,0,-2,0,0,0,-2,0,0,0,-2,0,0,0
6567,260000,208000,0,0,0,0,0,0,0,0,0,0,0,0,0,0,-2,0,0,0,-2,0,0,0
6568,20000,16000,0,0,0,0,0,1,4,8076,0,8076,3,7798,0,7798,2,8110,441,7669,0,10194,2368,7826
6569,260000,208000,0,0,0,0,0,0,0,138076,5003,133073,0,110044,5004,105040,0,111906,4052,107854,0,104073,4010,100063
6570,140000,112000,0,0,0,1,0,0,-2,167,167,0,-1,80644,80677,-33,-1,146651,0,146651,2,55776,2500,53276
6571,300000,240000,0,0,0,0,0,0,-1,-1921,0,-1921,-1,-1921,0,-1921,-2,1912,3833,-1921,-1,1921,9,1912
6572,230000,184000,0,0,0,0,0,0,2,115898,4600,111298,0,112930,4300,108630,0,115743,4700,111043,0,118933,5124,113809
6573,50000,40000,0,0,0,0,0,0,0,22161,2000,20161,0,24784,3000,21784,0,26750,2700,24050,0,29632,3500,26132
6574,70000,56000,0,1,1,1,1,0,0,67605,2507,65098,0,68855,2428,66427,0,70377,2594,67783,0,67818,2602,65216
6575,180000,144000,0,1,1,1,1,0,0,170788,8000,162788,0,174764,7000,167764,0,162667,6000,156667,0,166953,7000,159953
6576,200000,160000,0,0,0,0,0,0,-1,890,896,-6,-1,14137,14337,-200,-1,18067,7022,11045,0,24306,12000,12306
6577,50000,40000,0,1,1,0,0,0,2,43579,2207,41372,0,43825,2300,41525,0,28396,1006,27390,0,27437,1000,26437
6578,310000,248000,0,0,0,0,0,0,0,44209,2000,42209,0,45472,2000,43472,0,46739,2000,44739,0,47895,2000,45895
6579,30000,24000,0,1,1,1,1,1,2,29150,73,29077,2,26731,1418,25313,0,29273,4499,24774,0,29887,1200,28687
6580,70000,56000,0,0,0,0,0,0,0,9660,9660,0,-2,6208,6208,0,-1,702,702,0,-1,4320,4320,0
6581,20000,16000,1,1,1,1,0,0,0,44267,5000,39267,0,47149,10000,37149,-1,48497,3011,45486,0,14774,2011,12763
6582,140000,112000,0,0,0,0,0,0,0,56504,6000,50504,0,53528,5026,48502,0,42168,5000,37168,0,25742,3000,22742
6583,50000,40000,0,0,0,0,0,0,-1,0,0,0,-1,8796,8796,0,-1,6346,1000,5346,0,3600,4000,-400
6584,30000,24000,0,0,0,1,1,0,0,19869,10001,9868,0,26173,7000,19173,0,26848,1107,25741,0,27266,1000,26266
6585,230000,184000,0,0,0,0,0,0,-2,510,510,0,-2,0,0,0,-2,162,162,0,-2,0,0,0
6586,430000,344000,0,0,0,0,0,0,-2,46935,46935,0,-2,0,0,0,-2,46987,46987,0,-2,882,882,0
6587,10000,8000,0,0,0,0,0,1,0,9024,1200,7824,0,6292,1012,5280,0,2530,2530,0,-1,6727,6727,0
6588,360000,288000,0,0,0,0,0,0,-2,14101,14171,-70,-2,11959,12023,-64,-2,3184,3200,-16,-2,7252,7288,-36
6589,80000,64000,0,0,0,0,0,0,-1,4356,1000,3356,0,3450,0,3450,0,4318,4318,0,-1,0,0,0
6590,90000,72000,0,1,1,0,0,1,0,88338,4000,84338,0,78994,2602,76392,0,50095,2000,48095,0,48987,3000,45987
6591,450000,360000,0,0,0,0,0,0,-1,6350,6364,-14,-2,11670,11728,-58,-2,1530,1532,-2,-1,1232,1234,-2
6592,50000,40000,0,1,1,1,1,0,0,47332,2200,45132,0,47382,1600,45782,0,47370,978,46392,0,46200,2000,44200
6593,230000,184000,0,0,0,0,0,0,0,65691,2386,63305,0,67150,2553,64597,0,68398,2483,65915,0,69917,2657,67260
6594,310000,248000,0,0,0,0,0,0,0,43449,1460,41989,0,44925,1936,42989,0,42725,1742,40983,0,34303,1303,33000
6595,290000,232000,0,0,0,0,0,0,2,136012,5400,130612,0,136466,5200,131266,0,136929,5000,131929,0,132179,4667,127512
6596,50000,40000,0,0,1,0,0,0,0,50135,13000,37135,0,49526,5000,44526,0,19686,4010,15676,0,19374,6000,13374
6597,120000,96000,0,1,1,1,1,0,0,111238,4040,107198,0,113465,4079,109386,0,114759,4093,110666,0,117165,4240,112925
6598,190000,152000,0,0,0,0,0,0,0,129167,6147,123020,0,130331,4800,125531,0,132958,4800,128158,0,135814,5000,130814
6599,380000,304000,0,0,0,0,0,0,0,74275,12712,61563,0,47723,10000,37723,0,67463,20000,47463,0,36751,16751,20000
6600,500000,400000,0,0,0,0,0,0,-1,19230,19230,0,-1,116696,100062,16634,0,194483,94503,99980,0,195454,10000,185454
6601,30000,24000,0,1,1,1,1,0,0,30546,1613,28933,2,30255,1453,28802,0,30096,946,29150,0,30353,997,29356
6602,200000,160000,0,0,0,0,0,1,-1,69048,69054,-6,-1,3352,2000,1352,0,1992,0,1992,0,1176,1176,0
6603,100000,80000,0,0,0,0,0,0,2,44145,2000,42145,0,46148,3000,43148,0,43750,2000,41750,0,44771,2000,42771
6604,50000,40000,0,0,0,0,0,0,0,30785,1493,29292,0,29405,1393,28012,0,26594,912,25682,0,26732,940,25792
6605,350000,280000,0,0,0,0,0,0,-2,316,316,0,-2,466,466,0,-2,466,466,0,-2,316,316,0
6606,290000,232000,0,0,0,0,0,0,0,20073,1476,18597,0,25966,10002,15964,0,22347,447,21900,0,12572,251,12321
6607,160000,128000,0,0,0,0,0,0,0,0,0,0,-2,0,0,0,-2,390,390,0,-1,86188,86188,0
6608,100000,80000,0,0,0,0,0,0,0,63533,3000,60533,0,57079,3000,54079,0,16634,1000,15634,0,26438,10022,16416
6609,50000,40000,0,0,0,0,0,1,0,13012,1600,11412,0,13789,1300,12489,0,14560,1000,13560,0,15025,700,14325
6610,100000,80000,0,0,0,0,0,0,0,65864,3000,62864,0,66578,2400,64178,0,69503,4000,65503,0,72346,4000,68346
6611,400000,320000,0,0,0,0,0,0,0,60763,2200,58563,0,53184,1700,51484,0,45776,1500,44276,0,38432,1315,37117
6612,180000,144000,0,0,0,0,0,0,0,51869,2000,49869,0,52999,2468,50531,0,52096,1850,50246,0,52704,1909,50795
6613,120000,96000,0,0,0,0,0,0,0,5283,1000,4283,0,5444,1000,4444,0,6412,1000,5412,0,5121,1825,3296
6614,10000,8000,0,0,0,1,1,1,2,7968,2800,5168,0,8829,1000,7829,0,9685,1000,8685,0,9384,0,9384
6615,160000,128000,0,0,0,0,0,0,2,28328,0,28328,2,29099,1200,27899,0,29724,1200,28524,0,30624,1500,29124
6616,300000,240000,0,0,0,0,0,0,0,130595,4995,125600,0,132683,4516,128167,0,128557,4034,124523,0,125900,4088,121812
6617,500000,400000,0,0,0,0,0,0,0,9739,1049,8690,0,579,767,-188,-1,53599,87150,-33551,-1,25276,931,24345
6618,340000,272000,0,0,0,0,0,0,0,263928,18000,245928,0,260916,13000,247916,0,257001,12000,245001,0,210033,12000,198033
6619,80000,64000,0,0,0,0,0,0,0,47306,1801,45505,0,51179,5000,46179,0,52073,2035,50038,0,52833,2100,50733
6620,70000,56000,0,1,1,1,1,1,0,68334,2030,66304,2,67132,0,67132,2,66796,1866,64930,0,67743,1878,65865
6621,50000,40000,0,1,1,0,0,0,0,49814,1816,47998,0,51199,2201,48998,0,20306,716,19590,0,20306,721,19585
6622,70000,56000,0,1,1,1,1,0,0,65248,3000,62248,0,62958,2190,60768,0,64209,2201,62008,0,59482,2181,57301
6623,20000,16000,0,0,0,0,0,0,0,1854,1200,654,0,3296,1500,1796,0,3435,300,3135,0,4435,1000,3435
6624,50000,40000,0,0,0,0,0,0,0,5000,1200,3800,0,0,0,0,0,0,0,0,-2,0,0,0
6625,460000,368000,0,0,0,0,0,0,0,316330,12850,303480,0,325874,16700,309174,0,325857,11200,314657,0,327232,12000,315232
6626,180000,144000,0,0,0,0,0,0,0,78639,8000,70639,0,44295,1610,42685,0,44113,10000,34113,0,37805,1333,36472
6627,20000,16000,1,1,1,0,0,0,4,20521,0,20521,3,19817,0,19817,2,14932,448,14484,0,10812,380,10432
6628,160000,128000,0,0,0,0,0,1,-1,833,833,0,-1,833,833,0,-1,833,833,0,-1,833,833,0
6629,70000,56000,0,0,0,0,0,0,2,32397,5043,27354,0,24306,2500,21806,0,24316,2009,22307,0,20216,2015,18201
6630,200000,160000,0,0,0,0,0,0,-2,0,0,0,-2,0,0,0,-2,0,0,0,-2,0,0,0
6631,30000,24000,0,0,0,0,0,1,-1,390,0,390,2,0,0,0,2,9494,9494,0,-1,11473,3000,8473
6632,280000,224000,0,0,0,0,0,1,2,2500,0,2500,2,2500,0,2500,2,2500,0,2500,2,2500,0,2500
6633,190000,152000,1,1,1,1,0,1,5,218603,0,218603,4,202639,0,202639,3,199480,0,199480,2,188113,142000,46113
6634,200000,160000,0,0,0,0,0,0,0,108765,3274,105491,0,96918,3025,93893,0,98685,3266,95419,0,97621,3145,94476
6635,70000,56000,0,0,0,0,0,1,-1,28199,28000,199,0,28980,1250,27730,0,29795,1496,28299,0,27091,29251,-2160
6636,320000,256000,0,0,0,0,0,0,0,120285,15000,105285,0,124565,10000,114565,0,89699,22500,67199,0,62805,20000,42805
6637,320000,256000,0,0,0,0,0,0,0,74909,9805,65104,0,55472,5006,50466,0,53699,3704,49995,0,46313,12860,33453
6638,380000,304000,0,0,0,0,0,0,0,307166,12602,294564,0,311716,11500,300216,0,306830,10500,296330,0,303453,11000,292453
6639,140000,112000,0,1,1,0,0,0,0,132004,7000,125004,0,127275,5000,122275,0,48724,2000,46724,0,48875,2000,46875
6640,230000,184000,0,0,0,0,0,0,-1,326,326,0,-1,326,326,0,-1,1176,1176,0,-1,326,326,0
6641,50000,40000,0,0,0,0,0,0,0,37417,2943,34474,0,24663,0,24663,2,24655,887,23768,0,26088,2000,24088
6642,50000,40000,0,0,0,0,0,0,0,18131,4131,14000,0,18530,1000,17530,0,19079,1000,18079,0,19608,1000,18608
6643,300000,240000,1,1,1,1,1,0,0,322462,11254,311208,0,312973,10956,302017,0,262255,8587,253668,0,251413,8638,242775
6644,500000,400000,0,0,0,0,0,0,-1,12818,12818,0,-1,5674,5674,0,-1,11416,11416,0,-1,36000,36018,-18
6645,210000,168000,0,0,0,0,0,0,0,44864,1564,43300,0,45768,1468,44300,0,48204,3000,45204,0,49453,2000,47453
6646,80000,64000,0,0,0,0,0,0,0,0,0,0,0,0,0,0,-2,0,0,0,-2,0,0,0
6647,20000,16000,0,0,0,0,1,0,0,6741,1305,5436,0,3820,500,3320,0,16945,13500,3445,0,17509,1000,16509
6648,110000,88000,0,0,0,0,0,1,0,40110,2000,38110,0,41362,2000,39362,0,41296,2000,39296,0,41225,2000,39225
6649,230000,184000,0,0,0,0,0,0,-1,1509,1509,0,-1,1390,1390,0,-1,1072,0,1072,0,849,849,0
6650,10000,8000,0,0,1,0,0,0,-1,9159,9159,0,-1,9363,700,8663,0,8160,279,7881,0,7552,1000,6552
6651,30000,24000,1,1,1,0,0,1,0,38569,2200,36369,0,33570,1400,32170,0,19895,2000,17895,0,30125,30000,125
6652,50000,40000,0,0,0,0,0,1,0,3837,1064,2773,0,3913,140,3773,0,4146,296,3850,0,4225,296,3929
6653,80000,64000,0,0,0,0,0,0,0,6107,1500,4607,0,7141,1500,5641,0,7355,700,6655,0,7357,500,6857
6654,20000,16000,0,0,0,0,0,1,2,0,0,0,2,8303,8303,0,-1,8519,500,8019,0,9371,1000,8371
6655,230000,184000,0,0,0,0,0,0,-2,2920,2920,0,-2,2683,2683,0,-2,1674,1674,0,-2,3273,3273,0
6656,210000,168000,0,0,0,0,0,0,0,54019,5000,49019,0,58091,5000,53091,0,61630,4500,57130,0,65576,5000,60576
6657,250000,200000,0,0,0,0,0,0,-1,1372,0,1372,2,686,0,686,0,1522,1522,0,-1,686,0,686
6658,200000,160000,0,0,0,0,0,0,0,50776,1433,49343,0,51018,3224,47794,0,25982,775,25207,0,10170,5000,5170
6659,360000,288000,0,0,0,0,0,0,-1,2043,2043,0,-1,265,265,0,-1,265,265,0,-1,5862,5862,0
6660,140000,112000,0,0,0,0,0,0,0,139067,139067,0,-1,93325,4263,89062,0,94256,3376,90880,0,97009,4274,92735
6661,80000,64000,0,0,0,0,0,0,0,3600,1200,2400,0,0,0,0,0,68424,68424,0,-1,42601,1264,41337
6662,50000,40000,0,1,1,0,0,0,0,48630,2000,46630,0,50803,3000,47803,0,30789,2000,28789,0,15874,2000,13874
6663,20000,16000,0,1,1,1,1,0,0,17563,1388,16175,0,18290,1115,17175,0,18665,490,18175,0,19077,531,18546
6664,50000,40000,0,0,0,0,0,0,0,19917,1310,18607,0,20017,680,19337,0,20146,705,19441,0,20221,728,19493
6665,200000,160000,0,0,0,0,0,0,-2,1293,2000,-707,-1,968,0,968,0,643,0,643,0,318,0,318
6666,50000,40000,0,0,0,0,0,0,0,32101,1246,30855,0,17401,574,16827,0,19820,3000,16820,0,17399,649,16750
6667,20000,16000,0,0,0,0,0,1,2,2400,0,2400,2,2400,0,2400,7,2400,0,2400,7,2400,0,2400
6668,100000,80000,0,1,1,1,0,1,2,96611,4000,92611,2,97947,4005,93942,2,95602,600,95002,2,77323,2400,74923
6669,220000,176000,0,0,0,0,0,0,0,8419,8424,-5,-1,6523,20,6503,0,508,878,-370,-1,370,1,369
6670,240000,192000,0,0,0,0,0,0,-2,5240,5240,0,-1,7795,4101,3694,0,3771,3771,0,-1,1891,1891,0
6671,30000,24000,0,1,1,1,1,0,0,29523,1500,28023,0,29494,1500,27994,0,29464,1500,27964,0,29891,2000,27891
6672,310000,248000,0,0,0,0,0,0,0,234621,10000,224621,0,242570,12000,230570,0,246073,9019,237054,0,248376,10024,238352
6673,360000,288000,0,0,0,0,0,0,0,129978,129990,-12,-1,150637,30000,120637,0,138969,25000,113969,0,132118,5000,127118
6674,50000,40000,0,0,0,0,0,0,0,27634,1400,26234,0,26691,915,25776,0,26329,1500,24829,0,25923,1500,24423
6675,290000,232000,0,0,0,0,0,0,-1,0,0,0,-2,1085,1085,0,-2,445,447,-2,-2,145,145,0
6676,230000,184000,0,0,0,0,0,0,-2,0,0,0,-2,0,0,0,-2,0,0,0,-2,5347,5347,0
6677,60000,48000,0,1,1,1,1,0,2,63389,5229,58160,2,60919,18,60901,2,57800,3779,54021,2,58698,1764,56934
6678,10000,8000,0,0,0,0,0,1,2,8786,2000,6786,0,8014,430,7584,0,0,0,0,0,0,0,0
6679,220000,176000,0,0,0,0,0,0,0,126132,7449,118683,0,120827,3005,117822,0,119823,2400,117423,0,119460,21577,97883
6680,180000,144000,0,0,0,0,0,0,-1,325,325,0,-1,1000,1000,0,-1,1100,1100,0,-1,1100,0,1100
6681,40000,32000,0,0,0,0,0,1,0,11471,2000,9471,0,11776,1500,10276,0,12660,2330,10330,0,12660,2300,10360
6682,70000,56000,0,0,0,0,0,1,0,10030,2000,8030,0,11578,2000,9578,0,13408,2000,11408,0,12302,1000,11302
6683,140000,112000,1,1,1,0,0,1,0,255846,5528,250318,0,140057,4500,135557,0,100177,3500,96677,0,100873,4000,96873
6684,460000,368000,0,0,0,0,0,0,-1,4594,4790,-196,-1,1517,1517,0,-1,1517,0,1517,0,1306,1306,0
6685,50000,40000,0,0,0,0,0,1,2,19793,2000,17793,0,19378,1500,17878,0,18874,1000,17874,0,19361,2000,17361
6686,260000,208000,0,0,0,0,0,0,3,78536,0,78536,2,94069,17000,77069,2,92447,0,92447,2,95925,5015,90910
6687,220000,176000,0,0,0,0,0,0,0,9110,9046,64,0,6401,6007,394,0,7084,5030,2054,0,5625,5019,606
6688,170000,136000,0,0,0,0,0,1,2,81959,3800,78159,2,89991,10000,79991,2,88018,0,88018,4,86299,0,86299
6689,70000,56000,0,0,0,0,0,0,2,27189,2900,24289,2,26456,0,26456,2,28361,2500,25861,0,31873,4000,27873
6690,420000,336000,0,1,1,1,1,1,0,409078,17029,392049,0,412057,15514,396543,0,402926,15056,387870,0,373095,13707,359388
6691,150000,120000,0,0,0,0,0,0,-2,0,0,0,-2,0,0,0,-2,0,0,0,-2,0,0,0
6692,170000,136000,0,0,0,0,0,0,-2,0,0,0,-2,0,0,0,-2,0,0,0,-2,0,0,0
6693,30000,24000,0,0,0,0,0,0,-1,26539,27209,-670,-1,28352,5024,23328,0,17596,523,17073,0,7576,1000,6576
6694,360000,288000,0,0,0,0,0,0,-1,465,467,-2,-1,4251,5452,-1201,-1,1668,41,1627,0,2284,2286,-2
6695,210000,168000,0,0,0,0,0,0,-2,0,0,0,-2,0,0,0,-2,0,0,0,-2,0,0,0
6696,130000,104000,0,1,1,0,0,1,0,125614,6592,119022,0,125451,4000,121451,0,84103,3000,81103,0,84436,3062,81374
6697,300000,240000,0,0,0,0,0,0,-2,-745,1000,-1745,-2,-1302,1100,-2402,-2,-527,1100,-1627,-2,-518,1000,-1518
6698,280000,224000,0,0,0,0,0,1,0,780,780,0,-1,0,0,0,-1,0,0,0,-2,0,0,0
6699,20000,16000,0,0,0,0,0,0,0,7298,1500,5798,0,8515,1500,7015,0,9869,1500,8369,0,11196,1500,9696
6700,90000,72000,0,0,0,0,0,0,0,64926,2337,62589,0,59949,1634,58315,0,54029,1606,52423,0,48170,1371,46799
6701,20000,16000,0,0,0,0,0,0,-1,7839,15210,-7371,-1,5386,1000,4386,0,10690,10690,0,-1,3413,3413,0
6702,260000,208000,0,0,0,0,0,0,-1,397,398,-1,-1,208,208,0,-1,790,792,-2,-1,2788,2788,0
6703,30000,24000,0,0,0,0,0,1,0,8693,2500,6193,0,11541,3000,8541,0,13344,2000,11344,0,15118,2000,13118
6704,120000,96000,0,0,0,0,0,1,-2,0,0,0,-2,0,0,0,-2,0,0,0,-2,0,0,0
6705,30000,24000,0,0,0,0,0,1,2,8973,0,8973,2,10337,1675,8662,2,10022,0,10022,2,10924,1065,9859
6706,310000,248000,0,0,0,0,0,0,0,28216,28216,0,-1,4245,4245,0,-1,3500,3500,0,-1,396,396,0
6707,220000,176000,0,0,0,0,0,0,-1,2130,2130,0,-1,7510,7521,-11,-1,1117,1117,0,-1,916,916,0
6708,250000,200000,0,0,0,0,0,0,0,131031,10000,121031,0,83674,3011,80663,0,64760,3000,61760,0,52397,2500,49897
6709,20000,16000,0,0,0,0,0,0,-1,0,0,0,-1,593,593,0,-1,0,0,0,-1,0,0,0
6710,450000,360000,0,0,0,0,0,0,-1,57139,57425,-286,-1,15181,15257,-76,-1,7247,7283,-36,-1,13890,13959,-69
6711,150000,120000,0,0,0,0,0,0,-1,1000,1010,-10,-1,0,0,0,-1,0,0,0,-2,0,0,0
6712,20000,16000,0,1,0,0,1,0,0,18552,1250,17302,0,15562,800,14762,0,16308,1000,15308,0,17034,1000,16034
6713,80000,64000,0,0,0,0,0,0,-1,11047,11047,0,-1,9258,9300,-42,-1,3100,0,3100,0,814,0,814
6714,210000,168000,0,0,0,0,0,1,0,47182,2043,45139,0,37067,1552,35515,0,24511,2013,22498,0,22634,3002,19632
6715,30000,24000,0,0,0,0,0,0,-1,-6,0,-6,-1,-6,0,-6,-2,-6,0,-6,-2,-6,0,-6
6716,200000,160000,0,0,0,0,0,0,-1,21910,21957,-47,-1,12474,12474,0,-1,17785,17811,-26,-1,12500,12500,0
6717,230000,184000,0,0,0,0,0,0,0,49984,1222,48762,0,35526,7510,28016,0,24540,491,24049,0,16038,6600,9438
6718,230000,184000,0,0,0,0,0,1,0,72376,2614,69762,0,76870,6000,70870,0,75211,0,75211,2,76645,3000,73645
6719,310000,248000,0,0,0,0,0,1,2,70359,15000,55359,0,77884,10000,67884,0,87484,10200,77284,0,89633,2149,87484
6720,60000,48000,0,0,0,0,0,0,0,40356,1918,38438,0,39672,1390,38282,0,39863,1576,38287,0,40319,1647,38672
6721,60000,48000,0,0,0,0,0,0,0,10163,3000,7163,0,10692,1000,9692,0,15307,5000,10307,0,19838,5000,14838
6722,80000,64000,0,0,0,0,0,1,0,60311,3000,57311,0,62471,5000,57471,0,21071,10000,11071,0,2099,2099,0
6723,80000,64000,0,0,0,0,0,0,0,16000,1000,15000,0,0,0,0,0,0,0,0,-2,0,0,0
6724,60000,48000,0,0,0,0,0,0,-1,823,823,0,-1,683,0,683,0,240,240,0,-1,998,998,0
6725,300000,240000,0,0,0,0,0,0,0,150727,6000,144727,0,196467,50000,146467,0,201425,10013,191412,0,-8276,9505,-17781
6726,110000,88000,0,0,0,0,0,0,0,44310,1900,42410,0,34820,1815,33005,0,36005,2000,34005,0,25976,1500,24476
6727,50000,40000,0,0,0,0,0,0,0,26568,1500,25068,0,26414,1000,25414,0,26263,1000,25263,0,27076,2000,25076
6728,150000,120000,0,0,0,0,0,0,0,10403,3000,7403,0,10927,1000,9927,0,11598,1000,10598,0,13235,2000,11235
6729,50000,40000,0,1,1,0,1,0,0,48786,2148,46638,0,49768,2130,47638,0,27838,1200,26638,0,84810,1012,83798
6730,50000,40000,0,0,0,0,0,0,0,38085,1650,36435,0,0,0,0,0,10400,10400,0,-1,0,0,0
6731,220000,176000,0,1,1,0,0,0,0,212877,10000,202877,0,189161,8140,181021,0,180715,8000,172715,0,171449,7000,164449
6732,200000,160000,0,0,0,0,0,0,-1,780,780,0,-1,2220,2220,0,-1,0,0,0,-2,0,0,0
6733,190000,152000,0,1,0,0,0,0,0,162100,8004,154096,0,155584,5500,150084,0,157988,7000,150988,0,154366,6000,148366
6734,160000,128000,0,0,0,0,0,0,0,28406,0,28406,2,28836,1200,27636,0,30208,2000,28208,0,30853,1300,29553
6735,30000,24000,0,0,0,0,0,0,-1,-1202,0,-1202,-2,-2230,0,-2230,-2,6770,9000,-2230,-1,9579,4653,4926
6736,150000,120000,0,1,1,1,1,0,0,144913,14004,130909,0,135063,4876,130187,0,134417,4750,129667,0,134490,5090,129400
6737,30000,24000,0,0,0,0,0,0,-1,8069,0,8069,2,13042,5464,7578,2,12690,0,12690,2,15503,3027,12476
6738,180000,144000,0,0,0,0,0,1,-1,851,851,0,-1,0,0,0,-1,346,346,0,-2,1592,1592,0
6739,260000,208000,0,0,0,0,0,0,-1,992,992,0,-1,992,496,496,0,496,0,496,0,1488,1488,0
6740,130000,104000,0,0,0,0,0,0,-1,48108,1478,46630,0,40918,1119,39799,0,35111,1016,34095,0,24846,1026,23820
6741,100000,80000,0,0,0,0,0,0,0,13534,6000,7534,0,16158,4375,11783,0,6700,6700,0,-1,7730,3000,4730
6742,50000,40000,0,1,1,1,1,1,2,46345,0,46345,2,49231,3600,45631,2,48537,1900,46637,2,46774,0,46774
6743,150000,120000,0,0,0,0,0,1,-1,-948,632,-1580,-1,-1580,0,-1580,-2,316,1896,-1580,-2,316,316,0
6744,50000,40000,0,0,0,0,0,0,2,23046,0,23046,2,23314,950,22364,0,23801,862,22939,0,24354,947,23407
6745,360000,288000,0,0,0,0,0,0,-1,44803,46012,-1209,-1,118712,129567,-10855,-1,34244,685,33559,0,21269,425,20844
6746,120000,96000,0,0,1,1,1,0,2,99283,4500,94783,0,101935,5200,96735,0,102754,4000,98754,0,105924,5000,100924
6747,180000,144000,0,1,1,1,1,1,0,177754,6379,171375,0,178191,6319,171872,0,183051,10671,172380,0,179546,3000,176546
6748,110000,88000,0,0,0,0,0,1,2,25182,0,25182,2,28945,4200,24745,2,28183,0,28183,2,29869,2300,27569
6749,200000,160000,0,1,0,0,0,0,0,168430,6900,161530,0,100175,4200,95975,0,95267,3000,92267,0,87086,3200,83886
6750,10000,8000,0,0,0,0,0,1,2,0,0,0,2,0,0,0,-2,0,0,0,-2,0,0,0
6751,20000,16000,0,1,1,0,0,1,0,19472,3243,16229,0,18629,1200,17429,0,12683,254,12429,0,0,0,0
6752,80000,64000,0,1,1,0,1,0,0,76204,2600,73604,0,66876,2400,64476,0,66182,2500,63682,0,67199,2700,64499
6753,300000,240000,0,0,1,1,1,0,0,250477,11000,239477,0,254808,10000,244808,0,260562,10000,250562,0,266200,10000,256200
6754,120000,96000,0,0,0,0,0,0,2,82922,3000,79922,2,80989,0,80989,2,82761,3120,79641,0,84766,3500,81266
6755,30000,24000,0,0,0,0,0,0,0,2023,1002,1021,0,1163,23,1140,0,0,0,0,0,0,0,0
6756,550000,440000,0,0,0,0,0,0,-2,1091,1091,0,-2,2291,2309,-18,-2,1000,1000,0,-2,150,150,0
6757,130000,104000,0,0,0,0,0,1,0,58716,5000,53716,0,57174,0,57174,2,61240,5000,56240,2,61284,1200,60084
6758,280000,224000,0,0,0,0,0,0,-1,13947,14080,-133,-2,7676,7742,-66,-1,6155,6178,-23,-1,3695,3711,-16
6759,30000,24000,0,1,1,1,0,0,0,30560,1000,29560,2,30194,1377,28817,0,30113,1211,28902,0,23212,1000,22212
6760,320000,256000,0,0,0,0,0,0,-2,1127,1135,-8,-2,1943,1952,-9,-2,13312,13375,-63,-2,-5,5,-10
6761,50000,40000,1,1,1,1,1,0,2,56275,2031,54244,0,53936,1918,52018,0,51740,1993,49747,0,49043,1614,47429
6762,30000,24000,0,0,0,0,0,1,2,2395,0,2395,7,2395,0,2395,7,2395,0,2395,7,2395,0,2395
6763,50000,40000,0,0,0,0,0,0,0,28742,1077,27665,0,8150,1000,7150,0,6771,1000,5771,0,6713,1000,5713
6764,160000,128000,0,0,0,0,0,0,0,13962,2000,11962,0,14844,1000,13844,0,15716,1000,14716,0,131874,116425,15449
6765,20000,16000,0,1,1,1,0,1,2,20329,2300,18029,2,19616,0,19616,4,19303,0,19303,3,1013,0,1013
6766,240000,192000,0,0,0,0,0,0,-2,154353,155142,-789,-2,9617,9661,-44,-2,11360,11489,-129,-2,3842,3870,-28
6767,280000,224000,0,0,0,0,0,1,0,10247,3000,7247,0,10247,0,10247,0,6170,123,6047,0,11170,5000,6170
6768,150000,120000,0,0,0,0,0,0,-2,-18,0,-18,-2,-18,0,-18,-2,-18,0,-18,-2,-18,0,-18
6769,60000,48000,0,0,0,0,0,1,0,31688,4140,27548,0,30448,0,30448,2,452,904,-452,-1,302,0,302
6770,450000,360000,0,0,0,0,0,0,-1,4064,3057,1007,0,-8,0,-8,0,-8,0,-8,-2,402,410,-8
6771,130000,104000,0,0,0,0,0,0,0,94580,3000,91580,0,30000,4000,26000,0,0,0,0,0,0,0,0
6772,20000,16000,0,0,1,1,1,0,0,17080,1300,15780,0,18293,1500,16793,0,18752,900,17852,2,19195,900,18295
6773,100000,80000,0,1,1,0,0,0,0,97177,5000,92177,0,99043,4600,94443,0,74453,3000,71453,0,76252,3000,73252
6774,180000,144000,0,0,0,0,0,0,2,98314,0,98314,2,94552,10000,84552,0,92422,3000,89422,0,63022,5000,58022
6775,220000,176000,0,0,0,0,0,0,-1,0,0,0,-2,0,0,0,-2,0,0,0,-2,0,0,0
6776,200000,160000,0,1,1,0,0,0,0,202774,10120,192654,0,176737,6500,170237,0,147151,5500,141651,0,148866,7000,141866
6777,110000,88000,0,0,0,0,0,0,2,150,0,150,2,150,0,150,7,150,0,150,7,150,0,150
6778,150000,120000,0,0,0,0,0,0,0,43879,3000,40879,0,44446,1528,42918,0,45394,1600,43794,0,46702,2000,44702
6779,90000,72000,0,0,0,0,1,0,0,66748,2200,64548,0,70101,4035,66066,0,80611,12200,68411,0,89870,10000,79870
6780,70000,56000,0,1,1,0,0,1,0,69835,3013,66822,0,66216,2141,64075,0,30000,1200,28800,0,30096,1300,28796
6781,80000,64000,0,1,0,0,0,0,0,70110,2329,67781,0,62590,2400,60190,0,54177,2000,52177,0,60662,7400,53262
6782,180000,144000,0,0,0,0,0,0,-1,16477,18207,-1730,-1,13207,0,13207,0,73813,22479,51334,-1,34935,34935,0
6783,20000,16000,0,0,0,1,1,0,0,16116,1500,14616,0,16436,588,15848,0,16781,610,16171,0,17112,611,16501
6784,500000,400000,0,1,1,1,1,0,0,480411,18000,462411,0,489978,17534,472444,0,493062,17649,475413,0,474301,18007,456294
6785,80000,64000,0,0,0,0,0,0,0,539,539,0,-1,16673,16673,0,-1,21473,21473,0,-1,10715,10715,0
6786,50000,40000,0,0,0,0,0,1,0,33265,2000,31265,0,29300,1021,28279,0,20703,1004,19699,0,30101,10000,20101
6787,200000,160000,0,0,0,0,0,0,0,25652,1004,24648,2,25162,1004,24158,0,24995,1013,23982,0,23901,2018,21883
6788,70000,56000,1,1,1,1,1,1,0,74853,0,74853,2,78789,5816,72973,2,77084,0,77084,2,80572,5364,75208
6789,240000,192000,0,0,0,0,0,0,-1,4649,4649,0,-1,1528,1533,-5,-1,7378,7378,0,-1,682,0,682
6790,60000,48000,0,0,0,0,0,0,0,38051,1700,36351,0,37988,2000,35988,0,38725,1500,37225,0,39685,1600,38085
6791,140000,112000,0,1,1,1,1,0,2,118913,0,118913,2,120435,5000,115435,0,139795,21500,118295,0,142950,5500,137450
6792,200000,160000,0,0,0,0,0,0,-1,1894,1894,0,-1,8604,8615,-11,-1,3547,3563,-16,-1,43097,43097,0
6793,80000,64000,0,0,0,0,0,0,0,1724,1036,688,0,2884,1196,1688,0,2994,306,2688,0,28788,26045,2743
6794,100000,80000,0,1,1,0,0,0,2,94110,0,94110,2,92823,2000,90823,0,68136,2000,66136,0,53170,3000,50170
6795,20000,16000,0,1,0,0,0,0,0,18325,1500,16825,0,15680,500,15180,0,0,0,0,0,0,0,0
6796,130000,104000,0,0,0,0,0,0,-1,8699,0,8699,2,7199,199,7000,0,5699,199,5500,0,6275,2275,4000
6797,200000,160000,0,0,0,0,0,0,0,35939,1603,34336,0,34096,2000,32096,0,34876,2500,32376,0,34615,1500,33115
6798,140000,112000,0,0,0,0,0,0,-1,0,0,0,-2,0,0,0,-2,6400,6400,0,-1,11400,5000,6400
6799,200000,160000,0,0,0,0,0,0,0,12187,3038,9149,0,7402,3007,4395,0,10827,5005,5822,0,11351,2056,9295
6800,380000,304000,0,0,0,0,0,1,0,295550,9837,285713,0,277650,9154,268496,0,264217,9042,255175,0,238368,8515,229853
6801,220000,176000,0,0,0,1,0,1,0,173969,5013,168956,0,183030,10626,172404,0,181385,52,181333,2,174107,5255,168852
6802,70000,56000,0,1,1,1,1,0,2,63586,2500,61086,2,64440,2500,61940,2,65761,2500,63261,2,67128,2600,64528
6803,150000,120000,0,0,0,0,0,0,0,44798,2118,42680,0,44280,1800,42480,0,38006,1300,36706,0,32978,1300,31678
6804,240000,192000,0,0,0,0,0,0,0,55515,20000,35515,0,49049,3330,45719,2,57178,30000,27178,0,42009,10000,32009
6805,500000,400000,0,0,0,0,0,0,0,28527,7000,21527,0,27030,8000,19030,0,27454,10000,17454,0,30486,12000,18486
6806,20000,16000,0,0,0,1,1,0,2,15975,0,15975,2,17903,2500,15403,2,17336,0,17336,3,16910,0,16910
6807,160000,128000,0,0,0,0,0,1,2,0,0,0,-2,0,0,0,-2,0,0,0,-2,0,0,0
6808,600000,480000,0,0,0,0,0,0,-2,0,0,0,-2,0,0,0,-2,6677,6677,0,-2,83034,83034,0
6809,240000,192000,0,0,0,0,0,0,0,73008,50192,22816,0,61310,10078,51232,0,39694,24694,15000,0,45301,28407,16894
6810,130000,104000,0,0,0,0,0,1,-2,441,441,0,-1,305,305,0,-1,0,0,0,-1,0,0,0
6811,50000,40000,0,0,0,0,0,1,0,8511,1200,7311,0,10361,2000,8361,0,11039,1000,10039,0,11107,400,10707
6812,20000,16000,0,0,0,0,0,0,-1,10713,10739,-26,-1,4272,4272,0,-1,4285,13,4272,0,16542,16687,-145
6813,230000,184000,0,0,0,0,0,0,-2,5733,5756,-23,-2,4292,4303,-11,-2,4694,4711,-17,-2,4709,4741,-32
6814,150000,120000,0,1,1,1,0,0,0,134208,12440,121768,0,139551,10000,129551,0,134321,5000,129321,0,104513,5000,99513
6815,80000,64000,0,0,0,0,0,0,0,51616,2023,49593,0,47843,1850,45993,0,48427,1800,46627,0,49101,1806,47295
6816,490000,392000,0,0,0,0,0,0,-1,10149,10191,-42,-1,76760,77163,-403,-1,8879,8921,-42,-1,16705,16786,-81
6817,30000,24000,0,0,0,0,0,1,2,-471,0,-471,2,1479,1950,-471,3,1320,0,1320,2,930,390,540
6818,50000,40000,0,1,1,1,1,1,2,49086,4500,44586,2,48027,0,48027,2,49037,1751,47286,0,48032,1736,46296
6819,450000,360000,0,0,0,0,0,0,2,128901,0,128901,2,132982,6270,126712,0,141298,12000,129298,0,137347,16309,121038
6820,70000,56000,0,1,0,0,0,1,2,67682,2705,64977,0,50256,2115,48141,0,43353,1583,41770,0,44219,1597,42622
6821,50000,40000,0,0,0,0,0,0,0,41463,2000,39463,0,39577,2174,37403,0,32474,2000,30474,0,32303,2000,30303
6822,80000,64000,0,1,0,0,0,0,0,79207,2407,76800,0,0,0,0,0,0,0,0,-2,0,0,0
6823,200000,160000,0,0,0,0,0,1,0,99704,8300,91404,0,101169,4000,97169,2,103401,4000,99401,2,109831,8300,101531
6824,380000,304000,0,0,0,0,0,0,0,82583,3100,79483,0,84687,3500,81187,0,84832,3500,81332,0,84576,3200,81376
6825,80000,64000,0,0,0,0,0,0,-1,15020,15037,-17,-1,4233,4233,0,-1,5934,6092,-158,-1,158,0,158
6826,100000,80000,0,1,1,1,1,0,0,96389,4500,91889,0,97571,3800,93771,0,86202,3500,82702,0,92282,7500,84782
6827,30000,24000,1,1,0,0,0,0,0,30321,7,30314,2,23610,1511,22099,0,20614,5005,15609,0,18873,5183,13690
6828,140000,112000,0,0,0,0,0,1,-2,-150,0,-150,-2,-150,0,-150,-2,-150,0,-150,-2,-150,0,-150
6829,500000,400000,0,1,1,0,0,0,0,421996,12602,409394,0,426103,11000,415103,0,125218,4711,120507,0,126650,6000,120650
6830,280000,224000,0,0,0,0,0,0,0,151984,3000,148984,2,47851,0,47851,2,49374,3000,46374,0,50198,2000,48198
6831,80000,64000,0,0,0,0,0,1,0,21017,1500,19517,0,12883,1000,11883,0,-217,0,-217,0,45966,46700,-734
6832,20000,16000,0,0,0,0,0,0,-1,-74,0,-74,-2,749,823,-74,-1,0,0,0,-1,0,0,0
6833,320000,256000,0,1,1,1,0,1,0,286011,12000,274011,0,292636,12873,279763,0,298492,13020,285472,0,200098,8800,191298
6834,70000,56000,0,0,0,0,0,1,2,18013,1400,16613,0,19315,1600,17715,0,19859,1000,18859,2,19390,0,19390
6835,30000,24000,0,1,1,1,1,0,2,27469,1456,26013,0,28013,1000,27013,0,28614,1050,27564,0,29636,1500,28136
6836,260000,208000,0,0,0,0,0,1,-1,28656,29022,-366,-1,7497,7500,-3,-1,7685,27769,-20084,-1,15434,12000,3434
6837,70000,56000,0,1,1,0,0,0,2,59452,3000,56452,2,57771,17,57754,2,44043,2000,42043,0,45175,2000,43175
6838,260000,208000,0,0,0,0,0,0,-1,2552,2552,0,-1,2236,2236,0,-1,2236,0,2236,0,2450,2500,-50
6839,50000,40000,0,0,0,0,0,0,-2,0,0,0,-2,0,0,0,-2,0,0,0,-2,0,0,0
6840,120000,96000,0,0,0,0,0,0,-1,611,611,0,-1,593,593,0,-1,653,653,0,-1,587,587,0
6841,100000,80000,0,0,1,1,1,1,2,82759,3200,79559,2,83609,3100,80509,2,85325,3200,82125,2,87096,3332,83764
6842,160000,128000,0,0,0,0,0,0,-1,3711,3711,0,-1,2121,2121,0,-1,2275,2275,0,-1,2895,2895,0
6843,360000,288000,0,0,0,0,0,0,-2,0,0,0,-2,0,0,0,-2,0,0,0,-2,0,0,0
6844,530000,424000,0,0,0,0,0,0,0,333120,12639,320481,0,304353,11123,293230,0,282876,9600,273276,0,288945,10028,278917
6845,500000,400000,0,0,0,0,0,0,0,23839,3000,20839,0,24869,1432,23437,0,27437,3000,24437,0,31957,5000,26957
6846,360000,288000,0,0,0,0,0,0,-2,8556,8598,-42,-2,4578,4601,-23,-2,4784,4808,-24,-2,11938,11997,-59
6847,60000,48000,0,0,0,0,0,0,-2,-2320,0,-2320,-2,-1220,2000,-3220,-2,0,2000,-2000,-2,0,0,0
6848,210000,168000,0,0,0,0,0,0,0,31294,11294,20000,0,43790,13790,30000,0,510,1000,-490,-1,20188,20188,0
6849,300000,240000,0,0,0,0,0,0,0,49737,2000,47737,0,48015,1500,46515,0,36004,3000,33004,0,6748,1000,5748
6850,220000,176000,0,1,1,1,1,1,2,197466,8200,189266,2,189149,0,189149,2,187531,7000,180531,0,187856,7000,180856
6851,150000,120000,0,0,0,0,0,0,-1,0,0,0,-1,0,0,0,-2,0,0,0,-2,904,904,0
6852,240000,192000,0,0,0,0,0,1,-1,0,0,0,-1,0,0,0,-2,3853,3853,0,-1,29252,29252,0
6853,280000,224000,0,0,0,0,0,0,-2,8741,8844,-103,-2,8178,8247,-69,-2,-4,0,-4,-2,-4,0,-4
6854,110000,88000,0,0,0,0,0,0,0,34323,1428,32895,0,30452,1318,29134,0,22628,2171,20457,0,23468,3198,20270
6855,130000,104000,0,0,0,0,0,1,-1,776,1000,-224,-1,776,776,0,-1,776,776,0,-1,776,776,0
6856,80000,64000,0,1,1,1,0,1,2,81558,3100,78458,2,78761,0,78761,2,71352,2000,69352,0,19674,713,18961
6857,70000,56000,0,0,0,0,0,0,0,0,0,0,-2,0,0,0,-2,0,0,0,-2,1000,1000,0
6858,240000,192000,0,0,0,0,0,0,-1,-23,0,-23,-1,-23,0,-23,-2,7859,7882,-23,-1,-2,0,-2
6859,150000,120000,0,0,0,0,0,1,2,78214,3200,75014,2,76363,0,76363,2,79893,5137,74756,2,48052,0,48052
6860,140000,112000,0,0,0,0,0,1,2,390,390,0,-1,0,0,0,-1,780,780,0,-1,390,390,0
6861,180000,144000,0,0,0,0,0,0,0,119166,6000,113166,0,121661,6000,115661,0,122244,5000,117244,0,119536,4200,115336
6862,80000,64000,0,0,0,0,0,0,0,19385,1500,17885,0,20561,1500,19061,0,21261,1028,20233,0,21457,876,20581
6863,150000,120000,0,1,1,1,0,0,0,153309,5509,147800,0,152357,5672,146685,0,153133,6787,146346,0,0,0,0
6864,240000,192000,0,0,0,0,0,1,-1,8930,8930,0,-1,7324,0,7324,0,10506,10526,-20,-1,10625,10625,0
6865,390000,312000,0,0,0,0,0,0,0,7809,7809,0,-1,97774,97874,-100,-1,100912,32494,68418,0,152955,100000,52955
6866,80000,64000,0,1,1,0,0,0,0,76834,9000,67834,0,76333,3365,72968,0,49942,2000,47942,0,50191,2200,47991
6867,50000,40000,0,0,0,0,0,0,0,33329,6348,26981,0,20935,0,20935,2,15809,420,15389,0,16133,593,15540
6868,70000,56000,0,0,0,0,0,0,0,11106,1163,9943,0,11443,500,10943,0,10323,376,9947,0,11150,1000,10150
6869,200000,160000,0,0,0,0,0,0,-1,14714,14714,0,-1,11938,0,11938,0,303,303,0,-1,3262,3262,0
6870,20000,16000,0,0,0,0,0,0,2,3167,3179,-12,-2,-129,773,-902,-2,9703,9832,-129,-1,9871,10084,-213
6871,70000,56000,0,0,0,0,1,0,0,53041,2700,50341,0,55150,3000,52150,0,57098,3000,54098,0,59141,3000,56141
6872,220000,176000,0,0,0,0,0,0,-1,14129,14129,0,-1,28246,16000,12246,0,9995,5000,4995,0,198,198,0
6873,200000,160000,0,0,0,0,0,1,0,28727,31209,-2482,-1,19164,383,18781,0,0,0,0,0,0,0,0
6874,500000,400000,0,0,0,0,0,0,0,220047,10025,210022,0,217920,10294,207626,0,159393,6046,153347,0,149626,5076,144550
6875,10000,8000,0,1,1,1,0,0,0,9604,1000,8604,0,9800,196,9604,0,10000,200,9800,0,0,1000,-1000
6876,220000,176000,0,0,0,0,0,0,0,81847,3000,78847,0,79489,4000,75489,0,77040,3000,74040,0,78892,3000,75892
6877,20000,16000,0,1,1,0,0,0,0,18699,2000,16699,0,19324,2000,17324,0,16234,1000,15234,0,16609,1000,15609
6878,360000,288000,0,0,0,0,0,0,2,0,0,0,-2,0,0,0,-2,0,0,0,-2,0,0,0
6879,60000,48000,0,0,0,0,0,0,0,12944,0,12944,2,-7511,0,-7511,2,12606,28000,-15394,-1,6540,2000,4540
6880,50000,40000,0,0,0,0,0,0,0,7758,1000,6758,2,8459,1000,7459,2,8635,282,8353,0,7473,1000,6473
6881,210000,168000,0,0,0,0,0,0,-2,4292,4326,-34,-1,2388,2395,-7,-1,4090,4102,-12,-2,2375,2382,-7
6882,500000,400000,0,0,0,0,0,0,-2,966,1169,-203,-2,6675,6708,-33,-2,-10,0,-10,-2,2055,2065,-10
6883,360000,288000,0,0,0,0,0,0,0,193910,12000,181910,0,167029,15273,151756,0,134294,15000,119294,0,154290,25000,129290
6884,170000,136000,0,0,0,0,0,0,-1,1537,1537,0,-1,2156,2156,0,-1,1898,1898,0,-1,2656,2656,0
6885,170000,136000,0,0,0,0,0,0,0,128900,4860,124040,0,125514,22500,103014,0,127280,4820,122460,0,128839,4877,123962
6886,200000,160000,0,0,0,0,0,0,0,134110,20038,114072,0,139209,20019,119190,0,135902,5014,130888,0,138997,10047,128950
6887,10000,8000,0,1,1,1,1,0,-1,9506,1500,8006,0,9702,500,9202,0,9999,600,9399,0,10344,800,9544
6888,360000,288000,0,0,0,0,0,0,-2,-390,0,-390,-2,10872,11652,-780,-1,10540,358,10182,0,2203,2203,0
6889,230000,184000,0,0,0,0,0,0,-1,1982,0,1982,2,1982,991,991,0,991,0,991,0,5400,5400,0
6890,90000,72000,0,1,1,0,0,0,0,88118,3688,84430,0,87852,4559,83293,0,49042,1665,47377,0,49251,1707,47544
6891,350000,280000,0,0,0,0,0,1,-1,671,671,0,-1,671,671,0,-1,671,671,0,-1,30727,30727,0
6892,50000,40000,0,0,0,0,0,0,0,38734,1549,37185,0,23152,1611,21541,0,19860,800,19060,0,19486,802,18684
6893,90000,72000,0,1,0,0,0,1,2,80890,3000,77890,0,31565,3000,28565,0,33049,3000,30049,0,22694,2000,20694
6894,100000,80000,0,0,0,0,0,0,0,80993,3782,77211,0,72751,5000,67751,0,67146,5000,62146,0,68490,3000,65490
6895,240000,192000,0,0,0,0,0,1,0,185490,6790,178700,0,189351,6951,182400,0,193115,6915,186200,0,197445,7445,190000
6896,180000,144000,0,0,0,0,0,0,-1,104834,3877,100957,0,44452,1535,42917,0,41810,1517,40293,0,42641,1526,41115
6897,150000,120000,0,1,1,1,1,1,0,141046,4952,136094,0,143490,4019,139471,0,146060,4132,141928,0,149861,5037,144824
6898,50000,40000,0,1,0,0,0,0,0,48030,1547,46483,0,32097,1464,30633,0,31450,1078,30372,0,29695,1225,28470
6899,30000,24000,0,1,1,1,1,0,0,27688,0,27688,2,28134,3000,25134,0,29591,2000,27591,0,28883,1300,27583
6900,180000,144000,0,0,0,0,0,0,-1,0,0,0,-2,0,0,0,-2,0,0,0,-2,0,0,0
6901,80000,64000,0,0,0,0,0,0,0,57724,2081,55643,0,58892,2113,56779,0,61991,5000,56991,0,63224,2264,60960
6902,50000,40000,0,0,0,0,0,0,0,30627,3500,27127,0,28999,0,28999,2,29607,1051,28556,0,29285,1100,28185
6903,150000,120000,0,0,0,0,0,0,-1,1919,1919,0,-1,8144,8144,0,-1,2969,2969,0,-1,8642,8642,0
6904,240000,192000,0,0,0,0,0,1,-2,0,0,0,-2,0,0,0,-2,0,0,0,-2,0,0,0
6905,50000,40000,0,0,0,0,0,0,0,0,0,0,0,790,790,0,-1,3696,3696,0,-1,6696,3000,3696
6906,10000,8000,0,0,0,0,0,0,0,8225,3300,4925,0,8244,300,7944,2,7963,0,7963,2,8134,299,7835
6907,60000,48000,0,0,0,0,0,1,-1,3434,1048,2386,0,2386,1000,1386,0,2837,2837,0,-1,3358,3358,0
6908,340000,272000,0,0,0,0,0,1,0,271435,12101,259334,0,267100,10045,257055,0,263741,10010,253731,0,267488,10000,257488
6909,200000,160000,0,0,0,0,0,0,-1,7756,7756,0,-1,4792,0,4792,0,3107,38700,-35593,-1,17423,16724,699
6910,500000,400000,0,0,0,0,0,0,0,49677,10026,39651,0,49515,7241,42274,0,42568,50091,-7523,-1,48268,25000,23268
6911,100000,80000,1,1,1,0,0,0,0,107126,7000,100126,0,101859,3533,98326,0,79519,2673,76846,0,74368,3500,70868
6912,100000,80000,0,0,0,0,0,1,0,2456,1007,1449,0,1537,1741,-204,-1,1642,1646,-4,-1,110,100,10
6913,90000,72000,0,0,0,0,0,0,2,9621,1000,8621,0,17701,10000,7701,0,15496,0,15496,2,9341,1000,8341
6914,80000,64000,0,0,0,0,0,0,-1,1422,4,1418,2,2685,2693,-8,-1,1395,1395,0,-1,2896,2906,-10
6915,50000,40000,0,1,0,0,0,0,3,48608,0,48608,2,19600,392,19208,0,20000,400,19600,0,0,0,0
6916,290000,232000,0,0,0,0,0,0,-2,0,0,0,-2,0,0,0,-2,0,0,0,-2,0,0,0
6917,50000,40000,0,0,0,0,0,0,0,34426,2500,31926,0,34725,1353,33372,0,18049,1500,16549,0,19593,2000,17593
6918,30000,24000,0,1,1,1,1,0,0,29274,0,29274,2,31460,3000,28460,0,33890,2900,30990,0,31224,0,31224
6919,20000,16000,0,0,0,0,0,1,2,9159,0,9159,2,10000,1000,9000,0,0,0,0,0,0,0,0
6920,360000,288000,0,1,1,1,0,0,0,341528,12303,329225,0,350949,15005,335944,0,355869,13729,342140,0,210989,7700,203289
6921,80000,64000,0,0,0,0,0,1,-1,390,0,390,2,992,992,0,-1,602,0,602,0,-178,0,-178
6922,290000,232000,0,0,0,0,0,0,0,76453,4000,72453,0,59734,5500,54234,0,61238,2500,58738,0,63089,3000,60089
6923,20000,16000,0,0,0,0,0,0,0,16029,2559,13470,0,15470,0,15470,2,0,0,0,2,0,0,0
6924,10000,8000,0,1,1,1,0,0,0,9718,1076,8642,0,9916,274,9642,0,9250,370,8880,0,7461,472,6989
6925,260000,208000,0,0,0,0,0,1,2,150,0,150,2,150,0,150,2,2500,2500,0,-1,0,0,0
6926,140000,112000,0,1,1,0,0,0,0,143649,4700,138949,2,118593,114,118479,2,95257,3500,91757,0,93145,3500,89645
6927,50000,40000,0,0,0,0,0,0,0,23250,1602,21648,0,26293,10002,16291,0,21508,5000,16508,0,20971,2000,18971
6928,50000,40000,0,0,0,0,0,0,2,21186,3000,18186,2,22538,2000,20538,2,22274,400,21874,2,22767,1000,21767
6929,160000,128000,0,1,0,0,0,1,0,153047,7424,145623,0,122831,4251,118580,0,124794,6010,118784,0,116746,5000,111746
6930,200000,160000,0,0,0,0,0,1,-2,0,0,0,-2,0,0,0,-2,0,0,0,-2,0,0,0
6931,120000,96000,0,1,1,0,0,1,2,117580,4351,113229,0,120041,5000,115041,0,80578,3000,77578,0,82280,3000,79280
6932,320000,256000,0,1,1,0,0,0,0,319368,14033,305335,0,305308,14008,291300,0,188120,7000,181120,0,192087,7000,185087
6933,120000,96000,0,0,0,0,0,0,-1,390,390,0,-1,780,780,0,-1,240,0,240,2,630,930,-300
6934,50000,40000,0,0,0,0,0,0,0,23879,1400,22479,0,23960,850,23110,0,24067,871,23196,0,24253,974,23279
6935,320000,256000,0,0,0,0,0,0,0,48449,2961,45488,0,48948,1600,47348,0,49967,1579,48388,0,36697,1692,35005
6936,450000,360000,0,0,0,0,0,0,-1,6696,6696,0,-1,2461,5000,-2539,-1,4192,4192,0,-1,4378,4378,0
6937,10000,8000,0,0,0,0,0,0,-1,390,390,0,-1,390,390,0,-1,0,0,0,-1,1280,1280,0
6938,350000,280000,0,0,0,0,0,0,0,177597,7000,170597,0,181702,7007,174695,0,176253,7000,169253,0,179190,6500,172690
6939,180000,144000,0,0,0,0,0,0,-1,13413,13413,0,-1,8577,8577,0,-1,8596,8596,0,-1,24297,24297,0
6940,400000,320000,0,0,0,0,0,0,-2,123,123,0,-2,0,0,0,-2,349,349,0,-2,0,0,0
6941,50000,40000,0,0,0,0,0,0,0,25953,5000,20953,0,27350,3000,24350,0,19931,3002,16929,0,16845,3007,13838
6942,50000,40000,0,0,0,0,0,1,0,3243,1000,2243,0,1691,1700,-9,-1,-1889,0,-1889,-1,2720,5679,-2959
6943,350000,280000,0,0,0,0,0,0,0,272072,10000,262072,0,267277,10000,257277,0,255680,8200,247480,0,261573,9000,252573
6944,240000,192000,0,0,0,0,0,1,-1,0,0,0,-2,0,0,0,-2,0,0,0,-2,0,0,0
6945,140000,112000,0,0,0,0,0,1,0,60627,3600,57027,0,39760,1500,38260,0,40045,1300,38745,0,40865,1318,39547
6946,240000,192000,0,0,0,0,0,0,0,21061,18008,3053,0,27585,27067,518,0,18019,18046,-27,0,18116,10018,8098
6947,150000,120000,0,1,1,0,0,0,0,134382,10000,124382,0,134593,4749,129844,0,91112,3304,87808,0,68482,2285,66197
6948,20000,16000,0,0,0,0,0,1,2,8805,1158,7647,0,12647,4000,8647,0,12173,0,12173,3,11855,0,11855
6949,500000,400000,0,0,0,0,0,0,-1,294969,6486,288483,0,189612,234,189378,0,128459,90,128369,0,167105,167116,-11
6950,80000,64000,0,1,1,1,1,1,2,77343,3000,74343,0,78883,2744,76139,0,79915,3022,76893,0,80296,6000,74296
6951,180000,144000,0,1,0,0,0,1,0,184650,16500,168150,0,0,0,0,0,0,0,0,-2,0,0,0
6952,250000,200000,0,0,0,0,0,0,-1,220765,198031,22734,0,180488,6069,174419,0,173140,4310,168830,0,170233,5752,164481
6953,170000,136000,0,0,0,0,0,1,0,124636,10500,114136,0,121232,0,121232,2,124199,5000,119199,0,129346,11000,118346
6954,350000,280000,0,0,0,0,0,0,-2,0,0,0,-2,0,0,0,-2,0,0,0,-2,0,0,0
6955,150000,120000,0,0,0,0,0,1,-2,0,0,0,-2,0,0,0,-2,0,0,0,-2,0,0,0
6956,240000,192000,0,0,0,0,0,0,-2,0,0,0,-2,0,0,0,-2,0,0,0,-2,0,0,0
6957,360000,288000,0,0,0,0,0,1,-2,0,0,0,-2,0,0,0,-2,0,0,0,-2,0,0,0
6958,50000,40000,0,1,1,0,0,0,2,49422,3000,46422,0,49586,1500,48086,0,30023,5000,25023,0,28373,2000,26373
6959,30000,24000,0,0,0,0,0,0,-1,390,390,0,-1,0,0,0,-1,780,780,0,-1,0,0,0
6960,80000,64000,0,0,0,0,0,0,0,64065,2600,61465,0,54764,2000,52764,0,55868,2000,53868,0,57288,2303,54985
6961,70000,56000,0,1,1,1,1,0,0,64720,1600,63120,0,66031,1587,64444,0,67459,1700,65759,0,69171,2000,67171
6962,340000,272000,0,0,0,0,0,0,0,92068,4708,87360,0,91367,3163,88204,0,89601,3209,86392,0,86899,3102,83797
6963,90000,72000,0,1,0,0,0,0,0,90388,5150,85238,0,56087,1100,54987,0,27055,977,26078,0,22320,1202,21118
6964,360000,288000,0,0,0,0,0,0,0,78212,10005,68207,0,69453,10000,59453,0,73423,10000,63423,0,72575,10000,62575
6965,150000,120000,0,0,0,0,0,0,0,0,1500,-1500,0,0,0,0,-2,0,0,0,-2,0,0,0
6966,320000,256000,0,0,0,0,0,0,-1,1943,1952,-9,-2,13312,13375,-63,-1,-5,5,-10,-1,-5,0,-5
6967,290000,232000,0,0,0,0,0,1,0,140802,135000,5802,0,143354,5200,138154,0,146225,5500,140725,0,148820,5500,143320
6968,230000,184000,0,0,0,0,0,0,-1,7978,8178,-200,-1,2831,500,2331,0,3518,1000,2518,0,846,846,0
6969,30000,24000,0,0,0,0,0,1,2,20599,2014,18585,2,15642,6,15636,2,23789,25700,-1911,-1,20562,800,19762
6970,290000,232000,0,0,0,0,0,0,0,171002,1002,170000,0,170795,795,170000,0,170795,795,170000,0,171003,1003,170000
6971,280000,224000,0,0,0,0,0,0,0,75377,6000,69377,0,68277,0,68277,2,72042,4800,67242,2,65921,0,65921
6972,50000,40000,0,0,0,0,0,0,0,17827,2000,15827,0,7655,500,7155,0,7881,500,7381,0,8248,500,7748
6973,70000,56000,0,0,0,0,0,0,0,53163,7320,45843,0,49953,1700,48253,0,32535,1200,31335,0,27715,1400,26315
6974,140000,112000,0,0,0,0,0,0,0,74510,6000,68510,0,73876,4000,69876,0,76180,4000,72180,0,78400,4000,74400
6975,60000,48000,0,0,0,0,0,0,0,17660,0,17660,2,13104,0,13104,0,8722,174,8548,0,17976,13810,4166
6976,200000,160000,0,1,1,1,1,0,0,188181,8302,179879,0,190775,7225,183550,0,196449,10153,186296,0,192085,6987,185098
6977,260000,208000,0,0,0,0,0,0,-2,204,204,0,-1,-810,0,-810,-1,2190,3000,-810,-1,810,0,810
6978,350000,280000,0,0,0,0,0,1,0,220450,9000,211450,0,190173,8700,181473,0,192649,7000,185649,0,197269,7600,189669
6979,20000,16000,0,1,1,1,1,1,2,19753,0,19753,3,19160,0,19160,2,19661,788,18873,0,19816,558,19258
6980,50000,40000,0,0,0,0,0,0,0,15993,2600,13393,0,16327,600,15727,0,16863,800,16063,0,17282,700,16582
6981,400000,320000,0,0,0,0,0,0,0,317661,15012,302649,0,319004,13000,306004,0,316611,12055,304556,0,314106,13368,300738
6982,50000,40000,0,0,0,0,0,0,2,14817,2000,12817,0,13725,7000,6725,0,13147,5000,8147,0,5932,5932,0
6983,50000,40000,0,0,0,0,0,0,0,28868,1840,27028,0,44751,31000,13751,0,27557,977,26580,0,29125,2003,27122
6984,500000,400000,0,0,0,0,0,0,0,52196,12000,40196,0,43180,0,43180,0,1095,1095,0,-1,856,856,0
6985,160000,128000,0,0,0,0,0,0,2,100535,6497,94038,0,104382,8001,96381,0,100535,0,100535,2,101621,4000,97621
6986,80000,64000,0,0,0,0,0,0,0,61000,1600,59400,0,48300,0,48300,0,47300,1500,45800,0,3500,1500,2000
6987,240000,192000,0,0,0,0,0,0,-2,2178,2178,0,-2,2254,2406,-152,-2,4219,4219,0,-2,2489,2489,0
6988,30000,24000,0,0,1,0,0,1,2,25131,3200,21931,0,29148,5000,24148,0,12134,1000,11134,0,12976,1000,11976
6989,420000,336000,0,0,0,0,0,0,0,84079,3427,80652,0,85614,2909,82705,0,87053,2877,84176,0,88657,2976,85681
6990,90000,72000,0,0,0,0,0,0,-1,1261,1261,0,-1,1261,1261,0,-1,1261,1261,0,-1,1261,1261,0
6991,20000,16000,0,0,0,0,0,1,-2,0,0,0,-2,0,0,0,-2,0,0,0,-2,0,0,0
6992,390000,312000,0,0,0,0,0,0,2,59601,0,59601,2,60422,2734,57688,0,59094,2254,56840,0,59862,2178,57684
6993,200000,160000,0,0,0,0,0,0,-1,5448,5448,0,-1,632,632,0,-1,0,0,0,-1,646,646,0
6994,150000,120000,0,1,1,1,0,1,0,130388,6000,124388,0,138246,10500,127746,0,140513,5015,135498,2,118464,173,118291
6995,520000,416000,0,0,0,0,0,0,0,147972,18069,129903,0,157115,30000,127115,0,196804,46805,149999,0,21550,21550,0
6996,50000,40000,0,0,0,0,0,1,2,35527,0,35527,3,36247,1600,34647,2,35367,0,35367,2,37537,2900,34637
6997,10000,8000,0,0,1,1,1,1,0,8779,1153,7626,0,9379,1143,8236,0,9565,329,9236,0,9062,418,8644
6998,50000,40000,0,1,0,0,0,0,0,50608,2252,48356,0,37700,2498,35202,0,11325,372,10953,0,9814,500,9314
6999,190000,152000,0,0,0,0,0,0,0,0,0,0,0,0,0,0,-2,0,0,0,-2,0,0,0
7000,300000,240000,0,0,0,0,0,0,-1,6246,6279,-33,-1,3872,3883,-11,-1,11875,11883,-8,-1,5290,5305,-15
7001,170000,136000,0,0,0,0,0,1,2,68387,2000,66387,0,51511,3057,48454,0,33939,2000,31939,0,34330,5000,29330
7002,30000,24000,0,1,1,1,0,0,0,27876,1800,26076,0,26640,1500,25140,0,25896,1500,24396,0,25481,1500,23981
7003,30000,24000,0,0,0,0,0,1,2,12240,0,12240,3,11747,0,11747,2,12651,1100,11551,2,12305,0,12305
7004,20000,16000,0,1,1,1,0,1,0,20998,4000,16998,0,19468,0,19468,0,36702,367,36335,0,0,0,0
7005,20000,16000,0,0,0,0,0,1,0,15535,1019,14516,0,1434,900,534,0,500,0,500,0,0,1500,-1500
7006,60000,48000,0,0,0,0,0,0,0,30340,8565,21775,0,28368,969,27399,0,28962,1004,27958,0,26589,1000,25589
7007,140000,112000,0,0,0,0,0,0,-2,0,0,0,-2,0,0,0,-2,0,0,0,-2,0,0,0
7008,50000,40000,0,1,1,0,0,0,2,51010,2092,48918,0,50342,1460,48882,0,36025,1167,34858,0,36778,1209,35569
7009,150000,120000,0,0,0,0,0,0,0,98583,5000,93583,0,95810,4000,91810,0,87216,4000,83216,0,88201,3290,84911
7010,180000,144000,0,1,1,1,1,0,0,183172,7000,176172,0,183117,7000,176117,0,179277,6411,172866,0,183394,7000,176394
7011,50000,40000,0,0,0,0,0,0,0,26538,1279,25259,0,20818,687,20131,0,19759,690,19069,0,17907,671,17236
7012,100000,80000,0,0,0,0,0,0,-1,2098,2099,-1,-1,3494,3494,0,-1,2086,2086,0,-1,2379,2379,0
7013,200000,160000,0,0,0,0,0,0,-1,1169,1169,0,-1,3175,3178,-3,-1,153,153,0,-1,0,0,0
7014,220000,176000,0,0,0,0,0,0,-1,3606,13,3593,2,4656,4656,0,-1,8960,5000,3960,0,13264,5000,8264
7015,160000,128000,0,0,0,0,0,0,0,80435,3604,76831,0,79969,2972,76997,0,77108,3000,74108,0,76579,2228,74351
7016,50000,40000,0,0,0,0,0,1,0,42589,3000,39589,0,639,7000,-6361,-1,4639,4000,639,0,2312,2413,-101
7017,50000,40000,0,0,0,0,0,0,-2,1000,1103,-103,-2,0,0,0,-2,0,0,0,-2,0,0,0
7018,80000,64000,1,1,0,0,0,0,0,92131,2600,89531,0,47655,4300,43355,0,43182,2000,41182,0,44332,2000,42332
7019,160000,128000,0,0,0,0,0,0,-2,0,0,0,-2,0,0,0,-2,0,0,0,-2,0,0,0
7020,270000,216000,0,0,0,0,0,0,0,29722,10339,19383,0,36276,10034,26242,0,19065,54,19011,0,17937,10088,7849
7021,300000,240000,0,0,0,0,0,1,-2,0,0,0,-2,0,0,0,-2,0,0,0,-2,0,0,0
7022,360000,288000,0,0,0,0,0,0,0,7537,3004,4533,0,11227,5011,6216,0,9703,1061,8642,0,61882,65663,-3781
7023,210000,168000,0,0,0,0,0,0,-2,0,0,0,-2,0,0,0,-2,0,0,0,-2,0,0,0
7024,20000,16000,0,0,0,0,0,0,0,8145,1500,6645,0,8153,291,7862,0,8324,302,8022,0,8490,304,8186
7025,180000,144000,0,0,0,0,0,0,0,26941,1400,25541,0,27705,1554,26151,0,21955,0,21955,0,0,0,0
7026,190000,152000,0,0,0,0,0,0,-2,-1548,0,-1548,-2,40733,43500,-2767,-1,10876,2000,8876,0,2907,2907,0
7027,140000,112000,0,1,0,0,0,1,0,131559,4733,126826,0,111859,4015,107844,0,98815,4000,94815,0,97443,4000,93443
7028,60000,48000,0,1,1,1,1,1,2,62158,2746,59412,2,120142,0,120142,2,60428,2297,58131,0,58192,1875,56317
7029,200000,160000,0,0,0,0,0,0,-2,0,0,0,-2,0,0,0,-2,0,0,0,-2,0,0,0
7030,50000,40000,0,0,0,0,0,1,-2,0,0,0,-2,0,0,0,-2,0,0,0,-2,0,0,0
7031,300000,240000,0,0,0,0,0,0,-1,1938,1938,0,-1,81,81,0,-1,671,671,0,-1,8067,8067,0
7032,150000,120000,0,0,0,0,0,0,-1,0,0,0,-2,0,0,0,-2,0,0,0,-2,0,0,0
7033,400000,320000,0,0,0,0,0,0,0,63047,3000,60047,0,65508,3000,62508,0,66954,2000,64954,0,68411,2002,66409
7034,200000,160000,0,0,0,0,0,0,0,74865,4000,70865,0,72766,5012,67754,0,70444,4000,66444,0,69003,3000,66003
7035,180000,144000,0,0,0,0,0,0,-1,8388,3200,5188,0,8529,2700,5829,0,7739,2000,5739,0,3803,76,3727
7036,50000,40000,0,0,0,0,0,1,2,33239,2000,31239,2,33571,1171,32400,2,32732,0,32732,2,33416,1211,32205
7037,50000,40000,0,0,0,0,0,0,-1,0,300,-300,-1,0,0,0,-2,0,0,0,-2,0,0,0
7038,150000,120000,0,0,0,0,0,0,-2,831,833,-2,-2,6469,6488,-19,-2,5138,5153,-15,-2,7810,7833,-23
7039,140000,112000,0,0,0,0,0,0,0,1206,1000,206,0,5430,5000,430,0,4460,0,4460,2,8429,5000,3429
7040,60000,48000,0,0,0,0,0,1,-1,-61506,365,-61871,-1,3859,73000,-69141,-1,415,415,0,-1,415,415,0
7041,50000,40000,0,0,0,0,0,1,0,26283,2000,24283,0,26547,1000,25547,0,27119,1000,26119,0,27697,1028,26669
7042,250000,200000,0,0,0,0,0,0,2,31217,1443,29774,0,25231,560,24671,0,17009,4875,12134,0,4553,400,4153
7043,180000,144000,0,0,0,0,0,0,0,13669,3316,10353,0,316,316,0,-1,120961,120961,0,-1,123355,5000,118355
7044,30000,24000,0,0,0,0,0,1,2,1751,1751,0,-1,0,0,0,-1,0,0,0,-2,0,0,0
7045,70000,56000,0,0,0,0,0,0,0,12637,3000,9637,0,11204,0,11204,2,10983,2000,8983,0,11901,2000,9901
7046,180000,144000,0,0,0,0,0,0,-2,0,0,0,-2,0,0,0,-2,0,0,0,-2,0,0,0
7047,80000,64000,0,0,0,0,0,0,-2,0,0,0,-2,0,0,0,-2,0,0,0,-2,0,0,0
7048,210000,168000,0,0,0,0,0,0,-2,3056,3056,0,-2,213,213,0,-2,825,825,0,-2,1240,1240,0
7049,50000,40000,0,1,0,0,0,1,0,50297,2500,47797,0,36164,2000,34164,0,37616,2000,35616,0,39062,2000,37062
7050,90000,72000,0,1,1,1,1,0,-1,90659,4100,86559,0,82827,3200,79627,0,79359,3100,76259,0,81401,3500,77901
7051,480000,384000,0,0,0,0,0,0,0,37649,37754,-105,-1,45469,32970,12499,0,20020,8000,12020,0,3167,3167,0
7052,10000,8000,0,1,1,1,0,0,-1,9787,1000,8787,0,9897,500,9397,0,9707,200,9507,0,-173,0,-173
7053,140000,112000,0,0,0,0,0,0,0,90894,5000,85894,0,85805,3000,82805,0,85907,4000,81907,0,88615,4000,84615
7054,460000,368000,0,0,0,0,0,0,0,168730,7000,161730,0,172072,6000,166072,0,154177,5593,148584,0,157246,5630,151616
7055,260000,208000,0,0,0,0,0,0,-1,2504,2504,0,-2,15809,16593,-784,-2,3756,3764,-8,-2,9560,11092,-1532
7056,340000,272000,0,1,0,0,0,0,0,290374,10005,280369,0,5329,5336,-7,0,5029,5036,-7,-1,7079,38592,-31513
7057,350000,280000,0,0,0,0,0,1,2,2400,0,2400,7,2400,0,2400,7,2400,0,2400,7,2400,0,2400
7058,280000,224000,0,0,0,0,0,0,-2,646,646,0,-2,3689,3689,0,-2,560,560,0,-2,-150,0,-150
7059,20000,16000,0,1,0,0,0,0,0,19189,2000,17189,0,13708,1500,12208,0,11467,1000,10467,0,10614,1000,9614
7060,20000,16000,1,1,0,0,0,1,0,27820,0,27820,2,15824,4000,11824,0,15761,1700,14061,0,12510,1000,11510
7061,280000,224000,0,0,0,0,0,0,0,212405,15000,197405,0,194345,0,194345,0,161084,161084,0,-1,174622,15000,159622
7062,160000,128000,0,0,0,0,0,0,2,98427,3879,94548,0,102250,5459,96791,0,102734,3675,99059,0,104901,3821,101080
7063,160000,128000,0,0,0,0,0,0,0,11376,11426,-50,-1,2199,2199,0,-1,10856,10000,856,0,0,0,0
7064,160000,128000,0,0,0,0,0,0,-2,1217,1223,-6,-2,697,700,-3,-2,650,653,-3,-2,691,691,0
7065,240000,192000,0,0,0,0,0,0,-1,4670,4670,0,-1,17480,17480,0,-1,5489,0,5489,0,7740,7740,0
7066,240000,192000,0,0,0,0,0,0,0,173429,10429,163000,0,176943,10423,166520,0,176843,6843,170000,0,177183,7183,170000
7067,420000,336000,0,0,0,0,0,0,0,89489,14000,75489,0,87076,0,87076,2,55508,1837,53671,0,57771,3010,54761
7068,130000,104000,0,0,0,0,0,0,0,13371,0,13371,2,4405,1000,3405,0,1292,1292,0,-1,390,390,0
7069,140000,112000,0,1,0,0,0,0,0,131805,5000,126805,0,107950,4005,103945,0,88622,3500,85122,0,85165,3500,81665
7070,240000,192000,0,0,0,0,0,0,0,-15,0,-15,-2,-15,0,-15,-2,-15,0,-15,-2,1185,1200,-15
7071,80000,64000,0,1,1,1,1,1,2,73741,0,73741,2,75200,2700,72500,0,76959,2950,74009,0,78556,3000,75556
7072,270000,216000,0,0,0,0,0,0,-1,8091,8091,0,-1,8350,1000,7350,0,8350,0,8350,0,0,0,0
7073,150000,120000,0,1,0,0,0,0,0,151428,8794,142634,0,111159,3454,107705,0,97154,98231,-1077,-1,98404,3486,94918
7074,340000,272000,0,0,0,0,0,0,-1,1135,1144,-9,-2,0,0,0,-2,0,0,0,-2,0,0,0
7075,60000,48000,0,0,0,0,0,0,0,38144,1731,36413,0,29542,2009,27533,0,30700,4121,26579,0,30064,0,30064
7076,50000,40000,0,0,0,0,0,0,-1,20274,1408,18866,0,19945,3000,16945,0,20472,1000,19472,0,21000,869,20131
7077,50000,40000,0,0,0,0,0,0,0,34256,1855,32401,0,30723,1341,29382,0,19766,706,19060,0,20449,1000,19449
7078,150000,120000,0,0,0,0,0,0,0,435,870,-435,-1,0,0,0,-1,81824,82259,-435,-1,83101,3018,80083
7079,130000,104000,0,1,1,0,0,0,2,132549,5000,127549,2,128646,0,128646,2,100845,3512,97333,0,101545,3606,97939
7080,20000,16000,0,0,0,0,0,1,2,16160,1800,14360,2,15603,0,15603,2,15943,600,15343,0,16286,600,15686
7081,210000,168000,0,0,0,0,0,0,-1,61813,72037,-10224,-1,59024,5015,54009,0,63483,12000,51483,0,58991,5000,53991
7082,360000,288000,0,0,0,0,0,0,-1,27566,27566,0,-1,28558,2513,26045,0,12495,12495,0,-1,18906,8906,10000
7083,100000,80000,0,0,0,0,0,0,0,51103,5000,46103,0,52251,2000,50251,0,53480,2100,51380,0,54467,2000,52467
7084,80000,64000,0,0,0,0,0,1,-2,0,0,0,-2,0,0,0,-2,0,0,0,-2,0,0,0
7085,130000,104000,0,1,1,0,0,0,0,128615,6700,121915,0,130553,6050,124503,0,100976,4040,96936,0,96560,3700,92860
7086,340000,272000,0,0,0,0,0,0,0,69808,13500,56308,0,66670,13000,53670,0,63277,13000,50277,0,62027,13000,49027
7087,130000,104000,0,0,0,0,0,1,0,45004,1747,43257,0,46257,2000,44257,0,49312,3800,45512,0,50252,1900,48352
7088,50000,40000,0,0,0,0,0,0,-2,0,0,0,-2,0,0,0,-2,0,0,0,-2,0,0,0
7089,210000,168000,0,0,0,0,0,0,0,73077,20000,53077,0,62288,2205,60083,0,66309,5000,61309,0,66393,1982,64411
7090,20000,16000,0,1,1,1,1,0,0,18981,1773,17208,0,19608,1400,18208,0,19600,392,19208,0,20000,400,19600
7091,120000,96000,0,0,0,0,0,0,0,33828,6000,27828,0,34236,1200,33036,2,34734,1300,33434,2,35292,1200,34092
7092,370000,296000,0,0,0,0,0,0,-2,3007,3007,0,-2,4246,4305,-59,-2,3737,3737,0,-2,2290,2290,0
7093,600000,480000,0,0,0,0,0,0,-2,3474,3480,-6,-2,1952,1957,-5,-2,2182,2186,-4,-2,2305,2310,-5
7094,90000,72000,0,0,0,0,0,0,-2,0,0,0,-2,0,0,0,-2,9167,9167,0,-2,0,0,0
7095,20000,16000,0,0,0,0,0,0,0,11221,3520,7701,2,10656,0,10656,2,7928,1000,6928,0,580,580,0
7096,220000,176000,0,0,0,0,0,0,0,166288,8000,158288,0,168146,6108,162038,0,172345,7000,165345,0,177151,7743,169408
7097,30000,24000,0,0,0,0,0,0,0,25791,2000,23791,0,18972,1600,17372,0,28051,10000,18051,0,20782,2140,18642
7098,50000,40000,0,1,1,0,0,0,0,48691,2123,46568,0,49108,2675,46433,0,19809,552,19257,0,11314,1000,10314
7099,350000,280000,0,0,0,0,0,0,0,260963,0,260963,2,261263,11021,250242,0,255566,9200,246366,0,254941,8500,246441
7100,40000,32000,0,1,1,1,1,1,2,35597,1800,33797,2,36211,1500,34711,2,35334,0,35334,2,36170,1500,34670
7101,30000,24000,0,1,1,1,1,1,2,27574,2478,25096,2,28420,1600,26820,2,29318,1498,27820,2,28704,0,28704
7102,70000,56000,0,0,0,0,0,0,0,39926,2500,37426,0,18648,2500,16148,0,5022,1000,4022,0,5935,1000,4935
7103,60000,48000,0,0,0,0,0,1,-1,20680,0,20680,2,390,0,390,0,390,390,0,-1,14290,14290,0
7104,100000,80000,0,0,0,0,0,1,3,3336,0,3336,2,1863,0,1863,0,390,0,390,0,930,930,0
7105,170000,136000,1,1,1,0,0,0,0,183151,8271,174880,0,170838,5159,165679,0,80934,2700,78234,0,80821,2619,78202
7106,60000,48000,0,0,0,0,0,1,0,16586,5000,11586,0,5516,3000,2516,0,16378,16000,378,0,2670,3000,-330
7107,20000,16000,0,1,1,1,0,0,0,18877,1473,17404,0,19604,1200,18404,0,19800,396,19404,0,0,0,0
7108,50000,40000,0,1,1,0,0,0,0,49322,2300,47022,0,50618,2500,48118,0,13842,500,13342,0,14217,600,13617
7109,80000,64000,0,1,1,1,1,0,2,72926,3214,69712,0,73745,3000,70745,0,75675,3500,72175,0,75999,2266,73733
7110,130000,104000,0,0,0,0,0,0,2,74175,6000,68175,2,72383,0,72383,2,77217,6000,71217,2,75820,0,75820
7111,50000,40000,0,0,0,0,0,0,0,17159,2000,15159,0,8402,1500,6902,0,6646,500,6146,0,7534,1000,6534
7112,30000,24000,0,1,1,1,1,0,0,31336,2000,29336,0,32389,1500,30889,0,33142,1200,31942,0,33999,1330,32669
7113,140000,112000,0,0,0,0,0,0,0,103265,13265,90000,0,117188,17188,100000,0,113368,10000,103368,0,119194,15000,104194
7114,280000,224000,0,0,0,0,0,0,-1,335,335,0,-1,2300,2322,-22,-1,0,0,0,-1,0,0,0
7115,50000,40000,0,0,0,0,0,0,0,18777,1323,17454,0,19662,1598,18064,0,19348,674,18674,0,19355,690,18665
7116,70000,56000,0,0,0,0,0,0,0,15379,15006,373,0,2985,3000,-15,-1,29351,29100,251,0,29977,1100,28877
7117,200000,160000,0,0,0,0,0,0,-1,973,973,0,-1,0,0,0,-1,161,161,0,-1,1174,1174,0
7118,50000,40000,0,1,0,0,0,0,0,50453,2039,48414,0,19703,1237,18466,0,19345,634,18711,0,20106,5000,15106
7119,230000,184000,0,0,0,0,0,0,0,4979,2023,2956,0,631,0,631,2,1635,1004,631,0,10244,10019,225
7120,50000,40000,0,0,0,0,0,1,2,32617,1510,31107,0,18834,1724,17110,0,15810,0,15810,0,15786,366,15420
7121,200000,160000,0,0,0,0,0,0,0,82417,3000,79417,0,83877,2018,81859,0,82814,2743,80071,0,35484,1578,33906
7122,100000,80000,0,0,0,0,0,1,2,452,452,0,-1,1016,1580,-564,-1,1096,1096,0,-1,2202,2122,80
7123,150000,120000,0,0,0,0,0,1,0,111868,10700,101168,0,107702,1600,106102,2,103112,0,103112,2,103246,2800,100446
7124,410000,328000,0,0,0,0,0,1,-1,0,0,0,-1,0,0,0,-2,0,0,0,-2,666,666,0
7125,140000,112000,0,0,0,0,0,0,2,61459,0,61459,3,59798,0,59798,2,61287,3009,58278,0,8383,1000,7383
7126,180000,144000,0,0,0,0,0,0,-1,21282,0,21282,2,10200,200,10000,0,0,0,0,0,0,0,0
7127,200000,160000,0,0,0,0,0,0,-1,2297,2509,-212,-1,-3903,0,-3903,-1,11989,24000,-12011,-1,11839,0,11839
7128,90000,72000,0,0,0,0,0,0,-2,10613,10613,0,-2,316,316,0,-2,316,316,0,-2,316,316,0
7129,300000,240000,0,0,0,0,0,0,-1,2299,2299,0,-1,900,900,0,-1,1400,1400,0,-1,0,0,0
7130,220000,176000,0,0,0,0,0,0,0,0,0,0,0,0,0,0,-2,0,0,0,-2,0,0,0
7131,150000,120000,0,0,0,0,0,0,0,110255,5500,104755,0,110247,5300,104947,0,110955,3853,107102,0,105145,4000,101145
7132,500000,400000,0,0,0,0,0,0,0,115610,118640,-3030,-1,89359,5841,83518,0,63609,6000,57609,0,123128,100000,23128
7133,310000,248000,0,0,0,0,0,0,2,190938,7000,183938,0,202835,15001,187834,0,199417,1,199416,2,203830,8001,195829
7134,220000,176000,0,0,0,0,0,0,-1,0,0,0,-1,0,0,0,-2,0,0,0,-2,0,0,0
7135,50000,40000,0,0,0,0,0,0,0,8582,1500,7082,0,9719,1300,8419,0,9692,500,9192,0,9663,500,9163
7136,40000,32000,0,0,0,0,0,0,0,8484,1150,7334,0,10333,2000,8333,0,10023,0,10023,2,11258,1400,9858
7137,250000,200000,0,0,0,0,0,0,-1,3498,3498,0,-1,8963,8963,0,-1,0,0,0,-1,14660,14660,0
7138,50000,40000,0,0,0,0,0,0,-1,390,390,0,-1,390,390,0,-1,885,885,0,-1,885,885,0
7139,60000,48000,0,0,0,0,0,0,0,41690,3002,38688,0,21151,1364,19787,0,30059,10000,20059,0,13046,474,12572
7140,50000,40000,0,1,0,0,0,0,0,48942,2174,46768,0,36545,2117,34428,0,5107,117,4990,0,4640,4853,-213
7141,180000,144000,0,0,0,0,0,0,-1,18390,18399,-9,-1,13999,13999,0,-1,933,933,0,-1,933,933,0
7142,70000,56000,0,0,0,0,0,0,0,14897,1560,13337,0,15941,1600,14341,0,16376,1000,15376,0,16959,1000,15959
7143,360000,288000,0,0,0,0,0,0,-1,21908,21908,0,-1,1780,1780,0,-1,47307,47307,0,-1,0,0,0
7144,220000,176000,1,1,1,1,1,1,6,232446,0,232446,5,227800,0,227800,4,225044,0,225044,3,222356,0,222356
7145,130000,104000,0,0,0,0,0,0,0,65225,3000,62225,0,65588,3000,62588,0,66662,2500,64162,0,68176,3000,65176
7146,20000,16000,0,1,1,1,0,0,0,20539,1800,18739,0,19725,1200,18525,0,19836,751,19085,0,12559,1000,11559
7147,210000,168000,0,0,0,0,0,1,-1,2871,2871,0,-1,5087,5087,0,-1,1943,0,1943,0,3392,3392,0
7148,20000,16000,0,0,0,0,0,0,-2,0,0,0,-2,0,0,0,-2,0,0,0,-2,0,0,0
7149,50000,40000,0,1,1,1,1,0,0,51016,4206,46810,0,48133,391,47742,2,47822,1700,46122,0,48126,1806,46320
7150,350000,280000,0,0,0,0,0,0,0,47298,5045,42253,0,25692,3000,22692,0,24542,2005,22537,0,23697,3001,20696
7151,50000,40000,0,0,0,0,0,1,0,13990,1300,12690,0,14356,600,13756,0,14657,532,14125,0,15013,600,14413
7152,80000,64000,0,0,0,0,0,0,0,66437,2627,63810,0,54631,1850,52781,0,49219,1870,47349,0,50094,1773,48321
7153,260000,208000,0,0,0,0,0,0,-1,12996,13000,-4,-1,8788,0,8788,0,15104,15104,0,-1,16764,16764,0
7154,80000,64000,0,0,0,0,0,0,0,43850,2000,41850,0,38112,2000,36112,0,38876,1700,37176,0,39697,1600,38097
7155,200000,160000,0,0,0,0,0,1,0,153646,5542,148104,0,137087,5308,131779,0,134995,4587,130408,0,135953,4750,131203
7156,80000,64000,0,0,0,0,0,0,-1,31484,31610,-126,-1,396,396,0,-1,3832,3832,0,-1,3867,3867,0
7157,10000,8000,0,1,1,1,1,0,0,10004,1160,8844,0,9722,1139,8583,0,10044,1241,8803,0,9856,345,9511
7158,50000,40000,0,0,0,0,0,0,0,39394,1583,37811,0,33490,1347,32143,0,27316,1183,26133,0,0,0,0
7159,490000,392000,0,0,0,0,0,0,0,5342,2000,3342,0,7395,3500,3895,0,367,367,0,-1,13804,16024,-2220
7160,30000,24000,0,0,0,0,0,0,0,7877,1000,6877,2,8591,1000,7591,0,10302,2000,8302,0,10006,0,10006
7161,30000,24000,0,0,0,0,0,0,0,19500,1000,18500,0,0,0,0,0,0,0,0,-2,0,0,0
7162,80000,64000,0,0,0,0,0,0,-1,0,0,0,-2,0,0,0,-2,0,0,0,-2,59349,59349,0
7163,10000,8000,0,0,0,0,0,0,-1,6222,6222,0,-1,974,984,-10,-1,8834,8834,0,-1,6010,0,6010
7164,300000,240000,0,0,0,0,0,0,0,84462,4000,80462,0,86263,4100,82163,0,87238,3300,83938,0,89176,3500,85676
7165,20000,16000,0,0,0,0,0,0,0,0,0,0,0,0,0,0,-2,0,0,0,-2,0,0,0
7166,70000,56000,0,0,0,0,0,1,0,33033,3000,30033,0,32203,0,32203,2,32884,1200,31684,0,33587,1250,32337
7167,210000,168000,0,0,0,0,0,0,-2,780,780,0,-1,0,0,0,-1,0,0,0,-2,0,0,0
7168,160000,128000,0,0,0,0,0,0,-2,170,170,0,-2,-220,0,-220,-2,390,1000,-610,-2,390,390,0
7169,140000,112000,0,0,0,0,0,0,-1,21570,21570,0,-1,24986,4500,20486,0,25256,1050,24206,0,25091,1183,23908
7170,80000,64000,0,1,1,1,1,0,0,80171,3500,76671,0,80136,3000,77136,0,79151,2800,76351,0,78465,3000,75465
7171,130000,104000,0,0,0,0,0,0,-2,0,0,0,-2,402,402,0,-2,0,0,0,-2,2054,2054,0
7172,330000,264000,0,0,0,0,0,1,0,259517,21400,238117,0,253863,0,253863,2,257535,9400,248135,0,262753,9542,253211
7173,60000,48000,0,0,0,0,0,0,-1,3541,3541,0,-1,2248,2248,0,-1,0,0,0,-1,449,449,0
7174,90000,72000,0,0,0,0,0,0,-1,18644,2000,16644,0,12718,500,12218,0,12984,424,12560,0,13247,431,12816
7175,200000,160000,0,0,0,0,0,0,0,72556,2500,70056,0,63524,3000,60524,0,49914,2000,47914,0,18068,2000,16068
7176,480000,384000,0,0,0,0,0,0,-1,53425,55328,-1903,-1,76538,77000,-462,-1,106032,30048,75984,0,66535,30015,36520
7177,30000,24000,0,1,1,1,1,1,2,25048,0,25048,2,26060,1433,24627,0,26578,951,25627,0,27133,983,26150
7178,50000,40000,0,1,1,0,0,0,0,48188,1000,47188,2,49966,3800,46166,0,19294,820,18474,0,18971,900,18071
7179,150000,120000,0,1,1,1,1,1,2,131511,4006,127505,2,129369,3669,125700,2,123191,0,123191,2,132072,11781,120291
7180,160000,128000,0,0,0,0,0,0,0,49448,40015,9433,0,38415,1625,36790,0,59138,32044,27094,0,77579,27248,50331
7181,290000,232000,0,0,0,0,0,0,0,32453,1700,30753,0,27981,2015,25966,0,14096,2000,12096,0,10240,1000,9240
7182,20000,16000,0,0,0,1,1,1,0,15852,1000,14852,2,16862,1279,15583,0,17197,614,16583,0,17558,637,16921
7183,560000,448000,0,0,0,0,0,0,-2,4593,1023,3570,-2,2512,2519,-7,-1,11461,46518,-35057,-1,3402,3421,-19
7184,180000,144000,0,1,0,0,0,1,2,163930,0,163930,2,136145,7000,129145,0,133843,5000,128843,0,134352,8000,126352
7185,500000,400000,0,0,0,0,0,0,-2,10000,10000,0,-2,14218,14218,0,-2,62208,62500,-292,-2,83611,83611,0
7186,80000,64000,0,0,0,0,0,0,0,49432,2005,47427,0,49043,2000,47043,0,47805,2000,45805,0,45626,2000,43626
7187,130000,104000,0,0,0,0,0,0,-1,423,423,0,-1,2149,2149,0,-1,463,463,0,-1,2218,2218,0
7188,230000,184000,0,0,0,0,0,0,0,94328,3401,90927,0,96203,3420,92783,0,98474,3797,94677,0,98835,3476,95359
7189,90000,72000,0,0,0,0,0,0,0,65298,3000,62298,0,65233,2300,62933,0,66717,2500,64217,0,67562,3000,64562
7190,180000,144000,0,0,0,0,0,0,0,6216,3000,3216,0,3622,1622,2000,0,4095,4095,0,-1,6596,3000,3596
7191,190000,152000,0,0,0,0,0,0,2,46423,1400,45023,0,38493,770,37723,0,0,0,0,0,0,0,0
7192,80000,64000,0,0,0,0,0,0,0,28447,1378,27069,0,23537,1328,22209,0,7613,195,7418,0,3356,269,3087
7193,350000,280000,0,0,0,0,0,0,0,77472,5300,72172,0,68901,2500,66401,0,58259,2000,56259,0,47743,2000,45743
7194,80000,64000,0,0,0,0,0,0,-1,4724,4750,-26,-1,0,0,0,-1,1054,1054,0,-2,0,0,0
7195,160000,128000,0,0,0,0,0,0,-2,0,0,0,-2,0,0,0,-2,0,0,0,-2,695,695,0
7196,230000,184000,0,0,0,0,0,0,-2,285,285,0,-2,219,219,0,-2,415,416,-1,-2,142,142,0
7197,400000,320000,0,0,0,0,0,0,-2,118,118,0,-2,10349,10349,0,-2,2817,2817,0,-2,2410,2410,0
7198,30000,24000,0,0,0,0,0,0,0,22088,1268,20820,0,21624,694,20930,0,21833,866,20967,0,18174,695,17479
7199,220000,176000,0,0,0,0,0,0,0,184900,10000,174900,0,170611,10000,160611,0,125433,10053,115380,0,83709,4000,79709
7200,180000,144000,0,0,0,0,0,0,0,124014,4700,119314,0,125279,4316,120963,0,115315,4090,111225,0,117740,4245,113495
7201,50000,40000,0,0,0,0,0,0,0,18417,1500,16917,0,18877,1000,17877,0,18985,800,18185,0,18184,2000,16184
7202,230000,184000,0,0,0,0,0,0,0,109794,5505,104289,0,109143,5505,103638,0,107996,4000,103996,0,109230,4500,104730
7203,50000,40000,0,1,0,0,0,1,0,47843,1874,45969,0,29018,1049,27969,0,29777,1237,28540,0,28722,1100,27622
7204,60000,48000,0,0,0,0,0,1,3,44999,1500,43499,3,45463,1500,43963,3,45918,1500,44418,2,47863,3000,44863
7205,280000,224000,0,1,0,0,0,0,0,260274,11000,249274,0,153516,8000,145516,0,156830,5866,150964,0,152045,8000,144045
7206,420000,336000,0,0,0,0,0,0,-1,122212,100000,22212,0,117835,4013,113822,0,112705,3822,108883,0,111357,4086,107271
7207,500000,400000,0,0,0,0,0,0,-2,13000,13000,0,-2,13000,13000,0,-2,13000,13000,0,-2,13000,13000,0
7208,30000,24000,0,0,0,0,0,0,0,7738,0,7738,2,10179,3000,7179,0,11902,2000,9902,0,13109,1500,11609
7209,70000,56000,0,0,0,0,0,0,0,16318,1500,14818,0,17048,1000,16048,0,18772,2000,16772,0,18320,0,18320
7210,390000,312000,0,0,0,0,0,0,0,70791,14000,56791,0,66495,10000,56495,0,52055,12000,40055,0,68567,30000,38567
7211,110000,88000,0,0,0,0,0,0,-1,1555,1555,0,-1,2043,2045,-2,-1,1037,1037,0,-1,4718,4000,718
7212,140000,112000,0,0,0,0,0,1,2,100772,3200,97572,2,101562,3500,98062,2,103214,3193,100021,2,88085,0,88085
7213,480000,384000,0,0,0,0,0,0,0,107675,45000,62675,0,110289,12022,98267,0,100520,14000,86520,0,37080,14000,23080
7214,60000,48000,0,1,0,0,0,0,2,58583,0,58583,2,28301,600,27701,0,29301,1000,28301,0,14400,300,14100
7215,180000,144000,0,0,0,0,0,0,-2,0,0,0,-2,2537,2537,0,-1,0,0,0,-1,0,0,0
7216,50000,40000,0,1,1,0,0,0,2,49243,0,49243,2,49819,2169,47650,0,19324,702,18622,0,20103,1101,19002
7217,20000,16000,0,1,1,0,0,1,0,19343,1367,17976,0,19402,682,18720,0,11731,627,11104,0,0,0,0
7218,70000,56000,0,0,0,0,0,1,2,2044,0,2044,2,4152,4000,152,2,3023,0,3023,2,4014,2000,2014
7219,50000,40000,0,1,1,1,1,0,0,44694,2000,42694,2,43673,0,43673,2,44659,2000,42659,0,49512,6000,43512
7220,210000,168000,0,1,1,1,1,0,0,177856,8000,169856,0,181002,7600,173402,0,184690,6700,177990,0,188813,7100,181713
7221,210000,168000,0,1,0,0,0,1,0,204377,9000,195377,0,146575,6000,140575,0,144521,5500,139021,0,147938,5816,142122
7222,430000,344000,0,0,0,0,0,0,-2,34028,34028,0,-2,28407,28418,-11,-2,33608,33651,-43,-2,52015,52015,0
7223,170000,136000,0,0,0,0,0,0,0,20533,1000,19533,0,-919,16000,-16919,0,-919,16000,-16919,-2,-919,16000,-16919
7224,280000,224000,0,0,0,0,0,0,0,7860,3000,4860,0,10708,3000,7708,0,13516,3000,10516,0,16279,3000,13279
7225,440000,352000,0,0,0,0,0,0,0,18400,4375,14025,0,10978,271,10707,0,1175,497,678,0,32857,34255,-1398
7226,130000,104000,0,0,0,0,0,1,0,30569,2002,28567,0,28659,1400,27259,0,26952,600,26352,0,15852,1000,14852
7227,70000,56000,0,0,0,0,0,0,0,18596,1268,17328,0,9760,1052,8708,0,0,0,0,0,0,0,0
7228,160000,128000,0,0,0,0,0,0,0,122044,6300,115744,0,111799,5000,106799,0,92039,3000,89039,0,89536,2606,86930
7229,150000,120000,0,0,0,0,0,0,0,74749,3016,71733,0,80757,10000,70757,0,83685,4011,79674,0,81569,3073,78496
7230,20000,16000,0,0,0,0,0,0,-2,460,526,-66,-2,-201,201,-402,-2,1600,1801,-201,-1,0,0,0
7231,170000,136000,0,0,1,0,0,0,0,192575,83200,109375,0,157028,0,157028,0,135838,3006,132832,0,125483,132854,-7371
7232,260000,208000,0,0,0,0,0,0,-1,4663,4663,0,-1,3885,4140,-255,-1,4414,4414,0,-1,2514,2646,-132
7233,80000,64000,0,0,0,0,0,0,3,46037,0,46037,2,48457,3012,45445,2,47722,0,47722,2,48678,1569,47109
7234,90000,72000,0,1,0,0,0,0,0,87106,5110,81996,0,48730,2000,46730,0,27535,3000,24535,0,27751,1000,26751
7235,50000,40000,0,1,1,1,1,0,0,51922,5000,46922,0,51563,1200,50363,2,50677,0,50677,2,48556,1853,46703
7236,500000,400000,0,0,0,0,0,0,0,48785,1670,47115,0,16025,0,16025,2,19120,19120,0,-1,11461,11461,0
7237,90000,72000,0,0,1,1,1,0,0,76674,79786,-3112,-1,77974,2836,75138,0,80064,3657,76407,0,81747,2972,78775
7238,50000,40000,0,1,0,0,0,0,0,43157,3000,40157,0,14510,2000,12510,0,14963,500,14463,0,16580,2000,14580
7239,150000,120000,0,0,0,0,0,0,0,50043,2000,48043,0,55182,20000,35182,0,48983,2000,46983,0,50136,2000,48136
7240,150000,120000,0,0,0,0,0,0,0,5250,5250,0,-1,0,0,0,-1,0,0,0,-2,0,0,0
7241,260000,208000,0,0,0,0,0,0,-2,0,0,0,-2,0,0,0,-2,109,109,0,-2,945,945,0
7242,60000,48000,0,1,1,1,1,0,0,59592,2578,57014,0,58654,2039,56615,0,58664,2088,56576,0,59323,2767,56556
7243,110000,88000,0,0,0,0,0,0,0,51584,1800,49784,0,49601,1800,47801,0,50485,2000,48485,0,50565,2000,48565
7244,50000,40000,1,1,1,1,1,0,0,71000,10000,61000,0,73000,2000,71000,0,78000,5000,73000,0,80000,2000,78000
7245,30000,24000,0,0,0,0,0,0,-2,0,0,0,-2,0,0,0,-2,0,0,0,-2,0,0,0
7246,200000,160000,0,1,1,1,0,1,2,191752,9025,182727,0,178560,8030,170530,0,170092,5639,164453,0,161850,6054,155796
7247,130000,104000,0,1,1,1,1,0,2,117301,10000,107301,2,113926,0,113926,2,120846,8800,112046,2,118804,0,118804
7248,50000,40000,0,0,0,0,0,0,0,31811,1814,29997,0,13898,1000,12898,0,0,0,0,0,0,0,0
7249,200000,160000,0,0,0,0,0,0,0,44222,2668,41554,0,36869,1820,35049,0,31640,2000,29640,0,25334,882,24452
7250,60000,48000,0,1,1,0,0,0,0,60039,2906,57133,0,58887,2588,56299,0,29050,1055,27995,0,26055,2058,23997
7251,60000,48000,0,1,1,1,1,0,2,56105,2750,53355,0,59338,4850,54488,0,57870,0,57870,2,57884,2180,55704
7252,80000,64000,0,1,1,1,1,0,0,72812,2700,70112,0,74305,2700,71605,0,75872,2800,73072,0,77554,2900,74654
7253,400000,320000,0,0,0,0,0,0,-1,22396,10001,12395,0,26359,5023,21336,0,41627,20150,21477,0,16709,5082,11627
7254,350000,280000,0,0,0,0,0,0,0,630,630,0,-1,20682,20902,-220,-1,20902,5000,15902,0,16754,2000,14754
7255,200000,160000,0,0,0,0,0,0,-1,0,0,0,-2,0,0,0,-2,0,0,0,-2,17480,17480,0
7256,20000,16000,0,0,0,0,0,0,0,390,390,0,-1,390,390,0,-1,390,390,0,-1,0,0,0
7257,290000,232000,0,0,0,0,0,0,0,243722,12000,231722,0,235297,9000,226297,0,243312,12000,231312,0,242827,11000,231827
7258,30000,24000,0,1,1,1,1,0,2,29168,2000,27168,0,30566,2200,28366,0,29229,0,29229,2,26260,1100,25160
7259,30000,24000,0,0,0,0,0,1,2,13545,2993,10552,2,13531,500,13031,2,13017,0,13017,2,14008,1200,12808
7260,270000,216000,0,0,0,0,0,0,0,18865,5,18860,2,44908,34000,10908,0,19508,0,19508,0,15860,0,15860
7261,220000,176000,0,0,0,0,0,0,2,3619,3655,-36,-1,7069,7069,0,-1,4092,4092,0,-1,0,0,0
7262,100000,80000,0,1,1,1,1,1,2,95022,4000,91022,2,95972,3400,92572,2,98283,4000,94283,2,97819,1600,96219
7263,30000,24000,0,1,0,0,0,1,2,25406,0,25406,2,23339,2000,21339,0,17869,2000,15869,0,15284,1500,13784
7264,440000,352000,0,0,0,0,0,0,-2,-15641,752,-16393,-2,7059,34000,-26941,-2,-4220,284,-4504,-2,-16370,3650,-20020
7265,210000,168000,0,0,0,0,0,0,-2,141,141,0,-2,-104,88,-192,-2,-104,0,-104,-2,-104,0,-104
7266,60000,48000,0,0,0,0,0,1,0,15158,1275,13883,0,15450,544,14906,0,15933,3923,12010,0,16095,575,15520
7267,170000,136000,0,0,0,0,0,0,-1,780,780,0,-1,780,0,780,0,0,0,0,0,0,0,0
7268,200000,160000,0,0,0,0,0,0,-2,18718,18914,-196,-2,15033,15112,-79,-2,12785,12849,-64,-2,8426,8468,-42
7269,530000,424000,0,0,0,0,0,0,0,364298,14089,350209,0,345867,11962,333905,0,346676,11763,334913,0,352736,12557,340179
7270,70000,56000,0,0,0,0,0,0,0,51727,1813,49914,2,50594,0,50594,2,51823,2046,49777,0,54093,3300,50793
7271,60000,48000,0,1,0,0,0,0,0,56863,5900,50963,0,18473,1000,17473,0,15434,428,15006,0,7301,1000,6301
7272,100000,80000,0,0,0,0,0,0,0,69704,2600,67104,2,70566,2600,67966,2,69311,0,69311,2,70844,2685,68159
7273,150000,120000,0,1,1,1,1,0,2,131426,6100,125326,2,132703,4900,127803,2,129080,0,129080,2,136996,10200,126796
7274,500000,400000,0,0,0,0,0,1,-1,329774,255005,74769,0,328950,6780,322170,0,336073,8401,327672,0,1257,1262,-5
7275,320000,256000,0,0,0,0,0,0,-2,0,0,0,-2,0,0,0,-2,0,0,0,-2,0,0,0
7276,50000,40000,0,0,0,0,0,0,0,17615,5869,11746,0,17956,1000,16956,0,18091,795,17296,0,18259,1000,17259
7277,40000,32000,0,0,0,0,0,1,2,20406,10000,10406,2,20774,1000,19774,2,22132,2000,20132,2,21497,0,21497
7278,80000,64000,1,1,0,0,0,1,4,80581,0,80581,3,51537,0,51537,2,51381,1790,49591,0,48866,1890,46976
7279,210000,168000,0,0,0,0,0,1,2,61115,0,61115,2,62334,2235,60099,0,66196,4870,61326,0,64979,0,64979
7280,80000,64000,0,0,0,0,0,0,0,39720,1644,38076,0,34465,1222,33243,0,29488,1400,28088,0,32912,10000,22912
7281,30000,24000,0,1,1,1,1,0,0,31540,1800,29740,0,31016,1100,29916,0,30531,1500,29031,0,30528,1500,29028
7282,280000,224000,0,1,0,0,0,0,0,253365,11320,242045,0,221167,7608,213559,0,195058,6628,188430,0,189623,7004,182619
7283,230000,184000,0,0,0,0,0,1,-2,-18,0,-18,-2,-18,0,-18,-2,-18,0,-18,-2,-18,0,-18
7284,60000,48000,0,0,0,0,0,0,0,24215,1500,22715,0,17728,1173,16555,0,18087,532,17555,0,17730,597,17133
7285,30000,24000,0,0,0,0,0,0,0,5338,2000,3338,0,7239,2000,5239,0,9112,2000,7112,0,10949,2000,8949
7286,130000,104000,0,0,0,1,0,0,0,107783,5312,102471,0,84353,3100,81253,0,169121,3123,165998,0,87863,6293,81570
7287,60000,48000,0,0,0,0,0,0,2,0,0,0,2,1887,1887,0,-1,1543,0,1543,2,3972,3557,415
7288,30000,24000,0,0,0,0,0,0,0,20808,1300,19508,2,18908,0,18908,2,19556,2300,17256,2,19148,0,19148
7289,130000,104000,0,0,0,0,0,1,2,0,0,0,-2,0,0,0,-2,0,0,0,-2,0,0,0
7290,90000,72000,0,1,1,1,0,0,0,87247,3335,83912,0,88943,3319,85624,0,90961,3590,87371,0,44522,1368,43154
7291,140000,112000,0,0,0,0,0,0,0,91502,30000,61502,0,90859,4000,86859,0,88616,4000,84616,0,88450,3400,85050
7292,50000,40000,0,1,0,0,0,0,0,47539,4000,43539,0,17360,1000,16360,0,17928,1000,16928,0,19619,2000,17619
7293,80000,64000,0,0,0,0,0,0,-1,-3,0,-3,-1,1186,1579,-393,-1,-4,0,-4,-1,1633,1637,-4
7294,200000,160000,0,0,0,0,0,0,0,55277,30300,24977,0,38259,179,38080,2,8266,5415,2851,0,13200,10000,3200
7295,100000,80000,0,1,1,1,1,1,0,101461,5000,96461,0,101461,4000,97461,0,91752,3300,88452,0,91532,3400,88132
7296,140000,112000,0,0,0,0,0,0,0,4117,4117,0,-1,6817,3000,3817,0,0,0,0,0,0,0,0
7297,270000,216000,0,1,0,0,0,1,0,232661,10000,222661,0,150298,18021,132277,0,134808,8026,126782,0,129645,6011,123634
7298,60000,48000,0,0,0,0,0,0,0,17399,1584,15815,0,16553,1217,15336,0,14259,496,13763,0,14134,662,13472
7299,20000,16000,0,0,0,0,0,0,0,14399,1234,13165,0,15408,1243,14165,0,15728,563,15165,0,17082,1609,15473
7300,70000,56000,0,1,1,0,0,0,3,71946,2800,69146,2,69337,0,69337,2,29949,1200,28749,0,29380,1200,28180
7301,10000,8000,0,0,0,1,0,0,0,7565,2000,5565,0,8854,2000,6854,0,9229,1000,8229,0,8376,1000,7376
7302,70000,56000,0,0,0,0,0,0,0,22551,1010,21541,0,16008,328,15680,0,0,0,0,0,13180,13180,0
7303,260000,208000,0,0,0,0,0,0,0,191504,6345,185159,0,168983,7027,161956,0,160592,6000,154592,0,156826,5000,151826
7304,350000,280000,0,0,0,0,0,0,-1,50064,50206,-142,-1,8003,40,7963,0,8293,8334,-41,-1,23080,23102,-22
7305,210000,168000,0,0,0,0,0,1,-2,0,0,0,-2,0,0,0,-2,0,0,0,-2,0,0,0
7306,140000,112000,0,0,0,0,0,1,0,33430,1500,31930,2,32768,1800,30968,0,29701,2000,27701,0,24377,2000,22377
7307,260000,208000,0,0,0,0,0,0,0,159988,8000,151988,0,158114,6000,152114,0,158762,7000,151762,0,159108,7000,152108
7308,210000,168000,0,0,0,0,0,0,0,141553,5201,136352,0,143811,5160,138651,0,144587,5200,139387,0,146802,5300,141502
7309,390000,312000,0,0,0,0,0,0,0,91761,3277,88484,0,76756,3220,73536,0,65520,2236,63284,0,52904,2007,50897
7310,340000,272000,0,0,0,0,0,0,0,40990,5000,35990,0,42415,3000,39415,0,38367,2000,36367,0,37940,2000,35940
7311,210000,168000,0,1,0,0,0,0,0,206683,6549,200134,0,99411,4500,94911,0,63322,2407,60915,0,73433,12700,60733
7312,50000,40000,0,0,0,0,0,0,-1,14163,1500,12663,0,15517,2000,13517,0,14685,1000,13685,0,14016,2000,12016
7313,150000,120000,0,0,0,0,0,0,0,19961,1307,18654,0,16549,1178,15371,0,14227,1500,12727,0,15380,1500,13880
7314,30000,24000,0,0,0,0,0,0,2,19030,1500,17530,2,19424,1000,18424,2,18818,0,18818,2,23307,5000,18307
7315,170000,136000,0,0,0,0,0,0,0,46239,1888,44351,0,36300,1200,35100,0,29350,3782,25568,0,28164,1160,27004
7316,70000,56000,0,0,0,0,0,0,2,31137,2352,28785,2,32855,2531,30324,2,33316,1300,32016,2,34137,1500,32637
7317,150000,120000,0,0,0,0,0,0,-1,0,0,0,-2,316,316,0,-1,316,316,0,-1,316,316,0
7318,30000,24000,0,0,0,0,0,1,2,20071,0,20071,2,21432,2000,19432,2,21704,760,20944,2,21205,0,21205
7319,180000,144000,0,0,0,0,0,0,0,20171,1500,18671,0,20245,1000,19245,0,20769,1000,19769,0,23770,3490,20280
7320,120000,96000,0,0,0,0,0,0,-1,291,291,0,-1,1051,1051,0,-1,291,291,0,-1,671,671,0
7321,200000,160000,0,0,0,0,0,0,-2,32082,32105,-23,-2,6914,7186,-272,-2,1905,1905,0,-2,3244,3244,0
7322,80000,64000,0,0,0,0,0,0,0,0,0,0,0,0,0,0,-2,0,0,0,-2,0,0,0
7323,240000,192000,0,0,0,0,0,0,-1,390,780,-390,-1,780,780,0,-1,0,0,0,-1,0,0,0
7324,50000,40000,0,1,1,1,1,0,0,48102,1840,46262,0,48612,1751,46861,0,49465,1717,47748,0,50299,1773,48526
7325,470000,376000,0,0,0,0,0,0,-1,1512,1512,0,-1,3657,3657,0,-1,6556,6556,0,-1,3772,3772,0
7326,280000,224000,0,0,0,0,0,0,-2,-54,0,-54,-2,-54,0,-54,-2,-54,0,-54,-2,-54,0,-54
7327,130000,104000,0,0,0,0,0,0,-1,30403,30403,0,-1,9630,193,9437,0,7120,7120,0,-1,3940,79,3861
7328,20000,16000,0,1,1,1,1,0,2,16706,0,16706,3,18694,2560,16134,2,19049,955,18094,3,18459,0,18459
7329,60000,48000,0,0,0,0,0,0,0,32239,4500,27739,0,30110,2000,28110,0,30465,1301,29164,0,30510,1128,29382
7330,200000,160000,0,0,0,0,0,0,0,109339,4588,104751,0,113799,6910,106889,0,75536,30,75506,2,66643,2375,64268
7331,30000,24000,0,1,1,1,1,0,2,28303,0,28303,2,29462,3554,25908,2,28859,0,28859,2,29122,1190,27932
7332,320000,256000,0,0,0,0,0,0,0,100704,2704,98000,0,208794,108794,100000,0,213025,5123,207902,0,217400,5255,212145
7333,20000,16000,0,1,1,1,1,0,0,18343,1315,17028,0,19331,1303,18028,0,18541,663,17878,0,18929,686,18243
7334,500000,400000,0,0,0,0,0,0,0,14245,1500,12745,0,15199,1219,13980,0,20980,6000,14980,0,18255,1000,17255
7335,10000,8000,0,0,0,0,0,1,2,1050,0,1050,3,1050,0,1050,3,1050,0,1050,3,1050,0,1050
7336,130000,104000,0,0,0,0,0,0,0,48970,4500,44470,0,52740,4500,48240,0,56467,4500,51967,0,60119,4500,55619
7337,50000,40000,0,0,0,0,0,0,0,9275,1000,8275,0,11181,5000,6181,0,2931,0,2931,0,27209,25000,2209
7338,10000,8000,0,0,0,0,0,1,2,172,179,-7,-1,2034,2034,0,-1,2069,214,1855,2,1891,0,1891
7339,380000,304000,0,1,1,1,1,0,1,368318,74,368244,2,354443,14301,340142,2,354765,13000,341765,2,354579,12800,341779
7340,150000,120000,0,0,0,0,0,0,2,0,0,0,-2,0,0,0,-2,0,0,0,-2,0,0,0
7341,170000,136000,0,0,0,0,0,0,0,61987,3638,58349,0,63849,3500,60349,0,66276,3500,62776,0,68207,3000,65207
7342,470000,376000,0,0,0,0,0,0,-1,181,181,0,-1,3011,3020,-9,-1,2891,1804,1087,0,3502,1517,1985
7343,80000,64000,0,0,0,0,0,1,-2,0,0,0,-2,0,0,0,-2,2284,2284,0,-1,-786,0,-786
7344,80000,64000,0,1,1,1,0,0,0,67489,3056,64433,0,68535,2787,65748,0,66835,2745,64090,0,64962,2564,62398
7345,140000,112000,0,0,0,0,0,0,-1,282,282,0,-1,282,282,0,-1,454,454,0,-1,610,610,0
7346,30000,24000,0,0,0,0,0,0,-1,0,0,0,-2,0,0,0,-2,0,0,0,-2,0,0,0
7347,200000,160000,0,0,0,0,0,0,-1,30250,30250,0,-1,5215,5215,0,-1,90,90,0,-1,5690,6198,-508
7348,40000,32000,0,1,1,1,1,1,2,36993,1989,35004,0,38427,2423,36004,0,39875,2000,37875,2,39272,0,39272
7349,50000,40000,0,0,0,0,0,0,-1,23231,23501,-270,-1,2881,2889,-8,-1,3048,3057,-9,-1,2739,2746,-7
7350,20000,16000,0,1,1,0,0,1,0,19645,1710,17935,0,19935,1000,18935,0,0,0,0,0,0,0,0
7351,300000,240000,0,0,0,0,0,0,-2,0,0,0,-2,0,0,0,-2,0,0,0,-2,1280,1280,0
7352,480000,384000,0,0,0,0,0,0,-1,5367,5473,-106,-1,21222,21284,-62,-1,9083,9088,-5,-1,84804,84804,0
7353,240000,192000,0,0,0,0,0,1,-2,0,0,0,-2,0,0,0,-2,0,0,0,-2,0,0,0
7354,300000,240000,0,0,0,0,0,0,-1,360,360,0,-1,360,360,0,-1,1440,1440,0,-1,360,360,0
7355,80000,64000,0,0,0,0,0,0,2,31401,1183,30218,2,31986,1400,30586,2,32468,1139,31329,2,31794,0,31794
7356,70000,56000,0,1,1,1,1,1,0,69007,3303,65704,0,61845,2800,59045,0,60184,2200,57984,0,66801,7600,59201
7357,130000,104000,0,0,0,0,0,0,-2,0,0,0,-2,0,0,0,-2,0,0,0,-2,0,0,0
7358,250000,200000,0,0,0,0,0,0,-1,396,396,0,-1,3160,3160,0,-1,396,396,0,-1,396,396,0
7359,500000,400000,0,0,0,0,0,0,1,177741,177080,661,0,163299,4425,158874,0,159110,5666,153444,0,135658,4825,130833
7360,80000,64000,0,0,0,0,0,0,-1,-1573,675,-2248,-1,12481,14956,-2475,-1,4104,0,4104,0,2052,0,2052
7361,120000,96000,0,0,0,0,0,0,-1,780,0,780,2,0,0,0,2,0,0,0,-2,0,0,0
7362,360000,288000,0,0,0,0,0,0,2,2193,2193,0,-1,528,528,0,-1,264,0,264,0,264,264,0
7363,20000,16000,0,1,1,1,1,1,2,20602,1300,19302,2,19850,0,19850,2,20277,702,19575,0,17525,620,16905
7364,130000,104000,0,1,1,0,0,0,0,124824,6316,118508,0,123174,4845,118329,0,100585,3471,97114,0,97687,3673,94014
7365,150000,120000,0,1,0,0,0,1,0,129725,5100,124625,0,103050,4200,98850,0,54447,1900,52547,0,46943,1600,45343
7366,110000,88000,0,0,0,0,0,0,0,7590,1200,6390,0,8657,1200,7457,0,9013,500,8513,0,9367,500,8867
7367,200000,160000,0,0,0,0,0,0,-2,6372,6372,0,-1,1957,1957,0,-1,0,0,0,-1,596,596,0
7368,20000,16000,0,0,0,1,1,0,2,15979,0,15979,2,16410,1000,15410,0,17142,1000,16142,0,17705,1000,16705
7369,180000,144000,0,0,0,0,0,0,0,12500,1117,11383,0,13383,1000,12383,0,14760,1500,13260,0,15472,1000,14472
7370,190000,152000,0,1,0,0,0,1,0,191861,6200,185661,0,155967,5500,150467,0,153193,5600,147593,0,156494,5800,150694
7371,220000,176000,0,0,0,0,0,0,-2,788,788,0,-1,0,0,0,-1,349,349,0,-1,600,600,0
7372,50000,40000,0,0,0,0,0,1,0,30965,5000,25965,0,28612,1500,27112,0,25498,1000,24498,0,24866,2000,22866
7373,500000,400000,0,0,0,0,0,0,-1,9984,10009,-25,-1,7461,7488,-27,-1,8093,8129,-36,-1,7342,7369,-27
7374,280000,224000,0,0,0,0,0,1,2,-780,390,-1170,2,-1170,0,-1170,-2,1473,3033,-1560,-1,558,558,0
7375,200000,160000,0,0,0,0,0,0,0,138640,60000,78640,0,75983,3500,72483,0,44160,2000,42160,0,34671,2000,32671
7376,380000,304000,0,0,0,0,0,0,-1,1823,1823,0,-1,1823,1823,0,-1,1823,1823,0,-1,1198,1198,0
7377,80000,64000,0,0,0,0,0,0,0,32318,3000,29318,0,30171,2000,28171,0,32950,5000,27950,0,30899,3000,27899
7378,250000,200000,0,0,0,0,0,0,-1,2319,1000,1319,0,1856,1500,356,0,4356,2500,1856,0,7026,3000,4026
7379,90000,72000,1,1,1,0,0,0,0,90049,0,90049,2,86984,4100,82884,0,67076,5000,62076,0,66533,5000,61533
7380,30000,24000,0,1,1,0,1,1,2,29505,0,29505,2,29916,1300,28616,0,14330,884,13446,0,29000,780,28220
7381,200000,160000,0,0,0,0,0,0,-1,1167,1168,-1,-1,778,1,777,0,389,1,388,0,389,390,-1
7382,30000,24000,0,0,0,0,0,1,2,12973,0,12973,2,15144,2700,12444,2,14603,0,14603,2,15767,1400,14367
7383,240000,192000,0,0,0,0,0,0,-1,198351,6678,191673,0,195242,7537,187705,0,187710,10555,177155,0,171828,5223,166605
7384,50000,40000,0,0,0,0,0,0,0,32205,1534,30671,0,32846,1175,31671,0,33535,1218,32317,0,34201,1224,32977
7385,120000,96000,0,0,0,0,0,0,0,94478,5390,89088,0,74807,3200,71607,0,76952,3500,73452,0,0,3000,-3000
7386,200000,160000,0,0,0,0,0,0,-1,34484,30088,4396,0,13361,13378,-17,-1,5540,127,5413,0,12495,12502,-7
7387,110000,88000,0,1,1,0,0,1,2,112173,5000,107173,0,93675,3000,90675,0,59095,2100,56995,0,60336,2500,57836
7388,60000,48000,0,1,1,0,0,0,0,56585,3085,53500,0,77520,3623,73897,0,29002,0,29002,2,30274,3158,27116
7389,90000,72000,0,0,0,0,0,0,0,7391,1200,6191,0,4238,1000,3238,0,18003,21000,-2997,-1,16128,1500,14628
7390,60000,48000,0,0,0,0,0,0,0,38605,2000,36605,0,28184,1500,26684,0,28862,1500,27362,0,29161,1300,27861
7391,200000,160000,0,0,0,0,0,0,0,70387,2700,67687,0,71929,2242,69687,0,58133,2093,56040,0,40500,1300,39200
7392,160000,128000,0,0,0,0,0,0,0,25186,5000,20186,0,36100,14400,21700,0,21707,10000,11707,0,7928,4000,3928
7393,200000,160000,0,0,0,0,0,0,-1,14225,3884,10341,0,16017,5010,11007,0,12613,700,11913,0,6600,360,6240
7394,500000,400000,0,0,0,0,0,0,-2,0,0,0,-2,218,218,0,-2,11959,11959,0,-1,13692,2000,11692
7395,90000,72000,0,1,1,1,1,1,2,86858,3000,83858,2,86373,2800,83573,2,85875,1500,84375,2,82150,2299,79851
7396,80000,64000,0,0,0,0,0,0,0,11865,1461,10404,0,11549,535,11014,0,11549,700,10849,0,11231,500,10731
7397,220000,176000,0,0,0,0,0,0,-1,943,945,-2,-1,1467,1471,-4,-1,25075,25150,-75,-1,6862,6882,-20
7398,140000,112000,0,0,0,0,0,0,-1,-12,0,-12,-1,1900,1912,-12,-1,664,0,664,0,1085,1085,0
7399,280000,224000,0,0,0,0,0,0,0,131053,6150,124903,2,132418,5000,127418,2,134038,5300,128738,2,136939,5200,131739
7400,30000,24000,0,0,0,0,0,0,0,0,0,0,-2,0,0,0,-2,0,0,0,-2,0,0,0
7401,80000,64000,0,0,0,0,0,1,0,47680,4000,43680,0,33336,3000,30336,0,24439,2000,22439,0,26187,2000,24187
7402,200000,160000,0,0,0,0,0,0,-1,5512,5512,0,-1,1986,1996,-10,-1,2504,2504,0,-1,13484,13484,0
7403,200000,160000,0,0,0,0,0,0,-2,20341,20341,0,-2,16223,16223,0,-2,17466,17466,0,-1,16613,16613,0
7404,50000,40000,0,0,0,0,0,0,-1,1722,1722,0,-1,316,316,0,-1,2615,2615,0,-1,2104,2104,0
7405,10000,8000,0,0,0,0,0,0,0,8236,2800,5436,0,9130,1200,7930,0,7302,265,7037,0,7981,800,7181
7406,190000,152000,0,0,0,0,0,1,0,74959,2719,72240,0,76514,2800,73714,0,78047,2800,75247,0,79603,2900,76703
7407,230000,184000,0,0,0,0,0,0,-2,-152,0,-152,-2,-152,0,-152,-2,42668,42820,-152,-1,130,0,130
7408,160000,128000,0,0,0,0,0,0,2,1852,1852,0,-1,736,0,736,0,3542,3542,0,-1,1852,0,1852
7409,100000,80000,0,0,0,0,0,0,-1,4056,4066,-10,-1,10782,10900,-118,-1,3187,3196,-9,-1,18515,18543,-28
7410,10000,8000,0,0,0,0,0,0,-1,915,915,0,-1,352,352,0,-1,105,105,0,-1,0,0,0
7411,80000,64000,0,0,0,0,0,0,0,13207,1700,11507,0,13997,1400,12597,0,10914,200,10714,0,10685,1000,9685
7412,200000,160000,0,0,0,1,0,0,0,155871,35000,120871,0,193666,54461,139205,0,216666,46666,170000,0,18871,18871,0
7413,230000,184000,0,0,0,0,0,0,0,59349,0,59349,2,56418,3000,53418,0,52950,2000,50950,0,49439,1500,47939
7414,310000,248000,0,1,1,1,1,0,0,302438,11300,291138,0,293473,10500,282973,0,297926,10100,287826,0,280967,10000,270967
7415,350000,280000,0,0,0,0,0,1,0,244792,9790,235002,0,140218,5302,134916,0,181571,95621,85950,0,167905,11920,155985
7416,230000,184000,0,0,0,0,0,0,0,13200,1200,12000,0,15789,2789,13000,0,14242,1242,13000,0,15251,1251,14000
7417,200000,160000,0,1,0,0,0,0,0,190824,5818,185006,0,133233,4451,128782,0,115882,4472,111410,0,117534,3850,113684
7418,220000,176000,0,0,0,0,0,0,-1,3257,3257,0,-1,757,757,0,-1,757,757,0,-1,757,757,0
7419,500000,400000,0,0,0,0,0,0,-1,11626,11727,-101,-1,8986,8986,0,-1,4465,0,4465,0,24166,24166,0
7420,70000,56000,0,1,0,0,0,0,0,68338,1925,66413,0,26916,1000,25916,0,27480,997,26483,0,28043,1020,27023
7421,120000,96000,0,0,0,0,0,0,2,72381,3200,69181,2,70629,0,70629,2,74827,6000,68827,2,76470,3000,73470
7422,230000,184000,0,0,0,0,0,0,-2,4048,4053,-5,-2,0,0,0,-2,5092,5092,0,-1,7452,7464,-12
7423,280000,224000,0,0,0,0,0,0,-1,3188,3188,0,-1,4176,4189,-13,-1,10276,10276,0,-1,9898,9898,0
7424,230000,184000,0,1,0,0,0,0,2,203466,0,203466,2,150365,8000,142365,0,119512,5000,114512,0,87434,5000,82434
7425,150000,120000,0,0,0,0,0,0,-2,2473,2473,0,-2,1473,1473,0,-2,1473,1473,0,-2,1473,1473,0
7426,150000,120000,0,0,0,0,0,1,3,30759,0,30759,2,32764,2535,30229,0,36229,5000,31229,0,79827,5000,74827
7427,20000,16000,0,1,1,0,0,0,0,18385,1200,17185,0,18657,1000,17657,0,8539,1000,7539,0,0,0,0
7428,220000,176000,0,0,0,0,0,0,0,4664,4674,-10,-1,9530,9530,0,-1,118206,120000,-1794,-1,112206,0,112206
7429,360000,288000,0,1,1,0,0,0,0,358920,13016,345904,0,363999,13625,350374,0,292332,11019,281313,0,294752,9439,285313
7430,170000,136000,0,1,1,0,1,0,0,158528,14000,144528,0,138030,0,138030,2,139444,5200,134244,0,148093,11100,136993
7431,50000,40000,0,0,0,0,0,0,2,18305,1000,17305,3,18708,1000,17708,2,19105,1000,18105,2,19653,1000,18653
7432,170000,136000,0,0,0,0,0,0,0,68356,3626,64730,0,68724,2500,66224,0,68889,2450,66439,0,69712,2693,67019
7433,160000,128000,0,0,0,0,0,0,0,38988,10000,28988,0,19825,5000,14825,0,22654,5000,17654,0,16158,5000,11158
7434,230000,184000,0,0,0,0,0,0,-1,1434,1434,0,-1,1420,1420,0,-1,9225,9225,0,-1,19013,10000,9013
7435,400000,320000,0,0,0,0,0,0,2,49666,0,49666,2,52727,4500,48227,2,51286,0,51286,2,55077,4800,50277
7436,360000,288000,0,0,0,0,0,1,-1,390,390,0,-1,750,750,0,-1,930,930,0,-1,540,150,390
7437,20000,16000,0,0,0,0,0,0,0,12884,1216,11668,0,13784,1116,12668,0,13420,0,13420,2,13686,490,13196
7438,180000,144000,0,0,0,0,0,0,0,98905,6516,92389,0,75576,1611,73965,0,59889,3000,56889,0,51422,7080,44342
7439,180000,144000,0,0,0,0,0,0,-1,6608,65,6543,2,17087,17087,0,-1,17993,2013,15980,-1,8662,23,8639
7440,180000,144000,0,0,0,0,0,0,-1,25770,25770,0,-1,11475,11475,0,-1,69910,69910,0,-1,21949,21949,0
7441,50000,40000,0,0,0,0,0,0,0,43444,4013,39431,0,40616,5000,35616,0,2008,5000,-2992,-1,-1500,5000,-6500
7442,100000,80000,0,0,0,0,0,0,0,49699,2000,47699,0,47635,1691,45944,0,48664,1782,46882,0,49578,1739,47839
7443,100000,80000,0,0,0,0,0,0,0,24551,2500,22051,0,16333,2000,14333,0,9776,1000,8776,0,58408,58408,0
7444,90000,72000,0,0,0,0,0,1,2,72323,6500,65823,2,71631,2600,69031,2,68427,0,68427,2,69532,2700,66832
7445,80000,64000,0,0,0,0,0,0,0,11553,1035,10518,0,2350,1600,750,0,0,0,0,0,0,0,0
7446,240000,192000,0,0,0,1,1,0,0,143270,5000,138270,0,201082,60000,141082,0,215709,17464,198245,0,204302,6516,197786
7447,470000,376000,0,0,0,0,0,0,-2,32463,32520,-57,-2,20621,34,20587,-2,13711,68,13643,-2,8294,8334,-40
7448,100000,80000,0,0,1,0,0,1,0,87083,7138,79945,0,82653,0,82653,2,72867,2448,70419,0,74140,2674,71466
7449,360000,288000,0,0,0,0,0,1,-2,0,0,0,-2,0,0,0,-2,0,0,0,-2,0,0,0
7450,60000,48000,0,1,1,1,1,0,0,58440,2141,56299,0,59593,3000,56593,0,59642,2064,57578,0,60165,2672,57493
7451,250000,200000,0,0,0,0,0,0,-1,7304,7376,-72,-1,95,0,95,-1,0,0,0,-1,0,0,0
7452,110000,88000,0,0,0,0,0,0,0,88568,3500,85068,0,43720,2000,41720,0,42138,2000,40138,0,43085,1800,41285
7453,50000,40000,0,0,0,0,0,0,0,8319,0,8319,2,8672,1282,7390,0,9390,1000,8390,0,9861,1000,8861
7454,350000,280000,0,0,0,0,0,0,-1,240,240,0,-1,1041,1051,-10,-1,-12,0,-12,-1,6449,6461,-12
7455,250000,200000,0,0,0,0,0,0,-1,45297,48394,-3097,-1,17371,0,17371,0,11481,5461,6020,0,5922,15000,-9078
7456,120000,96000,0,0,0,0,0,0,0,81881,3850,78031,0,82628,3000,79628,0,84404,3100,81304,0,86096,3088,83008
7457,50000,40000,0,0,0,0,0,0,2,2808,602,2206,0,3325,569,2756,0,3989,718,3271,0,3610,0,3610
7458,50000,40000,0,0,0,0,0,0,0,15138,1065,14073,0,14036,5000,9036,0,14752,5000,9752,0,15445,5000,10445
7459,150000,120000,0,0,0,0,0,0,-2,0,0,0,-2,0,0,0,-2,222,222,0,-2,0,0,0
7460,80000,64000,0,1,1,1,1,1,2,72017,3000,69017,0,73816,3000,70816,0,75584,3000,72584,0,77365,3000,74365
7461,30000,24000,0,0,1,0,1,1,2,24988,1000,23988,2,24288,0,24288,2,26098,2200,23898,2,25530,0,25530
7462,80000,64000,0,0,0,0,0,0,0,6500,6500,0,-1,15525,15525,0,-1,0,0,0,-1,0,0,0
7463,160000,128000,0,0,0,0,0,0,-1,15513,15000,513,0,18087,3000,15087,0,17499,0,17499,2,19939,3000,16939
7464,170000,136000,0,0,0,0,0,0,-2,102108,102108,0,-2,2120,2120,0,-2,2873,2873,0,-2,0,0,0
7465,30000,24000,0,1,1,1,0,0,0,30022,1819,28203,0,30068,1328,28740,0,28829,709,28120,0,24935,1101,23834
7466,70000,56000,0,1,1,0,0,0,0,58204,2168,56036,0,58171,2000,56171,0,47135,2007,45128,0,44585,2000,42585
7467,360000,288000,0,0,0,0,0,0,-2,0,0,0,-2,0,0,0,-2,0,0,0,-2,1392,1392,0
7468,80000,64000,0,0,0,0,0,0,-2,11556,11556,0,-2,0,0,0,-2,0,0,0,-2,0,0,0
7469,80000,64000,0,0,0,0,0,1,0,18171,5000,13171,0,17582,0,17582,2,19281,2000,17281,0,19968,1000,18968
7470,300000,240000,0,0,0,0,0,0,-1,1461,1461,0,-1,3242,2000,1242,0,-80,0,-80,0,720,800,-80
7471,230000,184000,0,1,1,0,0,0,0,218694,8933,209761,0,191956,6956,185000,0,191741,7845,183896,0,176784,6784,170000
7472,110000,88000,0,0,0,0,0,0,0,60379,3000,57379,0,64369,5000,59369,0,66400,4000,62400,0,68294,3000,65294
7473,290000,232000,0,0,0,0,0,0,-1,550,550,0,-1,550,550,0,-1,550,550,0,-1,550,550,0
7474,130000,104000,0,0,0,0,0,0,-1,1048,1048,0,-1,1048,1048,0,-1,390,390,0,-1,390,390,0
7475,90000,72000,0,0,0,0,0,0,-1,332,332,0,-1,14579,14579,0,-1,2091,2091,0,-1,506,506,0
7476,500000,400000,0,0,0,0,0,0,-2,131063,135784,-4721,-2,131508,15000,116508,-2,182843,75550,107293,-2,10790,216,10574
7477,300000,240000,0,0,0,0,0,0,0,72350,3750,68600,0,0,0,0,0,0,0,0,-2,0,0,0
7478,160000,128000,0,0,0,0,0,0,2,72681,4500,68181,2,66526,2500,64026,2,66893,3000,63893,0,66637,3000,63637
7479,100000,80000,0,0,0,0,0,1,2,14236,1500,12736,2,12924,0,12924,2,12467,700,11767,2,10950,0,10950
7480,20000,16000,0,0,1,0,1,0,-2,16668,25464,-8796,-1,16105,0,16105,2,16496,800,15696,0,16872,800,16072
7481,170000,136000,0,1,1,0,0,0,0,166677,7424,159253,0,167049,7169,159880,0,38377,1241,37136,0,33668,1187,32481
7482,160000,128000,0,0,0,0,0,1,-1,0,0,0,-1,0,0,0,-2,0,0,0,-2,2755,2755,0
7483,140000,112000,0,0,0,0,0,0,0,18226,1500,16726,0,19915,2000,17915,0,20891,1300,19591,0,21542,1000,20542
7484,70000,56000,0,1,0,0,0,0,0,58476,1366,57110,0,20717,414,20303,0,11473,229,11244,0,22021,22021,0
7485,30000,24000,0,1,1,1,1,1,2,29276,1800,27476,2,28635,150,28485,2,30127,2250,27877,2,30525,1000,29525
7486,150000,120000,0,0,0,0,0,0,-1,4992,4992,0,-1,1578,1578,0,-1,1216,1216,0,-1,4475,4475,0
7487,300000,240000,0,0,0,0,0,0,-1,0,0,0,-1,0,0,0,-2,0,0,0,-2,380,380,0
7488,360000,288000,0,0,0,0,0,0,-2,990,990,0,-2,990,990,0,-2,990,990,0,-2,990,990,0
7489,140000,112000,0,0,0,0,0,0,-1,0,0,0,-2,0,0,0,-2,2243,2243,0,-1,5530,5530,0
7490,130000,104000,0,0,0,0,0,0,-1,3656,3656,0,-1,5008,5024,-16,-1,13734,13734,0,-1,14976,3000,11976
7491,120000,96000,0,0,0,0,0,0,0,31513,2254,29259,0,31659,1400,30259,0,30069,800,29269,0,8005,400,7605
7492,260000,208000,0,0,0,0,0,1,2,148332,6910,141422,0,160810,16502,144308,0,155683,0,155683,2,158771,5847,152924
7493,280000,224000,0,0,0,0,0,0,0,96763,5000,91763,0,67554,439,67115,0,-3,10603,-10606,0,1244,1247,-3
7494,20000,16000,0,1,0,0,0,0,0,18126,2000,16126,0,16557,1000,15557,0,17519,3000,14519,0,17111,2000,15111
7495,110000,88000,0,0,0,0,0,0,0,63447,3000,60447,0,65394,3000,62394,0,66810,2500,64310,0,68732,3000,65732
7496,20000,16000,0,0,0,0,0,0,0,12772,1161,11611,0,12630,409,12221,0,12524,444,12080,0,11179,405,10774
7497,210000,168000,0,0,0,0,0,0,0,76779,67000,9779,0,67518,2300,65218,0,66364,2365,63999,0,65038,2000,63038
7498,50000,40000,0,0,0,0,0,0,0,8868,1500,7368,0,9044,323,8721,0,9234,335,8899,0,9418,337,9081
7499,290000,232000,0,0,0,0,0,0,-2,4516,4516,0,-2,8140,8140,0,-2,59512,59512,0,-2,2716,2716,0
7500,240000,192000,0,0,1,1,1,0,0,199711,7711,192000,0,203767,7767,196000,0,208015,8015,200000,0,220109,15829,204280
7501,330000,264000,0,0,0,0,0,0,-1,2854,2854,0,-1,1690,1702,-12,-1,0,0,0,-2,1709,1709,0
7502,150000,120000,0,0,0,0,0,0,-1,-959,0,-959,-2,-959,0,-959,-2,-959,0,-959,-2,-959,0,-959
7503,330000,264000,0,0,0,0,0,0,-2,28933,28933,0,-1,14553,14553,0,-1,12400,12400,0,-1,20805,20805,0
7504,30000,24000,0,0,1,1,1,0,-1,29013,11500,17513,-1,28256,0,28256,2,28979,1177,27802,0,31369,3000,28369
7505,500000,400000,0,0,0,0,0,0,0,228765,10910,217855,0,185694,7239,178455,0,179853,5576,174277,0,178763,6717,172046
7506,120000,96000,0,0,0,0,0,0,0,16991,1991,15000,0,18730,3730,15000,0,21076,9076,12000,0,24134,4134,20000
7507,280000,224000,0,1,0,0,0,1,0,280276,10447,269829,0,188923,6006,182917,0,192333,6006,186327,0,195774,6147,189627
7508,340000,272000,0,0,0,0,0,0,0,68670,15000,53670,0,20299,12000,8299,0,27816,10000,17816,0,43637,20000,23637
7509,100000,80000,0,0,0,0,0,0,0,78343,3400,74943,0,79111,3000,76111,0,79993,3000,76993,0,81279,3000,78279
7510,150000,120000,0,0,0,0,0,0,0,75249,6254,68995,0,61949,6119,55830,0,67280,33333,33947,0,64374,4374,60000
7511,180000,144000,0,0,0,0,0,0,0,121661,6000,115661,0,122244,5000,117244,0,119536,4200,115336,0,109210,3862,105348
7512,90000,72000,0,0,0,0,0,0,0,0,0,0,0,5398,5398,0,-1,6360,1200,5160,0,8292,2045,6247
7513,300000,240000,0,0,0,0,0,0,0,205629,9006,196623,0,215827,17000,198827,0,208464,12000,196464,0,212508,9557,202951
7514,310000,248000,0,1,1,1,1,0,0,288581,12000,276581,0,294745,12500,282245,0,301286,12930,288356,0,306515,12000,294515
7515,50000,40000,0,1,0,0,0,0,0,45763,1852,43911,0,27659,990,26669,0,28236,1023,27213,0,28797,1029,27768
7516,130000,104000,0,0,0,0,0,0,-1,545,545,0,-1,1262,1262,0,-1,1019,1019,0,-1,530,530,0
7517,110000,88000,0,1,0,0,1,0,0,112071,4519,107552,0,89274,4000,85274,0,91413,4000,87413,0,95541,6000,89541
7518,50000,40000,0,0,0,0,0,1,0,9202,1000,8202,0,9800,598,9202,0,1000,1000,0,-1,0,0,0
7519,90000,72000,0,1,1,0,0,0,0,88065,4000,84065,0,90032,4003,86029,0,50802,2000,48802,0,50821,2000,48821
7520,160000,128000,0,0,0,0,0,0,-2,-18,0,-18,-2,-18,0,-18,-2,-18,0,-18,-2,-18,0,-18
7521,50000,40000,0,0,0,0,0,0,0,18086,2000,16086,0,18545,1000,17545,0,15453,1000,14453,0,15847,800,15047
7522,280000,224000,0,0,0,0,0,0,0,35497,17,35480,2,30164,3364,26800,0,7164,0,7164,0,7164,0,7164
7523,100000,80000,0,0,0,1,1,0,2,388,388,0,-1,90907,90907,0,-1,91550,3413,88137,0,92907,3359,89548
7524,80000,64000,0,0,0,0,0,0,-1,380,380,0,-1,0,0,0,-1,0,0,0,-2,363,363,0
7525,180000,144000,0,0,0,0,0,0,-1,10122,10122,0,-1,770,770,0,-1,4159,4159,0,-1,4159,0,4159
7526,280000,224000,0,0,0,0,0,0,-2,67119,69805,-2686,-1,53044,1711,51333,0,66668,26743,39925,0,61466,10057,51409
7527,360000,288000,0,0,0,0,0,1,2,5154,1025,4129,0,2453,2465,-12,-1,570,572,-2,-1,0,0,0
7528,80000,64000,0,1,1,1,1,1,2,78743,0,78743,2,79176,2900,76276,0,81574,6355,75219,0,78445,0,78445
7529,50000,40000,1,1,1,1,1,0,2,69424,23,69401,2,64201,4023,60178,0,58110,2523,55587,0,57337,7926,49411
7530,60000,48000,0,0,0,0,0,0,0,23338,1388,21950,0,23810,860,22950,0,25418,2000,23418,0,26050,1055,24995
7531,180000,144000,0,0,0,0,0,0,0,55112,2002,53110,0,56394,2200,54194,0,57577,2242,55335,0,58564,2100,56464
7532,240000,192000,0,0,0,0,0,0,0,80473,6100,74373,0,78883,0,78883,2,80625,2900,77725,0,79334,3000,76334
7533,100000,80000,0,0,0,0,0,1,0,40037,1953,38084,0,40584,1500,39084,0,43629,3700,39929,0,41432,0,41432
7534,150000,120000,0,0,0,0,0,0,0,31907,20000,11907,0,33300,10000,23300,0,34681,10000,24681,0,36060,10000,26060
7535,210000,168000,0,0,0,0,0,1,-1,390,390,0,-1,390,390,0,-1,390,390,0,-1,390,390,0
7536,200000,160000,0,0,0,0,0,0,-2,0,0,0,-2,0,0,0,-2,0,0,0,-2,0,0,0
7537,30000,24000,0,1,1,1,1,0,2,30653,2000,28653,0,28410,2000,26410,0,29068,2000,27068,0,30383,2000,28383
7538,80000,64000,0,0,0,0,0,0,0,41914,1996,39918,0,42618,1700,40918,0,43525,1745,41780,0,44433,1800,42633
7539,320000,256000,0,0,0,0,0,0,-2,13185,13270,-85,-2,17439,17562,-123,-2,66408,66751,-343,-2,14333,14405,-72
7540,420000,336000,0,0,0,0,0,0,0,24813,2034,22779,0,25893,1500,24393,0,26397,1467,24930,0,26557,1267,25290
7541,20000,16000,0,1,1,1,1,1,2,18451,0,18451,2,19961,1956,18005,2,19229,0,19229,2,19694,651,19043
7542,70000,56000,0,1,0,0,0,0,0,69641,4938,64703,0,46458,1693,44765,0,50679,5000,45679,0,50061,2200,47861
7543,220000,176000,0,0,0,0,0,0,-1,4028,4028,0,-1,3576,3576,0,-1,2378,2378,0,-1,5946,5946,0
7544,80000,64000,0,1,1,1,1,1,2,69258,2500,66758,2,70526,3000,67526,2,71774,3000,68774,2,70503,0,70503
7545,140000,112000,0,0,0,0,0,0,0,83468,3216,80252,0,41202,2003,39199,0,41687,3000,38687,0,36335,3041,33294
7546,60000,48000,0,0,0,0,0,0,0,17973,1500,16473,0,18403,2000,16403,0,17898,1000,16898,0,17388,1000,16388
7547,30000,24000,0,1,1,1,1,0,2,30737,3513,27224,2,27808,0,27808,2,28204,1155,27049,0,28792,1190,27602
7548,50000,40000,0,0,0,0,0,0,0,22792,1236,21556,0,20861,649,20212,0,19116,831,18285,0,15286,568,14718
7549,100000,80000,0,0,0,0,0,0,0,13516,1150,12366,0,1541,1600,-59,-1,8805,8000,805,0,11329,5000,6329
7550,240000,192000,0,0,0,0,0,0,-1,1874,1874,0,-1,1151,1151,0,-1,23169,23169,0,-1,9372,9372,0
7551,170000,136000,0,0,0,0,0,0,0,42805,2447,40358,0,38017,1200,36817,0,39239,3000,36239,0,39411,2000,37411
7552,210000,168000,0,0,0,0,0,1,-2,0,0,0,-2,0,0,0,-2,0,0,0,-2,0,0,0
7553,450000,360000,0,0,0,0,0,0,-1,1183,1188,-5,-1,1745,1745,0,-1,0,0,0,-1,7519,7519,0
7554,80000,64000,0,0,0,0,0,0,-2,0,0,0,-2,0,0,0,-2,0,0,0,-2,0,0,0
7555,250000,200000,0,0,0,0,0,1,0,48130,1650,46480,0,49625,2100,47525,0,51500,3000,48500,0,0,0,0
7556,390000,312000,0,0,0,0,0,0,0,148629,10000,138629,0,141571,10000,131571,0,126583,5010,121573,0,154557,50000,104557
7557,100000,80000,0,1,0,0,0,0,2,100693,3509,97184,0,71253,3047,68206,0,70206,3500,66706,0,71060,3000,68060
7558,40000,32000,0,1,1,1,0,0,0,37112,1750,35362,0,37695,1300,36395,0,38580,1409,37171,0,0,0,0
7559,20000,16000,0,1,1,1,1,1,0,19106,1601,17505,0,18467,810,17657,0,19018,1000,18018,0,19383,692,18691
7560,260000,208000,0,0,0,0,0,0,0,160654,6000,154654,0,155059,7100,147959,0,141570,5300,136270,0,134143,5000,129143
7561,380000,304000,0,1,0,1,0,1,0,356474,12238,344236,0,308948,13479,295469,0,547880,13532,534348,0,309322,12015,297307
7562,180000,144000,0,0,0,0,0,0,-1,199,0,199,2,580,580,0,-1,0,0,0,-1,0,0,0
7563,130000,104000,0,0,0,0,0,1,2,70604,6300,64304,2,68904,0,68904,2,70369,2700,67669,0,71682,2600,69082
7564,320000,256000,0,0,0,0,0,0,2,13355,8000,5355,0,16876,5000,11876,0,20443,5000,15443,0,24101,5000,19101
7565,100000,80000,0,1,1,1,1,1,0,94421,4421,90000,0,97486,5486,92000,0,97604,3400,94204,0,97241,3541,93700
7566,30000,24000,0,0,0,0,0,0,-1,579,0,579,2,1430,1420,10,0,1414,400,1014,0,1398,400,998
7567,400000,320000,0,0,0,0,0,1,0,43146,1800,41346,0,44227,1800,42427,0,45062,1700,43362,0,46012,1700,44312
7568,210000,168000,0,1,1,1,1,0,0,197027,10292,186735,0,198293,8900,189393,0,197841,7200,190641,0,205864,14300,191564
7569,250000,200000,0,0,0,0,0,0,-1,0,0,0,-2,120,120,0,-1,-6,6,-12,-1,1639,1645,-6
7570,20000,16000,0,0,0,0,0,1,-2,0,0,0,-2,0,0,0,-2,0,0,0,-2,0,0,0
7571,140000,112000,0,0,0,0,0,0,0,77133,32637,44496,0,71397,15027,56370,0,71546,10021,61525,0,83412,20055,63357
7572,250000,200000,0,0,0,0,0,0,-1,3989,3989,0,-1,11577,11577,0,-1,11377,0,11377,0,500,500,0
7573,50000,40000,0,0,0,0,0,0,0,36546,1725,34821,0,6421,1000,5421,0,5263,400,4863,0,-12,0,-12
7574,200000,160000,0,0,0,0,0,0,0,110031,5449,104582,0,112410,5694,106716,0,128894,20000,108894,0,131588,4774,126814
7575,90000,72000,0,0,0,0,0,0,0,45074,2000,43074,0,38489,2412,36077,0,28558,1200,27358,0,29245,1300,27945
7576,180000,144000,0,0,0,0,0,0,-1,666,666,0,-1,666,666,0,-1,666,666,0,-1,666,666,0
7577,310000,248000,0,0,0,0,0,0,0,11505,11512,-7,-1,17264,7271,9993,0,10919,5000,5919,0,3185,3215,-30
7578,290000,232000,0,0,0,0,0,0,0,93718,4250,89468,0,89712,5000,84712,0,82809,3241,79568,0,76334,3500,72834
7579,120000,96000,0,0,0,0,0,0,2,1700,0,1700,2,1125,1125,0,-1,909,909,0,-1,786,786,0
7580,80000,64000,0,0,0,0,0,0,0,31768,4012,27756,0,28223,1013,27210,0,25557,2010,23547,0,18220,655,17565
7581,50000,40000,0,1,1,1,1,1,2,47250,2000,45250,2,46192,0,46192,2,46997,1700,45297,0,48221,2000,46221
7582,70000,56000,0,0,0,0,0,0,0,54762,5090,49672,0,38750,2000,36750,0,39924,2000,37924,0,37757,4000,33757
7583,50000,40000,0,0,0,0,0,0,0,25680,10028,15652,0,13577,5000,8577,0,1148,6,1142,0,-6,0,-6
7584,140000,112000,0,0,0,0,0,0,-1,840,840,0,-1,2153,2153,0,-1,827,827,0,-1,-8808,827,-9635
7585,280000,224000,0,0,1,0,0,0,0,228907,9000,219907,0,234179,9329,224850,0,180684,7000,173684,0,184319,6511,177808
7586,50000,40000,0,0,0,0,0,1,2,33261,3400,29861,2,32427,0,32427,2,34579,2700,31879,2,35476,1600,33876
7587,10000,8000,0,0,0,0,0,0,0,6816,2500,4316,0,5210,1000,4210,0,0,0,0,0,0,0,0
7588,80000,64000,0,0,0,0,0,0,0,22790,1379,21411,0,23411,1000,22411,0,23882,1000,22882,0,24356,871,23485
7589,280000,224000,0,0,0,0,0,0,0,118249,4340,113909,0,115422,3994,111428,0,114694,3968,110726,0,113047,4068,108979
7590,250000,200000,0,0,0,0,0,0,-1,0,0,0,-1,800,800,0,-1,3576,3576,0,-1,0,0,0
7591,160000,128000,0,0,0,0,0,0,-2,0,0,0,-2,0,0,0,-2,0,0,0,-2,0,0,0
7592,240000,192000,0,0,0,0,0,1,-1,2508,2508,0,-1,1672,0,1672,0,836,0,836,0,563,563,0
7593,30000,24000,0,1,0,0,0,1,0,30246,1555,28691,0,23774,631,23143,0,24384,769,23615,0,15855,317,15538
7594,320000,256000,0,0,0,0,0,0,-2,0,0,0,-2,0,0,0,-2,0,0,0,-2,0,0,0
7595,360000,288000,0,0,0,0,0,0,0,128518,6000,122518,0,134368,8000,126368,0,135626,4918,130708,0,134864,5000,129864
7596,120000,96000,0,1,1,1,1,1,2,115306,3600,111706,2,112404,0,112404,2,114269,3400,110869,0,116332,3500,112832
7597,390000,312000,0,0,0,0,0,0,2,15229,1000,14229,0,18229,3000,15229,0,9290,9290,0,-1,1826,1826,0
7598,200000,160000,0,1,0,0,0,0,0,176158,6000,170158,0,159556,6000,153556,0,162943,5800,157143,0,156612,6000,150612
7599,180000,144000,0,0,0,0,0,0,0,65420,3000,62420,0,67722,4000,63722,0,70970,5000,65970,0,72670,3000,69670
7600,30000,24000,0,1,1,1,1,1,2,24705,0,24705,2,25202,791,24411,0,26608,1699,24909,0,25926,0,25926
7601,360000,288000,0,0,0,0,0,0,-2,0,0,0,-2,0,0,0,-2,0,0,0,-2,0,0,0
7602,120000,96000,0,0,0,0,0,1,3,390,0,390,2,390,390,0,-1,282,282,0,-1,-108,0,-108
7603,240000,192000,0,0,0,0,0,0,0,84626,3728,80898,0,76205,3612,72593,0,46771,0,46771,2,35207,1100,34107
7604,100000,80000,0,0,0,0,0,0,-2,0,0,0,-2,0,0,0,-2,0,0,0,-2,0,0,0
7605,360000,288000,0,0,0,0,0,0,0,54913,10072,44841,0,25407,25821,-414,-1,22179,609,21570,0,337,1,336
7606,30000,24000,0,0,0,0,0,1,0,6992,2992,4000,0,20412,16500,3912,0,14427,0,14427,0,5119,5119,0
7607,200000,160000,0,0,0,0,0,0,-1,820,824,-4,-1,1889,1889,0,-1,6617,6617,0,-1,3986,3986,0
7608,50000,40000,0,0,0,0,0,1,0,26829,1326,25503,0,18948,642,18306,0,18830,2000,16830,0,19358,824,18534
7609,150000,120000,1,1,1,1,0,0,3,155368,2000,153368,3,123906,0,123906,2,128597,8000,120597,0,105967,9000,96967
7610,50000,40000,0,0,0,0,0,0,-1,11143,3009,8134,0,9580,1000,8580,0,9793,321,9472,0,8768,2000,6768
7611,100000,80000,0,0,0,0,0,0,0,58766,5500,53266,0,58950,2300,56650,2,56889,0,56889,2,60255,5000,55255
7612,360000,288000,0,0,0,0,0,0,0,43956,1732,42224,0,44972,1748,43224,0,45866,1642,44224,0,49327,4200,45127
7613,80000,64000,0,1,1,0,0,1,0,81146,3200,77946,0,80674,2606,78068,0,63110,2431,60679,0,40376,1779,38597
7614,60000,48000,0,0,0,0,0,0,0,14232,1556,12676,0,14676,1000,13676,0,1976,300,1676,0,2976,1000,1976
7615,200000,160000,0,0,0,0,0,0,0,154994,4699,150295,0,153386,7543,145843,0,144067,3970,140097,0,110946,3146,107800
7616,110000,88000,0,0,0,0,0,0,0,78232,3500,74732,0,69426,3000,66426,0,70987,3500,67487,0,75835,7000,68835
7617,50000,40000,0,0,0,0,0,0,-1,770,0,770,2,0,0,0,2,0,0,0,-2,0,0,0
7618,700000,560000,0,0,0,0,0,0,-2,2131,2131,0,-2,5746,5750,-4,-2,733,733,0,-2,2913,2917,-4
7619,140000,112000,0,1,1,1,1,1,0,135691,6000,129691,2,137675,5700,131975,2,135371,0,135371,2,138455,5500,132955
7620,120000,96000,0,0,0,0,0,1,-1,2411,2411,0,-1,1925,1925,0,-1,2943,2943,0,-1,6249,6249,0
7621,250000,200000,0,0,0,0,0,0,0,0,0,0,-2,0,0,0,-2,0,0,0,-2,0,0,0
7622,60000,48000,0,0,0,0,0,0,0,3801,1000,2801,0,694,2694,-2000,-1,531,531,0,-1,531,531,0
7623,120000,96000,0,0,0,0,0,0,0,53021,2600,50421,0,53216,4241,48975,0,49194,1700,47494,0,48487,2500,45987
7624,380000,304000,0,0,0,0,0,0,-1,11824,13826,-2002,-1,23991,24071,-80,-1,13944,4065,9879,0,20962,21061,-99
7625,90000,72000,0,0,0,0,0,0,-1,0,0,0,-2,0,0,0,-2,0,0,0,-2,1980,1980,0
7626,40000,32000,0,1,1,1,1,1,2,34549,1577,32972,0,35572,1600,33972,0,36481,1500,34981,0,37889,2000,35889
7627,360000,288000,0,0,0,0,0,0,-1,14418,14418,0,-1,8625,0,8625,0,516,516,0,-1,0,0,0
7628,260000,208000,0,0,0,0,0,0,-2,500,500,0,-2,210,210,0,-1,210,0,210,0,-90,0,-90
7629,200000,160000,0,0,0,0,0,1,0,110149,5000,105149,0,110333,5000,105333,0,85201,3000,82201,0,84809,5000,79809
7630,260000,208000,0,0,0,0,0,0,0,8840,4000,4840,0,8464,0,8464,2,10068,2000,8068,0,10977,1500,9477
7631,280000,224000,0,0,0,0,0,0,-1,0,0,0,-1,121,121,0,-1,0,0,0,-1,0,0,0
7632,40000,32000,0,0,0,0,0,0,-2,6597,6597,0,-2,5552,5552,0,-2,4081,4081,0,-2,3232,3232,0
7633,50000,40000,0,0,0,0,0,0,0,24939,1386,23553,0,23962,1399,22563,0,24439,876,23563,0,25044,1000,24044
7634,310000,248000,0,0,0,0,0,0,0,25223,1596,23627,0,25555,1447,24108,0,24311,93,24218,0,17992,118,17874
7635,70000,56000,0,0,0,0,1,1,2,53925,0,53925,2,56814,4400,52414,2,58053,2300,55753,2,59246,2300,56946
7636,100000,80000,0,0,0,0,0,0,0,68584,47000,21584,0,66901,2540,64361,0,63261,3000,60261,0,64409,3000,61409
7637,80000,64000,0,0,0,0,0,1,2,390,390,0,-1,25190,25190,0,-1,390,390,0,-1,390,390,0
7638,240000,192000,0,0,0,0,0,0,-1,-4661,4838,-9499,-1,-23,4638,-4661,-2,4638,4661,-23,-1,2500,2500,0
7639,180000,144000,0,0,0,0,0,0,-1,660,660,0,-1,660,660,0,-1,36906,36906,0,-1,1470,1320,150
7640,10000,8000,0,0,1,0,0,1,0,8454,2000,6454,0,9454,1000,8454,0,5784,0,5784,0,0,0,0
7641,10000,8000,0,0,0,1,0,0,2,9196,9196,0,-1,8518,1106,7412,0,8690,278,8412,0,7472,258,7214
7642,30000,24000,0,0,0,0,0,1,-1,1100,0,1100,2,710,0,710,0,320,0,320,0,-70,0,-70
7643,50000,40000,0,0,0,0,0,0,-1,3780,3780,0,-1,1468,1468,0,-1,1468,1468,0,-1,1644,1644,0
7644,80000,64000,0,1,0,0,0,0,0,74554,3000,71554,0,43727,1400,42327,0,16307,326,15981,0,1755,1755,0
7645,100000,80000,0,0,0,0,0,0,-2,3168,3168,0,-2,0,0,0,-2,0,0,0,-2,550,550,0
7646,240000,192000,0,1,1,0,0,0,0,239228,10500,228728,0,243318,10000,233318,0,195320,7000,188320,0,196664,7300,189364
7647,150000,120000,0,0,0,0,1,0,-1,19312,19312,0,-1,46321,30000,16321,-1,146947,105180,41767,-1,237926,103752,134174
7648,80000,64000,0,0,0,0,0,0,-1,390,390,0,-1,390,390,0,-1,390,390,0,-1,383,383,0
7649,240000,192000,0,0,0,0,0,0,-1,4157,4164,-7,-1,14342,14371,-29,-1,11411,11411,0,-1,3006,3006,0
7650,380000,304000,1,1,1,1,0,0,0,689643,13000,676643,0,334456,26000,308456,0,329981,20095,309886,0,292421,11000,281421
7651,70000,56000,0,0,0,0,0,0,0,25074,1424,23650,0,25978,1717,24261,0,26341,1080,25261,0,26093,1094,24999
7652,290000,232000,0,0,0,0,0,0,-1,1401,1000,401,0,1503,1000,503,0,834,200,634,0,931,265,666
7653,160000,128000,0,0,0,0,0,0,0,0,0,0,-2,0,0,0,-2,0,0,0,-2,0,0,0
7654,180000,144000,0,0,0,0,0,0,-1,629,629,0,-1,11542,11545,-3,-1,2348,2348,0,-1,122,122,0
7655,20000,16000,0,0,0,0,0,1,0,10974,1511,9463,0,14963,4500,10463,0,15123,700,14423,2,14741,0,14741
7656,90000,72000,0,0,0,0,0,0,-2,4607,2980,1627,2,-6,3000,-3006,2,-2153,0,-2153,-2,-4306,0,-4306
7657,140000,112000,0,0,0,0,0,1,0,99274,3213,96061,0,100878,2857,98021,0,102984,2963,100021,0,106628,4566,102062
7658,380000,304000,0,0,0,0,0,0,-2,0,0,0,-2,196050,202129,-6079,-1,202129,9500,192629,0,295891,98500,197391
7659,130000,104000,0,0,0,0,0,0,0,103942,4400,99542,0,94623,5000,89623,0,90556,4000,86556,0,92394,3500,88894
7660,150000,120000,0,0,0,0,0,0,-1,4290,4354,-64,-1,-10,0,-10,-1,1999,2009,-10,-1,10559,10610,-51
7661,120000,96000,0,0,0,0,0,0,-1,2080,0,2080,2,2280,200,2080,0,0,0,0,0,0,0,0
7662,80000,64000,0,0,0,0,0,0,-1,390,390,0,-1,1080,1080,0,-1,540,0,540,2,390,390,0
7663,210000,168000,0,0,0,0,0,0,-1,5474,5474,0,-1,69536,69536,0,-1,76188,10000,66188,0,72678,4000,68678
7664,100000,80000,0,0,0,0,0,0,-1,79527,22004,57523,-1,18950,656,18294,0,19667,1000,18667,0,18531,396,18135
7665,110000,88000,1,1,1,1,1,0,2,114087,3500,110587,2,113879,3400,110479,2,112268,0,112268,2,107423,4000,103423
7666,180000,144000,0,0,0,0,0,1,2,4571,200,4371,2,5071,500,4571,0,5195,124,5071,0,0,0,0
7667,440000,352000,0,0,0,0,0,0,0,366049,19077,346972,0,262697,9518,253179,0,267922,9576,258346,0,274502,11083,263419
7668,180000,144000,0,0,0,0,0,0,0,106353,10000,96353,0,113047,10000,103047,0,115572,4500,111072,0,117660,4500,113160
7669,50000,40000,0,1,0,0,0,0,0,44792,3000,41792,0,18649,14000,4649,0,16260,545,15715,0,18745,5000,13745
7670,200000,160000,0,0,0,0,0,0,0,90837,3856,86981,0,85520,2753,82767,0,84945,2900,82045,0,81431,3000,78431
7671,160000,128000,0,0,0,0,0,1,0,-1801,0,-1801,0,-5513,0,-5513,-2,743,6256,-5513,-1,1012,1050,-38
7672,470000,376000,0,0,0,0,0,0,0,83882,4100,79782,0,66207,2022,64185,0,65549,2100,63449,0,60805,2156,58649
7673,370000,296000,0,0,0,0,0,0,-2,0,0,0,-2,0,0,0,-2,0,0,0,-2,0,0,0
7674,70000,56000,0,0,0,0,1,0,2,55981,4545,51436,2,54484,0,54484,2,59080,5500,53580,2,59096,2090,57006
7675,360000,288000,0,0,0,0,0,1,-1,10772,10786,-14,-1,21847,21916,-69,-1,21835,21904,-69,-1,9255,9261,-6
7676,70000,56000,0,0,0,0,0,0,-1,0,0,0,-1,0,0,0,-2,0,0,0,-2,0,0,0
7677,10000,8000,0,0,0,0,0,0,0,0,0,0,0,0,0,0,-2,0,0,0,-2,0,0,0
7678,30000,24000,0,0,0,0,0,0,-1,390,390,0,-1,390,390,0,-1,390,390,0,-1,390,390,0
7679,50000,40000,0,0,0,0,0,0,0,20990,1330,19660,0,16236,1160,15076,0,9759,330,9429,0,8789,314,8475
7680,220000,176000,0,0,0,0,0,0,-1,17563,17563,0,-1,13184,13184,0,-1,14111,14111,0,-1,15549,20239,-4690
7681,80000,64000,0,0,0,0,0,0,0,38281,2000,36281,0,38993,2000,36993,0,39268,2000,37268,0,39620,1408,38212
7682,150000,120000,0,1,0,0,0,0,0,133145,5000,128145,0,120821,4030,116791,0,107280,4000,103280,0,105510,4000,101510
7683,310000,248000,0,0,0,0,0,0,-2,22217,22328,-111,-2,-5,0,-5,-2,1116,1121,-5,-2,374,401,-27
7684,150000,120000,0,0,0,0,0,0,-1,1200,1212,-12,-1,4100,4100,0,-1,0,0,0,-1,0,0,0
7685,240000,192000,0,0,0,0,0,0,0,150359,4199,146160,0,62242,1322,60920,0,0,2480,-2480,0,0,0,0
7686,50000,40000,0,0,0,0,0,0,-1,-104,0,-104,-1,9732,10500,-768,-1,9927,337,9590,0,9339,333,9006
7687,200000,160000,0,0,0,0,0,0,-1,100000,100000,0,-1,0,0,0,-1,0,0,0,-2,0,0,0
7688,130000,104000,0,1,0,0,0,1,0,112881,4911,107970,0,96191,3533,92658,0,88934,3301,85633,0,90633,3607,87026
7689,60000,48000,0,1,0,0,0,0,0,54398,2131,52267,0,46937,2010,44927,0,19085,1000,18085,0,19506,1000,18506
7690,10000,8000,0,0,1,1,1,1,2,8965,3000,5965,2,8672,0,8672,2,9525,1000,8525,2,9228,0,9228
7691,280000,224000,0,0,0,0,0,1,-2,5623,5672,-49,-2,5400,5427,-27,-2,3866,3885,-19,-2,3526,3543,-17
7692,20000,16000,0,0,0,0,0,0,0,15723,547,15176,2,15173,0,15173,2,15925,1000,14925,0,16245,585,15660
7693,120000,96000,0,0,0,0,0,0,0,12399,1500,10899,0,4199,1000,3199,0,3059,682,2377,0,674,0,674
7694,290000,232000,0,0,0,0,0,1,-2,3094,3112,-18,-2,8164,8164,0,-2,1509,1509,0,-2,8262,8262,0
7695,150000,120000,0,1,1,1,1,0,0,151308,6308,145000,0,152576,16644,135932,0,152368,12381,139987,0,142030,9320,132710
7696,50000,40000,0,0,0,0,0,0,0,692,694,-2,-1,1184,1186,-2,-1,24119,34029,-9910,-1,24027,1002,23025
7697,220000,176000,0,0,0,0,0,0,-1,433,433,0,-1,1831,1831,0,-1,0,0,0,-1,2891,2891,0
7698,30000,24000,0,0,0,0,0,0,0,0,0,0,-2,90,90,0,-1,-40,0,-40,-1,-3000,0,-3000
7699,230000,184000,0,0,0,0,0,0,-1,267,267,0,-1,0,0,0,-1,0,0,0,-2,0,0,0
7700,130000,104000,0,0,0,0,0,0,2,95602,3369,92233,0,91328,3423,87905,0,93099,3400,89699,0,95825,4275,91550
7701,260000,208000,0,0,0,0,0,0,-2,0,0,0,-2,0,0,0,-2,0,0,0,-2,5181,5181,0
7702,300000,240000,0,0,0,0,0,0,-1,11409,11488,-79,-1,11907,11967,-60,-1,3965,3983,-18,-1,18327,18416,-89
7703,60000,48000,0,0,0,0,0,0,2,33489,0,33489,2,35615,3000,32615,0,38027,3000,35027,0,39239,2000,37239
7704,20000,16000,0,0,0,0,0,0,4,1800,0,1800,3,1800,0,1800,2,1800,0,1800,3,1800,0,1800
7705,190000,152000,0,0,0,0,0,1,2,6214,1000,5214,2,7104,1000,6104,0,8973,2000,6973,0,10809,2000,8809
7706,50000,40000,0,0,0,0,0,0,0,23297,1500,21797,0,22546,2150,20396,0,19563,0,19563,2,20227,1000,19227
7707,210000,168000,0,0,0,0,0,0,-1,792,0,792,2,396,0,396,0,396,396,0,-1,396,396,0
7708,100000,80000,0,1,1,1,1,0,2,93046,3400,89646,0,94898,3383,91515,0,97763,4380,93383,0,99102,4300,94802
7709,50000,40000,0,1,0,0,0,0,0,48120,1989,46131,0,28450,1018,27432,0,29046,1054,27992,0,29647,1084,28563
7710,30000,24000,0,0,1,1,1,0,0,24417,2500,21917,0,27020,3000,24020,0,28107,1500,26607,0,28727,1056,27671
7711,220000,176000,0,0,0,0,0,0,-1,2879,3000,-121,-1,4483,2000,2483,0,6087,2000,4087,0,-273,0,-273
7712,500000,400000,0,0,0,0,0,0,0,285034,14500,270534,0,290002,10370,279632,0,295756,11000,284756,0,302149,11000,291149
7713,60000,48000,0,0,0,0,0,0,2,43457,43460,-3,-1,34481,1700,32781,0,28695,1100,27595,0,26040,1000,25040
7714,110000,88000,0,0,0,0,0,1,3,40995,3000,37995,2,40106,0,40106,2,42492,3300,39192,2,43197,1463,41734
7715,60000,48000,0,0,0,0,0,0,0,48187,2168,46019,0,42658,1642,41016,0,40587,1563,39024,0,40605,1600,39005
7716,150000,120000,0,0,0,0,0,0,0,36260,4000,32260,0,35037,0,35037,2,34631,2000,32631,0,63156,30000,33156
7717,130000,104000,0,0,0,0,0,0,0,15720,1047,14673,0,0,0,0,0,0,0,0,-2,0,0,0
7718,50000,40000,0,1,1,1,1,0,0,47922,5007,42915,0,46307,2008,44299,0,45983,3004,42979,0,50635,7019,43616
7719,230000,184000,0,0,0,0,0,0,-1,342,342,0,-1,955,955,0,-1,957,2,955,0,1407,1511,-104
7720,80000,64000,0,0,1,0,0,0,0,81162,81000,162,0,71470,1513,69957,0,28718,47921,-19203,-1,27813,10000,17813
7721,350000,280000,0,0,0,0,0,0,-1,19194,15084,4110,0,4389,2028,2361,0,1717,1725,-8,-1,4066,4086,-20
7722,80000,64000,0,1,0,0,0,1,0,79757,2449,77308,0,40498,1612,38886,0,29212,798,28414,0,29621,1307,28314
7723,80000,64000,0,0,0,0,0,0,-2,0,0,0,-2,0,0,0,-2,0,0,0,-2,0,0,0
7724,120000,96000,0,1,1,0,0,0,0,117491,5001,112490,0,118513,4134,114379,0,75278,2700,72578,0,77070,3000,74070
7725,170000,136000,0,0,0,0,0,0,0,132485,6107,126378,0,120267,6000,114267,0,117453,4500,112953,0,115778,4500,111278
7726,210000,168000,0,0,0,0,0,1,2,116004,16,115988,2,78564,5812,72752,2,37154,218,36936,2,0,0,0
7727,50000,40000,0,0,0,0,0,0,0,19258,2000,17258,0,19268,1000,18268,0,19040,1000,18040,0,19555,1000,18555
7728,20000,16000,0,1,1,1,1,0,0,17590,1500,16090,0,18107,800,17307,0,18756,936,17820,0,19949,2000,17949
7729,20000,16000,0,0,0,0,0,1,0,0,0,0,0,0,0,0,-2,0,0,0,-2,0,0,0
7730,360000,288000,0,1,1,1,1,1,0,337593,13806,323787,0,341528,12303,329225,0,350949,15005,335944,0,355869,13729,342140
7731,30000,24000,0,0,0,0,0,0,-2,0,0,0,-2,14071,14071,0,-1,14350,514,13836,0,14650,532,14118
7732,300000,240000,0,0,0,0,0,0,-2,21180,21286,-106,-2,-20,0,-20,-2,-20,0,-20,-2,4045,4065,-20
7733,30000,24000,0,1,1,1,0,0,0,30819,2500,28319,2,29214,0,29214,2,29478,910,28568,0,23384,1000,22384
7734,120000,96000,0,0,0,0,0,0,0,61723,21903,39820,0,25638,25646,-8,-1,26092,5080,21012,0,14586,0,14586
7735,50000,40000,0,1,0,0,0,1,0,48521,2290,46231,0,8731,1500,7231,0,8777,1000,7777,0,9261,1000,8261
7736,250000,200000,0,0,0,0,1,0,0,200957,7335,193622,0,205454,8871,196583,0,205710,8055,197655,0,210115,8426,201689
7737,240000,192000,0,0,0,0,0,0,-2,2088,2088,0,-2,7795,7795,0,-2,1335,1335,0,-2,2928,2928,0
7738,80000,64000,0,0,0,0,0,0,-1,8351,6458,1893,0,3234,3917,-683,-1,1819,1819,0,-1,1909,2299,-390
7739,50000,40000,0,0,0,0,0,0,-1,1253,1256,-3,-1,190,190,0,-1,13390,13400,-10,-1,9902,30,9872
7740,80000,64000,0,0,0,0,0,0,-1,31432,31432,0,-1,24455,3000,21455,0,26920,3000,23920,0,0,0,0
7741,50000,40000,0,0,0,0,0,0,0,25775,1800,23975,0,0,0,0,0,0,0,0,-2,0,0,0
7742,20000,16000,0,1,1,0,0,0,0,17285,1200,16085,0,18085,1000,17085,0,11205,500,10705,0,5982,1000,4982
7743,10000,8000,0,0,0,0,0,0,-2,3980,4000,-20,-2,0,0,0,-2,9263,9263,0,-2,3693,3693,0
7744,50000,40000,0,1,0,0,0,0,0,45333,3000,42333,0,27095,2000,25095,0,28508,2000,26508,0,28814,967,27847
7745,500000,400000,0,0,0,0,0,0,-1,15272,16652,-1380,-1,12925,76146,-63221,-1,75667,67697,7970,0,67609,67609,0
7746,220000,176000,0,0,0,0,0,0,-1,1756,1756,0,-1,1986,2075,-89,-1,4772,4774,-2,-1,1115,1115,0
7747,30000,24000,0,1,1,1,1,0,0,30526,1661,28865,0,29219,1238,27981,0,30012,1031,28981,0,28422,1083,27339
7748,30000,24000,0,0,0,0,1,0,2,24056,1698,22358,0,24380,1022,23358,0,24835,1000,23835,0,25423,1000,24423
7749,130000,104000,0,0,0,0,0,0,0,24934,2007,22927,0,17810,1000,16810,0,11705,1000,10705,0,10007,600,9407
7750,120000,96000,0,0,0,0,0,0,0,54724,45000,9724,0,32400,5151,27249,0,9207,2000,7207,0,5828,5000,828
7751,210000,168000,0,0,0,0,0,0,0,170663,8000,162663,0,169291,5556,163735,0,140384,5100,135284,0,138574,5016,133558
7752,360000,288000,0,0,0,0,0,1,0,777,783,-6,0,-3,0,-3,-2,-3,0,-3,-2,-3,0,-3
7753,10000,8000,0,1,0,0,1,0,0,9080,1000,8080,0,1410,1115,295,0,9508,9329,179,0,8997,331,8666
7754,100000,80000,0,0,0,0,0,0,-2,0,0,0,-2,0,0,0,-2,0,0,0,-2,0,0,0
7755,200000,160000,0,0,0,0,0,0,-1,0,0,0,-2,92384,92384,0,-1,13180,13196,-16,-1,1194,1200,-6
7756,10000,8000,0,0,1,1,1,1,0,9596,2603,6993,0,9289,0,9289,2,9593,1000,8593,0,9795,500,9295
7757,240000,192000,0,0,0,0,0,0,-1,1276,1276,0,-1,0,0,0,-1,8621,8621,0,-1,0,0,0
7758,160000,128000,0,0,0,0,0,0,-2,0,0,0,-2,0,0,0,-2,0,0,0,-2,0,0,0
7759,150000,120000,0,0,0,0,0,0,-1,5228,1000,4228,0,1623,1623,0,-1,0,0,0,-1,0,0,0
7760,200000,160000,0,0,0,0,0,0,-1,2203,2583,-380,-1,2189,2189,0,-1,5475,5475,0,-1,5506,5506,0
7761,240000,192000,0,0,0,0,0,0,-2,0,0,0,-2,0,0,0,-2,0,0,0,-2,0,0,0
7762,50000,40000,1,1,1,0,0,0,0,55739,3000,52739,0,55957,1591,54366,0,29238,72,29166,0,6119,1134,4985
7763,10000,8000,0,0,0,0,0,0,2,2989,1500,1489,2,2813,0,2813,2,2008,0,2008,0,2132,150,1982
7764,210000,168000,0,0,0,0,0,0,0,1666,1666,0,-1,1010,1010,0,-1,300,300,0,-1,300,0,300
7765,150000,120000,0,0,0,0,0,0,-2,27498,27498,0,-2,1213,1213,0,-2,26636,26636,0,-2,2547,2704,-157
7766,160000,128000,0,1,1,1,0,0,0,152835,0,152835,2,152638,6000,146638,0,142454,5300,137154,0,128895,4784,124111
7767,50000,40000,0,0,0,0,0,0,0,42332,2500,39832,0,37872,1660,36212,0,35748,1457,34291,0,33631,1300,32331
7768,500000,400000,0,0,0,0,0,0,0,14509,8014,6495,0,16910,14030,2880,0,10854,7012,3842,0,16809,16016,793
7769,50000,40000,0,1,0,0,0,0,2,49581,28,49553,2,36828,1502,35326,0,19361,670,18691,0,19780,708,19072
7770,90000,72000,0,0,0,0,0,0,0,28034,3000,25034,0,29753,2000,27753,0,30601,3000,27601,0,33083,3000,30083
7771,80000,64000,0,0,0,0,0,0,0,50767,1771,48996,0,45721,1715,44006,0,49006,4000,45006,0,56275,8697,47578
7772,360000,288000,0,0,0,0,0,0,-2,0,200,-200,-2,13467,13467,0,-1,17800,5300,12500,0,0,0,0
7773,320000,256000,0,0,0,0,0,1,2,92697,3500,89197,0,106221,15100,91121,0,104313,11,104302,3,103251,3129,100122
7774,500000,400000,0,0,0,0,0,0,0,33134,18000,15134,0,34571,20000,14571,0,36003,20000,16003,0,37416,20007,17409
7775,20000,16000,0,1,1,1,1,0,0,19046,1297,17749,0,19221,672,18549,0,18603,675,17928,0,19075,781,18294
7776,200000,160000,0,0,0,0,0,0,-1,1863,1863,0,-1,9323,9323,0,-1,1612,1612,0,-1,1619,2054,-435
7777,50000,40000,0,0,0,0,0,0,-2,0,0,0,-2,0,0,0,-2,0,0,0,-2,5275,5275,0
7778,500000,400000,0,0,0,0,0,0,-2,121867,126768,-4901,-1,116089,3468,112621,0,114293,4050,110243,0,118081,15099,102982
7779,420000,336000,0,0,0,0,0,0,0,35340,3000,32340,0,54763,20000,34763,0,59037,5000,54037,0,60290,2000,58290
7780,90000,72000,0,1,0,0,0,1,2,88705,7,88698,2,65632,2054,63578,0,49431,1800,47631,0,50864,2864,48000
7781,290000,232000,0,0,0,0,0,0,-2,8809,5000,3809,-2,0,0,0,-2,7241,7241,0,-1,10289,5000,5289
7782,50000,40000,0,0,0,0,0,0,-1,226,390,-164,-1,390,1000,-610,-1,220,220,0,-1,320,640,-320
7783,160000,128000,0,0,0,0,0,1,2,76917,5500,71417,2,75370,0,75370,2,81943,7500,74443,2,80203,0,80203
7784,250000,200000,0,0,0,0,0,0,0,130658,7000,123658,0,79361,4000,75361,0,81196,3000,78196,0,83040,3000,80040
7785,60000,48000,0,0,0,0,0,0,0,42769,1621,41148,0,38855,1400,37455,0,38768,1395,37373,0,38846,1500,37346
7786,230000,184000,0,0,0,0,0,0,0,45941,1764,44177,0,46853,1676,45177,0,47834,1735,46099,0,48942,1902,47040
7787,60000,48000,0,0,0,0,0,1,-1,734,737,-3,-1,399,399,0,-1,670,670,0,-1,0,0,0
7788,180000,144000,0,0,0,0,0,0,0,44132,2100,42032,0,24594,1500,23094,0,25686,1500,24186,0,26780,1500,25280
7789,460000,368000,0,0,0,0,0,0,0,8317,1,8316,2,12338,5002,7336,0,12744,1001,11743,0,12397,3,12394
7790,50000,40000,0,1,1,0,0,1,2,49060,2400,46660,2,47086,4,47082,2,9306,503,8803,0,8962,1109,7853
7791,20000,16000,0,1,0,0,0,1,7,16193,0,16193,6,16445,780,15665,5,15624,0,15624,4,15096,0,15096
7792,290000,232000,0,0,0,0,0,0,0,3164,1000,2164,0,2277,1000,1277,0,1497,1497,0,-1,1887,1887,0
7793,180000,144000,0,0,0,0,0,0,-2,0,0,0,-2,0,0,0,-2,383,773,-390,-1,2388,2395,-7
7794,20000,16000,0,0,0,0,0,0,0,12426,2426,10000,0,11449,1000,10449,0,341,407,-66,-1,20875,21769,-894
7795,50000,40000,0,0,0,0,0,0,0,2515,2522,-7,-1,7885,7951,-66,-1,14493,14493,0,-1,2113,2120,-7
7796,180000,144000,0,0,0,0,0,0,-2,0,0,0,-2,0,0,0,-2,0,0,0,-2,0,0,0
7797,80000,64000,0,0,0,0,0,0,0,32282,2000,30282,0,32869,1520,31349,0,31988,888,31100,0,48431,16696,31735
7798,110000,88000,0,1,0,0,0,0,0,109937,3000,106937,0,47250,2000,45250,0,48543,2000,46543,0,47848,2000,45848
7799,180000,144000,0,0,0,0,0,0,-1,435,435,0,-1,2145,2145,0,-1,3090,3090,0,-1,4165,4165,0
7800,240000,192000,0,0,0,0,0,0,0,154926,10000,144926,0,148681,300,148381,0,24105,1000,23105,0,9770,9770,0
7801,60000,48000,0,0,0,0,0,0,0,42368,1900,40468,0,35730,1908,33822,0,28670,1133,27537,0,27979,1015,26964
7802,180000,144000,0,0,0,0,0,0,0,158050,30032,128018,0,149023,20027,128996,0,135798,40000,95798,0,112666,10000,102666
7803,350000,280000,0,0,0,0,0,0,-1,187,187,0,-1,698,700,-2,-1,188,188,0,-1,183,183,0
7804,130000,104000,0,0,0,0,0,0,-1,2420,1001,1419,0,0,0,0,0,682,682,0,-1,0,0,0
7805,80000,64000,0,1,1,0,0,0,0,71541,3391,68150,0,72541,3000,69541,0,54061,2000,52061,0,55136,1974,53162
7806,50000,40000,0,0,0,0,0,1,2,1050,0,1050,3,1050,0,1050,3,1050,0,1050,3,1050,0,1050
7807,470000,376000,0,0,0,0,0,0,-1,4753,4757,-4,-1,5289,5289,0,-1,831,831,0,-1,2140,2140,0
7808,190000,152000,0,0,0,0,0,0,0,136994,80000,56994,0,118268,5000,113268,0,110476,4000,106476,0,111802,4100,107702
7809,90000,72000,0,0,0,0,0,0,0,35538,1583,33955,0,34780,1773,33007,0,34468,1294,33174,0,30520,1248,29272
7810,240000,192000,0,0,0,0,0,0,0,165755,6800,158955,0,166291,4050,162241,0,141380,6084,135296,0,130742,8028,122714
7811,160000,128000,0,0,0,0,0,0,-2,-4650,0,-4650,-2,930,5580,-4650,-1,930,930,0,-1,2010,2010,0
7812,80000,64000,0,1,1,0,0,0,0,81140,3300,77840,0,80567,2602,77965,0,59560,1800,57760,0,40390,1432,38958
7813,350000,280000,0,0,0,0,0,0,-1,33112,33276,-164,-1,2341,2353,-12,-1,63698,64017,-319,-1,38355,38546,-191
7814,240000,192000,0,0,0,0,0,0,-1,191142,191142,0,-1,98080,98080,0,-1,19380,79380,-60000,-1,100000,100000,0
7815,300000,240000,0,0,0,0,0,0,-2,0,0,0,-2,0,0,0,-2,0,0,0,-2,0,0,0
7816,70000,56000,0,1,1,0,0,0,0,70410,4602,65808,0,68248,63,68185,2,47910,1800,46110,0,48820,1731,47089
7817,270000,216000,0,1,1,1,1,1,2,268769,11000,257769,2,263144,0,263144,2,273783,16002,257781,2,239278,111,239167
7818,130000,104000,0,0,0,0,0,0,2,40851,6000,34851,2,39526,0,39526,2,41346,3000,38346,0,40630,1000,39630
7819,400000,320000,0,0,0,1,0,0,-1,26096,26099,-3,-1,396988,397092,-104,-1,348029,7864,340165,0,173170,3785,169385
7820,80000,64000,0,1,0,0,0,0,-1,77955,3694,74261,0,49955,1694,48261,0,47700,1454,46246,0,48689,1499,47190
7821,70000,56000,0,0,0,0,0,0,0,58608,3000,55608,0,28105,3000,25105,0,30656,3000,27656,0,32674,3000,29674
7822,50000,40000,0,1,1,0,0,0,0,50784,6000,44784,0,43238,0,43238,2,30248,3500,26748,2,27447,0,27447
7823,120000,96000,0,0,0,0,0,0,0,13590,5007,8583,0,11501,3200,8301,0,10151,2000,8151,0,11171,3000,8171
7824,180000,144000,0,0,0,0,0,0,-2,0,0,0,-2,0,0,0,-2,298,298,0,-1,7550,7550,0
7825,500000,400000,0,0,0,0,0,0,0,284198,13000,271198,0,285419,10000,275419,0,261073,10000,251073,0,233343,10000,223343
7826,50000,40000,0,1,1,1,1,0,0,46814,1814,45000,0,47978,1978,46000,0,48733,1733,47000,0,50241,2241,48000
7827,220000,176000,0,0,0,0,0,0,-1,5990,5990,0,-1,7767,7767,0,-1,42731,40645,2086,-1,33266,0,33266
7828,500000,400000,0,0,0,0,0,0,0,8689,5026,3663,0,-131,0,-131,0,-131,0,-131,-2,-131,0,-131
7829,500000,400000,0,0,0,0,0,1,-2,0,0,0,-2,0,0,0,-2,0,0,0,-2,0,0,0
7830,170000,136000,0,0,0,0,0,0,-1,850,850,0,-1,6390,6390,0,-1,1958,5,1953,0,1346,1358,-12
7831,280000,224000,0,0,0,0,0,0,-1,486,486,0,-1,0,0,0,-1,0,0,0,-2,244,244,0
7832,30000,24000,0,0,0,0,0,1,0,16882,1577,15305,0,16911,606,16305,0,17416,778,16638,0,17608,630,16978
7833,110000,88000,0,1,1,1,1,1,2,108533,0,108533,2,112475,7800,104675,2,108976,0,108976,2,108385,4428,103957
7834,300000,240000,0,0,0,0,0,0,-1,2612,2612,0,-1,3408,1914,1494,0,1908,0,1908,0,1108,1108,0
7835,290000,232000,0,0,0,0,0,0,0,66658,2500,64158,0,68627,3000,65627,0,61578,3000,58578,0,59274,3000,56274
7836,80000,64000,0,0,0,0,0,0,0,43727,1400,42327,0,16307,326,15981,0,1755,1755,0,-1,470,0,470
7837,150000,120000,0,0,0,0,0,0,0,39552,2000,37552,0,40393,1500,38893,0,41243,1500,39743,0,42157,1600,40557
7838,30000,24000,0,0,0,0,0,0,0,5172,1241,3931,0,5931,1000,4931,0,7665,2000,5665,0,9535,2000,7535
7839,290000,232000,0,0,0,0,0,0,0,145676,7037,138639,0,144305,7019,137286,0,140375,6005,134370,0,142119,6006,136113
7840,320000,256000,0,0,0,0,0,0,-2,3829,3848,-19,-2,933,937,-4,-2,5446,5473,-27,-2,8523,8565,-42
7841,200000,160000,0,0,0,0,0,1,-2,0,0,0,-2,0,0,0,-2,0,0,0,-2,0,0,0
7842,360000,288000,0,0,0,0,0,0,2,0,0,0,2,0,0,0,-2,0,0,0,-2,0,0,0
7843,30000,24000,0,0,0,0,0,0,0,11492,1700,9792,0,12391,1500,10891,0,12891,500,12391,0,9069,1000,8069
7844,50000,40000,0,0,0,0,0,0,0,16991,31991,-15000,-1,17727,1500,16227,0,18391,1200,17191,0,18490,10000,8490
7845,400000,320000,0,0,0,0,0,0,-1,799,0,799,2,1883,1883,0,-1,587,0,587,0,0,0,0
7846,60000,48000,0,0,0,0,0,0,0,21106,1386,19720,0,22345,1625,20720,0,25720,4000,21720,0,23467,3000,20467
7847,210000,168000,0,0,0,0,0,0,0,79503,2861,76642,0,75528,2388,73140,0,72567,3000,69567,0,69502,3000,66502
7848,120000,96000,0,0,0,0,0,0,0,30212,1506,28706,0,31226,1520,29706,0,31844,1138,30706,0,32513,1180,31333
7849,80000,64000,0,0,0,0,0,0,-1,7920,7932,-12,-1,2830,2838,-8,-1,3092,3112,-20,-1,2315,2333,-18
7850,20000,16000,0,0,0,0,0,0,0,12071,0,12071,2,12567,1000,11567,0,13949,1600,12349,0,14318,600,13718
7851,140000,112000,0,0,0,0,0,0,0,27026,1450,25576,0,27714,1138,26576,0,28139,1021,27118,0,28697,1026,27671
7852,50000,40000,0,0,0,0,0,0,0,21489,1302,20187,0,20414,700,19714,0,19342,699,18643,0,19482,849,18633
7853,180000,144000,0,0,0,0,0,0,0,102711,3600,99111,0,95652,3415,92237,0,97661,3542,94119,0,99656,3616,96040
7854,30000,24000,0,1,0,0,0,0,0,26540,1500,25040,0,13842,499,13343,0,16299,3000,13299,0,18547,3000,15547
7855,200000,160000,0,1,0,0,0,0,0,183493,7000,176493,0,146143,5000,141143,0,144339,6000,138339,0,140340,6000,134340
7856,30000,24000,0,0,0,0,0,0,-1,780,780,0,-1,0,0,0,-1,0,0,0,-2,0,0,0
7857,50000,40000,0,0,0,0,0,0,0,22289,1537,20752,0,22752,1000,21752,0,9325,187,9138,0,9270,185,9085
7858,50000,40000,0,0,1,1,1,0,0,42897,3500,39397,0,44388,2500,41888,0,46528,3000,43528,2,44986,0,44986
7859,30000,24000,0,0,1,1,1,0,-1,24886,1245,23641,0,25014,763,24251,0,29356,5000,24356,0,25515,1164,24351
7860,50000,40000,0,1,0,0,0,1,0,49754,2200,47554,0,19169,1000,18169,0,19480,1000,18480,0,19569,800,18769
7861,20000,16000,0,0,0,0,0,1,4,10398,0,10398,3,10000,0,10000,2,10000,0,10000,0,10000,0,10000
7862,160000,128000,0,0,0,0,0,0,-1,165,168,-3,-1,165,165,0,-1,165,165,0,-1,165,165,0
7863,60000,48000,0,0,0,0,0,1,0,42449,2100,40349,0,43243,1800,41443,0,48537,6000,42537,0,47606,0,47606
7864,340000,272000,0,0,0,0,0,0,-1,8548,8591,-43,-1,11190,11246,-56,-1,8210,8251,-41,-1,7981,8021,-40
7865,360000,288000,0,0,0,0,0,1,-1,0,0,0,-1,0,0,0,-2,0,0,0,-2,0,0,0
7866,180000,144000,0,0,0,0,0,0,0,36862,3007,33855,0,34337,3002,31335,0,33524,3000,30524,0,35223,3000,32223
7867,50000,40000,0,1,1,0,0,1,2,44187,8,44179,2,43165,1500,41665,0,37967,1490,36477,0,36327,1303,35024
7868,400000,320000,0,0,0,0,0,0,0,60049,5000,55049,0,60876,1902,58974,0,65178,5000,60178,0,45933,0,45933
7869,90000,72000,0,1,0,0,0,0,0,76947,4142,72805,0,46589,1700,44889,0,47730,1888,45842,0,49488,2710,46778
7870,340000,272000,0,0,0,0,0,0,-2,291,291,0,-2,291,291,0,-2,291,291,0,-2,291,291,0
7871,50000,40000,0,0,0,0,0,1,2,33408,1900,31508,2,32577,0,32577,2,34329,2600,31729,2,33643,0,33643
7872,50000,40000,0,1,0,0,0,0,0,47486,1365,46121,0,24769,848,23921,0,23029,1000,22029,0,23495,1000,22495
7873,230000,184000,0,0,0,0,0,0,0,78868,3500,75368,0,80343,3000,77343,0,82564,3500,79064,0,74531,3000,71531
7874,40000,32000,0,1,1,1,1,1,2,34773,2000,32773,2,33917,0,33917,2,36704,3500,33204,2,40404,4471,35933
7875,490000,392000,0,0,0,0,0,0,0,3404,3404,0,-1,14445,14445,0,-1,7672,7672,0,-1,2295,2295,0
7876,200000,160000,0,0,0,0,0,0,-2,-6,0,-6,-2,657,663,-6,-2,2088,2088,0,-2,150,150,0
7877,230000,184000,0,0,0,0,0,1,-1,0,0,0,-2,11660,11660,0,-1,11898,238,11660,0,14898,3000,11898
7878,200000,160000,0,0,0,0,0,0,-2,0,0,0,-2,0,0,0,-2,2894,2894,0,-2,210,210,0
7879,170000,136000,0,0,0,0,0,0,-2,3824,3824,0,-2,22709,22865,-156,-2,0,0,0,-2,0,0,0
7880,20000,16000,0,0,0,1,1,1,0,15936,0,15936,2,18015,2355,15660,2,17431,0,17431,2,18000,1000,17000
7881,80000,64000,0,0,0,0,0,0,0,43427,5400,38027,0,42421,0,42421,2,42344,1662,40682,0,43229,1717,41512
7882,120000,96000,0,0,0,0,0,1,-1,1086,1086,0,-1,1230,1230,0,-1,1230,0,1230,0,2806,2806,0
7883,50000,40000,0,1,1,0,0,0,0,49484,1755,47729,0,46077,1500,44577,0,23536,842,22694,0,24045,888,23157
7884,80000,64000,0,0,0,0,0,0,0,46595,2200,44395,0,47224,1738,45486,0,46903,1796,45107,0,46973,1832,45141
7885,150000,120000,0,0,0,0,0,0,0,20880,3030,17850,0,17305,3118,14187,0,16094,3003,13091,0,18516,3040,15476
7886,120000,96000,0,0,0,0,0,0,0,12210,5312,6898,0,3095,3095,0,-1,0,0,0,-1,2873,2873,0
7887,130000,104000,0,0,0,0,0,1,0,92765,4112,88653,0,48481,2007,46474,0,47779,2516,45263,0,42362,1119,41243
7888,220000,176000,0,0,0,0,0,0,0,32978,5000,27978,0,30415,13500,16915,0,28038,14000,14038,0,25669,13500,12169
7889,500000,400000,0,0,0,0,0,0,-1,32109,32189,-80,-1,56370,56436,-66,-1,36918,36918,0,-1,35017,35017,0
7890,360000,288000,0,0,0,0,0,0,-1,5757,5762,-5,-1,28974,29000,-26,-1,8093,8093,0,-1,3250,1500,1750
7891,10000,8000,0,0,0,0,0,1,4,7817,0,7817,3,7545,0,7545,2,8268,1000,7268,2,7993,0,7993
7892,190000,152000,0,0,0,0,0,0,0,117856,6000,111856,2,119570,5000,114570,2,116284,0,116284,2,123528,9000,114528
7893,310000,248000,0,0,0,0,0,0,0,14605,1576,13029,0,15125,1000,14125,0,18048,3100,14948,0,16607,2000,14607
7894,50000,40000,0,0,0,0,0,1,2,17796,2150,15646,2,17213,0,17213,2,18432,1500,16932,2,18981,1000,17981
7895,120000,96000,0,0,0,0,0,0,0,57868,3588,54280,0,60790,10000,50790,0,50091,5000,45091,0,51113,5000,46113
7896,100000,80000,0,0,0,0,0,1,2,55581,2000,53581,2,59253,4600,54653,2,61145,3000,58145,2,62181,2200,59981
7897,500000,400000,0,0,0,0,0,0,0,74664,3030,71634,0,70270,3028,67242,0,66053,2513,63540,0,63924,2100,61824
7898,360000,288000,0,0,0,0,0,0,0,91834,7000,84834,0,95631,10000,85631,0,100123,10000,90123,0,100738,10000,90738
7899,430000,344000,0,0,0,0,0,0,-1,4705,4723,-18,-1,2029,2035,-6,-1,41581,41784,-203,-1,25984,26108,-124
7900,270000,216000,0,0,0,0,0,0,-1,13951,13999,-48,-1,8938,8964,-26,-1,15280,15325,-45,-1,18002,18028,-26
7901,90000,72000,0,0,0,0,0,1,2,18451,2000,16451,2,17857,0,17857,2,20256,2700,17556,2,20785,1000,19785
7902,150000,120000,0,0,0,0,0,0,-1,316,316,0,-1,5469,5469,0,-1,3360,3360,0,-1,2399,2399,0
7903,320000,256000,0,0,0,0,0,0,-1,19905,19905,0,-1,15645,15452,193,0,11388,11388,0,-1,28017,28017,0
7904,720000,576000,0,0,0,0,0,1,0,158694,6000,152694,0,148956,6000,142956,0,135217,5237,129980,0,85300,3000,82300
7905,170000,136000,0,0,0,0,0,0,0,28592,3000,25592,0,29364,2000,27364,0,29096,1000,28096,0,29353,977,28376
7906,460000,368000,0,0,0,0,0,0,0,163366,5677,157689,0,151904,5350,146554,0,146707,5473,141234,0,140104,5218,134886
7907,110000,88000,0,0,0,0,0,0,0,3404,3000,404,0,407,410,-3,-1,1250,1250,0,-1,88628,89035,-407
7908,270000,216000,0,1,1,0,0,1,2,229286,8000,221286,2,217644,0,217644,2,223690,16000,207690,2,221413,8000,213413
7909,60000,48000,0,0,0,0,0,0,-2,0,0,0,-2,0,0,0,-2,0,0,0,-2,0,0,0
7910,110000,88000,0,0,0,0,0,0,0,82501,2636,79865,0,54458,1883,52575,0,45943,1584,44359,0,44724,1604,43120
7911,70000,56000,0,0,0,0,0,0,-1,772,772,0,-1,390,8,382,0,780,780,0,-1,390,0,390
7912,50000,40000,0,0,0,0,0,0,0,35492,3100,32392,0,7988,3000,4988,0,8986,1500,7486,0,10463,2000,8463
7913,170000,136000,0,0,0,0,0,0,-1,1409,1409,0,-1,1337,1337,0,-1,1337,0,1337,0,53885,53885,0
7914,400000,320000,0,0,0,0,0,0,-2,0,0,0,-2,0,0,0,-2,1600,1600,0,-1,78388,78388,0
7915,270000,216000,0,0,0,0,0,0,0,113480,5800,107680,0,114432,4300,110132,0,112124,5000,107124,0,114885,4500,110385
7916,160000,128000,0,0,0,0,0,0,-1,-7,0,-7,-1,3298,3305,-7,-1,455,455,0,-1,-325,0,-325
7917,330000,264000,0,0,0,0,0,0,0,290451,102428,188023,0,192123,4100,188023,0,196860,4937,191923,0,-3140,3140,-6280
7918,20000,16000,0,0,0,0,0,0,0,2333,2333,0,-1,1300,0,1300,0,0,0,0,0,0,0,0
7919,20000,16000,0,1,1,0,0,0,0,21017,1453,19564,0,19772,691,19081,0,15628,512,15116,0,12501,1430,11071
7920,130000,104000,0,1,1,0,0,1,0,131352,5108,126244,0,121931,3860,118071,0,61755,82367,-20612,-1,61453,3041,58412
7921,320000,256000,0,0,0,0,0,0,-1,14080,14109,-29,-1,9931,11,9920,0,7590,38,7552,0,9685,9733,-48
7922,140000,112000,0,0,0,0,0,1,2,89397,3800,85597,2,90514,3500,87014,2,91661,3500,88161,2,90100,0,90100
7923,280000,224000,0,0,0,0,0,0,-1,2184,2194,-10,-1,2542,2554,-12,-1,2186,2196,-10,-1,2109,2119,-10
7924,150000,120000,0,0,0,0,0,0,-1,3323,3323,0,-1,5953,5970,-17,-1,2559,2571,-12,-1,4509,4515,-6
7925,350000,280000,0,0,0,0,0,0,-1,61044,61349,-305,-1,22611,22687,-76,-1,1385,1389,-4,-1,6043,6058,-15
7926,160000,128000,0,0,0,0,0,0,-1,0,0,0,-1,0,0,0,-2,0,0,0,-2,0,0,0
7927,80000,64000,0,0,0,0,0,0,0,58577,3923,54654,0,60169,2500,57669,0,58426,2100,56326,0,58204,2200,56004
7928,110000,88000,0,0,0,0,0,0,0,10018,1000,9018,0,0,0,0,0,0,0,0,-2,0,0,0
7929,100000,80000,0,0,0,0,0,0,0,8186,5000,3186,0,1127,1127,0,-1,10880,10143,737,-1,10143,0,10143
7930,200000,160000,0,1,0,0,0,0,0,173325,10000,163325,0,153953,6000,147953,0,144206,6000,138206,0,143178,6000,137178
7931,50000,40000,0,0,0,0,0,0,0,90,90,0,-1,390,690,-300,-1,1080,1080,0,-1,540,0,540
7932,70000,56000,0,0,0,0,0,0,2,45870,20000,25870,0,46918,1807,45111,0,53153,7042,46111,0,52174,0,52174
7933,200000,160000,0,0,0,0,0,0,-1,1230,1234,-4,-1,3393,3510,-117,-1,1340,1344,-4,-1,3416,3426,-10
7934,40000,32000,0,0,0,0,0,1,2,29089,3000,26089,2,28522,200,28322,2,28914,1000,27914,2,29482,1200,28282
7935,310000,248000,0,0,0,0,0,0,-1,6204,6206,-2,-1,2905,2905,0,-1,7944,7944,0,-1,13125,13524,-399
7936,170000,136000,0,0,0,0,0,0,-2,1740,1777,-37,-1,97961,114593,-16632,-1,66257,5823,60434,0,12106,439,11667
7937,210000,168000,0,0,0,0,0,0,-2,0,0,0,-2,0,0,0,-2,1849,1849,0,-2,12837,12837,0
7938,270000,216000,0,0,0,0,0,0,-2,0,0,0,-2,0,0,0,-2,0,0,0,-2,0,0,0
7939,50000,40000,0,0,0,0,0,1,2,17127,0,17127,2,18076,1259,16817,0,17061,591,16470,0,17419,613,16806
7940,50000,40000,0,0,0,0,0,0,-1,667,673,-6,-1,0,0,0,-1,0,0,0,-2,0,0,0
7941,500000,400000,0,0,0,0,0,0,0,15219,2000,13219,0,14044,1100,12944,0,14191,505,13686,0,13650,700,12950
7942,80000,64000,0,0,0,0,0,0,0,59223,2132,57091,0,40128,1650,38478,0,41152,2000,39152,0,41527,1503,40024
7943,50000,40000,0,0,0,0,0,0,-1,14659,1300,13359,0,14951,519,14432,0,14195,518,13677,0,14471,515,13956
7944,20000,16000,0,0,0,0,0,0,0,0,0,0,0,1728,1728,0,-1,1953,225,1728,-1,1780,0,1780
7945,240000,192000,0,1,1,1,1,0,2,229923,0,229923,2,238940,18000,220940,2,238775,9000,229775,2,238202,8600,229602
7946,260000,208000,0,0,0,0,0,0,-2,16869,3000,13869,-2,12713,12713,0,-2,10420,10420,0,-2,12532,12532,0
7947,100000,80000,0,0,0,1,0,0,0,48258,1803,46455,0,49218,1763,47455,0,99677,1843,97834,0,51738,4654,47084
7948,50000,40000,0,0,0,0,0,0,0,27836,1484,26352,0,40346,3675,36671,0,38668,698,37970,0,20016,1000,19016
7949,110000,88000,0,0,0,0,0,0,0,53160,3031,50129,0,54331,3000,51331,0,53024,3000,50024,0,51317,2000,49317
7950,220000,176000,0,0,0,0,0,0,-2,0,0,0,-2,584,584,0,-2,790,790,0,-2,0,0,0
7951,110000,88000,0,0,0,0,0,0,0,22546,0,22546,2,22204,1314,20890,0,22107,2000,20107,0,21745,1500,20245
7952,130000,104000,0,0,0,0,0,1,2,20484,0,20484,2,22145,2000,20145,2,21652,0,21652,2,23138,2000,21138
7953,100000,80000,0,0,0,0,0,0,0,10388,1400,8988,0,3762,3786,-24,0,1434,1774,-340,-2,12609,12714,-105
7954,290000,232000,0,0,0,0,0,0,-2,2436,2436,0,-2,266,266,0,-2,0,0,0,-2,3412,3412,0
7955,50000,40000,0,0,0,0,0,0,0,18403,1300,17103,0,19369,1300,18069,0,20094,1000,19094,0,17934,1000,16934
7956,20000,16000,0,0,0,0,0,0,-1,0,0,0,-2,0,0,0,-2,0,528,-528,-2,0,0,0
7957,20000,16000,0,0,0,0,0,1,2,13324,1528,11796,0,14029,1233,12796,0,14308,512,13796,0,14625,547,14078
7958,50000,40000,0,0,0,0,0,0,0,26075,1425,24650,2,25358,0,25358,2,27123,2190,24933,2,27509,965,26544
7959,50000,40000,0,1,1,1,1,0,2,49646,7775,41871,0,44051,3000,41051,0,45912,3000,42912,0,45383,5000,40383
7960,60000,48000,0,1,1,1,1,1,0,54126,4553,49573,0,58732,5800,52932,0,59306,2000,57306,0,59728,1000,58728
7961,90000,72000,0,1,1,1,1,1,2,92226,3600,88626,2,89817,0,89817,2,87296,3300,83996,0,89130,3400,85730
7962,50000,40000,0,0,0,0,0,0,0,14388,5000,9388,0,18804,5000,13804,0,23460,5000,18460,0,27870,5000,22870
7963,100000,80000,0,0,0,0,0,0,0,56323,2081,54242,0,48985,2077,46908,0,23894,1003,22891,0,23402,1015,22387
7964,230000,184000,0,0,0,0,0,0,-2,390,390,0,-2,390,390,0,-2,1240,1240,0,-2,4234,4234,0
7965,120000,96000,1,1,1,0,0,0,0,130935,6000,124935,0,124458,3000,121458,0,78671,3000,75671,0,8730,2000,6730
7966,320000,256000,0,0,0,0,0,1,0,-2793,23,-2816,0,-2793,0,-2793,-2,20381,23381,-3000,-1,25198,5000,20198
7967,110000,88000,0,1,1,1,1,0,2,95768,7300,88468,2,97004,3700,93304,2,99005,3700,95305,2,101213,4000,97213
7968,80000,64000,0,0,0,0,0,0,0,44654,5013,39641,0,42464,3044,39420,0,38320,5006,33314,0,40586,5012,35574
7969,50000,40000,0,0,0,0,0,0,-2,0,0,0,-2,0,0,0,-2,0,0,0,-2,0,0,0
7970,100000,80000,0,0,0,0,0,0,0,26704,2000,24704,0,27640,2000,25640,0,30035,3000,27035,0,33697,5000,28697
7971,80000,64000,0,1,0,0,0,0,0,79121,3862,75259,0,59165,2056,57109,0,60084,2200,57884,0,59920,2130,57790
7972,230000,184000,0,0,0,0,0,0,0,25000,1224,23776,0,22046,655,21391,0,19860,627,19233,0,19831,620,19211
7973,230000,184000,0,0,0,0,0,1,-2,0,0,0,-2,0,0,0,-2,0,0,0,-2,0,0,0
7974,90000,72000,0,0,0,0,0,0,0,63198,4236,58962,0,61633,3000,58633,0,62837,2000,60837,0,69422,7000,62422
7975,10000,8000,0,1,1,0,0,0,0,9540,1000,8540,0,9735,195,9540,0,8070,161,7909,0,0,0,0
7976,310000,248000,0,0,0,0,0,0,-1,-8,0,-8,-1,1624,1632,-8,-1,0,0,0,-1,0,0,0
7977,120000,96000,0,0,0,0,0,0,0,82094,2847,79247,0,59105,2066,57039,0,53442,1919,51523,0,46775,2200,44575
7978,20000,16000,0,1,1,1,0,1,0,20319,1458,18861,0,20638,1277,19361,0,20025,494,19531,0,15463,427,15036
7979,200000,160000,0,0,0,0,0,0,-1,60571,60025,546,0,57990,5032,52958,0,9568,5054,4514,0,82,5000,-4918
7980,390000,312000,0,0,0,0,0,0,-1,5985,5985,0,-1,7151,7000,151,0,-200,0,-200,0,-200,0,-200
7981,330000,264000,0,0,0,0,0,0,0,47398,2007,45391,0,40334,2000,38334,0,34443,2000,32443,0,33898,2000,31898
7982,200000,160000,0,1,1,0,0,0,0,179899,8000,171899,0,170716,7520,163196,0,164553,6000,158553,0,165326,6100,159226
7983,310000,248000,0,0,0,0,0,0,-2,17314,17417,-103,-2,8639,8702,-63,-2,12862,12926,-64,-2,4553,4575,-22
7984,500000,400000,0,0,0,0,0,0,-2,3609,3609,0,-1,4053,4053,0,-1,0,0,0,-1,4487,4487,0
7985,700000,560000,0,0,0,0,0,0,0,328316,11939,316377,0,325968,10312,315656,0,271596,20004,251592,0,286805,20000,266805
7986,40000,32000,0,0,0,0,0,0,0,7145,1049,6096,0,2424,1000,1424,0,822,0,822,0,0,0,0
7987,180000,144000,0,0,0,0,0,0,-1,-4,0,-4,-1,55566,61411,-5845,-1,1056,1056,0,-1,390,0,390
7988,50000,40000,0,1,1,0,0,1,2,49463,0,49463,2,50046,2300,47746,0,19858,1000,18858,0,19278,1000,18278
7989,360000,288000,0,0,0,0,0,1,-2,2178,2178,0,-2,316,316,0,-2,1812,1812,0,-2,1510,1510,0
7990,260000,208000,0,0,0,0,0,0,0,117089,20057,97032,0,95975,5113,90862,0,62817,3040,59777,0,61221,20000,41221
7991,150000,120000,0,0,0,0,0,0,2,23978,2145,21833,0,17853,10000,7853,0,34527,22000,12527,0,28277,3000,25277
7992,180000,144000,0,0,0,0,0,0,0,7738,2000,5738,0,6369,2000,4369,0,6109,3109,3000,0,7603,5000,2603
7993,260000,208000,0,0,0,0,0,0,-1,827,827,0,-1,827,827,0,-1,755,755,0,-1,-72,0,-72
7994,140000,112000,0,0,0,0,0,0,-1,0,0,0,-1,1686,1686,0,-1,1686,0,1686,0,205,205,0
7995,20000,16000,0,1,1,0,0,1,0,17265,1170,16095,0,16647,500,16147,0,12213,420,11793,0,10998,397,10601
7996,20000,16000,0,1,1,1,1,0,2,20491,3700,16791,2,19803,0,19803,2,19734,1000,18734,0,19613,2000,17613
7997,80000,64000,0,0,0,0,0,0,-1,416,416,0,-1,416,416,0,-1,416,416,0,-1,416,416,0
7998,50000,40000,0,0,0,0,0,1,2,34992,1424,33568,0,25916,1500,24416,0,27207,1677,25530,0,26192,1500,24692
7999,500000,400000,0,0,0,0,0,0,0,2234,2019,215,0,5404,5025,379,0,2375,2011,364,0,10078,10046,32
8000,100000,80000,0,0,0,0,0,0,-1,44591,44591,0,-1,8910,0,8910,0,0,0,0,0,0,0,0
8001,300000,240000,0,0,0,0,0,0,0,9265,1500,7765,0,7263,1500,5763,0,14145,9433,4712,0,11535,2000,9535
8002,120000,96000,0,0,0,0,0,0,-1,250,250,0,-2,2561,3265,-704,-1,-295,0,-295,-1,-295,0,-295
8003,120000,96000,0,0,0,0,0,0,-2,3529,3538,-9,-1,11050,11050,0,-1,15811,5313,10498,0,14774,516,14258
8004,20000,16000,0,0,0,0,0,0,0,17057,3130,13927,0,13450,1275,12175,0,7944,159,7785,0,780,0,780
8005,200000,160000,0,0,0,0,0,0,-1,21602,21666,-64,-1,3760,4971,-1211,-1,2925,2933,-8,-1,16751,16759,-8
8006,360000,288000,0,0,0,0,0,0,0,63146,8004,55142,0,63723,5000,58723,0,65108,5000,60108,0,66078,5000,61078
8007,250000,200000,0,0,0,0,0,0,-1,4997,9544,-4547,-1,0,0,0,-1,0,0,0,-2,0,0,0
8008,90000,72000,0,0,0,0,0,0,2,750,0,750,3,750,0,750,3,2450,2000,450,3,2150,0,2150
8009,230000,184000,0,0,0,0,0,0,0,146464,6707,139757,0,144227,10038,134189,0,133638,4782,128856,0,136605,5119,131486
8010,80000,64000,0,0,0,1,1,0,0,62813,3662,59151,0,65151,4000,61151,0,66568,2500,64068,0,70168,4509,65659
8011,230000,184000,0,1,1,0,0,0,0,204255,10000,194255,0,207347,10000,197347,0,51134,50000,1134,0,50222,2000,48222
8012,120000,96000,0,0,0,0,0,0,0,60364,3000,57364,0,70420,11299,59121,0,62549,1943,60606,0,47683,2000,45683
8013,20000,16000,0,0,0,1,1,0,2,16184,1000,15184,2,16913,1000,15913,0,17640,1000,16640,0,18688,1500,17188
8014,200000,160000,0,0,0,0,0,0,-2,1348,1348,0,-2,20836,20836,0,-2,1321,1321,0,-2,561,561,0
8015,50000,40000,1,1,0,0,0,0,0,169217,3703,165514,0,18056,1000,17056,0,18179,660,17519,0,18563,686,17877
8016,200000,160000,0,0,0,0,0,0,-1,6721,4000,2721,0,-780,780,-1560,0,-780,0,-780,-2,-780,0,-780
8017,300000,240000,0,1,1,0,0,1,0,279613,14000,265613,0,286449,20000,266449,0,191187,6500,184687,0,194333,8000,186333
8018,220000,176000,0,0,0,0,0,0,-1,64735,64775,-40,-1,22792,22794,-2,-1,184483,184483,0,-1,62140,62140,0
8019,460000,368000,0,1,1,1,1,0,0,453770,17500,436270,0,396600,13810,382790,0,392879,14100,378779,0,398478,14520,383958
8020,200000,160000,0,0,0,0,0,1,2,84900,4100,80800,2,85758,3000,82758,2,87003,3400,83603,2,89112,3500,85612
8021,160000,128000,0,0,0,0,0,1,-1,2551,18,2533,2,4217,4217,0,-1,1255,0,1255,0,1554,1000,554
8022,160000,128000,0,0,0,0,0,0,0,5140,1500,3640,0,5379,1500,3879,0,3183,1000,2183,0,5120,2000,3120
8023,260000,208000,0,0,0,0,0,0,0,206210,9000,197210,0,208752,8910,199842,0,209083,7570,201513,0,208463,7751,200712
8024,50000,40000,0,0,0,0,0,0,0,24965,1575,23390,0,7592,1582,6010,0,1582,593,989,2,1099,242,857
8025,230000,184000,0,0,0,0,0,0,0,122493,4600,117893,0,124743,4389,120354,0,127507,4697,122810,0,121400,4800,116600
8026,20000,16000,0,1,1,0,0,0,0,18057,0,18057,2,18536,2175,16361,2,11532,0,11532,2,19450,10000,9450
8027,20000,16000,0,0,0,0,0,0,3,8280,0,8280,2,11500,4000,7500,0,9000,7000,2000,0,0,0,0
8028,90000,72000,0,0,0,0,0,0,0,40162,3000,37162,0,41422,2000,39422,0,42172,1600,40572,0,34477,1500,32977
8029,40000,32000,0,1,1,1,1,1,0,38401,0,38401,2,39224,2100,37124,0,40364,3226,37138,0,38391,0,38391
8030,50000,40000,0,0,0,0,0,0,0,6974,1500,5474,0,5315,0,5315,2,4645,1000,3645,0,3955,1000,2955
8031,110000,88000,0,0,0,0,0,1,2,57502,2500,55002,2,58460,2500,55960,2,59876,2500,57376,2,58761,0,58761
8032,50000,40000,0,0,0,0,0,1,-1,10496,1000,9496,0,3614,0,3614,0,2254,0,2254,0,1494,0,1494
8033,300000,240000,0,0,0,0,0,0,0,18497,2008,16489,0,8426,301,8125,0,11291,3000,8291,0,14449,5000,9449
8034,20000,16000,0,0,0,0,0,0,3,8505,0,8505,2,9557,1200,8357,0,10395,1000,9395,0,11227,1000,10227
8035,100000,80000,0,0,0,0,0,0,-2,0,0,0,-2,0,0,0,-2,0,0,0,-2,2947,2947,0
8036,60000,48000,0,0,0,0,0,0,0,28937,1400,27537,0,29614,1000,28614,0,30391,1100,29291,0,23159,1000,22159
8037,50000,40000,0,0,0,0,0,0,0,18202,2701,15501,0,18601,700,17901,0,19138,847,18291,0,18319,655,17664
8038,60000,48000,0,0,0,0,0,0,0,26964,1599,25365,0,27265,900,26365,0,30329,4500,25829,0,24104,0,24104
8039,160000,128000,0,0,0,0,1,0,0,115096,5400,109696,0,76037,4082,71955,0,152837,163107,-10270,-1,156042,5668,150374
8040,100000,80000,0,0,0,0,0,1,0,39321,4200,35121,0,39145,900,38245,2,39494,1400,38094,2,39896,900,38996
8041,200000,160000,0,0,0,0,0,1,-1,3635,3650,-15,-1,130,130,0,-1,1209,1209,0,-1,938,938,0
8042,260000,208000,0,0,0,0,0,1,0,176632,6729,169903,0,129022,5022,124000,0,131447,4447,127000,0,135699,5699,130000
8043,240000,192000,0,0,0,0,0,1,-2,0,0,0,-2,0,0,0,-2,0,0,0,-2,0,0,0
8044,210000,168000,0,0,0,0,0,0,-2,0,0,0,-2,225,225,0,-2,760,760,0,-2,0,0,0
8045,240000,192000,0,0,0,0,0,0,0,168081,6000,162081,0,166589,8808,157781,0,165981,6006,159975,0,165951,6000,159951
8046,50000,40000,0,0,0,0,0,0,0,29117,1477,27640,0,28764,1444,27320,0,28390,1100,27290,0,29443,1500,27943
8047,50000,40000,1,1,1,1,1,1,2,54882,2700,52182,0,53894,2450,51444,0,52382,1830,50552,0,53947,4300,49647
8048,230000,184000,0,0,0,0,0,0,-1,0,0,0,-2,0,0,0,-2,0,0,0,-2,31868,31868,0
8049,80000,64000,0,0,0,0,0,1,2,9937,350,9587,2,9629,0,9629,2,10571,1100,9471,2,10749,500,10249
8050,50000,40000,0,0,0,0,0,1,0,25376,2456,22920,0,23845,784,23061,2,21691,0,21691,2,20426,778,19648
8051,260000,208000,0,0,0,0,0,0,0,215056,7979,207077,0,212791,6807,205984,0,177159,5247,171912,0,143920,5240,138680
8052,80000,64000,0,0,0,0,0,0,-2,15728,15728,0,-1,9265,1500,7765,0,10400,1400,9000,0,0,0,0
8053,540000,432000,0,0,0,0,0,0,-2,736,736,0,-2,736,736,0,-2,0,0,0,-2,-736,0,-736
8054,210000,168000,0,0,0,0,0,0,0,42889,3000,39889,0,42936,1000,41936,0,44936,2000,42936,0,47166,2230,44936
8055,50000,40000,0,0,0,0,0,1,0,30385,2000,28385,2,18399,0,18399,2,19037,2000,17037,0,17945,726,17219
8056,180000,144000,0,0,0,0,0,0,0,133557,6600,126957,0,129909,6000,123909,0,133043,6000,127043,0,133835,6000,127835
8057,200000,160000,0,0,0,0,0,0,-2,7458,7471,-13,-2,1086,1086,0,-2,25643,25643,0,-2,35237,35237,0
8058,70000,56000,0,0,0,0,0,0,0,51258,2011,49247,0,48564,2013,46551,0,47512,2001,45511,0,48164,2000,46164
8059,510000,408000,0,0,0,0,0,1,-1,17023,3500,13523,0,9706,2500,7206,0,7271,1380,5891,0,9551,2380,7171
8060,80000,64000,0,0,0,0,0,1,-2,0,0,0,-2,0,0,0,-2,0,0,0,-2,0,0,0
8061,20000,16000,0,0,1,1,1,0,0,17111,3000,14111,0,18422,2000,16422,0,18234,779,17455,0,18217,796,17421
8062,30000,24000,0,1,1,1,1,0,0,30395,3000,27395,0,29962,2468,27494,0,30360,1700,28660,0,29899,2500,27399
8063,330000,264000,0,0,0,0,0,0,-1,2335,2579,-244,-1,7278,7278,0,-1,6646,6,6640,0,5324,26,5298
8064,180000,144000,0,1,1,1,1,1,2,166492,12552,153940,2,168487,6200,162287,2,172662,7000,165662,2,172027,2304,169723
8065,270000,216000,0,0,0,0,0,0,-1,11013,11013,0,-1,1188,1196,-8,-1,14989,14989,0,-1,2609,2609,0
8066,20000,16000,0,1,1,1,0,1,0,17914,1122,16792,0,18357,565,17792,0,19155,1000,18155,0,10200,204,9996
8067,400000,320000,0,0,0,0,0,0,-2,14037,14079,-42,-2,20356,20417,-61,-2,90159,90180,-21,-1,79053,79176,-123
8068,150000,120000,0,0,0,0,0,0,-1,39008,40010,-1002,-1,19483,19,19464,0,32901,20000,12901,0,8790,0,8790
8069,360000,288000,0,0,0,0,0,0,2,2618,2618,0,-1,2868,2868,0,-1,425,425,0,-1,29879,29879,0
8070,360000,288000,0,0,0,0,0,0,-2,0,0,0,-2,0,0,0,-2,0,0,0,-2,0,0,0
8071,260000,208000,0,0,0,0,0,0,0,77156,2795,74361,0,73658,2779,70879,0,70273,2947,67326,0,67100,3400,63700
8072,60000,48000,0,0,0,0,0,1,2,44438,0,44438,2,35619,1539,34080,0,30210,1500,28710,0,1527,1527,0
8073,30000,24000,0,1,1,1,1,0,2,26571,1800,24771,0,28128,2300,25828,0,27548,0,27548,2,29536,2600,26936
8074,20000,16000,0,1,1,1,1,0,2,20346,3208,17138,2,19597,0,19597,2,19086,600,18486,0,16755,453,16302
8075,150000,120000,0,1,1,1,1,0,0,151264,10031,141233,0,146328,4630,141698,0,148012,4918,143094,0,151014,9000,142014
8076,200000,160000,0,0,0,0,0,0,0,16996,1020,15976,0,11461,229,11232,0,8150,183,7967,0,5584,5584,0
8077,500000,400000,0,0,0,0,0,0,-1,26324,27056,-732,-1,26091,26096,-5,-2,9558,9605,-47,-2,4242,4242,0
8078,360000,288000,0,0,0,0,0,0,0,147037,6000,141037,0,146117,4818,141299,0,145884,5000,140884,0,147645,5000,142645
8079,90000,72000,0,1,1,1,1,0,0,85248,0,85248,2,86483,3500,82983,0,87765,3500,84265,0,85855,3500,82355
8080,210000,168000,0,0,0,0,0,1,-2,7846,7846,0,-2,38141,38218,-77,-2,9461,10000,-539,-2,33978,33978,0
8081,130000,104000,0,1,0,0,0,1,0,120976,9000,111976,0,40177,2000,38177,0,41529,2000,39529,0,43734,3000,40734
8082,20000,16000,0,1,1,1,1,0,0,19061,1479,17582,0,20182,1600,18582,0,19982,400,19582,0,19482,0,19482
8083,80000,64000,0,0,0,0,0,1,2,2696,2704,-8,-1,1457,1461,-4,-1,990,993,-3,-1,3356,3366,-10
8084,510000,408000,0,0,0,0,0,0,0,181801,0,181801,2,178179,6508,171671,0,223100,50000,173100,0,216225,7000,209225
8085,50000,40000,0,0,0,0,0,0,0,27954,1500,26454,0,26702,1800,24902,0,26993,1000,25993,0,25758,1200,24558
8086,360000,288000,0,0,0,0,0,0,2,390,0,390,2,3115,3115,0,-1,8069,8069,0,-1,390,390,0
8087,80000,64000,0,0,0,0,0,0,-1,3179,3381,-202,-2,3344,3384,-40,-2,3552,3958,-406,-1,0,0,0
8088,30000,24000,0,0,0,0,0,0,0,13874,1200,12674,0,15304,1630,13674,0,8588,4000,4588,0,4873,1000,3873
8089,50000,40000,0,0,0,0,0,1,0,40697,1400,39297,0,16751,335,16416,0,17093,342,16751,0,13191,4000,9191
8090,260000,208000,0,0,0,0,0,0,-1,2218,2220,-2,-1,4068,4068,0,-1,9829,9829,0,-1,21270,11680,9590
8091,30000,24000,0,0,0,0,0,0,0,14634,2000,12634,0,16378,2000,14378,0,16961,1000,15961,0,19669,3000,16669
8092,360000,288000,0,0,0,0,0,0,-2,7365,7365,0,-2,0,0,0,-2,0,0,0,-2,0,0,0
8093,30000,24000,0,0,0,0,0,0,0,22978,5200,17778,0,23078,3078,20000,0,24994,5000,19994,0,25330,3000,22330
8094,250000,200000,0,0,0,0,0,0,0,150035,7004,143031,0,145876,5414,140462,0,100971,2500,98471,0,50333,1010,49323
8095,470000,376000,0,0,0,0,0,0,0,143646,20745,122901,0,113422,13422,100000,0,96921,6921,90000,0,94405,5645,88760
8096,310000,248000,0,0,0,0,0,0,0,70459,3031,67428,0,72958,10091,62867,0,55547,1429,54118,0,30970,1500,29470
8097,50000,40000,0,0,0,0,0,0,0,0,0,0,-2,0,0,0,-2,0,0,0,-2,0,0,0
8098,110000,88000,0,1,0,0,0,0,0,110436,4108,106328,0,50175,4100,46075,0,50874,3000,47874,0,50730,1900,48830
8099,10000,8000,0,0,0,0,0,1,0,5295,2000,3295,0,5635,3009,2626,0,8735,4000,4735,0,6745,0,6745
8100,220000,176000,0,0,0,0,0,1,-1,8105,8117,-12,-1,2224,0,2224,2,150,150,0,2,1000,1000,0
8101,220000,176000,0,0,0,0,0,0,0,110700,20010,90690,0,58674,2481,56193,0,50247,20000,30247,0,85500,55827,29673
8102,430000,344000,0,0,0,0,0,0,-1,0,0,0,-1,925,925,0,-1,12151,12151,0,-1,39673,29000,10673
8103,500000,400000,0,0,0,0,0,0,-1,4402,4402,0,-1,339,339,0,-1,339,339,0,-1,339,339,0
8104,260000,208000,0,0,0,0,0,0,2,128251,0,128251,2,142480,18000,124480,2,145630,7000,138630,2,150147,7000,143147
8105,50000,40000,0,1,0,0,0,1,0,44013,2000,42013,0,28094,1200,26894,0,29138,1500,27638,0,30625,2000,28625
8106,100000,80000,0,0,0,0,0,0,-1,1440,1440,0,-1,1440,1440,0,-1,1440,1440,0,-1,6059,6059,0
8107,40000,32000,0,0,0,0,0,0,-1,780,780,0,-1,0,0,0,-1,0,0,0,-2,0,0,0
8108,110000,88000,0,0,0,0,0,0,-1,0,0,0,-2,1930,1930,0,-1,-170,0,-170,-1,-170,0,-170
8109,160000,128000,0,0,0,0,0,0,-2,0,0,0,-2,0,0,0,-2,0,0,0,-2,1300,1300,0
8110,320000,256000,0,0,0,0,0,0,0,5127,2000,3127,0,6871,2000,4871,0,7751,1000,6751,0,8623,1000,7623
8111,220000,176000,0,1,1,1,1,0,0,216062,7484,208578,0,209288,7109,202179,0,202578,6969,195609,0,195567,6661,188906
8112,470000,376000,0,0,0,0,0,0,-2,3161,3176,-15,-2,762,766,-4,-2,3637,3673,-36,-2,16847,16906,-59
8113,220000,176000,0,0,0,0,0,1,-2,0,0,0,-2,0,0,0,-2,0,0,0,-2,0,0,0
8114,120000,96000,0,0,0,0,0,1,-1,1117,0,1117,2,425,0,425,0,-267,0,-267,0,1451,2210,-759
8115,50000,40000,0,1,0,0,0,1,3,50071,300,49771,2,8086,300,7786,2,8263,293,7970,2,9533,1400,8133
8116,480000,384000,0,0,0,0,0,0,-2,123988,123988,0,-1,177054,60000,117054,0,273429,100000,173429,0,293157,24250,268907
8117,80000,64000,0,1,1,1,1,0,0,68120,3000,65120,0,70088,3109,66979,0,71345,3000,68345,0,72314,3000,69314
8118,30000,24000,0,0,0,0,0,0,0,22185,1700,20485,0,22551,1000,21551,0,23223,1000,22223,0,24837,2000,22837
8119,50000,40000,0,1,1,1,1,0,0,46755,2501,44254,0,47412,2000,45412,0,47703,2000,45703,0,49495,2500,46995
8120,100000,80000,0,0,0,0,0,0,-1,326,326,0,-1,6198,6198,0,-1,326,326,0,-1,326,326,0
8121,500000,400000,0,0,0,0,0,0,0,12976,13976,-1000,-1,34469,34828,-359,-1,27425,28289,-864,-1,28506,18175,10331
8122,240000,192000,0,0,0,0,0,0,0,189572,7170,182402,0,194799,9000,185799,0,52599,3000,49599,0,51487,3000,48487
8123,90000,72000,1,1,1,0,0,1,0,99522,8500,91022,0,89674,0,89674,2,10874,217,10657,0,0,0,0
8124,80000,64000,0,1,1,1,1,0,0,77329,5000,72329,0,78147,3000,75147,0,79785,3000,76785,0,76766,2501,74265
8125,30000,24000,0,1,1,1,0,0,2,29349,0,29349,2,29400,1000,28400,0,30000,600,29400,0,0,0,0
8126,170000,136000,0,1,1,0,0,1,0,160660,6200,154460,0,163652,10000,153652,0,131396,5100,126296,0,130402,5500,124902
8127,50000,40000,0,1,0,0,0,0,0,47977,1572,46405,0,34783,1700,33083,0,20570,1739,18831,0,20047,0,20047
8128,370000,296000,0,0,0,0,0,0,0,178625,7014,171611,0,164483,6000,158483,0,157497,6000,151497,0,141493,6000,135493
8129,400000,320000,0,0,0,0,0,0,0,52383,3000,49383,0,48139,3000,45139,0,35898,4000,31898,0,30754,3000,27754
8130,50000,40000,0,0,0,0,0,0,-2,0,0,0,-2,0,0,0,-2,0,0,0,-2,0,0,0
8131,130000,104000,0,0,0,0,0,1,0,85327,3096,82231,0,87021,3112,83909,0,88843,3222,85621,0,90618,3250,87368
8132,50000,40000,0,0,0,0,0,0,0,19932,1200,18732,0,19762,30,19732,0,10708,1031,9677,0,20148,20201,-53
8133,260000,208000,0,1,0,0,0,1,0,254767,10617,244150,0,190432,8555,181877,0,105466,4722,100744,0,2312,2146,166
8134,500000,400000,0,0,0,0,0,0,-1,65181,326,64855,2,5466,5494,-28,-1,30177,30328,-151,-1,11602,11658,-56
8135,30000,24000,0,1,0,1,0,1,0,26496,1500,24996,0,25098,1450,23648,0,26209,1500,24709,0,25325,1500,23825
8136,150000,120000,0,0,0,0,0,1,0,0,0,0,-2,0,0,0,-2,0,0,0,-2,0,0,0
8137,290000,232000,0,0,0,0,0,1,-2,4524,4524,0,-1,8440,4000,4440,0,10300,2000,8300,0,0,0,0
8138,280000,224000,0,0,0,0,0,1,-1,153190,5546,147644,0,147589,6007,141582,0,149291,5507,143784,0,151357,6007,145350
8139,80000,64000,0,0,0,0,0,0,-2,5288,5296,-8,-2,1823,1823,0,-2,19879,19884,-5,-2,1974,1974,0
8140,110000,88000,0,0,0,0,0,0,0,82975,6000,76975,2,80446,12,80434,2,80006,3100,76906,0,80421,3200,77221
8141,80000,64000,0,0,0,1,0,0,2,60949,3000,57949,0,71829,15000,56829,0,67567,0,67567,2,62658,3000,59658
8142,180000,144000,0,1,0,0,0,0,0,175233,5299,169934,0,106288,3305,102983,0,28089,5040,23049,0,178719,160719,18000
8143,20000,16000,0,0,0,0,0,1,2,11528,1204,10324,0,13524,2200,11324,0,13508,500,13008,2,13149,0,13149
8144,150000,120000,0,0,0,0,0,1,2,744,3,741,2,5714,5762,-48,-1,809,813,-4,-1,2315,2318,-3
8145,210000,168000,0,0,0,0,0,0,0,142119,5500,136619,0,99699,3600,96099,0,17718,1000,16718,0,150758,135000,15758
8146,500000,400000,0,0,0,0,0,0,0,395522,13173,382349,0,312315,10143,302172,0,265742,7519,258223,0,248866,8866,240000
8147,50000,40000,0,0,1,0,1,0,2,41774,4086,37688,2,40806,0,40806,4,41357,1500,39857,3,41380,1000,40380
8148,200000,160000,0,1,1,1,1,0,0,180416,6546,173870,0,184018,6600,177418,0,188151,7100,181051,0,199766,15000,184766
8149,20000,16000,0,0,0,0,0,0,2,2924,2924,0,-1,1462,0,1462,0,1462,1462,0,-1,6105,6105,0
8150,200000,160000,0,0,0,0,0,0,-1,2500,2500,0,-1,2500,0,2500,2,2500,0,2500,2,2500,0,2500
8151,60000,48000,0,0,0,0,0,0,0,20934,1298,19636,0,20694,1000,19694,0,20175,721,19454,0,19421,811,18610
8152,210000,168000,0,0,0,0,0,0,-1,326,326,0,-1,326,326,0,-1,326,326,0,-1,326,326,0
8153,40000,32000,0,0,0,0,0,1,2,26532,0,26532,2,29089,3000,26089,2,28522,200,28322,2,28914,1000,27914
8154,500000,400000,0,0,0,0,0,0,-2,0,0,0,-2,0,0,0,-2,0,0,0,-2,0,0,0
8155,210000,168000,0,0,0,0,0,0,-1,0,0,0,-1,0,0,0,-2,580,580,0,-1,500,500,0
8156,350000,280000,0,0,0,0,0,1,2,1844,1844,0,-1,1248,0,1248,2,832,0,832,0,416,0,416
8157,130000,104000,0,0,0,0,0,0,0,49874,0,49874,2,52000,5000,47000,0,53590,4000,49590,0,54606,3000,51606
8158,360000,288000,0,0,0,0,0,0,-1,9696,5000,4696,0,14332,8500,5832,0,21446,10000,11446,0,9476,9476,0
8159,260000,208000,0,0,0,0,0,0,-2,1109,1119,-10,-2,1181,1186,-5,-2,-18,18,-36,-2,3791,3809,-18
8160,80000,64000,0,0,0,0,0,0,0,54063,2500,51563,0,54608,2000,52608,0,55695,2500,53195,0,56786,2500,54286
8161,30000,24000,0,1,1,1,1,1,0,29473,3000,26473,0,28719,0,28719,2,29513,2400,27113,2,28890,0,28890
8162,200000,160000,0,1,1,1,1,0,0,206563,9000,197563,0,202896,8000,194896,0,173111,7000,166111,0,170326,7200,163126
8163,20000,16000,0,0,0,1,1,1,0,16020,4000,12020,0,16457,1000,15457,2,20906,4750,16156,2,20289,0,20289
8164,110000,88000,0,0,0,0,0,0,-1,3796,3796,0,-1,0,0,0,-1,0,0,0,-2,0,0,0
8165,140000,112000,0,0,0,0,0,0,0,91744,8000,83744,0,70832,0,70832,2,70768,8000,62768,2,71755,3000,68755
8166,140000,112000,0,0,0,0,0,0,0,36775,1800,34975,0,35877,1300,34577,0,34812,1400,33412,0,33899,1400,32499
8167,80000,64000,0,0,0,0,0,0,0,47160,2026,45134,0,32382,4360,28022,0,8706,2000,6706,0,3876,1000,2876
8168,20000,16000,0,1,1,1,1,0,2,19136,1736,17400,0,20080,1618,18462,0,17366,902,16464,0,17128,1000,16128
8169,200000,160000,0,0,0,0,0,0,0,45574,1756,43818,0,49022,2662,46360,0,47459,1726,45733,0,49666,3000,46666
8170,40000,32000,0,0,1,1,1,0,3,33168,3000,30168,2,33527,1200,32327,2,32854,0,32854,2,33947,1641,32306
8171,140000,112000,0,0,0,0,0,0,0,48943,2200,46743,0,42337,2000,40337,0,35446,1300,34146,0,29383,2000,27383
8172,170000,136000,0,0,0,0,0,0,-1,3406,2703,703,0,1703,0,1703,0,495,495,0,-1,6616,6616,0
8173,200000,160000,0,0,0,0,0,0,0,1443,1443,0,-2,1443,1443,0,-2,1443,1443,0,-2,871,871,0
8174,230000,184000,0,0,0,0,0,0,-2,856,856,0,-2,6147,6147,0,-2,7387,7387,0,-2,13492,13492,0
8175,220000,176000,0,0,0,0,0,0,-2,24621,10040,14581,-2,17125,1000,16125,-2,18378,1253,17125,-2,1344,1350,-6
8176,80000,64000,0,0,0,0,0,0,-2,0,0,0,-2,0,0,0,-2,0,0,0,-2,0,0,0
8177,130000,104000,0,0,0,0,0,0,0,56566,2650,53916,0,57139,2100,55039,0,58300,2100,56200,0,59523,2150,57373
8178,30000,24000,1,1,1,1,1,0,0,32218,1537,30681,0,31963,1755,30208,0,30942,1207,29735,0,29945,1076,28869
8179,50000,40000,0,1,1,0,0,1,2,43781,0,43781,2,45021,2554,42467,2,28660,0,28660,2,27807,1800,26007
8180,130000,104000,0,0,0,0,0,1,-2,0,200,-200,-2,2115,2115,0,-2,0,0,0,-2,0,0,0
8181,380000,304000,0,0,0,0,0,0,-2,360,360,0,-2,720,720,0,-2,360,0,360,-2,360,360,0
8182,150000,120000,0,0,0,0,0,0,-2,-19,0,-19,-2,-19,0,-19,-2,7962,7981,-19,-2,0,0,0
8183,50000,40000,0,0,0,0,0,0,0,8108,2001,6107,0,7358,2000,5358,0,3098,0,3098,0,0,0,0
8184,90000,72000,0,0,0,0,0,0,0,14747,1240,13507,0,4753,1220,3533,0,5152,1000,4152,0,4664,500,4164
8185,220000,176000,0,0,0,0,0,0,-2,36010,36204,-194,-2,1050,1055,-5,-2,9522,9569,-47,-2,2340,6995,-4655
8186,70000,56000,0,0,0,0,0,0,0,32669,1630,31039,0,31429,890,30539,0,31749,1300,30449,0,21385,762,20623
8187,180000,144000,0,0,0,0,0,0,-1,2579,2583,-4,-1,326,326,0,-1,1005,1005,0,-1,625,625,0
8188,150000,120000,0,0,0,0,0,0,-1,0,0,0,-1,580,580,0,-1,780,200,580,0,0,0,0
8189,20000,16000,0,0,1,1,1,0,0,16457,1000,15457,2,20906,4750,16156,2,20289,0,20289,3,20407,600,19807
8190,260000,208000,0,0,0,0,0,1,0,15018,5000,10018,0,15520,5000,10520,0,3491,3491,0,-1,5651,3000,2651
8191,200000,160000,0,0,0,0,0,0,-1,5961,5961,0,-1,1829,1829,0,-1,1652,1652,0,-1,584,584,0
8192,20000,16000,0,0,0,0,0,0,-2,2310,3637,-1327,-2,973,973,0,-2,406,406,0,-2,1317,2228,-911
8193,10000,8000,0,0,1,1,1,0,-1,8327,8327,0,-1,9379,1200,8179,0,9566,342,9224,0,9766,354,9412
8194,300000,240000,0,0,0,0,0,1,-2,0,0,0,-2,0,0,0,-2,0,0,0,-2,0,0,0
8195,50000,40000,0,1,1,1,1,0,0,49366,2150,47216,0,49221,2200,47021,0,48848,2000,46848,0,47545,2000,45545
8196,130000,104000,0,0,0,0,0,0,-2,-915,0,-915,-2,-915,0,-915,-2,-915,0,-915,-2,-1070,0,-1070
8197,50000,40000,0,0,0,0,0,1,0,18356,2400,15956,0,18181,420,17761,2,18285,600,17685,2,10220,600,9620
8198,500000,400000,0,0,0,0,0,0,0,26463,1543,24920,0,23503,1215,22288,0,23918,3717,20201,0,23937,14014,9923
8199,80000,64000,0,0,0,0,0,0,0,22638,4238,18400,0,18805,5051,13754,0,6058,3118,2940,0,0,0,0
8200,190000,152000,0,0,0,0,0,1,2,72413,2600,69813,2,73366,2600,70766,2,74830,2650,72180,2,76237,2650,73587
8201,110000,88000,0,0,0,0,0,1,0,39457,2005,37452,0,39075,2006,37069,0,39307,3006,36301,0,39564,3010,36554
8202,50000,40000,0,0,0,0,0,0,-2,0,0,0,-2,0,0,0,-2,0,0,0,-2,0,0,0
8203,20000,16000,0,0,0,0,0,1,-2,0,0,0,-2,0,0,0,-2,0,0,0,-2,1273,1273,0
8204,600000,480000,0,0,0,0,0,0,2,464983,15287,449696,0,416550,14069,402481,0,416545,15013,401532,0,420232,15003,405229
8205,280000,224000,0,0,0,0,0,0,2,0,0,0,2,430,430,0,-1,430,0,430,0,-550,550,-1100
8206,20000,16000,1,1,1,1,1,0,0,22251,1300,20951,0,18040,1284,16756,0,18402,646,17756,0,19118,1000,18118
8207,10000,8000,0,0,1,1,1,0,0,9002,1298,7704,0,9182,478,8704,0,9729,847,8882,0,9411,0,9411
8208,260000,208000,0,0,0,0,0,0,0,130539,5300,125239,0,112300,4303,107997,0,105517,3600,101917,0,108011,4000,104011
8209,20000,16000,0,0,0,0,0,0,0,11613,0,11613,2,10750,237,10513,0,10606,242,10364,0,7263,163,7100
8210,220000,176000,0,0,0,0,0,0,0,150748,0,150748,2,154481,8000,146481,0,156487,7000,149487,0,154870,6500,148370
8211,30000,24000,0,0,0,0,0,1,0,18621,2088,16533,0,19017,1000,18017,2,18571,0,18571,2,19264,1001,18263
8212,50000,40000,0,1,0,0,0,0,0,43670,1978,41692,0,16643,1144,15499,0,10021,341,9680,0,9833,345,9488
8213,200000,160000,0,0,0,0,0,0,0,73220,4000,69220,0,74419,3000,71419,0,76078,3000,73078,0,77822,3000,74822
8214,40000,32000,0,1,1,1,1,1,0,40311,4300,36011,0,39380,2000,37380,0,41389,2938,38451,0,40628,0,40628
8215,160000,128000,0,1,0,0,0,0,0,138767,10000,128767,0,131237,10000,121237,0,76104,5000,71104,0,56237,3000,53237
8216,420000,336000,0,0,0,0,0,0,-2,106030,107382,-1352,-2,33694,33850,-156,-2,49354,49587,-233,-2,44744,47222,-2478
8217,140000,112000,0,0,0,0,0,0,2,63445,3000,60445,0,63729,2000,61729,0,63751,2000,61751,0,65421,2000,63421
8218,500000,400000,0,0,0,0,0,0,-1,6783,6802,-19,-1,11507,11523,-16,-1,4883,14,4869,0,5897,5914,-17
8219,120000,96000,0,0,0,0,0,0,0,94242,4251,89991,0,88828,6000,82828,0,97643,10000,87643,0,79371,3019,76352
8220,240000,192000,0,0,0,0,0,1,-1,297,297,0,-1,0,0,0,-1,0,0,0,-2,0,0,0
8221,70000,56000,0,1,1,1,1,0,0,70352,2667,67685,0,69936,2321,67615,0,68118,2391,65727,0,65942,2316,63626
8222,40000,32000,0,0,0,0,0,0,-1,18583,18583,0,-1,19353,1460,17893,0,19440,547,18893,0,20279,1000,19279
8223,80000,64000,0,0,0,0,0,0,0,53200,1874,51326,0,29707,2000,27707,0,28427,1000,27427,0,10072,1000,9072
8224,310000,248000,0,0,0,0,0,0,-2,342,344,-2,-2,41726,41884,-158,-1,15051,5025,10026,0,8663,40,8623
8225,120000,96000,0,0,0,0,0,1,-2,0,0,0,-2,0,0,0,-2,0,0,0,-2,0,0,0
8226,80000,64000,0,1,0,0,0,0,0,77468,3574,73894,0,60167,2300,57867,0,57474,2300,55174,0,58815,2300,56515
8227,20000,16000,0,0,0,0,0,0,0,5813,1300,4513,0,7052,1500,5552,0,7779,1000,6779,0,8495,1000,7495
8228,140000,112000,0,1,1,1,1,0,0,137950,6600,131350,0,140254,6500,133754,0,139679,5100,134579,0,141748,5300,136448
8229,160000,128000,0,1,1,0,0,1,2,159094,7342,151752,0,132809,3675,129134,0,100693,2910,97783,0,97181,3904,93277
8230,180000,144000,0,0,0,0,0,0,0,119946,4971,114975,0,114977,4750,110227,0,88757,2997,85760,0,84936,3133,81803
8231,400000,320000,0,0,0,0,0,0,-1,4465,4465,0,-1,14272,14272,0,-1,1965,1965,0,-1,958,958,0
8232,50000,40000,0,0,0,0,0,0,0,27382,1500,25882,0,28081,1153,26928,0,28578,1100,27478,0,29450,1346,28104
8233,50000,40000,0,0,1,1,0,0,0,50639,16216,34423,0,53052,8734,44318,0,47335,1018,46317,0,32489,9421,23068
8234,280000,224000,0,0,0,0,0,0,0,244092,101585,142507,0,210226,90762,119464,0,177595,50119,127476,0,153181,282,152899
8235,240000,192000,0,0,0,0,0,1,2,836,836,0,-1,2508,2508,0,-1,1672,0,1672,0,836,0,836
8236,180000,144000,0,0,0,0,0,0,0,127636,12000,115636,0,138164,20000,118164,0,142921,10000,132921,0,153691,20000,133691
8237,480000,384000,0,0,0,0,0,0,-1,4279,5096,-817,-2,24973,25173,-200,-1,76738,25896,50842,-1,25108,25108,0
8238,160000,128000,0,0,0,0,0,0,0,25418,2000,23418,0,28196,3000,25196,0,29961,2000,27961,0,49404,20000,29404
8239,70000,56000,0,0,0,0,0,0,0,22066,3000,19066,0,23515,2000,21515,0,10990,3000,7990,0,0,0,0
8240,50000,40000,0,1,1,1,1,0,0,50375,2000,48375,0,46952,2000,44952,0,50343,5001,45342,0,48831,5000,43831
8241,280000,224000,0,0,0,0,0,0,0,210226,90762,119464,0,177595,50119,127476,0,153181,282,152899,2,145852,50436,95416
8242,10000,8000,0,1,1,1,1,0,2,9289,0,9289,2,10140,1008,9132,2,10417,584,9833,2,10104,0,10104
8243,20000,16000,0,1,1,1,0,0,0,19078,1478,17600,0,19800,1200,18600,0,20000,400,19600,0,0,0,0
8244,30000,24000,0,0,0,0,0,0,0,0,0,0,0,1473,1473,0,-1,780,780,0,-1,0,0,0
8245,350000,280000,0,0,0,0,0,0,-2,7763,7813,-50,-2,20573,20604,-31,-2,2367,2376,-9,-2,11486,11493,-7
8246,210000,168000,0,0,0,0,0,0,0,153238,5510,147728,0,156384,5500,150884,0,160056,6000,154056,0,163188,6000,157188
8247,200000,160000,0,0,0,0,0,1,-2,0,0,0,-2,0,0,0,-2,0,0,0,-2,0,0,0
8248,120000,96000,0,0,0,0,0,0,0,5192,1261,3931,0,380,300,80,0,441,441,0,-1,425,425,0
8249,320000,256000,0,0,0,0,0,1,2,0,0,0,-2,0,0,0,-2,0,0,0,-2,0,0,0
8250,110000,88000,0,0,0,0,0,0,0,12973,2000,10973,0,12468,0,12468,2,13763,1500,12263,2,13989,600,13389
8251,240000,192000,0,0,0,0,0,0,-1,11680,11680,0,-1,4060,0,4060,0,17903,17964,-61,-1,15961,61,15900
8252,200000,160000,1,1,1,1,1,0,0,282023,12003,270020,0,286199,11010,275189,0,265201,15000,250201,0,271381,10004,261377
8253,360000,288000,0,0,0,0,0,0,-1,-8,0,-8,-1,32170,32178,-8,-1,680,680,0,-1,6205,6205,0
8254,50000,40000,0,1,1,0,0,0,2,50292,4800,45492,2,48532,0,48532,2,27308,1200,26108,0,27539,1200,26339
8255,130000,104000,0,0,0,0,0,0,0,16172,1808,14364,0,16898,7014,9884,0,11236,27,11209,0,6944,7011,-67
8256,170000,136000,0,0,0,0,0,0,-1,7332,7332,0,-1,2716,2716,0,-1,4200,4200,0,-1,7708,7708,0
8257,80000,64000,0,1,1,1,1,1,0,67325,2404,64921,0,68652,3000,65652,0,70388,2800,67588,0,76743,7700,69043
8258,60000,48000,0,1,0,0,0,0,0,52413,2219,50194,0,44436,1727,42709,0,28098,1120,26978,0,26749,1500,25249
8259,20000,16000,0,0,0,0,0,1,0,12145,1000,11145,2,12648,1000,11648,2,13438,1000,12438,0,14222,1000,13222
8260,460000,368000,0,0,0,0,0,0,-1,0,0,0,-1,880,880,0,-1,1018,1018,0,-1,99,99,0
8261,300000,240000,0,0,0,0,0,0,-2,1970,1979,-9,-2,1687,1695,-8,-2,248,249,-1,-2,600,600,0
8262,310000,248000,0,0,0,0,0,0,0,39805,1620,38185,0,36823,1332,35491,0,38987,2772,36215,0,32304,1500,30804
8263,180000,144000,0,0,0,0,0,0,0,15404,1500,13904,0,19885,4911,14974,0,22355,10355,12000,0,22902,10902,12000
8264,200000,160000,0,0,0,0,0,0,-2,0,0,0,-2,0,0,0,-2,0,0,0,-2,5659,5659,0
8265,150000,120000,0,0,0,0,0,0,-2,0,0,0,-2,0,0,0,-2,0,0,0,-2,0,0,0
8266,360000,288000,0,0,0,0,0,1,-2,0,0,0,-2,0,0,0,-2,0,0,0,-2,0,0,0
8267,50000,40000,0,0,0,0,1,0,0,9145,1189,7956,0,12423,3467,8956,0,41956,30000,11956,0,45112,4000,41112
8268,20000,16000,0,0,0,0,0,0,2,1170,1170,0,-1,780,0,780,0,390,0,390,0,0,0,0
8269,190000,152000,0,0,0,0,0,1,0,100526,7700,92826,0,94909,0,94909,2,94804,3545,91259,0,94007,3386,90621
8270,160000,128000,0,1,0,0,0,0,0,136572,3358,133214,2,95115,0,95115,2,96847,3200,93647,0,101443,8000,93443
8271,200000,160000,0,0,0,0,0,1,-2,0,0,0,-2,0,0,0,-2,0,0,0,-2,0,0,0
8272,130000,104000,0,1,1,1,1,1,2,109965,5400,104565,2,110797,4100,106697,2,107529,0,107529,2,114104,8500,105604
8273,110000,88000,0,0,0,0,0,0,0,83734,4088,79646,0,82532,3677,78855,0,81032,5400,75632,0,79835,0,79835
8274,270000,216000,0,0,0,0,0,0,0,33846,33894,-48,-1,42278,42399,-121,-1,36841,36841,0,-1,57844,57844,0
8275,100000,80000,0,0,0,0,0,1,2,65747,3100,62647,0,67046,3000,64046,0,69938,4000,65938,0,74800,6000,68800
8276,50000,40000,0,0,0,0,0,0,2,32007,3000,29007,0,34474,3000,31474,0,37905,4000,33905,0,38131,1000,37131
8277,90000,72000,0,1,0,0,0,0,0,87396,3503,83893,0,67761,2420,65341,0,65602,2400,63202,0,65902,2400,63502
8278,140000,112000,0,0,0,0,0,0,0,26276,12000,14276,0,26847,915,25932,0,21713,788,20925,0,22143,791,21352
8279,420000,336000,0,0,0,0,0,0,2,3392,1000,2392,0,4392,1000,3392,0,-796,0,-796,0,-796,0,-796
8280,170000,136000,0,0,0,0,0,0,-2,0,0,0,-2,1012,1012,0,-2,0,0,0,-2,0,0,0
8281,150000,120000,1,1,1,0,1,0,0,168741,8069,160672,0,170544,6708,163836,0,146787,40502,106285,0,149759,5706,144053
8282,200000,160000,0,0,0,0,0,0,-1,13207,1005,12202,0,8738,185,8553,0,6471,6482,-11,-1,2723,2731,-8
8283,20000,16000,0,1,1,1,1,0,2,18067,1800,16267,0,18917,1600,17317,0,18717,400,18317,0,17144,0,17144
8284,350000,280000,0,0,0,0,0,0,-2,5568,5596,-28,-2,9571,9632,-61,-2,6370,6402,-32,-2,9674,9722,-48
8285,50000,40000,0,0,0,0,0,0,0,28637,1487,27150,0,38137,21704,16433,0,27128,3000,24128,0,29992,15000,14992
8286,210000,168000,0,0,0,0,0,1,-1,497,497,0,-1,15433,15436,-3,-1,8500,170,8330,0,10500,2000,8500
8287,260000,208000,0,0,0,0,0,0,-2,693,703,-10,-2,1557,1564,-7,-2,685,688,-3,-2,11625,11683,-58
8288,80000,64000,0,0,0,0,0,0,-1,2281,2281,0,-1,1356,0,1356,2,355,0,355,2,-520,0,-520
8289,290000,232000,0,0,0,0,0,1,0,118163,4200,113963,0,110728,4938,105790,0,106426,10000,96426,0,15300,2420,12880
8290,50000,40000,0,0,0,0,1,1,0,27835,1800,26035,0,29070,2000,27070,0,30891,2600,28291,0,54741,0,54741
8291,100000,80000,0,0,0,0,0,1,0,21644,3000,18644,0,9209,0,9209,2,6495,6000,495,2,78080,80900,-2820
8292,100000,80000,0,0,0,0,0,0,0,56267,1353,54914,0,11788,1739,10049,0,11400,0,11400,2,11419,1000,10419
8293,140000,112000,0,1,0,0,0,1,0,134000,4200,129800,0,74388,3105,71283,0,92555,86417,6138,0,86993,3936,83057
8294,50000,40000,0,0,0,0,0,0,0,0,0,0,0,4249,4249,0,-1,4865,2065,2800,0,2157,2157,0
8295,300000,240000,0,0,0,0,0,0,-2,19333,19333,0,-2,19333,19333,0,-2,20333,20333,0,-2,20333,20333,0
8296,50000,40000,0,0,0,0,0,0,0,21103,2300,18803,0,20101,0,20101,2,20402,1000,19402,0,20132,2000,18132
8297,20000,16000,0,1,0,0,0,1,0,19621,0,19621,2,14051,281,13770,0,0,0,0,0,0,0,0
8298,140000,112000,0,0,0,0,0,1,2,73305,0,73305,2,78454,7000,71454,2,79571,3000,76571,2,78176,0,78176
8299,230000,184000,0,1,1,0,0,0,0,213682,10000,203682,0,219016,10000,209016,0,172407,10000,162407,0,163690,10000,153690
8300,50000,40000,0,0,0,0,0,1,0,0,0,0,0,0,0,0,-2,0,0,0,-2,0,0,0
8301,180000,144000,0,0,0,0,0,0,0,83338,4000,79338,0,90031,8000,82031,0,93692,5000,88692,0,96100,4000,92100
8302,200000,160000,0,0,0,0,0,0,-1,-201,0,-201,-2,-201,0,-201,-2,-201,0,-201,-2,-201,0,-201
8303,160000,128000,0,0,0,0,0,0,-1,15877,4055,11822,0,12311,6000,6311,0,16270,7000,9270,0,7922,3000,4922
8304,90000,72000,0,0,0,0,0,0,0,35387,1549,33838,0,36838,2000,34838,0,35867,2000,33867,0,36841,2000,34841
8305,80000,64000,0,0,0,1,0,1,2,38318,0,38318,2,42614,5000,37614,0,86966,1500,85466,0,41950,1500,40450
8306,30000,24000,0,1,1,0,0,1,0,27779,1500,26279,0,28340,959,27381,0,0,0,0,0,0,0,0
8307,100000,80000,0,1,1,1,1,0,2,95189,4300,90889,2,96332,3600,92732,2,97560,3700,93860,2,95885,0,95885
8308,220000,176000,0,0,0,0,0,0,0,131810,5042,126768,0,118866,3687,115179,0,115256,3660,111596,0,97161,3528,93633
8309,360000,288000,0,0,0,0,0,0,-1,840,864,-24,-1,68110,124037,-55927,-1,55905,1679,54226,0,42239,1163,41076
8310,50000,40000,0,0,0,0,0,0,0,21241,1400,19841,0,21788,900,20888,0,23281,2000,21281,0,22756,0,22756
8311,40000,32000,0,0,0,0,0,1,2,25635,0,25635,2,28100,2900,25200,2,27352,0,27352,2,27862,1100,26762
8312,180000,144000,0,1,0,0,0,0,0,177694,7000,170694,0,127051,5000,122051,0,128562,5000,123562,0,129128,10000,119128
8313,20000,16000,0,0,0,0,0,0,0,-10,0,-10,0,-10,0,-10,-2,-10,0,-10,-2,3990,4000,-10
8314,170000,136000,0,0,0,0,0,0,0,20245,8245,12000,0,15429,5429,10000,0,16594,4500,12094,0,14035,5415,8620
8315,300000,240000,0,1,1,0,0,0,0,263571,9000,254571,0,252197,8000,244197,0,226555,7000,219555,0,206642,7500,199142
8316,360000,288000,0,0,0,0,0,0,-1,863,1000,-137,-1,390,1000,-610,-1,390,390,0,-1,3540,3540,0
8317,200000,160000,0,0,0,0,0,0,-1,38526,42497,-3971,-1,-93,0,-93,-1,18681,18774,-93,-1,12399,12461,-62
8318,180000,144000,0,0,0,0,0,0,-2,182,182,0,-2,0,0,0,-2,0,0,0,-2,0,0,0
8319,290000,232000,0,0,0,0,0,0,-1,264,264,0,-1,264,264,0,-1,264,264,0,-1,264,264,0
8320,500000,400000,0,0,0,0,0,0,-1,4730,4730,0,-1,4628,4628,0,-1,5127,5127,0,-1,3400,3400,0
8321,140000,112000,0,0,1,0,0,0,-1,136239,143200,-6961,-1,137748,5200,132548,0,81195,2352,78843,0,47338,2000,45338
8322,180000,144000,0,0,0,0,0,0,0,86893,4000,82893,0,89014,4000,85014,0,91946,10000,81946,0,93237,3200,90037
8323,200000,160000,0,0,0,0,0,0,-2,8457,8457,0,-2,48757,48757,0,-2,4200,4200,0,-2,7312,7312,0
8324,150000,120000,0,0,0,0,0,0,2,10633,1175,9458,0,10649,1135,9514,0,10570,1000,9570,0,10481,1000,9481
8325,30000,24000,0,1,1,1,0,0,3,28920,0,28920,2,29887,1900,27987,2,29525,15,29510,2,25006,1030,23976
8326,360000,288000,0,0,0,0,0,0,-2,0,0,0,-2,0,0,0,-2,0,0,0,-2,0,0,0
8327,170000,136000,0,0,0,0,0,1,-1,6953,6953,0,-1,16157,10000,6157,0,28856,15000,13856,0,4941,4941,0
8328,60000,48000,1,1,1,1,1,1,2,60745,0,60745,2,58828,4580,54248,2,55606,0,55606,2,58551,4727,53824
8329,290000,232000,0,0,0,0,0,0,0,148949,6000,142949,0,141711,5000,136711,0,122755,10000,112755,0,216138,100000,116138
8330,150000,120000,0,0,0,0,0,0,0,25304,1715,23589,0,21894,1200,20694,0,18452,625,17827,0,28191,10000,18191
8331,90000,72000,0,0,0,0,0,0,0,26406,1500,24906,0,24364,1508,22856,0,19726,1000,18726,0,19166,1000,18166
8332,160000,128000,0,1,1,1,1,0,0,150548,7000,143548,0,152170,5600,146570,0,155476,5900,149576,0,165902,13200,152702
8333,200000,160000,0,0,0,0,0,0,-1,0,0,0,-1,0,0,0,-2,561,561,0,-2,3854,3878,-24
8334,30000,24000,0,0,0,0,0,0,-1,6323,6485,-162,-1,2870,2870,0,-1,1485,1485,0,-1,3926,3926,0
8335,50000,40000,0,0,0,0,0,1,0,29695,3000,26695,0,30908,2000,28908,2,30112,0,30112,2,32123,2500,29623
8336,120000,96000,0,1,1,0,0,0,0,116574,6000,110574,0,117041,5000,112041,0,50980,5000,45980,0,51285,58895,-7610
8337,100000,80000,0,0,0,0,0,0,0,63848,3000,60848,0,64692,2500,62192,0,66114,2500,63614,0,67396,2500,64896
8338,20000,16000,0,0,0,0,0,0,-2,0,0,0,-2,0,0,0,-2,0,0,0,-2,0,0,0
8339,180000,144000,0,0,0,0,0,0,-1,2145,3212,-1067,-1,12532,12532,0,-1,655,655,0,-1,390,157,233
8340,50000,40000,0,0,0,0,0,0,0,10982,3000,7982,0,10243,1000,9243,2,10826,1000,9826,0,11699,1000,10699
8341,490000,392000,0,0,0,0,0,0,-1,2803,2803,0,-1,6027,6027,0,-1,10722,10722,0,-1,8452,6000,2452
8342,200000,160000,0,0,0,0,0,1,2,110,110,0,-1,11946,11946,0,-1,32836,21000,11836,0,110,110,0
8343,80000,64000,0,0,0,0,0,0,0,55900,2606,53294,0,55622,2200,53422,0,56295,2100,54195,0,61598,6679,54919
8344,20000,16000,0,0,0,0,0,1,2,14475,1000,13475,2,14936,1000,13936,2,15688,1000,14688,0,16435,1000,15435
8345,140000,112000,0,0,0,0,0,1,2,93890,4000,89890,2,91013,0,91013,2,91535,3000,88535,0,93065,7893,85172
8346,20000,16000,0,0,0,0,0,0,0,14953,1275,13678,0,14710,2704,12006,0,900,3200,-2300,-1,0,0,0
8347,190000,152000,0,0,0,0,1,0,0,104430,5000,99430,0,93,93,0,0,158481,159212,-731,-1,161866,5800,156066
8348,100000,80000,0,1,1,1,1,1,2,99542,4700,94842,2,99898,2950,96948,2,99786,3100,96686,2,97670,5,97665
8349,150000,120000,0,0,0,0,0,0,-2,0,0,0,-2,0,0,0,-2,0,0,0,-2,0,0,0
8350,50000,40000,0,0,0,0,0,0,0,8347,3000,5347,0,12321,7508,4813,0,6294,1000,5294,0,3333,1000,2333
8351,150000,120000,0,0,0,0,0,0,0,99655,10000,89655,0,100000,2000,98000,0,0,0,0,0,0,0,0
8352,180000,144000,0,0,0,0,0,0,0,115445,4200,111245,0,112938,4000,108938,0,109306,3789,105517,0,104106,3959,100147
8353,60000,48000,0,0,0,0,0,0,0,39803,1966,37837,0,40837,2000,38837,0,41783,1600,40183,0,42689,1600,41089
8354,200000,160000,0,0,0,0,0,0,-2,0,0,0,-2,2907,2907,0,-1,2400,2400,0,-1,945,945,0
8355,260000,208000,0,1,1,1,1,0,0,258390,10004,248386,0,256252,10000,246252,0,250390,10000,240390,0,251336,10000,241336
8356,300000,240000,0,0,0,0,0,0,0,49831,5000,44831,0,51818,5000,46818,0,50244,5000,45244,0,49484,5000,44484
8357,500000,400000,0,0,0,0,0,1,-2,0,0,0,-2,0,0,0,-2,0,0,0,-2,0,0,0
8358,380000,304000,0,0,0,0,0,0,0,35199,5044,30155,0,31136,5036,26100,0,28839,5081,23758,0,14584,2022,12562
8359,210000,168000,0,0,0,0,0,0,-1,0,0,0,-1,0,0,0,-2,1858,1858,0,-1,45,45,0
8360,180000,144000,0,0,0,0,0,0,-2,2250,2250,0,-2,899,899,0,-2,0,0,0,-2,1375,1375,0
8361,50000,40000,0,0,1,1,1,0,-1,44804,10443,34361,-1,44800,2001,42799,2,43576,1,43575,2,44315,2001,42314
8362,130000,104000,0,0,0,0,0,0,0,18776,1500,17276,0,20858,2400,18458,0,20225,0,20225,2,21396,1500,19896
8363,50000,40000,0,0,0,0,0,0,0,21780,1402,20378,0,22722,1344,21378,0,21907,1002,20905,0,2917,58,2859
8364,110000,88000,0,0,0,0,0,0,0,34419,2000,32419,0,36829,3000,33829,0,38080,2000,36080,0,40434,3000,37434
8365,360000,288000,0,0,0,0,0,0,-1,3969,3969,0,-1,6657,6657,0,-1,642,642,0,-1,6204,6204,0
8366,50000,40000,0,0,0,0,0,0,0,21933,0,21933,2,16137,1500,14637,0,16030,3000,13030,0,15373,5000,10373
8367,280000,224000,0,1,1,0,0,0,-1,253682,13000,240682,0,260274,11000,249274,0,153516,8000,145516,0,156830,5866,150964
8368,60000,48000,0,0,0,0,0,0,-1,430,430,0,-2,717,717,0,-2,430,430,0,-2,4171,4171,0
8369,200000,160000,0,0,0,0,0,0,0,124413,11518,112895,0,118419,0,118419,2,121047,4600,116447,0,123719,4800,118919
8370,80000,64000,0,1,1,0,0,0,0,77790,3013,74777,0,80528,4000,76528,0,23567,2000,21567,0,25171,2000,23171
8371,360000,288000,0,0,0,0,0,0,0,0,0,0,-2,1672,1672,0,-1,0,0,0,-1,986,986,0
8372,280000,224000,0,0,0,0,0,0,0,132165,6256,125909,0,133948,6275,127673,0,133070,5012,128058,0,135089,5363,129726
8373,50000,40000,0,0,0,0,0,0,0,34435,416,34019,2,30859,3000,27859,0,27429,3000,24429,0,24222,3000,21222
8374,120000,96000,0,0,0,0,0,0,-1,1113,1113,0,-1,390,390,0,-1,390,390,0,-1,14613,14613,0
8375,130000,104000,0,0,1,0,0,0,0,132260,103012,29248,0,127335,3965,123370,0,51104,3508,47596,0,50536,3011,47525
8376,90000,72000,0,0,0,0,0,0,-2,-295,0,-295,-2,-295,0,-295,-2,-295,1,-296,-2,9727,10022,-295
8377,300000,240000,0,0,0,0,0,0,-1,685,687,-2,-1,1144,1144,0,-1,0,0,0,-2,67,67,0
8378,100000,80000,0,0,0,0,0,0,0,23837,1829,22008,0,24166,1554,22612,0,24216,1000,23216,0,24901,1000,23901
8379,130000,104000,0,0,0,0,0,0,0,72,72,0,-1,10458,10458,0,-1,10149,0,10149,2,11805,2000,9805
8380,60000,48000,0,0,0,0,0,0,0,11335,10341,994,0,9341,0,9341,0,6451,0,6451,0,3592,3592,0
8381,20000,16000,0,0,0,0,0,0,-1,1164,1164,0,-1,1523,1523,0,-1,1228,1228,0,-1,500,500,0
8382,110000,88000,0,0,0,0,0,0,-1,0,0,0,-2,0,0,0,-2,0,0,0,-2,0,0,0
8383,360000,288000,0,0,0,0,0,0,0,96679,25006,71673,0,79703,20200,59503,0,71682,40000,31682,0,24230,0,24230
8384,500000,400000,0,0,0,0,0,0,0,5574,5584,-10,-1,10403,6348,4055,0,2293,46,2247,0,2702,2702,0
8385,210000,168000,0,0,0,0,0,1,-1,19631,19631,0,-1,23906,23906,0,-1,373,0,373,0,3073,3073,0
8386,10000,8000,0,0,0,0,0,1,0,2917,1000,1917,0,1473,29,1444,0,390,390,0,-1,1320,1320,0
8387,80000,64000,0,0,0,0,0,1,2,55327,4327,51000,2,56804,3000,53804,2,57469,2200,55269,2,58505,2100,56405
8388,70000,56000,0,0,0,0,0,0,0,33798,1500,32298,0,25993,2000,23993,0,26263,1000,25263,0,26812,972,25840
8389,140000,112000,0,0,0,0,0,0,0,16923,2001,14922,0,12103,401,11702,0,11519,1000,10519,0,11611,1000,10611
8390,70000,56000,1,1,1,1,1,0,0,96815,3990,92825,0,90968,2700,88268,0,86011,2300,83711,0,81276,2300,78976
8391,30000,24000,1,1,1,1,1,1,0,38049,1700,36349,2,35435,1100,34335,2,31976,0,31976,2,29704,1030,28674
8392,50000,40000,0,0,0,0,0,1,-2,-2587,0,-2587,-2,-2587,0,-2587,-2,-2587,0,-2587,-2,-2587,0,-2587
8393,360000,288000,0,0,0,0,0,0,-1,11357,2000,9357,0,12123,1000,11123,0,9743,0,9743,0,9567,0,9567
8394,300000,240000,0,0,0,0,0,0,-1,0,0,0,-2,0,0,0,-2,0,0,0,-2,0,0,0
8395,340000,272000,0,0,0,0,0,0,-1,34402,1215471,-1181069,-1,205931,889043,-683112,-1,265431,621000,-355569,-1,270237,20000,250237
8396,220000,176000,0,0,0,0,0,0,0,147558,7000,140558,0,102365,3500,98865,0,63842,1500,62342,0,43252,2000,41252
8397,250000,200000,0,0,0,0,0,0,0,13600,13600,0,-1,3274,3274,0,-1,2446,0,2446,0,26710,26710,0
8398,50000,40000,0,0,0,0,0,0,2,4613,0,4613,2,5378,1000,4378,0,5848,557,5291,0,5606,0,5606
8399,220000,176000,0,0,0,0,0,1,-1,3352,3352,0,-1,3352,3352,0,-1,3352,3352,0,-1,3352,3352,0
8400,210000,168000,0,0,0,0,0,0,-2,0,0,0,-2,0,0,0,-2,0,0,0,-2,0,0,0
8401,50000,40000,0,0,0,0,0,0,0,836,836,0,-1,836,836,0,-1,836,836,0,-1,3300,3300,0
8402,210000,168000,0,1,1,0,0,1,0,193598,0,193598,2,178416,7193,171223,0,143879,3500,140379,0,125004,4881,120123
8403,90000,72000,0,0,0,0,0,0,0,10360,3000,7360,0,0,0,0,0,0,0,0,-2,0,0,0
8404,50000,40000,0,0,0,0,0,0,0,16657,2500,14157,0,17863,1518,16345,0,16811,1000,15811,0,16802,2000,14802
8405,50000,40000,0,0,0,0,0,0,-1,25967,25000,967,0,17227,754,16473,0,15714,600,15114,0,15876,800,15076
8406,70000,56000,0,0,0,0,0,0,0,31941,3000,28941,0,35087,4000,31087,0,34226,0,34226,2,35514,2000,33514
8407,360000,288000,0,0,0,0,0,0,-2,2037,2043,-6,-2,989,992,-3,-2,2885,2903,-18,-2,989,992,-3
8408,210000,168000,0,0,0,0,0,0,-1,3655,3626,29,0,0,0,0,0,41257,41257,0,-1,35432,709,34723
8409,50000,40000,0,0,0,0,0,0,2,27168,1400,25768,0,27585,1200,26385,0,27910,1500,26410,0,27380,1000,26380
8410,150000,120000,0,0,0,0,0,0,0,67443,4000,63443,0,68720,3000,65720,0,70572,3000,67572,0,72275,3000,69275
8411,260000,208000,0,0,0,0,0,0,0,127074,6500,120574,0,14,0,14,0,124493,124479,14,0,128463,6000,122463
8412,30000,24000,0,0,0,0,0,1,-1,14904,3000,11904,-1,14340,0,14340,2,15131,1000,14131,0,16909,2000,14909
8413,220000,176000,1,1,1,1,1,0,2,228368,0,228368,2,224414,10000,214414,0,196229,7200,189029,0,190050,7001,183049
8414,100000,80000,0,0,0,0,0,0,0,6314,2500,3814,0,3410,1500,1910,0,1396,1000,396,0,1640,1700,-60
8415,50000,40000,1,1,1,1,1,1,2,128267,6300,121967,0,139912,15300,124612,0,136604,0,136604,3,134705,0,134705
8416,240000,192000,0,0,0,0,0,0,-1,-28,0,-28,-1,-401,0,-401,-2,5109,7000,-1891,-1,7001,2000,5001
8417,60000,48000,0,0,0,0,0,0,2,29503,1802,27701,0,29538,1737,27801,0,29971,1170,28801,0,29798,1189,28609
8418,50000,40000,0,0,0,0,0,0,0,20361,1265,19096,0,17527,5000,12527,0,17318,700,16618,0,17738,700,17038
8419,160000,128000,0,0,0,0,0,0,0,14742,6037,8705,0,16617,8528,8089,0,17670,7053,10617,0,0,0,0
8420,230000,184000,0,0,0,0,0,0,-2,0,0,0,-2,1158,1158,0,-1,1158,0,1158,0,1158,0,1158
8421,350000,280000,0,0,0,0,0,0,-2,44293,44538,-245,-2,66525,67211,-686,-2,7502,7502,0,-2,15268,15268,0
8422,70000,56000,0,0,0,0,0,1,0,47413,2100,45313,0,44590,1600,42990,0,45890,2000,43890,0,47126,2000,45126
8423,80000,64000,0,1,1,1,1,0,0,81244,2929,78315,0,80391,3000,77391,0,75589,5522,70067,0,77373,3000,74373
8424,250000,200000,0,0,0,0,0,0,-1,24079,24104,-25,-1,13141,13144,-3,-1,22728,12000,10728,0,9300,9300,0
8425,500000,400000,0,1,1,1,1,0,0,488166,18852,469314,0,485249,16673,468576,0,441981,15244,426737,0,424592,15216,409376
8426,210000,168000,0,0,0,0,0,0,2,28719,3550,25169,2,27964,0,27964,2,28364,1164,27200,0,28855,1100,27755
8427,260000,208000,0,1,1,0,0,0,0,262546,11000,251546,0,238614,13067,225547,0,195149,10003,185146,0,195771,8000,187771
8428,20000,16000,0,0,0,0,0,1,2,15195,3077,12118,2,14659,0,14659,2,14642,524,14118,0,15102,696,14406
8429,30000,24000,0,0,0,0,0,0,0,12471,5003,7468,0,7985,7983,2,0,13619,10000,3619,0,17997,10103,7894
8430,50000,40000,0,0,0,0,0,0,0,25327,3314,22013,0,25668,1050,24618,2,24959,0,24959,2,25506,1100,24406
8431,50000,40000,0,1,0,0,0,0,0,50144,1500,48644,0,10683,1300,9383,0,9953,800,9153,0,9567,1000,8567
8432,310000,248000,0,0,0,0,0,0,0,129449,16036,113413,0,106382,5000,101382,0,98892,3000,95892,0,92599,3000,89599
8433,80000,64000,0,0,0,0,0,0,0,46307,6000,40307,0,45324,0,45324,2,41887,2033,39854,0,38600,5000,33600
8434,220000,176000,0,0,0,0,0,0,0,112108,6000,106108,0,113520,5000,108520,0,101164,3649,97515,0,88354,3580,84774
8435,30000,24000,0,0,0,0,0,1,0,0,0,0,0,0,0,0,-2,0,0,0,-2,0,0,0
8436,360000,288000,0,0,0,0,0,0,-2,0,0,0,-2,0,0,0,-2,474,474,0,-2,0,0,0
8437,200000,160000,0,0,0,0,0,0,-1,44758,15000,29758,0,45571,1622,43949,0,40592,2068,38524,0,7145,1000,6145
8438,50000,40000,0,0,0,0,0,0,0,9677,1300,8377,0,8826,350,8476,0,10177,1500,8677,0,9865,0,9865
8439,70000,56000,0,0,0,0,0,0,0,51005,2464,48541,0,54141,4600,49541,0,52676,0,52676,2,53871,2200,51671
8440,50000,40000,0,0,0,0,0,0,0,10236,1800,8436,0,7896,1000,6896,0,6211,1211,5000,0,23315,20000,3315
8441,80000,64000,0,0,0,0,0,1,-2,0,0,0,-2,0,0,0,-2,826,826,0,-1,1803,1803,0
8442,400000,320000,0,0,0,0,0,1,-2,0,0,0,-2,0,0,0,-2,0,0,0,-2,0,0,0
8443,130000,104000,0,0,0,0,0,0,0,93977,4363,89614,0,94427,3300,91127,0,89041,3178,85863,0,89833,3178,86655
8444,100000,80000,0,0,0,0,0,0,0,78115,7000,71115,0,79244,3000,76244,2,77373,0,77373,2,78973,3000,75973
8445,240000,192000,0,1,1,0,0,1,0,234261,9358,224903,0,231597,5104,226493,0,42209,864,41345,0,26348,527,25821
8446,160000,128000,0,0,0,0,0,0,-1,11520,13040,-1520,-1,1520,0,1520,-1,5171,5171,0,-1,3716,3716,0
8447,150000,120000,0,0,0,0,0,0,0,95250,3709,91541,0,55070,1101,53969,0,44425,2000,42425,0,7582,152,7430
8448,140000,112000,0,0,0,0,0,1,-2,0,0,0,-2,0,0,0,-2,0,0,0,-2,0,0,0
8449,150000,120000,0,0,0,0,0,0,0,26352,2000,24352,0,27607,2000,25607,0,29457,2457,27000,0,40706,12060,28646
8450,500000,400000,0,0,0,0,0,0,-1,10515,10556,-41,-1,4158,4170,-12,-2,7958,7963,-5,-1,-196,196,-392
8451,50000,40000,0,0,0,0,0,0,2,8472,0,8472,2,8641,310,8331,0,9298,797,8501,0,9000,0,9000
8452,60000,48000,0,1,0,0,0,0,0,58196,2200,55996,0,47007,1500,45507,0,32834,1200,31634,0,29116,1100,28016
8453,270000,216000,0,0,0,0,0,0,0,125284,5000,120284,2,126708,5000,121708,0,134352,10000,124352,0,108585,5000,103585
8454,80000,64000,0,0,0,0,0,0,-2,538,538,0,-2,15664,15664,0,-2,150,150,0,-2,1150,1150,0
8455,70000,56000,0,1,1,1,0,0,2,63061,2407,60654,0,61520,2041,59479,0,63080,2387,60693,0,2900,2905,-5
8456,340000,272000,0,0,0,0,0,0,0,102819,4500,98319,0,105477,5000,100477,0,107454,4000,103454,0,110419,5000,105419
8457,130000,104000,0,0,0,0,0,0,-2,0,0,0,-2,96963,96963,0,-1,99004,3554,95450,0,101833,4435,97398
8458,230000,184000,0,0,0,0,0,0,-2,2528,2532,-4,-2,1865,1865,0,-2,1496,1496,0,-2,1873,1873,0
8459,50000,40000,0,0,0,0,0,0,0,16978,2003,14975,0,16282,1200,15082,0,17363,1281,16082,0,8833,1512,7321
8460,180000,144000,0,0,0,0,0,0,-1,6554,6557,-3,-1,0,0,0,-1,21398,21398,0,-1,298,298,0
8461,330000,264000,0,0,0,0,0,0,0,141674,7000,134674,0,136790,5000,131790,0,141469,7004,134465,0,143453,6015,137438
8462,50000,40000,0,0,0,0,0,0,-2,0,0,0,-2,0,0,0,-2,0,0,0,-2,0,0,0
8463,30000,24000,0,0,1,1,1,0,0,25022,2000,23022,0,26405,2100,24305,0,25861,0,25861,2,27778,2500,25278
8464,280000,224000,0,0,0,0,0,0,-2,0,0,0,-2,0,0,0,-2,0,0,0,-2,0,0,0
8465,200000,160000,0,0,0,0,0,0,0,24612,4452,20160,0,19527,0,19527,2,16471,708,15763,0,13408,656,12752
8466,80000,64000,0,0,0,0,0,0,0,19476,56,19420,2,61302,62877,-1575,-1,0,0,0,-1,0,41150,-41150
8467,150000,120000,0,0,0,0,0,0,-1,177,177,0,-1,1596,1596,0,-1,405,405,0,-1,0,0,0
8468,70000,56000,0,1,1,1,1,1,0,65615,3000,62615,0,66429,2500,63929,0,67858,2500,65358,0,69723,3000,66723
8469,50000,40000,1,1,0,0,0,0,0,53321,1066,52255,0,49263,50045,-782,-1,29063,992,28071,0,26644,1000,25644
8470,230000,184000,0,0,0,0,0,1,-2,0,0,0,-2,0,0,0,-2,0,0,0,-2,0,0,0
8471,120000,96000,0,0,0,0,0,0,0,32222,1500,30722,0,32877,1000,31877,0,30587,1000,29587,0,25938,2000,23938
8472,160000,128000,0,0,0,0,0,0,2,12900,2000,10900,2,12396,0,12396,2,13692,1500,12192,2,13323,0,13323
8473,70000,56000,0,1,0,0,0,0,0,62007,2075,59932,0,38391,2000,36391,0,38996,1541,37455,0,39819,1600,38219
8474,470000,376000,0,0,0,0,0,0,0,181531,5552,175979,0,52119,1781,50338,0,48386,3021,45365,0,35425,3008,32417
8475,50000,40000,0,0,0,0,0,1,-1,929,1000,-71,-1,474,0,474,0,0,0,0,0,1288,1288,0
8476,10000,8000,0,0,0,0,1,0,0,4810,2000,2810,0,7546,3000,4546,0,9260,2000,7260,0,10000,1000,9000
8477,70000,56000,0,0,0,0,0,0,0,9638,2000,7638,0,8761,0,8761,2,8572,1000,7572,0,9274,1000,8274
8478,30000,24000,0,0,0,0,0,1,0,21403,2000,19403,0,21074,1500,19574,0,21289,2000,19289,0,21425,1000,20425
8479,170000,136000,0,1,1,1,1,0,0,171014,7540,163474,0,168142,7540,160602,0,169821,6301,163520,0,173014,6517,166497
8480,310000,248000,0,0,0,0,0,0,-2,0,0,0,-2,0,0,0,-2,0,0,0,-2,0,0,0
8481,50000,40000,0,0,0,0,0,0,0,29284,2000,27284,0,30487,2000,28487,0,33831,4000,29831,0,33138,0,33138
8482,320000,256000,0,0,0,0,0,0,0,342,342,0,-1,-6,2,-8,-1,1252,1500,-248,-1,0,0,0
8483,80000,64000,0,1,1,1,1,0,0,70489,4200,66289,0,74146,5500,68646,0,72375,0,72375,2,70811,2500,68311
8484,30000,24000,0,0,0,0,0,0,-1,18245,18245,0,-1,9714,9714,0,-1,28103,28112,-9,-1,9207,9207,0
8485,160000,128000,0,0,1,1,1,0,-2,140184,140248,-64,-1,141992,6600,135392,0,143277,5122,138155,0,146438,5464,140974
8486,20000,16000,0,0,0,0,0,0,0,4679,0,4679,2,2960,1000,1960,0,0,0,0,0,0,0,0
8487,20000,16000,0,0,0,0,0,0,-1,10269,10269,0,-1,5880,118,5762,0,3330,67,3263,0,4339,2000,2339
8488,260000,208000,0,0,1,0,1,1,3,213758,8000,205758,2,208821,0,208821,2,213083,7800,205283,0,217340,7800,209540
8489,200000,160000,0,0,0,0,0,0,-2,3432,47015,-43583,-1,-3684,0,-3684,-1,0,4000,-4000,-2,1386,100000,-98614
8490,30000,24000,0,0,0,0,0,0,-1,836,0,836,2,390,390,0,-1,390,390,0,-1,390,390,0
8491,140000,112000,0,1,0,0,0,1,0,133250,5000,128250,0,98147,3500,94647,0,98924,3510,95414,0,95100,3500,91600
8492,20000,16000,0,0,1,1,1,0,0,17488,2900,14588,0,17923,1000,16923,0,16838,800,16038,0,18535,2000,16535
8493,500000,400000,0,0,0,0,0,0,0,197247,18011,179236,0,188044,13014,175030,0,210940,45049,165891,0,201108,20102,181006
8494,200000,160000,0,0,0,0,0,0,-2,0,0,0,-2,0,0,0,-2,0,0,0,-2,0,0,0
8495,180000,144000,0,0,0,0,0,0,-1,2358,2358,0,-1,18572,18577,-5,-1,11560,11560,0,-1,4298,4298,0
8496,80000,64000,0,0,1,1,1,0,0,70203,10010,60193,0,67934,3000,64934,0,75781,9400,66381,0,73848,0,73848
8497,20000,16000,0,0,0,0,0,0,-1,1140,1140,0,-1,0,0,0,-1,7014,7014,0,-1,7696,800,6896
8498,400000,320000,0,0,0,0,0,0,-2,0,0,0,-2,0,0,0,-2,0,0,0,-2,0,0,0
8499,200000,160000,0,0,0,0,0,0,-1,5800,1000,4800,0,6000,200,5800,0,0,0,0,0,0,0,0
8500,30000,24000,0,0,0,0,0,0,-2,0,0,0,-2,0,0,0,-2,7092,7092,0,-1,6832,0,6832
8501,10000,8000,0,0,0,0,0,1,-1,1709,1709,0,-1,1470,1470,0,-1,2010,2010,0,-1,780,0,780
8502,310000,248000,0,0,0,0,0,0,-2,19950,20033,-83,-2,79227,79520,-293,-2,20097,94,20003,-2,25594,25910,-316
8503,500000,400000,0,1,0,0,0,0,0,489856,18694,471162,0,356583,12271,344312,0,289398,9699,279699,0,274590,9420,265170
8504,210000,168000,0,0,0,0,0,0,0,38179,1936,36243,0,39243,2000,37243,0,39740,1450,38290,0,40574,1472,39102
8505,20000,16000,0,1,1,0,0,0,0,19145,1500,17645,0,17322,822,16500,0,16989,1000,15989,0,12699,1000,11699
8506,230000,184000,0,0,0,0,0,0,-2,0,0,0,-2,0,0,0,-2,0,0,0,-2,150,150,0
8507,130000,104000,0,0,0,0,0,0,0,88331,2892,85439,0,81192,2733,78459,0,78774,2752,76022,0,77117,3159,73958
8508,150000,120000,0,0,0,0,0,1,2,-311,0,-311,2,-602,0,-602,-2,-893,0,-893,-2,-1184,0,-1184
8509,300000,240000,0,0,0,0,0,0,-1,19615,19615,0,-1,11123,11123,0,-1,10266,10266,0,-1,12467,12467,0
8510,200000,160000,0,0,0,0,0,0,0,136545,5065,131480,0,116549,4005,112544,0,109622,3900,105722,0,111113,4003,107110
8511,70000,56000,0,1,0,0,0,0,0,69938,2095,67843,0,16518,1000,15518,0,14096,2000,12096,0,830,3000,-2170
8512,120000,96000,0,1,0,0,0,0,0,105262,2731,102531,0,46605,3000,43605,0,45590,5000,40590,0,46204,3000,43204
8513,180000,144000,0,0,0,0,0,0,-2,2109,2120,-11,-2,600,901,-301,-2,476,476,0,-1,326,0,326
8514,130000,104000,0,0,0,0,0,0,-1,1373,1373,0,-1,390,390,0,-1,2746,2746,0,-1,390,0,390
8515,250000,200000,0,0,0,0,0,0,0,24448,2000,22448,0,20492,1007,19485,0,18812,1031,17781,0,17663,2000,15663
8516,50000,40000,0,0,0,0,0,0,0,26265,1420,24845,0,19526,391,19135,0,13250,300,12950,0,11250,500,10750
8517,10000,8000,0,0,0,0,0,1,0,9622,1801,7821,0,7773,0,7773,2,5968,700,5268,0,5380,1300,4080
8518,50000,40000,0,0,0,0,0,0,0,6845,2300,4545,0,4364,0,4364,2,2185,44,2141,0,2162,2200,-38
8519,50000,40000,0,0,0,0,0,1,5,31499,0,31499,4,30748,0,30748,3,30162,0,30162,2,30016,3100,26916
8520,300000,240000,0,0,0,0,0,0,0,31333,1507,29826,0,35906,5406,30500,0,38963,3963,35000,0,40283,2283,38000
8521,80000,64000,0,0,0,0,0,1,-2,0,0,0,-2,0,0,0,-2,0,0,0,-2,0,0,0
8522,300000,240000,0,0,0,0,0,0,-2,26283,26443,-160,-1,16624,16624,0,-1,6316,6166,150,0,8394,8078,316
8523,30000,24000,0,0,0,0,0,0,0,5297,1026,4271,0,4340,125,4215,0,3105,1500,1605,0,5053,2000,3053
8524,70000,56000,0,0,0,0,0,1,2,39214,0,39214,2,39861,1600,38261,0,41063,2000,39063,0,42918,2700,40218
8525,320000,256000,0,0,0,0,0,0,0,31236,10000,21236,0,66091,36091,30000,0,5800,5800,0,-1,5800,0,5800
8526,20000,16000,0,1,1,1,0,0,0,20060,1500,18560,0,18780,1000,17780,0,19580,800,18780,0,0,0,0
8527,270000,216000,0,0,0,0,0,0,-1,25237,22438,2799,0,44395,20000,24395,0,44741,1587,43154,0,45209,2000,43209
8528,130000,104000,0,0,0,0,0,0,0,19802,1394,18408,0,11515,1015,10500,0,4261,99,4162,0,45718,47657,-1939
8529,80000,64000,0,0,0,0,0,0,0,29143,10000,19143,0,33520,5000,28520,0,19060,3000,16060,0,14275,3000,11275
8530,240000,192000,0,0,0,0,0,0,-2,2762,2762,0,-2,10264,10318,-54,-2,316,316,0,-2,9801,17677,-7876
8531,230000,184000,0,0,0,0,0,0,0,0,0,0,-2,0,0,0,-2,0,0,0,-2,0,0,0
8532,30000,24000,0,0,0,0,0,0,2,4476,7,4469,2,8830,7002,1828,2,8153,13,8140,2,6422,155,6267
8533,90000,72000,0,1,1,1,1,1,2,81630,3200,78430,2,82890,3200,79690,2,84709,3300,81409,2,86252,3100,83152
8534,70000,56000,0,1,1,1,1,0,0,67879,3182,64697,0,69161,3144,66017,0,68264,2600,65664,0,61757,2360,59397
8535,10000,8000,0,1,0,1,1,0,-1,9488,1152,8336,0,9129,1150,7979,0,9479,500,8979,0,9523,345,9178
8536,20000,16000,0,0,0,1,1,1,0,15237,1265,13972,0,17164,2192,14972,0,17294,694,16600,2,16110,0,16110
8537,50000,40000,0,0,0,0,0,0,2,180,0,180,-2,2672,2672,0,-1,3101,3101,0,-1,5465,5465,0
8538,150000,120000,0,0,0,0,0,0,-2,0,0,0,-2,0,0,0,-2,0,0,0,-2,0,0,0
8539,200000,160000,0,0,0,0,0,0,0,142520,5000,137520,0,151078,10000,141078,0,176717,27080,149637,0,168431,10017,158414
8540,200000,160000,0,0,0,0,0,0,-2,0,0,0,-2,0,0,0,-2,0,0,0,-2,0,0,0
8541,30000,24000,0,1,1,0,0,1,2,28301,1400,26901,0,31072,3561,27511,0,24147,483,23664,0,4007,80,3927
8542,150000,120000,0,0,0,0,0,0,-2,0,0,0,-2,0,0,0,-2,0,0,0,-2,0,0,0
8543,40000,32000,0,1,1,1,1,0,0,40929,2300,38629,0,40528,1600,38928,0,39575,1330,38245,0,40526,1500,39026
8544,100000,80000,0,0,0,0,0,1,-1,712,712,0,-1,712,712,0,-1,862,862,0,-1,712,712,0
8545,200000,160000,0,0,0,0,0,0,-2,-5,0,-5,-2,-5,0,-5,-2,-5,0,-5,-2,1028,1033,-5
8546,150000,120000,0,0,0,0,0,0,-2,21886,21888,-2,-2,447,447,0,-2,3458,3458,0,-2,898,898,0
8547,150000,120000,0,0,0,0,0,1,0,92499,2616,89883,0,94364,2647,91717,0,97589,4000,93589,0,99921,3158,96763
8548,300000,240000,0,0,0,0,0,0,-2,0,0,0,-2,0,0,0,-2,610,610,0,-2,2165,2165,0
8549,220000,176000,0,0,0,0,0,0,0,2908,2000,908,0,3054,3200,-146,-1,3054,3054,0,-1,0,0,0
8550,160000,128000,0,0,0,0,0,0,0,24994,5060,19934,0,15778,5000,10778,0,9333,1500,7833,0,7083,0,7083
8551,80000,64000,0,0,0,0,0,1,2,1551,1551,0,-1,1100,1100,0,-1,0,0,0,-2,4374,4374,0
8552,180000,144000,0,0,0,0,0,1,-1,1586,1586,0,-1,1758,1758,0,-1,480,480,0,-1,1918,1918,0
8553,120000,96000,0,0,0,0,0,0,-2,0,0,0,-2,0,0,0,-2,0,0,0,-2,0,0,0
8554,100000,80000,0,0,0,0,0,0,0,25409,1452,23957,0,23072,1226,21846,0,22745,675,22070,0,22492,748,21744
8555,30000,24000,0,0,0,0,0,0,0,24572,1505,23067,0,23448,1305,22143,0,21919,1000,20919,0,20756,1000,19756
8556,80000,64000,0,0,0,0,0,0,-2,0,0,0,-2,0,0,0,-2,0,0,0,-2,0,0,0
8557,130000,104000,0,0,0,0,0,0,-2,1020,1023,-3,-2,3640,3650,-10,-2,948,950,-2,-2,9071,9093,-22
8558,190000,152000,0,1,0,0,0,0,0,161193,6596,154597,0,123203,4831,118372,0,85510,2806,82704,0,83704,2870,80834
8559,90000,72000,0,0,0,0,0,0,0,0,0,0,-2,0,0,0,-2,0,0,0,-2,0,0,0
8560,260000,208000,0,1,1,1,1,0,0,214885,6430,208455,0,219204,6495,212709,0,223899,6849,217050,0,228279,6799,221480
8561,350000,280000,0,0,0,0,0,0,0,23309,2072,21237,0,13002,0,13002,0,14473,2071,12402,0,11496,11553,-57
8562,50000,40000,0,0,0,0,0,0,2,28927,1617,27310,0,19896,816,19080,0,19475,1003,18472,0,19168,1004,18164
8563,160000,128000,0,0,0,0,0,0,-1,-436,0,-436,-1,-436,0,-436,-2,436,872,-436,-1,436,0,436
8564,50000,40000,0,0,0,0,0,1,2,7156,0,7156,2,8492,1500,6992,0,9515,1100,8415,0,9287,0,9287
8565,500000,400000,0,0,0,0,0,0,0,64537,3022,61515,0,60228,2502,57726,0,59038,2250,56788,0,58738,2350,56388
8566,50000,40000,0,0,0,0,0,0,0,11200,1188,10012,0,12214,1202,11012,0,12608,596,12012,0,12718,461,12257
8567,200000,160000,0,0,0,0,0,0,0,74770,3010,71760,0,75826,2600,73226,0,77741,3000,74741,0,79597,3000,76597
8568,50000,40000,0,0,0,0,0,0,0,0,0,0,0,777,777,0,-1,793,16,777,0,26793,26000,793
8569,150000,120000,0,1,1,1,1,0,0,141297,4000,137297,0,144605,4500,140105,0,148420,5000,143420,0,150500,3500,147000
8570,20000,16000,0,1,1,1,0,0,2,19441,1414,18027,0,20113,1146,18967,0,19864,729,19135,0,15424,970,14454
8571,290000,232000,0,0,0,0,0,0,0,27009,3000,24009,0,26671,3000,23671,0,24826,3000,21826,0,22287,3000,19287
8572,80000,64000,0,1,0,0,0,0,0,76290,2454,73836,0,58987,2059,56928,0,57947,2100,55847,0,58077,2149,55928
8573,80000,64000,1,1,0,0,0,0,0,83023,2000,81023,0,79031,83731,-4700,-1,41149,2000,39149,0,30244,2000,28244
8574,200000,160000,0,0,0,0,0,0,0,113723,4002,109721,0,109447,4005,105442,0,75423,3002,72421,0,22919,1002,21917
8575,70000,56000,0,0,0,0,0,0,0,58055,2213,55842,0,44593,1565,43028,0,-1380,0,-1380,0,48757,50137,-1380
8576,360000,288000,0,0,0,0,0,0,0,85777,81970,3807,0,81919,3261,78658,0,75332,1886,73446,0,47622,3035,44587
8577,680000,544000,0,0,0,0,0,0,0,17806,2400,15406,0,15498,600,14898,0,13810,400,13410,0,164969,161000,3969
8578,50000,40000,0,0,0,0,0,0,0,37600,5000,32600,0,0,0,0,0,0,0,0,-2,-5000,0,-5000
8579,20000,16000,0,1,1,1,1,0,0,19370,1800,17570,0,19355,1106,18249,0,17155,435,16720,0,18660,1599,17061
8580,270000,216000,0,0,0,0,0,0,0,29891,10000,19891,0,24531,10000,14531,0,19391,10000,9391,0,8850,8850,0
8581,100000,80000,0,0,0,0,0,0,0,66046,2098,63948,0,66779,1916,64863,0,45833,1707,44126,0,46369,1732,44637
8582,70000,56000,0,0,0,0,0,0,0,28642,1200,27442,2,30670,2820,27850,2,31133,1100,30033,2,31965,1500,30465
8583,30000,24000,0,0,0,0,0,0,2,24921,1500,23421,0,25945,5229,20716,0,20634,942,19692,0,1600,1704,-104
8584,200000,160000,0,0,0,0,0,0,0,94901,5013,89888,0,92866,5024,87842,0,93514,10000,83514,0,85659,5000,80659
8585,360000,288000,0,0,0,0,0,1,0,68810,1793,67017,0,12800,2757,10043,0,0,0,0,0,0,0,0
8586,30000,24000,0,1,1,1,1,0,0,29489,2000,27489,0,30237,1502,28735,0,30504,1112,29392,0,29771,1100,28671
8587,50000,40000,0,0,0,0,0,1,0,15445,1263,14182,0,16782,1600,15182,0,16960,754,16206,0,17208,671,16537
8588,20000,16000,0,1,1,1,1,0,0,18541,1300,17241,0,19250,1000,18250,0,19805,1000,18805,0,20356,1258,19098
8589,120000,96000,0,0,0,0,0,0,-1,880,880,0,-1,880,880,0,-1,880,880,0,-1,1030,1030,0
8590,200000,160000,0,0,0,0,0,1,0,4579,0,4579,2,5840,1500,4340,2,5603,0,5603,2,6352,1000,5352
8591,160000,128000,0,0,0,0,0,0,-1,15086,15086,0,-1,8578,9123,-545,-1,13028,13028,0,-1,21712,29712,-8000
8592,320000,256000,0,1,1,0,0,0,0,277482,13000,264482,0,282869,11160,271709,0,253903,8418,245485,0,249866,8325,241541
8593,320000,256000,0,0,0,0,0,0,0,18087,1140,16947,0,5639,5639,0,-1,-41,0,-41,-1,5613,5654,-41
8594,50000,40000,0,0,0,0,0,0,0,21772,2049,19723,0,22541,5000,17541,0,22871,1500,21371,0,23989,1500,22489
8595,20000,16000,0,0,0,0,0,1,0,12146,2400,9746,0,11954,600,11354,2,14750,3000,11750,2,14371,0,14371
8596,50000,40000,0,0,0,0,0,1,-1,1000,1000,0,-1,4874,4874,0,-1,5374,500,4874,0,5874,500,5374
8597,130000,104000,0,0,0,0,0,0,-2,0,0,0,-2,0,0,0,-2,402,402,0,-2,0,0,0
8598,290000,232000,1,1,0,0,0,0,0,415700,8501,407199,0,232732,15018,217714,0,220460,10001,210459,0,224780,7997,216783
8599,320000,256000,0,0,0,0,0,0,-1,4144,4160,-16,-1,6290,6296,-6,-1,977,977,0,-1,-23,23,-46
8600,290000,232000,0,0,0,0,0,0,0,157605,7549,150056,0,133904,10000,123904,0,128276,15000,113276,0,130419,5000,125419
8601,30000,24000,1,1,1,1,1,1,2,34639,1200,33439,2,32493,0,32493,2,32001,1500,30501,0,33064,3100,29964
8602,130000,104000,1,1,1,1,1,1,2,132249,0,132249,2,132416,5600,126816,0,131959,5150,126809,0,128375,5100,123275
8603,330000,264000,0,0,0,0,0,0,-1,3429,5726,-2297,-1,0,0,0,-1,0,0,0,-2,749,749,0
8604,210000,168000,0,0,0,0,0,0,-1,2989,2992,-3,-1,2046,2046,0,-1,17239,17239,0,-1,3680,3680,0
8605,50000,40000,0,0,0,0,0,1,2,0,0,0,2,0,0,0,-2,0,0,0,-2,0,0,0
8606,20000,16000,0,0,0,0,0,0,-2,0,0,0,-2,0,0,0,-2,0,0,0,-2,0,0,0
8607,180000,144000,0,1,1,1,1,0,0,154063,6001,148062,0,158494,7000,151494,0,161855,6000,155855,0,171055,12000,159055
8608,60000,48000,0,0,0,0,0,0,-1,26,26,0,-1,3742,4822,-1080,-1,3352,3352,0,-1,3570,3570,0
8609,110000,88000,0,0,0,0,0,0,0,61195,2310,58885,0,28154,1010,27144,0,24773,980,23793,0,21620,900,20720
8610,50000,40000,0,1,0,0,0,0,0,47942,1120,46822,0,1261,1300,-39,-1,17147,17147,0,-1,16609,1000,15609
8611,50000,40000,0,0,0,0,0,0,0,23096,1366,21730,0,18970,1000,17970,0,19514,1000,18514,0,20038,1000,19038
8612,120000,96000,0,0,1,1,1,0,3,100536,5400,95136,3,103478,5500,97978,3,104886,4600,100286,4,107220,4600,102620
8613,100000,80000,0,0,0,0,0,1,-2,0,0,0,-2,0,0,0,-2,0,0,0,-2,4747,4747,0
8614,230000,184000,0,0,0,0,0,1,-2,2580,2580,0,-2,48310,48342,-32,-2,6390,6390,0,-2,7194,7194,0
8615,260000,208000,0,0,0,0,0,0,-1,650,650,0,-1,3562,3562,0,-1,3044,0,3044,0,3044,0,3044
8616,510000,408000,0,0,0,0,0,0,0,217620,8200,209420,0,218692,7268,211424,0,191069,7000,184069,0,195124,7177,187947
8617,230000,184000,0,0,0,0,0,0,0,0,0,0,-2,51750,52066,-316,-1,51295,2000,49295,0,53257,3000,50257
8618,200000,160000,0,0,0,0,0,0,0,23524,3000,20524,0,23788,3000,20788,0,26089,4092,21997,0,25908,1000,24908
8619,80000,64000,1,1,1,1,1,0,7,121216,0,121216,6,97622,0,97622,5,88878,0,88878,4,80518,0,80518
8620,200000,160000,0,0,0,0,0,0,0,0,0,0,-2,0,0,0,-2,0,0,0,-2,0,0,0
8621,350000,280000,0,0,0,0,0,1,-2,44164,44743,-579,-1,35233,0,35233,0,884,884,0,0,9924,9924,0
8622,50000,40000,0,1,0,0,0,0,0,49273,2250,47023,0,40385,1509,38876,0,36901,1329,35572,0,29263,1300,27963
8623,20000,16000,0,1,1,1,1,0,0,19762,1592,18170,0,19807,637,19170,0,19830,700,19130,0,20347,827,19520
8624,360000,288000,0,0,0,0,0,0,-1,3740,3740,0,-1,0,0,0,-1,0,0,0,-2,0,0,0
8625,180000,144000,0,0,0,0,0,0,-1,326,326,0,-1,326,326,0,-1,652,652,0,-1,326,0,326
8626,160000,128000,0,1,0,0,0,0,2,136732,5000,131732,2,101473,0,101473,2,100895,3770,97125,0,103107,4000,99107
8627,430000,344000,0,0,1,1,1,1,0,354716,358689,-3973,-1,361373,15066,346307,0,368484,14126,354358,0,365148,13065,352083
8628,210000,168000,0,0,0,0,0,0,0,50999,5000,45999,0,51884,2020,49864,2,50926,0,50926,2,54404,4500,49904
8629,200000,160000,1,1,1,0,1,0,2,228720,0,228720,2,234177,5857,228320,0,201490,202076,-586,-1,190721,6726,183995
8630,30000,24000,0,0,0,0,0,0,0,29342,10019,19323,0,23572,1219,22353,0,21381,1032,20349,0,28609,28609,0
8631,360000,288000,0,0,0,0,0,0,-2,47535,48271,-736,-2,186,187,-1,-2,38169,38359,-190,-2,2665,2678,-13
8632,10000,8000,0,0,0,0,0,1,-1,0,0,0,-1,780,780,0,-1,0,0,0,-1,0,0,0
8633,210000,168000,0,0,0,0,0,0,0,18652,1074,17578,0,13464,1000,12464,0,109722,99000,10722,0,105573,3745,101828
8634,180000,144000,0,0,0,0,0,0,0,48469,2200,46269,0,49553,2200,47353,0,49772,2000,47772,0,50829,2000,48829
8635,200000,160000,0,0,0,0,0,0,-2,0,0,0,-2,320,329,-9,-1,170,0,170,2,2865,2865,0
8636,10000,8000,0,0,0,0,0,0,0,4139,2000,2139,0,2583,583,2000,0,0,0,0,0,0,0,0
8637,120000,96000,0,0,0,0,0,0,0,78471,4100,74371,0,77711,3000,74711,0,79250,3000,76250,0,55860,2000,53860
8638,200000,160000,0,0,0,0,0,1,2,89064,0,89064,2,90019,3000,87019,0,92850,4000,88850,0,98666,7000,91666
8639,50000,40000,0,0,0,0,0,0,2,22883,1636,21247,0,18069,700,17369,0,19273,1500,17773,0,19929,1000,18929
8640,30000,24000,0,1,1,1,1,0,0,30204,1500,28704,0,28501,1000,27501,0,29687,4000,25687,0,29497,1900,27597
8641,130000,104000,0,0,0,0,0,0,-2,2751,2751,0,-2,2995,2995,0,-2,2018,2018,0,-2,938,938,0
8642,50000,40000,0,0,0,0,0,0,-2,0,0,0,-2,0,0,0,-2,0,0,0,-2,0,0,0
8643,200000,160000,0,0,0,0,0,0,-1,9781,9781,0,-1,29313,20000,9313,0,49113,20000,29113,0,732,732,0
8644,200000,160000,0,0,0,0,0,0,0,49352,2300,47052,0,49682,2000,47682,0,50588,2000,48588,0,42629,1500,41129
8645,50000,40000,1,1,1,0,0,1,2,50092,4,50088,2,50332,2300,48032,0,29690,1100,28590,0,30246,1400,28846
8646,420000,336000,0,0,0,0,0,0,0,135987,7000,128987,0,134719,4500,130219,0,135426,5000,130426,0,111697,4000,107697
8647,230000,184000,0,0,0,0,0,0,0,55284,2000,53284,0,42693,1535,41158,0,42541,1183,41358,0,34197,1500,32697
8648,190000,152000,0,0,0,0,0,0,0,43563,8000,35563,0,40909,0,40909,2,50758,12000,38758,2,36922,3000,33922
8649,500000,400000,0,0,0,0,0,0,-1,2544,2556,-12,-1,949,955,-6,-1,86362,86793,-431,-1,-8,0,-8
8650,220000,176000,0,0,0,0,0,0,-1,1210,1216,-6,-1,632,640,-8,-1,15243,15251,-8,-1,5471,5472,-1
8651,360000,288000,0,0,0,0,0,1,0,0,0,0,-2,0,0,0,-2,0,0,0,-2,2650,2650,0
8652,500000,400000,0,0,0,0,0,0,-2,18653,18661,-8,-2,45391,45402,-11,-2,1460,1460,0,-2,580,580,0
8653,440000,352000,0,0,0,0,0,0,-1,10065,6020,4045,0,2500,0,2500,0,0,0,0,-2,11560,11560,0
8654,500000,400000,0,0,0,0,0,0,-2,-9,0,-9,-2,-9,0,-9,-2,1796,1805,-9,-2,-90,0,-90
8655,50000,40000,0,1,1,1,1,0,0,49173,2200,46973,0,49290,1700,47590,0,48910,1000,47910,0,48910,0,48910
8656,20000,16000,0,1,1,0,0,0,0,20102,2203,17899,0,19575,2114,17461,0,0,0,0,0,0,0,0
8657,260000,208000,0,0,0,0,0,0,0,21557,6015,15542,0,23186,5055,18131,0,14117,2011,12106,0,15797,4078,11719
8658,50000,40000,0,0,0,0,0,0,-2,2698,2698,0,-1,4640,2000,2640,0,6554,2000,4554,0,8434,2000,6434
8659,110000,88000,0,0,0,0,0,0,0,58442,3000,55442,0,55485,2000,53485,0,53539,2941,50598,0,41193,1512,39681
8660,150000,120000,0,0,0,0,0,1,-1,850,850,0,-1,430,430,0,-1,840,840,0,-1,430,430,0
8661,120000,96000,0,0,0,0,0,0,0,44823,3000,41823,0,44683,2000,42683,0,45537,3000,42537,0,50293,7000,43293
8662,160000,128000,0,0,0,0,0,0,-1,6062,6085,-23,-1,4203,4230,-27,-1,5780,5797,-17,-1,12575,12589,-14
8663,50000,40000,0,1,1,0,0,0,0,43395,2251,41144,0,42334,1451,40883,0,12316,540,11776,0,9997,503,9494
8664,70000,56000,0,1,1,1,1,0,0,61578,2400,59178,0,63061,2500,60561,0,64403,2500,61903,0,64948,2300,62648
8665,360000,288000,0,0,0,0,0,0,-1,2469,2469,0,-1,0,0,0,-1,5724,5724,0,-1,7334,7334,0
8666,90000,72000,0,1,0,0,0,0,0,76589,3571,73018,0,62892,2381,60511,0,58326,2083,56243,0,59491,2100,57391
8667,300000,240000,0,0,0,0,0,0,-1,6431,6495,-64,-1,3645,3681,-36,-1,2041,2448,-407,-1,1800,1910,-110
8668,220000,176000,0,0,0,0,0,0,-1,541,541,0,-1,4188,4188,0,-1,3473,3473,0,-1,7653,7653,0
8669,50000,40000,0,0,0,0,0,0,-1,42835,42863,-28,-1,8500,8500,0,-1,0,0,0,-1,0,0,0
8670,80000,64000,0,0,0,0,0,0,0,13263,1308,11955,0,11045,506,10539,0,10259,1516,8743,0,5773,1000,4773
8671,130000,104000,0,0,0,0,0,0,-1,-1523,0,-1523,-1,-1523,0,-1523,-2,-1523,0,-1523,-2,48477,50000,-1523
8672,140000,112000,0,0,0,0,0,1,2,90859,4200,86659,0,92734,4261,88473,0,48461,2182,46279,0,49067,1844,47223
8673,240000,192000,0,0,0,0,0,0,0,187389,7000,180389,0,181348,7000,174348,0,174998,6500,168498,0,168176,6000,162176
8674,330000,264000,0,0,0,0,0,0,0,23622,1700,21922,0,23253,1700,21553,0,22525,1000,21525,0,22419,1000,21419
8675,100000,80000,0,1,1,0,0,0,0,88489,3505,84984,0,83639,3479,80160,0,80893,3097,77796,0,81643,3259,78384
8676,230000,184000,0,0,0,0,0,0,-2,9420,9420,0,-2,16639,16688,-49,-2,600,606,-6,-2,0,0,0
8677,140000,112000,0,0,0,0,0,1,0,54293,2510,51783,0,53294,2450,50844,0,51558,1676,49882,0,52800,1900,50900
8678,90000,72000,0,0,0,0,0,0,-1,26854,26854,0,-1,28146,3000,25146,0,0,0,0,0,2000,2000,0
8679,200000,160000,0,0,0,0,0,0,2,1383,980,403,2,976,0,976,2,1126,563,563,2,563,0,563
8680,20000,16000,0,0,0,0,0,0,0,9582,2700,6882,0,9282,0,9282,2,9977,1000,8977,0,10812,1000,9812
8681,500000,400000,0,0,0,0,0,0,-2,1384,1384,0,-2,1384,1384,0,-2,5590,5590,0,-2,4542,4542,0
8682,130000,104000,0,0,0,0,0,0,2,52000,5000,47000,0,53590,4000,49590,0,54606,3000,51606,0,51033,3500,47533
8683,200000,160000,0,0,0,0,0,0,0,20398,0,20398,2,19888,8000,11888,0,22713,5000,17713,0,19405,3000,16405
8684,20000,16000,0,0,0,0,0,1,0,7736,1287,6449,0,8745,1296,7449,0,9394,945,8449,0,9101,0,9101
8685,230000,184000,0,0,0,0,0,0,0,170323,6158,164165,0,172136,6247,165889,0,175550,6276,169274,0,179291,6562,172729
8686,200000,160000,0,0,0,0,0,1,-2,0,0,0,-2,0,0,0,-2,0,0,0,-2,0,0,0
8687,330000,264000,0,0,0,0,0,0,0,100498,4600,95898,0,95072,4000,91072,0,94164,4190,89974,0,94043,6680,87363
8688,210000,168000,0,0,0,0,0,0,-1,2258,2261,-3,-1,8241,11008,-2767,-1,428,428,0,-1,3537,3537,0
8689,150000,120000,0,0,0,0,0,0,0,84641,4000,80641,0,86330,4000,82330,0,88885,4000,84885,0,97402,10000,87402
8690,70000,56000,0,0,0,0,0,0,0,24619,1410,23209,0,25107,898,24209,0,25634,931,24703,0,26143,936,25207
8691,380000,304000,0,0,0,0,0,0,-2,-9415,0,-9415,-2,-9415,0,-9415,-2,-9415,0,-9415,-2,-9415,0,-9415
8692,50000,40000,0,1,1,0,0,0,0,50446,2200,48246,0,49910,2270,47640,0,29844,1204,28640,0,30524,1300,29224
8693,230000,184000,0,1,1,0,0,0,0,201440,7750,193690,0,192978,6246,186732,0,110055,2500,107555,0,100857,2600,98257
8694,60000,48000,0,0,0,0,0,0,0,30077,2000,28077,0,30246,2300,27946,0,30257,2000,28257,0,29768,3000,26768
8695,20000,16000,0,0,0,0,0,0,0,11585,1198,10387,0,12899,1512,11387,0,13087,700,12387,0,13327,600,12727
8696,110000,88000,0,0,0,0,0,0,0,47291,3000,44291,0,43857,2173,41684,0,45684,3000,42684,0,40994,3500,37494
8697,50000,40000,0,0,0,0,0,0,0,10834,1087,9747,0,10531,297,10234,0,10239,309,9930,0,5741,220,5521
8698,40000,32000,0,0,0,0,0,0,-1,1583,1583,0,-1,1020,0,1020,2,630,0,630,0,240,0,240
8699,130000,104000,0,0,0,0,0,0,0,35595,3000,32595,0,36200,3000,33200,0,34081,2000,32081,0,31542,3000,28542
8700,260000,208000,0,1,1,0,0,1,2,233958,10698,223260,0,252615,24799,227816,0,186443,0,186443,2,190345,7035,183310
8701,200000,160000,0,0,0,0,0,0,-2,0,0,0,-2,0,0,0,-2,0,0,0,-2,0,0,0
8702,280000,224000,0,0,0,0,0,0,-2,4250,4250,0,-2,1000,1000,0,-2,5507,5507,0,-2,5348,5348,0
8703,50000,40000,1,1,1,1,0,1,2,66468,1400,65068,2,56847,0,56847,2,50680,1545,49135,0,26729,2022,24707
8704,120000,96000,0,0,0,0,0,1,-1,326,326,0,-1,652,652,0,-1,326,0,326,0,326,326,0
8705,190000,152000,0,0,0,0,0,0,0,5610,1610,4000,0,7300,2310,4990,0,4694,2000,2694,0,2250,1000,1250
8706,210000,168000,0,1,1,1,1,0,0,180618,10000,170618,0,184110,8000,176110,0,189134,8000,181134,0,194966,9000,185966
8707,180000,144000,0,0,0,0,0,1,-1,416,416,0,-1,416,416,0,-1,416,416,0,-1,832,832,0
8708,170000,136000,0,1,1,0,0,0,0,169636,9000,160636,0,152603,5800,146803,0,114885,3505,111380,0,105735,3500,102235
8709,130000,104000,0,1,1,1,1,0,0,112635,4600,108035,0,114472,4200,110272,0,117556,5000,112556,0,116090,5000,111090
8710,250000,200000,0,0,0,0,0,0,0,13346,13346,0,-1,9163,9163,0,-1,8338,8338,0,-1,17793,18618,-825
8711,200000,160000,0,0,0,0,0,0,0,64222,2008,62214,2,50518,3008,47510,0,44892,9056,35836,0,76088,36100,39988
8712,210000,168000,0,0,0,0,0,0,-1,0,0,0,-1,1783,1783,0,-1,1000,1000,0,-1,150,150,0
8713,160000,128000,0,1,1,0,0,0,0,157395,7771,149624,0,159178,7300,151878,0,121642,4163,117479,0,124347,4470,119877
8714,60000,48000,0,1,0,0,0,0,0,59942,2742,57200,0,28934,1200,27734,0,27461,1461,26000,0,28504,1504,27000
8715,200000,160000,0,0,0,0,0,0,-1,0,0,0,-2,0,0,0,-2,0,0,0,-2,0,0,0
8716,460000,368000,0,0,0,0,0,0,0,19403,9456,9947,0,10063,10063,0,-1,8628,0,8628,0,0,0,0
8717,160000,128000,0,0,0,0,0,0,-1,827,827,0,-1,827,827,0,-1,827,827,0,-1,827,827,0
8718,140000,112000,0,0,0,0,0,0,-1,5413,0,5413,2,5841,5000,841,2,5215,0,5215,2,8671,8671,0
8719,410000,328000,0,0,0,0,0,0,0,246011,10000,236011,0,240845,7500,233345,0,213767,8000,205767,0,214410,8000,206410
8720,230000,184000,0,1,1,1,0,1,0,213058,7769,205289,0,216260,7757,208503,0,215968,8030,207938,0,174195,6549,167646
8721,50000,40000,0,0,0,0,0,0,0,0,0,0,-2,0,0,0,-2,0,0,0,-2,0,0,0
8722,30000,24000,0,1,1,1,1,0,0,27209,1451,25758,0,27924,1166,26758,0,30204,2900,27304,0,30000,600,29400
8723,80000,64000,0,0,0,0,0,1,0,66171,2470,63701,0,58683,2228,56455,0,43421,1516,41905,0,44267,2000,42267
8724,160000,128000,0,0,0,0,0,0,0,28350,5002,23348,0,25186,5000,20186,0,36100,14400,21700,0,21707,10000,11707
8725,100000,80000,0,0,0,0,0,0,0,20904,5000,15904,0,13955,1000,12955,0,14573,4000,10573,0,16084,5000,11084
8726,10000,8000,0,0,0,0,0,1,2,2400,0,2400,7,2400,0,2400,7,2400,0,2400,7,2400,0,2400
8727,400000,320000,0,0,0,0,0,0,-1,499,499,0,-1,1487,1487,0,-1,499,499,0,-1,499,499,0
8728,140000,112000,0,1,1,0,0,1,0,137236,8000,129236,0,121914,5485,116429,0,71210,5000,66210,0,72778,3000,69778
8729,150000,120000,0,0,0,0,0,0,2,29425,29425,0,-1,30437,2000,28437,0,31123,1528,29595,0,28997,1518,27479
8730,250000,200000,0,0,0,0,0,0,0,169492,7037,162455,0,172936,6358,166578,0,136182,4918,131264,0,139362,5420,133942
8731,180000,144000,0,0,0,0,0,0,0,101689,6500,95189,0,102925,5000,97925,0,0,0,0,0,0,0,0
8732,140000,112000,0,0,0,0,0,1,2,98015,3600,94415,2,99155,3600,95555,2,100979,3500,97479,2,99251,0,99251
8733,200000,160000,0,0,0,0,0,0,-1,2521,2521,0,-1,6934,6935,-1,-1,2255,2255,0,-1,3021,3021,0
8734,380000,304000,0,0,0,0,0,0,0,257028,10600,246428,0,266487,15000,251487,0,269786,9800,259986,0,265312,10000,255312
8735,360000,288000,0,0,0,0,0,0,-2,0,0,0,-2,0,0,0,-2,0,0,0,-2,0,0,0
8736,110000,88000,0,0,0,0,0,0,0,25656,1700,23956,0,22049,1800,20249,0,22456,1000,21456,0,18326,800,17526
8737,140000,112000,0,0,0,0,0,0,0,67571,4000,63571,0,26968,2000,24968,0,-4082,0,-4082,0,-4082,0,-4082
8738,50000,40000,0,0,0,0,0,0,0,21190,1352,19838,0,21838,1000,20838,0,22485,1000,21485,0,23110,1000,22110
8739,20000,16000,0,0,0,1,0,1,2,16429,1700,14729,0,19764,4000,15764,0,19140,0,19140,2,6420,1000,5420
8740,20000,16000,0,1,1,1,1,0,0,18911,1611,17300,0,19000,700,18300,0,19397,704,18693,0,19941,867,19074
8741,50000,40000,0,0,0,0,1,0,0,36251,1021,35230,0,438,438,0,-1,43367,43367,0,-1,44305,1800,42505
8742,200000,160000,0,0,0,0,0,0,-1,6143,24,6119,2,2982,2991,-9,-1,6013,6031,-18,-1,15916,16028,-112
8743,20000,16000,0,1,1,1,1,1,0,18600,1368,17232,0,19034,1192,17842,0,19022,570,18452,0,19046,606,18440
8744,500000,400000,0,0,0,0,0,0,0,26176,1055,25121,2,18124,23,18101,2,8133,9,8124,0,4051,20,4031
8745,150000,120000,0,1,1,0,0,0,0,133619,4900,128719,0,127043,4677,122366,0,112067,4707,107360,0,39901,1700,38201
8746,20000,16000,1,1,1,1,1,1,0,21867,1400,20467,0,21813,1400,20413,0,21228,800,20428,0,21614,1783,19831
8747,260000,208000,0,0,0,0,0,0,0,55359,33061,22298,0,39189,5039,34150,0,49909,20154,29755,0,20782,2854,17928
8748,150000,120000,0,0,0,0,0,0,-1,0,0,0,-1,0,0,0,-2,0,0,0,-2,0,0,0
8749,150000,120000,0,0,0,0,0,0,-1,18204,18267,-63,-1,16132,16142,-10,-2,-5880,5880,-11760,-2,-20544,13707,-34251
8750,290000,232000,0,0,0,0,0,0,0,213931,7714,206217,0,212770,7283,205487,0,211098,7407,203691,0,202491,10000,192491
8751,50000,40000,0,0,1,1,1,1,2,41167,1900,39267,2,41890,1700,40190,2,42605,1700,40905,2,41792,0,41792
8752,10000,8000,0,1,1,1,1,0,2,10277,1800,8477,2,9736,0,9736,2,9704,500,9204,0,9725,600,9125
8753,80000,64000,0,0,0,0,0,1,-1,9947,2000,7947,0,10671,2000,8671,0,11923,2000,9923,0,12050,2000,10050
8754,120000,96000,0,0,0,0,0,0,0,16907,1564,15343,0,14920,528,14392,0,10866,494,10372,0,8788,3000,5788
8755,70000,56000,0,0,0,0,0,0,2,4885,4885,0,-1,11889,11889,0,-1,0,0,0,-1,4280,4280,0
8756,160000,128000,0,0,0,0,0,0,-1,671,671,0,-1,671,671,0,-1,671,671,0,-1,1492,1492,0
8757,20000,16000,0,0,0,0,1,1,2,8810,1495,7315,2,9470,1000,8470,2,18315,9000,9315,0,19237,1800,17437
8758,50000,40000,0,0,0,1,0,0,0,26097,1600,24497,0,27148,1500,25648,0,54991,1000,53991,0,28480,2400,26080
8759,120000,96000,0,0,0,0,0,0,0,11761,1000,10761,0,6761,0,6761,0,7189,1000,6189,0,1087,1087,0
8760,260000,208000,0,0,0,0,0,0,-1,2527,2527,0,-1,1698,1698,0,-1,0,0,0,-1,5062,5062,0
8761,230000,184000,0,1,1,1,1,1,2,221419,10000,211419,2,224753,8500,216253,2,228022,8500,219522,2,232724,8500,224224
8762,30000,24000,0,1,0,0,0,0,0,29016,1276,27740,0,7946,1132,6814,0,8114,300,7814,0,8382,400,7982
8763,20000,16000,0,0,1,0,0,0,0,19670,5200,14470,0,16730,350,16380,0,18757,4500,14257,0,12875,1000,11875
8764,50000,40000,0,0,0,0,0,0,-1,22553,22730,-177,-1,14900,14911,-11,-1,6758,6758,0,-1,3727,3727,0
8765,200000,160000,0,0,0,0,0,0,0,155290,6760,148530,0,147604,5018,142586,0,146719,5370,141349,0,143317,5294,138023
8766,120000,96000,0,0,0,0,0,0,-2,316,316,0,-2,316,316,0,-2,316,316,0,-2,316,316,0
8767,200000,160000,0,1,1,1,1,0,0,204693,9593,195100,0,195319,6919,188400,0,193566,5666,187900,0,182175,4686,177489
8768,180000,144000,0,0,0,0,0,0,2,130083,4052,126031,0,64398,2293,62105,0,62277,2295,59982,0,58216,2400,55816
8769,150000,120000,0,0,0,0,0,0,0,24335,0,24335,2,24908,1200,23708,0,15339,507,14832,0,0,0,0
8770,20000,16000,0,0,0,0,0,0,0,7720,3000,4720,0,9907,2500,7407,0,9627,0,9627,2,11500,2000,9500
8771,50000,40000,0,0,0,0,0,0,-1,997,1000,-3,-1,-3,0,-3,-1,999,1002,-3,-1,491,492,-1
8772,200000,160000,0,0,0,0,0,1,0,139725,6600,133125,0,142605,6700,135905,0,149894,11200,138694,0,153054,5700,147354
8773,120000,96000,0,1,0,0,0,0,0,106464,10000,96464,0,92788,20014,72774,0,29989,0,29989,0,31215,6000,25215
8774,140000,112000,0,1,1,0,0,1,0,139462,6,139456,2,125046,4578,120468,0,46364,1427,44937,0,83460,87179,-3719
8775,120000,96000,0,0,0,0,0,0,-1,1887,1887,0,-1,435,435,0,-1,435,435,0,-1,435,435,0
8776,160000,128000,0,0,0,0,0,0,0,75521,5000,70521,0,78987,10000,68987,0,80891,4000,76891,0,62113,3000,59113
8777,130000,104000,0,0,0,0,0,0,0,17740,5000,12740,0,1330,1330,0,-1,7095,7095,0,-1,1190,1190,0
8778,210000,168000,0,0,0,0,0,1,-1,326,326,0,-1,326,326,0,-1,326,326,0,-1,326,326,0
8779,210000,168000,0,0,0,0,0,1,-1,390,390,0,-1,390,390,0,-1,390,390,0,-1,150,150,0
8780,140000,112000,0,1,0,0,0,1,0,140661,5500,135161,0,100656,2650,98006,0,49783,36000,13783,0,49310,1000,48310
8781,170000,136000,0,0,0,0,0,0,0,44283,2000,42283,0,46352,3000,43352,0,51384,6000,45384,0,50568,0,50568
8782,50000,40000,0,1,0,0,0,0,0,49505,2204,47301,0,17612,656,16956,0,19461,2159,17302,0,18660,678,17982
8783,50000,40000,0,0,0,0,0,0,0,22829,2506,20323,0,13216,3000,10216,0,16100,3000,13100,0,16696,1070,15626
8784,20000,16000,0,1,1,1,1,0,0,20269,2276,17993,0,18654,791,17863,0,18914,686,18228,0,20200,1600,18600
8785,80000,64000,0,0,0,0,0,0,3,2321,0,2321,2,4247,2001,2246,2,3914,4,3910,2,3242,1073,2169
8786,20000,16000,0,0,1,0,0,0,0,16749,1417,15332,0,17538,1206,16332,0,13840,284,13556,0,7370,147,7223
8787,70000,56000,0,0,0,0,0,1,3,28968,0,28968,2,29540,2032,27508,0,29505,1069,28436,0,29428,1066,28362
8788,30000,24000,0,0,0,0,0,0,0,12192,1300,10892,0,12986,1000,11986,0,13775,1000,12775,0,14393,1000,13393
8789,200000,160000,0,0,0,0,0,0,-2,0,0,0,-2,0,0,0,-2,0,0,0,-2,0,0,0
8790,100000,80000,0,0,0,0,0,1,2,59730,5600,54130,3,61693,3500,58193,4,59186,0,59186,4,57949,0,57949
8791,450000,360000,0,0,0,0,0,0,-2,0,0,0,-2,1620,1620,0,-2,0,0,0,-2,4155,4155,0
8792,50000,40000,0,0,0,0,0,0,0,31539,1281,30258,0,17342,700,16642,0,17541,700,16841,0,18149,1000,17149
8793,130000,104000,0,0,0,0,0,0,2,70912,4130,66782,2,63626,43,63583,2,59200,2000,57200,0,38263,1368,36895
8794,270000,216000,0,0,0,0,0,0,0,11452,14468,-3016,-1,2295,2295,0,-1,0,0,0,-1,0,0,0
8795,90000,72000,0,0,0,0,0,1,-2,1330,1330,0,-2,950,950,0,-2,950,950,0,-2,11786,11786,0
8796,20000,16000,0,1,1,0,0,0,0,18570,1376,17194,0,17604,1383,16221,0,11973,1000,10973,0,9517,455,9062
8797,310000,248000,0,0,0,0,0,0,0,121016,0,121016,2,111214,5000,106214,0,101957,4000,97957,0,92805,4000,88805
8798,260000,208000,0,0,0,0,0,0,0,72994,2376,70618,0,57382,2084,55298,0,58522,2095,56427,0,59748,2169,57579
8799,210000,168000,0,0,0,0,0,0,-2,1032,1032,0,-2,788,788,0,-2,3499,3565,-66,-2,3372,3372,0
8800,50000,40000,0,0,0,0,0,0,0,20712,1200,19512,0,17834,2500,15334,0,18248,618,17630,0,19390,4000,15390
8801,170000,136000,0,1,1,0,0,0,0,165816,7103,158713,0,166023,5451,160572,0,96415,6000,90415,0,127480,80000,47480
8802,90000,72000,0,1,1,1,1,0,-1,77974,2836,75138,0,80064,3657,76407,0,81747,2972,78775,0,86611,6228,80383
8803,210000,168000,0,0,0,0,0,0,-1,188,188,0,-1,16464,16476,-12,-1,13947,0,13947,0,0,0,0
8804,300000,240000,0,0,0,0,0,0,-2,0,0,0,-2,0,0,0,-2,1894,1894,0,-1,2394,500,1894
8805,80000,64000,0,1,0,0,0,0,0,80041,8443,71598,0,19000,1582,17418,0,15178,548,14630,0,14717,531,14186
8806,50000,40000,0,1,0,0,0,0,2,50556,2247,48309,0,29759,1054,28705,0,30381,1090,29291,0,30440,1261,29179
8807,230000,184000,0,0,0,0,0,0,0,41862,10010,31852,0,21655,5000,16655,0,64645,64667,-22,-1,44627,5003,39624
8808,500000,400000,0,0,0,0,0,0,-2,0,0,0,-2,0,0,0,-2,0,0,0,-2,0,0,0
8809,290000,232000,1,1,1,1,1,0,0,314085,12012,302073,0,317631,11016,306615,0,315820,11088,304732,0,305498,12031,293467
8810,30000,24000,0,1,1,1,1,0,0,30221,1518,28703,0,29376,1439,27937,0,29564,1017,28547,0,28762,1032,27730
8811,10000,8000,0,0,0,0,0,1,0,5785,1155,4630,0,7134,1500,5634,0,3535,1000,2535,0,4323,1000,3323
8812,50000,40000,0,1,1,0,0,1,0,50702,2514,48188,0,49663,2475,47188,0,0,0,0,0,0,0,0
8813,260000,208000,0,0,0,0,0,1,2,145333,0,145333,2,148332,6910,141422,0,160810,16502,144308,0,155683,0,155683
8814,490000,392000,0,0,0,0,0,0,-2,380,380,0,-2,15240,15240,0,-1,19656,5000,14656,0,24006,5000,19006
8815,110000,88000,0,0,0,0,0,0,0,31752,2000,29752,0,30539,2000,28539,0,29468,2000,27468,0,33259,7000,26259
8816,230000,184000,0,0,0,0,0,1,-2,44178,2600,41578,-2,4221,7797,-3576,-1,4009,0,4009,2,8990,5180,3810
8817,240000,192000,0,1,1,0,0,1,0,233781,10128,223653,0,220150,8012,212138,0,190170,6500,183670,0,194018,7000,187018
8818,50000,40000,0,0,0,0,0,0,0,18332,1274,17058,0,18301,633,17668,0,18639,1000,17639,0,18516,724,17792
8819,230000,184000,0,0,0,0,0,0,-2,500,500,0,-2,1614,1614,0,-2,0,0,0,-2,2800,2800,0
8820,450000,360000,0,0,0,0,0,0,0,136434,6000,130434,0,126121,5087,121034,0,115050,5000,110050,0,105901,5000,100901
8821,130000,104000,0,0,0,0,0,0,0,94597,8600,85997,0,92077,0,92077,2,93272,3500,89772,0,96298,7100,89198
8822,290000,232000,0,0,0,0,0,0,0,71541,4033,67508,0,59493,2828,56665,0,67821,10000,57821,0,71546,5000,66546
8823,50000,40000,0,0,0,0,0,1,0,3,1000,-997,-1,18080,19000,-920,-1,12227,12500,-273,-1,13296,2000,11296
8824,200000,160000,0,0,0,0,0,0,0,160181,6402,153779,0,161469,6715,154754,0,104232,4625,99607,0,151726,50086,101640
8825,70000,56000,0,1,1,0,0,1,0,70815,3202,67613,0,63183,2989,60194,0,31633,1081,30552,0,31275,1099,30176
8826,80000,64000,0,1,1,1,1,0,0,80510,2931,77579,0,81565,3600,77965,0,81232,2908,78324,0,81422,3117,78305
8827,30000,24000,0,0,0,0,1,0,0,22120,1510,20610,0,23746,3000,20746,0,25346,2000,23346,0,24801,0,24801
8828,120000,96000,0,0,0,0,0,0,0,37179,1616,35563,0,38500,1937,36563,0,38955,1392,37563,0,39926,1596,38330
8829,90000,72000,0,0,0,0,0,0,2,12628,2000,10628,0,20172,20172,0,-1,73512,73512,0,-1,72588,3000,69588
8830,180000,144000,0,0,0,0,0,0,-2,0,0,0,-2,0,0,0,-2,0,0,0,-2,0,0,0
8831,20000,16000,0,1,1,1,1,1,-2,19342,1281,18061,0,19081,658,18423,0,19799,1000,18799,0,18718,1000,17718
8832,270000,216000,0,0,0,0,0,0,0,166550,16000,150550,0,162244,7,162237,2,126877,5000,121877,0,129903,5000,124903
8833,140000,112000,0,0,0,0,0,0,-1,13380,10000,3380,0,18415,8000,10415,0,20135,5000,15135,0,27390,22000,5390
8834,220000,176000,0,0,0,0,0,1,3,4283,0,4283,2,5807,1587,4220,2,5568,0,5568,2,5827,500,5327
8835,110000,88000,0,0,0,0,0,0,0,68170,2500,65670,0,69634,2600,67034,0,73981,5519,68462,0,72676,0,72676
8836,120000,96000,0,0,0,0,0,0,0,44943,1500,43443,0,37176,1500,35676,0,38245,1500,36745,0,28682,1500,27182
8837,360000,288000,0,0,0,0,0,0,-1,1488,5,1483,2,490,2,488,0,1697,1705,-8,-1,789,792,-3
8838,20000,16000,0,0,0,0,0,0,-1,-220,0,-220,-2,-610,0,-610,-2,390,1390,-1000,-1,0,0,0
8839,50000,40000,0,0,0,0,0,0,0,28134,1500,26634,0,29208,1500,27708,0,7778,0,7778,0,9790,5000,4790
8840,130000,104000,0,0,0,0,0,0,-2,390,1560,-1170,-1,0,0,0,-1,-390,0,-390,-2,390,1170,-780
8841,50000,40000,0,0,0,0,0,0,0,0,0,0,0,940,940,0,-1,0,0,0,-1,0,0,0
8842,260000,208000,0,0,0,0,0,0,-2,-40,0,-40,-2,8117,8157,-40,-2,-8,0,-8,-2,-8,0,-8
8843,210000,168000,0,0,0,0,0,0,-1,16488,16560,-72,-1,12900,13024,-124,-1,20108,12541,7567,0,18378,7091,11287
8844,300000,240000,0,0,0,0,0,0,0,31180,1427,29753,0,19507,600,18907,0,18169,1200,16969,0,18533,2500,16033
8845,50000,40000,0,0,0,0,0,0,0,8832,1002,7830,0,10931,13359,-2428,-1,11578,800,10778,-1,10547,0,10547
8846,130000,104000,0,0,0,0,0,1,0,74745,2584,72161,0,68597,4000,64597,0,54774,2006,52768,0,53728,2000,51728
8847,240000,192000,0,0,0,0,0,0,0,48370,0,48370,2,49660,2000,47660,0,53090,4000,49090,0,48215,0,48215
8848,380000,304000,0,0,0,0,0,0,0,270219,270219,0,-1,3641,131,3510,0,3717,135,3582,0,3791,136,3655
8849,80000,64000,0,1,1,0,0,1,2,78353,0,78353,2,78814,3328,75486,0,49062,1888,47174,0,48764,1787,46977
8850,20000,16000,0,1,1,1,0,0,0,20112,1400,18712,0,19712,0,19712,0,19712,0,19712,0,6321,0,6321
8851,430000,344000,0,0,0,0,0,0,0,202412,8000,194412,0,207496,12000,195496,0,250337,50000,200337,0,255277,28000,227277
8852,200000,160000,0,0,0,0,0,1,-2,0,0,0,-2,0,0,0,-2,0,0,0,-2,0,0,0
8853,80000,64000,0,0,0,0,0,0,0,60738,10000,50738,0,62818,7296,55522,0,45413,3000,42413,0,44793,3000,41793
8854,370000,296000,0,0,0,0,0,0,0,72547,3046,69501,0,74501,3000,71501,0,76058,2589,73469,0,77572,2603,74969
8855,80000,64000,0,0,0,0,0,0,0,40502,2030,38472,0,15948,1476,14472,0,15915,833,15082,0,390,390,0
8856,30000,24000,0,0,0,0,0,0,0,0,0,0,0,0,0,0,-2,0,0,0,-2,0,0,0
8857,50000,40000,1,1,0,0,0,0,0,57608,1815,55793,0,19394,657,18737,0,19619,1000,18619,0,20024,1000,19024
8858,230000,184000,0,0,0,0,0,1,-1,5090,5090,0,-1,19394,19394,0,-1,205,0,205,-1,0,3916,-3916
8859,500000,400000,0,0,0,0,0,0,-1,13202,13357,-155,-1,16546,16600,-54,-1,12585,12585,0,-1,14287,14287,0
8860,110000,88000,0,1,1,1,1,0,0,111867,4230,107637,0,111535,4200,107335,0,111870,4300,107570,0,110979,4150,106829
8861,10000,8000,0,0,1,1,1,0,0,8519,1299,7220,0,9376,1156,8220,0,9562,342,9220,0,9762,354,9408
8862,320000,256000,0,0,0,0,0,1,-1,204787,205211,-424,-1,122501,6100,116401,0,63816,5000,58816,0,17257,2000,15257
8863,500000,400000,0,0,0,0,0,0,-1,4055,4065,-10,-1,3000,3000,0,-1,3000,3000,0,-1,8063,8063,0
8864,210000,168000,0,0,0,0,0,1,-2,0,0,0,-2,0,0,0,-2,0,0,0,-2,0,0,0
8865,200000,160000,0,0,0,0,0,0,-1,1649,1649,0,-1,2121,2121,0,-1,0,0,0,-1,51110,51110,0
8866,200000,160000,0,0,0,0,0,1,-2,0,0,0,-2,0,0,0,-2,1830,1830,0,-1,0,0,0
8867,10000,8000,0,0,0,1,0,0,0,5239,5000,239,0,7911,4000,3911,0,17890,2000,15890,0,10000,22400,-12400
8868,20000,16000,0,0,0,0,0,1,0,13082,1500,11582,0,13498,634,12864,0,14278,1151,13127,0,13899,0,13899
8869,230000,184000,0,0,0,0,0,0,-1,0,0,0,-1,198,198,0,-1,0,0,0,-1,525,525,0
8870,20000,16000,0,0,0,0,0,1,3,9686,0,9686,2,0,5000,-5000,2,6884,13749,-6865,-1,0,0,0
8871,100000,80000,0,1,1,0,0,0,0,96620,3800,92820,0,97938,3900,94038,0,78126,3000,75126,0,65680,2300,63380
8872,420000,336000,0,0,0,0,0,0,-1,0,0,0,-2,0,0,0,-2,1643,1643,0,-1,6800,3400,3400
8873,120000,96000,0,1,1,1,1,1,2,116061,0,116061,2,116959,9500,107459,2,112050,0,112050,2,111153,4100,107053
8874,50000,40000,0,0,0,0,0,0,-1,1413,1413,0,-1,2890,2890,0,-1,4715,4715,0,-1,1262,1262,0
8875,170000,136000,0,0,0,0,0,0,2,79274,5000,74274,0,82034,5000,77034,0,85664,5000,80664,0,89272,5000,84272
8876,40000,32000,0,0,0,0,0,1,0,23642,0,23642,2,25936,3000,22936,2,25384,0,25384,2,26905,2100,24805
8877,20000,16000,0,1,1,1,1,0,0,19302,0,19302,2,19897,1311,18586,0,19895,699,19196,0,20313,725,19588
8878,90000,72000,0,0,0,0,0,0,-1,4788,5,4783,2,7370,5042,2328,-1,1051,0,1051,0,14014,14014,0
8879,40000,32000,1,1,1,1,0,0,0,92387,3692,88695,0,94078,2846,91232,0,101340,7540,93800,0,20650,0,20650
8880,50000,40000,0,0,0,0,0,0,0,33034,1000,32034,0,0,0,0,0,0,0,0,-2,0,0,0
8881,80000,64000,0,0,0,0,0,0,0,34593,3000,31593,0,38808,5000,33808,0,40942,5000,35942,0,40854,3000,37854
8882,360000,288000,0,0,0,0,0,0,-2,0,0,0,-2,0,0,0,-2,0,0,0,-2,300,300,0
8883,20000,16000,0,0,0,0,0,0,-1,-29,0,-29,-1,2992,3021,-29,-1,3664,3664,0,-1,5364,5364,0
8884,120000,96000,0,1,0,0,0,0,0,112900,5500,107400,0,0,0,0,0,0,0,0,-2,0,0,0
8885,250000,200000,0,0,0,0,0,0,-2,14505,14548,-43,-1,4757,4771,-14,-1,11357,11491,-134,-1,6679,6896,-217
8886,90000,72000,0,1,0,0,0,1,0,89791,5000,84791,0,53096,3100,49996,0,52340,1700,50640,0,27660,1421,26239
8887,240000,192000,0,0,0,0,0,0,-1,25331,0,25331,2,26605,2000,24605,0,26279,0,26279,0,1256,1256,0
8888,180000,144000,0,0,0,0,0,1,0,128505,6000,122505,0,130078,5000,125078,0,128771,5001,123770,0,106396,4100,102296
8889,80000,64000,0,1,0,0,0,0,0,78401,3100,75301,0,49496,1669,47827,0,50562,1759,48803,0,45682,1700,43982
8890,90000,72000,0,0,0,0,0,0,0,47657,10000,37657,0,52372,6000,46372,0,52112,1570,50542,0,56257,5000,51257
8891,30000,24000,0,0,0,0,0,0,-1,1170,1170,0,-1,780,0,780,0,780,0,780,0,0,0,0
8892,230000,184000,0,0,0,0,0,0,-2,0,0,0,-2,0,0,0,-2,0,0,0,-2,6946,6946,0
8893,380000,304000,0,0,0,0,0,0,0,58665,2555,56110,0,43837,1515,42322,0,72069,37056,35013,0,61925,2413,59512
8894,230000,184000,0,0,0,0,0,0,-2,986,995,-9,-1,0,0,0,-1,0,0,0,-2,900,900,0
8895,160000,128000,0,1,1,1,1,1,2,146534,5500,141034,2,147955,5310,142645,2,145488,0,145488,2,155041,12000,143041
8896,120000,96000,0,0,0,0,0,0,-1,0,0,0,-2,0,0,0,-2,0,0,0,-2,0,0,0
8897,290000,232000,0,0,0,0,0,0,0,32034,6010,26024,0,29620,5000,24620,0,29822,1200,28622,0,28502,2000,26502
8898,240000,192000,0,1,0,0,0,1,2,204769,0,204769,2,62670,2806,59864,0,10408,500,9908,0,10848,562,10286
8899,20000,16000,0,1,0,0,0,0,0,18405,1000,17405,0,0,400,-400,0,380,380,0,-1,-400,0,-400
8900,140000,112000,0,0,0,0,0,0,-1,9778,9803,-25,-1,6417,1004,5413,0,1831,1831,0,-1,7126,7126,0
8901,80000,64000,0,0,0,0,0,0,0,70223,10000,60223,0,53429,23000,30429,0,28689,5000,23689,0,24827,10000,14827
8902,50000,40000,0,0,0,0,0,0,0,38604,1906,36698,0,33570,1000,32570,0,0,0,0,0,0,0,0
8903,200000,160000,0,0,0,0,0,0,-1,19272,19272,0,-1,22388,10004,12384,0,21105,10000,11105,0,3471,3471,0
8904,100000,80000,0,1,1,1,1,0,0,98010,4000,94010,2,99633,4507,95126,0,88708,2983,85725,0,93474,6000,87474
8905,190000,152000,0,1,1,0,0,0,0,186002,7962,178040,0,170873,7000,163873,0,98013,3417,94596,0,94600,3463,91137
8906,10000,8000,0,0,0,0,0,0,0,8386,1100,7286,2,7512,1107,6405,0,7615,600,7015,0,7621,264,7357
8907,200000,160000,0,0,0,0,0,0,2,93114,0,93114,2,94239,3365,90874,0,99428,6700,92728,0,101843,4000,97843
8908,180000,144000,0,0,0,0,0,0,-1,0,0,0,-1,3180,3180,0,-1,2682,2682,0,-1,0,0,0
8909,50000,40000,0,1,1,1,1,0,0,47750,2100,45650,0,48194,1900,46294,0,48111,1900,46211,0,48664,1900,46764
8910,70000,56000,0,0,0,0,0,0,2,17695,1300,16395,0,17791,1240,16551,0,15704,600,15104,0,16257,1000,15257
8911,80000,64000,0,1,1,1,1,1,0,78145,0,78145,2,80584,6000,74584,2,81693,3000,78693,2,78470,0,78470
8912,70000,56000,0,0,0,0,0,0,0,22729,3500,19229,0,24346,2000,22346,0,24940,1000,23940,0,25539,1000,24539
8913,80000,64000,0,0,0,0,0,0,0,2521,1000,1521,0,531,531,0,0,9766,9354,412,-2,10042,438,9604
8914,140000,112000,0,0,0,0,0,1,-2,0,0,0,-2,76,76,0,-1,76,0,76,-1,76,0,76
8915,50000,40000,0,0,0,0,0,0,0,34725,2354,32371,0,15735,4147,11588,0,0,0,0,0,0,0,0
8916,320000,256000,0,1,1,0,0,1,0,293055,22,293033,2,269585,11155,258430,0,248093,9100,238993,0,239025,8700,230325
8917,390000,312000,0,0,0,0,0,0,0,187648,7001,180647,0,192538,8001,184537,0,198828,10000,188828,0,206489,10000,196489
8918,90000,72000,0,0,0,0,0,0,0,25574,16776,8798,0,21948,19689,2259,0,19689,0,19689,0,11026,5000,6026
8919,90000,72000,0,1,0,0,0,0,0,87653,3597,84056,0,35565,1179,34386,0,30942,1112,29830,0,30835,1104,29731
8920,80000,64000,0,1,1,0,0,0,0,73968,2875,71093,0,71919,3000,68919,0,59894,3000,56894,0,59405,4000,55405
8921,50000,40000,0,0,0,0,0,1,3,429,0,429,2,4836,4836,0,-1,1170,0,1170,0,780,0,780
8922,220000,176000,0,0,0,0,0,0,0,24081,2000,22081,0,25356,2000,23356,0,20952,1000,19952,0,18340,1200,17140
8923,220000,176000,0,0,0,0,0,0,2,18474,2000,16474,0,20667,2500,18167,0,20195,0,20195,2,21854,2000,19854
8924,160000,128000,0,0,0,0,0,0,0,4443,1038,3405,0,0,0,0,0,0,0,0,-2,0,0,0
8925,420000,336000,0,0,0,0,0,0,-1,3400,3400,0,-1,2535,2535,0,-1,3216,3216,0,-1,4652,2652,2000
8926,170000,136000,0,0,0,0,0,0,-2,1630,1630,0,-2,2326,2326,0,-2,660,660,0,-2,1373,1373,0
8927,50000,40000,0,1,1,0,0,1,0,50866,2184,48682,0,48390,1248,47142,0,17953,359,17594,0,23,0,23
8928,150000,120000,0,0,0,0,0,0,0,103297,4573,98724,0,100603,5000,95603,0,98188,5000,93188,0,101441,5000,96441
8929,50000,40000,1,1,1,0,0,1,0,51052,0,51052,2,50116,2000,48116,0,20181,19000,1181,0,19702,1000,18702
8930,180000,144000,0,0,0,0,0,0,0,76602,3310,73292,0,76896,2900,73996,0,78588,3040,75548,0,77770,3500,74270
8931,90000,72000,0,0,0,0,0,1,2,9078,0,9078,2,10267,1500,8767,0,10350,550,9800,0,10564,529,10035
8932,290000,232000,0,0,0,0,0,1,2,197238,9000,188238,0,202680,10500,192180,0,133478,17000,116478,0,131024,0,131024
8933,240000,192000,0,0,0,0,0,0,0,16873,16906,-33,-1,1143,1143,0,-1,4317,4317,0,-1,14940,14940,0
8934,130000,104000,0,0,0,0,0,0,-2,0,0,0,-2,0,0,0,-2,0,0,0,-2,0,0,0
8935,400000,320000,0,0,0,0,0,0,-1,2691,2691,0,-1,1781,1781,0,-1,7123,7123,0,-1,1470,1470,0
8936,80000,64000,0,0,0,0,0,0,0,801,801,0,-1,1030,1030,0,-1,2030,1000,1030,0,763,0,763
8937,50000,40000,0,1,1,0,0,0,0,50135,2200,47935,0,50269,3300,46969,0,29182,1200,27982,0,29096,1100,27996
8938,290000,232000,0,0,0,0,0,0,0,71523,2598,68925,0,73099,2767,70332,0,74469,2702,71767,0,76200,2968,73232
8939,360000,288000,0,0,0,0,0,0,-1,4993,5018,-25,-1,498,505,-7,-1,-2,0,-2,-1,-2,0,-2
8940,110000,88000,0,0,0,0,0,0,0,83913,3021,80892,0,47369,1649,45720,0,48905,3513,45392,0,46046,0,46046
8941,20000,16000,0,1,1,1,1,1,2,20645,1000,19645,2,20750,718,20032,2,20300,3,20297,2,20482,1800,18682
8942,300000,240000,0,0,0,0,0,0,-2,743,743,0,-2,3040,3047,-7,-2,1927,1927,0,-2,14713,14713,0
8943,180000,144000,0,0,0,0,0,0,-1,3044,3044,0,-1,5283,5283,0,-1,1660,1660,0,-1,6671,6671,0
8944,20000,16000,0,0,0,0,0,1,-2,0,0,0,-2,0,0,0,-2,0,0,0,-2,0,0,0
8945,50000,40000,0,1,1,0,0,1,0,48468,2500,45968,0,42840,2070,40770,0,30378,1266,29112,0,29706,2000,27706
8946,50000,40000,1,1,1,0,0,0,0,98450,1000,97450,2,48689,2000,46689,0,19773,900,18873,0,19931,900,19031
8947,50000,40000,0,1,1,1,1,1,2,47390,1700,45690,2,44520,0,44520,2,45310,3500,41810,2,44430,0,44430
8948,140000,112000,0,0,0,0,0,1,-1,326,326,0,-1,326,326,0,-1,326,326,0,-1,326,326,0
8949,120000,96000,0,1,0,0,0,0,0,115767,4300,111467,0,38070,1175,36895,0,39306,1658,37648,0,39200,784,38416
8950,80000,64000,0,0,0,0,0,0,0,51787,2400,49387,0,52422,2000,50422,0,53608,2100,51508,0,50312,2500,47812
8951,30000,24000,0,1,1,1,1,1,2,30324,2700,27624,2,27446,0,27446,2,29329,2300,27029,2,29720,1000,28720
8952,80000,64000,0,0,0,0,0,1,-2,647,647,0,-2,1988,1990,-2,-2,1049,1049,0,-2,1466,1466,0
8953,330000,264000,0,0,0,0,0,0,0,184973,6710,178263,0,172124,6223,165901,0,158958,5671,153287,0,144889,5274,139615
8954,290000,232000,0,1,1,1,1,1,0,278422,11600,266822,0,283034,12628,270406,0,284430,8000,276430,2,294131,16600,277531
8955,50000,40000,0,0,0,0,0,0,0,3847,3858,-11,-1,11117,11139,-22,-1,6479,3009,3470,0,6187,3016,3171
8956,70000,56000,0,0,0,0,0,1,2,24419,0,24419,2,23541,2000,21541,0,10576,1000,9576,0,6985,0,6985
8957,160000,128000,0,1,1,0,0,1,2,148953,6100,142853,2,144119,0,144119,2,48552,2000,46552,0,49770,2000,47770
8958,90000,72000,1,1,1,1,1,0,2,94681,3500,91181,2,93965,3500,90465,2,90545,0,90545,2,90529,3500,87029
8959,250000,200000,0,0,0,0,0,0,0,21867,1585,20282,0,13190,3028,10162,0,27817,27817,0,-1,22001,0,22001
8960,130000,104000,0,0,0,0,0,0,0,91199,3130,88069,0,89446,3100,86346,0,91336,3200,88136,0,84756,3100,81656
8961,70000,56000,0,0,0,0,0,0,-1,24726,0,24726,2,25377,875,24502,0,24818,600,24218,0,14978,1000,13978
8962,230000,184000,0,0,0,0,0,0,0,21729,1700,20029,0,23113,2007,21106,0,22936,1000,21936,0,23378,1000,22378
8963,500000,400000,0,0,0,0,0,0,-2,248807,248902,-95,-1,179086,3582,175504,0,160121,3202,156919,0,52190,52190,0
8964,20000,16000,0,0,0,0,0,1,-1,0,0,0,-1,0,0,0,-2,0,0,0,-2,0,0,0
8965,210000,168000,0,0,0,0,0,0,-1,2570,2570,0,-1,14722,14722,0,-1,11220,11220,0,-1,14800,14800,0
8966,200000,160000,0,0,0,0,0,1,-1,-2,0,-2,-1,120,122,-2,-1,150,300,-150,-1,928,928,0
8967,170000,136000,0,0,0,0,0,0,-1,970,970,0,-1,290,290,0,-1,590,590,0,-1,1222,1222,0
8968,180000,144000,0,1,1,0,0,0,0,182287,7100,175187,0,159992,5659,154333,0,145387,5100,140287,0,137632,4900,132732
8969,50000,40000,0,0,0,0,0,0,0,16275,3096,13179,0,23790,12000,11790,0,2250,2250,0,-1,2100,500,1600
8970,180000,144000,0,0,0,0,0,0,0,26103,1738,24365,0,27113,1748,25365,0,27495,1130,26365,0,27914,1011,26903
8971,260000,208000,0,0,0,0,0,0,0,121805,4150,117655,0,127594,8000,119594,0,110146,4000,106146,0,112364,4000,108364
8972,180000,144000,0,0,0,0,0,0,-1,1200,1200,0,-1,0,0,0,-1,0,0,0,-2,0,0,0
8973,60000,48000,0,1,0,0,0,0,0,50469,1612,48857,0,40564,1404,39160,0,40601,1442,39159,0,40467,1445,39022
8974,130000,104000,0,0,0,0,0,0,0,35400,5000,30400,0,0,0,0,0,0,0,0,-2,0,0,0
8975,160000,128000,0,0,0,0,0,1,0,0,0,0,0,0,0,0,-2,0,0,0,-2,0,0,0
8976,500000,400000,0,0,0,0,0,0,-2,1556,1742,-186,-2,2080,2080,0,-2,4403,4409,-6,-2,3405,3405,0
8977,370000,296000,0,0,0,0,0,0,0,285705,11000,274705,0,295747,15000,280747,0,250158,10000,240158,0,255956,10000,245956
8978,240000,192000,0,0,0,0,0,0,0,12073,4014,8059,0,9643,113,9530,0,-8074,6423,-14497,0,108493,120000,-11507
8979,20000,16000,0,0,0,0,0,0,-1,0,0,0,-1,780,780,0,-1,0,0,0,-1,378,378,0
8980,100000,80000,0,0,0,0,0,1,0,75856,10000,65856,0,74062,0,74062,3,72756,0,72756,2,76355,5000,71355
8981,320000,256000,0,0,0,0,0,0,0,178018,6343,171675,0,172200,6003,166197,0,164032,5967,158065,0,165857,6525,159332
8982,180000,144000,0,0,0,0,0,0,-1,316,316,0,-1,396,396,0,-1,396,396,0,-1,3306,3306,0
8983,260000,208000,0,0,0,0,0,1,2,18488,10000,8488,0,27022,11264,15758,0,28402,1580,26822,0,800,2,798
8984,30000,24000,0,0,0,0,0,0,-2,3781,4000,-219,-2,1991,1991,0,-2,3951,3951,0,-2,2612,2612,0
8985,50000,40000,0,0,0,0,0,0,0,21784,1700,20084,0,22794,1679,21115,0,23115,1000,22115,0,23752,1010,22742
8986,190000,152000,0,0,0,0,0,0,0,131132,7000,124132,0,96083,3585,92498,0,97453,3700,93753,0,99426,3754,95672
8987,100000,80000,0,0,0,0,0,0,0,73749,3025,70724,0,68512,2344,66168,0,72518,5000,67518,0,65890,3000,62890
8988,20000,16000,0,0,0,1,1,1,0,15784,1500,14284,0,19062,4300,14762,0,19444,624,18820,0,20004,800,19204
8989,400000,320000,0,0,0,0,0,0,-2,6888,7013,-125,-2,3519,3600,-81,-2,77,1500,-1423,-2,927,1000,-73
8990,30000,24000,0,0,0,0,0,1,0,15504,1257,14247,0,15812,565,15247,0,16143,585,15558,0,16606,730,15876
8991,50000,40000,0,0,0,0,0,0,0,16908,1500,15408,0,17327,1000,16327,0,17895,1000,16895,0,18346,900,17446
8992,170000,136000,0,0,0,0,0,0,0,18800,1196,17604,0,17647,544,17103,0,18015,563,17452,0,12930,629,12301
8993,100000,80000,0,0,0,0,0,0,-2,-1678,0,-1678,-2,-1478,200,-1678,-2,1058,4058,-3000,-2,5556,5738,-182
8994,220000,176000,0,0,0,0,0,0,-2,6791,6835,-44,-2,6495,6535,-40,-2,5093,5118,-25,-2,5503,5529,-26
8995,130000,104000,0,0,0,0,0,0,0,2315,2315,0,-1,101035,100000,1035,0,82288,3500,78788,0,86788,8000,78788
8996,150000,120000,0,0,0,0,0,0,0,105000,3000,102000,0,0,0,0,0,0,0,0,-2,0,0,0
8997,500000,400000,0,0,0,0,0,0,-1,10697,10758,-61,-1,19757,19883,-126,-1,5158,5180,-22,-1,43859,44064,-205
8998,360000,288000,0,0,0,0,0,0,-2,6458,9091,-2633,-1,825,825,0,-1,825,825,0,-1,825,825,0
8999,200000,160000,0,0,0,0,0,0,-1,3783,4000,-217,-1,2522,0,2522,0,1261,0,1261,0,1436,1436,0
9000,50000,40000,0,0,0,0,0,0,0,17865,1035,16830,0,6431,500,5931,0,6939,508,6431,0,4509,410,4099
9001,170000,136000,0,0,0,0,0,0,0,58450,2197,56253,0,58556,1934,56622,0,51671,1793,49878,0,51090,2500,48590
9002,410000,328000,0,0,0,0,0,0,-1,7884,7898,-14,-1,1842,1842,0,-1,1129,1129,0,-1,7592,7592,0
9003,180000,144000,0,0,0,0,0,0,-1,21430,11820,9610,0,21040,21040,0,-1,2234,2234,0,-1,12485,10641,1844
9004,90000,72000,0,0,0,0,0,1,0,19137,0,19137,2,20212,1400,18812,0,20874,1000,19874,0,21387,1000,20387
9005,310000,248000,0,0,0,0,0,0,-2,4566,4566,0,-2,5329,5433,-104,-2,5724,5724,0,-2,1518,1336,182
9006,260000,208000,0,0,0,0,0,0,0,11736,4036,7700,0,10190,204,9986,0,18122,8122,10000,0,0,0,0
9007,50000,40000,0,1,1,0,0,0,0,48160,2100,46060,0,48398,1300,47098,0,17942,650,17292,0,16334,600,15734
9008,180000,144000,0,0,0,0,0,0,-2,-200,0,-200,-2,-200,0,-200,-2,0,200,-200,-2,4709,4709,0
9009,250000,200000,0,0,0,0,0,0,-2,191,191,0,-1,2160,2160,0,-1,0,0,0,-1,900,900,0
9010,180000,144000,0,0,0,0,0,0,-1,0,0,0,-1,880,880,0,-1,150,150,0,-1,430,430,0
9011,30000,24000,0,1,1,0,1,1,0,33364,4501,28863,0,30149,2396,27753,0,27028,4000,23028,0,29261,3076,26185
9012,190000,152000,0,0,0,0,0,0,0,100209,40000,60209,0,85218,25000,60218,0,112672,35000,77672,0,76224,2897,73327
9013,280000,224000,0,0,0,0,0,1,-1,1206,1206,0,-1,300,300,0,-1,460,460,0,-1,861,861,0
9014,200000,160000,0,0,0,0,0,0,0,154977,5854,149123,0,157166,5000,152166,0,160870,5000,155870,0,164101,4600,159501
9015,100000,80000,0,0,0,0,0,0,-1,7626,0,7626,2,11896,11896,0,-1,15520,11008,4512,-1,7156,0,7156
9016,140000,112000,0,0,0,0,0,0,0,21854,5080,16774,0,21711,10000,11711,0,25999,6000,19999,0,902,902,0
9017,290000,232000,0,1,1,1,0,0,0,263204,10508,252696,0,263612,8530,255082,0,259786,8777,251009,0,208000,7421,200579
9018,200000,160000,0,0,0,0,0,0,0,55039,1828,53211,0,55712,1811,53901,0,56421,1816,54605,0,57203,1880,55323
9019,180000,144000,0,1,1,1,1,1,2,159924,8000,151924,0,162775,7000,155775,0,174719,15000,159719,0,178651,7000,171651
9020,90000,72000,0,0,0,0,0,1,-2,0,0,0,-2,0,0,0,-2,0,0,0,-2,0,0,0
9021,210000,168000,0,0,0,0,0,0,-2,569,569,0,-2,378,378,0,-2,378,378,0,-2,378,378,0
9022,150000,120000,0,0,0,0,0,0,0,332,332,0,-1,0,0,0,-1,332,664,-332,-1,332,0,332
9023,230000,184000,0,0,0,0,0,1,0,18968,3000,15968,0,21435,4000,17435,0,27151,8000,19151,0,26815,4000,22815
9024,80000,64000,0,0,0,0,0,0,0,37330,2000,35330,0,38407,2000,36407,0,39168,1700,37468,0,40037,1650,38387
9025,350000,280000,0,0,0,0,0,0,-2,13176,13316,-140,-2,9399,9446,-47,-2,10477,10529,-52,-2,10775,10829,-54
9026,20000,16000,0,1,1,1,1,1,2,19260,2921,16339,2,18653,0,18653,2,20041,1702,18339,2,19582,0,19582
9027,300000,240000,0,0,0,0,0,0,0,54176,2000,52176,0,60363,7100,53263,0,59973,0,59973,2,60399,2000,58399
9028,20000,16000,0,1,1,1,1,1,4,19299,0,19299,4,20686,2000,18686,3,20073,0,20073,4,19470,0,19470
9029,160000,128000,0,0,0,0,0,0,0,19536,10000,9536,0,7550,3006,4544,0,6977,3000,3977,0,7811,3000,4811
9030,140000,112000,0,0,0,0,0,0,0,114989,4246,110743,0,81475,5000,76475,0,82812,3000,79812,0,71484,3000,68484
9031,390000,312000,0,0,0,0,0,0,0,178698,10000,168698,0,182101,8004,174097,0,155517,10000,145517,0,154668,6000,148668
9032,200000,160000,0,0,0,0,0,0,0,4494,1140,3354,0,4771,1000,3771,0,9454,5000,4454,0,8595,3000,5595
9033,150000,120000,0,1,1,1,1,0,0,136378,3900,132478,0,139219,4000,135219,0,142172,4100,138072,0,145065,4100,140965
9034,350000,280000,0,0,0,0,0,0,-1,24620,24692,-72,-1,22381,22388,-7,-1,13115,13115,0,-1,5167,5167,0
9035,20000,16000,0,1,1,1,1,1,2,19012,1612,17400,0,19100,700,18400,0,19506,714,18792,0,20037,861,19176
9036,20000,16000,0,0,0,0,0,0,2,150,0,150,2,150,0,150,2,150,0,150,2,1150,1150,0
9037,350000,280000,0,0,0,0,0,0,-2,5339,10678,-5339,-2,0,0,0,-2,0,0,0,-2,0,0,0
9038,130000,104000,0,0,0,0,0,1,0,17285,22511,-5226,-1,12448,600,11848,0,12855,1005,11850,0,11795,1004,10791
9039,10000,8000,0,0,0,0,0,0,0,0,0,0,0,1660,1660,0,-1,660,0,660,0,660,0,660
9040,180000,144000,0,0,0,0,0,0,0,43604,3005,40599,0,43571,3002,40569,0,19360,3004,16356,0,20650,3000,17650
9041,130000,104000,0,0,0,0,0,1,-2,0,0,0,-2,0,0,0,-2,0,0,0,-2,0,0,0
9042,160000,128000,0,0,0,0,0,0,-1,3107,3107,0,-1,4187,4187,0,-1,2474,0,2474,0,192,192,0
9043,50000,40000,0,0,0,0,0,1,0,36740,1610,35130,0,37469,1339,36130,0,38254,1387,36867,0,39014,1395,37619
9044,10000,8000,0,1,1,1,1,0,0,9501,0,9501,2,10029,830,9199,2,9730,0,9730,2,9974,400,9574
9045,30000,24000,0,0,0,0,0,1,2,300,0,300,2,300,0,300,2,1300,1000,300,2,1150,150,1000
9046,30000,24000,0,1,1,1,1,1,3,26363,0,26363,2,27379,1758,25621,0,28953,2332,26621,0,28354,0,28354
9047,200000,160000,0,0,0,0,0,0,-2,44326,44452,-126,-2,9353,9355,-2,-2,11156,11156,0,-2,17725,17725,0
9048,160000,128000,0,0,0,0,0,1,3,1170,0,1170,2,780,0,780,0,780,0,780,0,0,0,0
9049,50000,40000,0,0,0,0,0,0,0,38493,1900,36593,0,33769,1355,32414,0,34211,1300,32911,0,34944,1300,33644
9050,140000,112000,0,0,0,0,0,0,0,57219,3000,54219,0,57621,2000,55621,0,48323,2000,46323,0,45082,1636,43446
9051,440000,352000,0,0,0,0,0,0,-2,32921,32921,0,-2,22680,15701,6979,-2,13711,5711,8000,-2,11074,5074,6000
9052,10000,8000,0,0,1,1,1,1,0,9580,2000,7580,0,9267,700,8567,0,10096,1500,8596,0,9415,0,9415
9053,20000,16000,0,0,0,0,0,0,-1,7001,2000,5001,0,6695,2000,4695,0,0,0,0,0,0,3300,-3300
9054,240000,192000,0,0,0,0,0,0,0,138197,4916,133281,0,140983,4982,136001,0,138214,5017,133197,0,141187,5272,135915
9055,90000,72000,0,0,0,0,0,0,0,23270,5000,18270,0,27372,5000,22372,0,31905,5000,26905,0,34954,3600,31354
9056,50000,40000,0,0,0,0,0,0,0,21514,10000,11514,0,25359,5000,20359,0,30400,5780,24620,0,39678,10000,29678
9057,60000,48000,0,1,1,1,1,0,0,51466,2006,49460,0,50506,1862,48644,0,56373,6729,49644,0,55341,0,55341
9058,500000,400000,0,0,0,0,0,1,-2,5921,5950,-29,-2,2381,2392,-11,-2,823,827,-4,-2,801,805,-4
9059,50000,40000,0,0,0,0,0,1,0,28185,1500,26685,0,28842,1100,27742,0,30399,2000,28399,0,29977,1500,28477
9060,80000,64000,0,0,0,0,0,0,0,1250,1250,0,-1,175,175,0,-1,175,175,0,-1,175,175,0
9061,50000,40000,0,0,0,0,0,0,2,9288,1300,7988,0,9990,1000,8990,0,9694,0,9694,2,9879,500,9379
9062,100000,80000,0,0,0,0,0,1,0,39145,900,38245,2,39494,1400,38094,2,39896,900,38996,2,28256,6440,21816
9063,50000,40000,0,1,0,0,0,0,0,49885,2010,47875,0,25773,796,24977,0,25544,957,24587,0,26264,1175,25089
9064,100000,80000,0,0,0,0,0,0,0,18726,2326,16400,0,19225,1600,17625,0,18299,0,18299,0,20056,4000,16056
9065,240000,192000,0,0,0,0,0,1,-2,0,0,0,-2,0,0,0,-2,0,0,0,-2,0,0,0
9066,360000,288000,0,0,0,0,0,0,-2,56337,56663,-326,-2,10959,11013,-54,-2,7056,7091,-35,-2,0,0,0
9067,20000,16000,0,0,0,0,0,1,-1,1395,1395,0,-1,10555,10555,0,-1,9500,0,9500,0,9588,9588,0
9068,20000,16000,0,1,1,1,1,0,0,18584,1309,17275,0,19097,822,18275,0,19328,682,18646,0,37576,0,37576
9069,50000,40000,0,1,1,1,0,0,0,50146,2341,47805,0,49685,2128,47557,0,50252,344,49908,0,9958,359,9599
9070,150000,120000,0,0,0,0,0,0,-1,6527,8589,-2062,2,2168,2500,-332,-1,-7,0,-7,-1,1373,1380,-7
9071,130000,104000,0,0,0,0,0,1,-1,4058,4058,0,-1,5732,2000,3732,0,7406,2000,5406,0,4124,4124,0
9072,240000,192000,0,0,0,0,0,0,0,132218,5000,127218,0,136003,6000,130003,0,139798,6000,133798,0,142574,5098,137476
9073,30000,24000,0,0,0,0,0,1,-1,3415,3415,0,-1,2250,2250,0,-1,2486,2486,0,-1,844,844,0
9074,310000,248000,0,0,0,0,0,0,0,103459,20000,83459,0,80237,10000,70237,0,74627,6000,68627,0,52057,5000,47057
9075,50000,40000,0,1,1,0,0,0,0,49597,5230,44367,0,43885,1927,41958,0,0,0,0,0,0,0,0
9076,360000,288000,0,0,0,0,0,0,-2,0,0,0,-2,0,0,0,-2,166,166,0,-1,541,543,-2
9077,360000,288000,0,0,0,0,0,0,-1,4268,4268,0,-1,2085,2085,0,-1,26896,13448,13448,-1,18455,7455,11000
9078,20000,16000,0,1,1,1,1,0,2,16292,0,16292,2,18010,2000,16010,0,18411,1000,17411,0,19455,1500,17955
9079,60000,48000,0,1,0,0,0,0,0,51024,2530,48494,0,32215,1525,30690,0,31088,1200,29888,0,33581,3000,30581
9080,300000,240000,0,0,0,0,0,0,-2,-3,0,-3,-2,329,332,-3,-2,0,0,0,-2,0,0,0
9081,360000,288000,0,0,0,0,0,1,-2,0,0,0,-2,0,0,0,-2,0,0,0,-2,0,0,0
9082,240000,192000,0,0,0,0,0,0,-1,16665,10000,6665,0,13039,3500,9539,0,9439,0,9439,0,11378,5000,6378
9083,130000,104000,0,0,0,0,0,0,0,41268,2000,39268,0,31836,2000,29836,0,33559,2000,31559,0,10390,2000,8390
9084,60000,48000,0,0,0,0,0,1,0,34134,3638,30496,0,23552,0,23552,2,24020,1000,23020,0,26615,3000,23615
9085,60000,48000,0,0,0,0,0,0,-1,7,0,7,2,11965,11958,7,0,11958,0,11958,0,12069,611,11458
9086,210000,168000,0,0,1,1,0,0,0,173443,13000,160443,0,179686,10000,169686,0,197458,20000,177458,0,138218,7000,131218
9087,240000,192000,0,0,0,0,0,0,0,126384,5000,121384,0,126917,4000,122917,0,90822,4000,86822,0,83742,4000,79742
9088,50000,40000,0,0,0,0,0,0,0,30610,3202,27408,0,30227,3502,26725,0,18413,3200,15213,0,17195,2500,14695
9089,30000,24000,0,0,0,0,0,0,-1,640,640,0,-1,0,0,0,-1,2583,2583,0,-1,4653,4653,0
9090,130000,104000,0,0,0,0,0,0,0,9522,2000,7522,0,3939,2000,1939,0,6939,3000,3939,0,950,900,50
9091,30000,24000,0,1,1,1,1,0,0,26882,1500,25382,0,27570,1135,26435,0,28075,1100,26975,0,29065,1455,27610
9092,30000,24000,0,1,1,1,1,0,0,28400,1458,26942,0,28115,1443,26672,0,28826,1154,27672,0,27745,1008,26737
9093,190000,152000,0,0,0,0,0,0,0,80548,3331,77217,0,81778,3359,78419,0,83082,2663,80419,0,84811,2751,82060
9094,60000,48000,0,0,0,0,0,0,-1,440,0,440,2,880,880,0,-1,440,0,440,0,1681,1681,0
9095,240000,192000,0,0,0,0,0,0,-1,329,329,0,-1,9228,9228,0,-1,7776,7776,0,-1,7500,7500,0
9096,30000,24000,0,0,0,0,0,0,-1,557,1000,-443,-1,1299,1306,-7,-1,600,600,0,-1,450,0,450
9097,50000,40000,0,1,0,0,0,0,0,46716,1835,44881,0,18685,669,18016,0,19076,692,18384,0,19466,707,18759
9098,60000,48000,0,0,0,0,0,0,2,37280,1800,35480,0,35321,1414,33907,0,36099,1500,34599,0,36724,1377,35347
9099,80000,64000,0,0,0,0,0,0,0,0,0,0,0,0,0,0,-2,0,0,0,-2,0,0,0
9100,30000,24000,0,0,0,0,1,0,0,23670,0,23670,2,24002,1023,22979,0,26373,2925,23448,0,25798,0,25798
9101,70000,56000,0,0,0,0,0,1,0,8143,1200,6943,0,8507,500,8007,0,8869,500,8369,0,9220,500,8720
9102,200000,160000,0,0,0,0,0,0,-1,780,780,0,-1,387,387,0,-1,-3,0,-3,-1,4540,4543,-3
9103,10000,8000,0,1,1,1,1,0,2,10525,2126,8399,0,10050,390,9660,0,9903,328,9575,0,9984,476,9508
9104,420000,336000,0,0,0,0,0,0,0,2940,1500,1440,0,3160,3160,0,-1,4160,1000,3160,0,883,883,0
9105,20000,16000,0,0,0,0,0,0,-1,390,400,-10,-1,390,390,0,-1,370,370,0,-1,-20,0,-20
9106,100000,80000,0,0,0,0,0,1,2,33862,3000,30862,2,35007,2000,33007,2,34147,0,34147,2,35437,2000,33437
9107,120000,96000,0,0,0,0,0,0,0,5814,5814,0,-1,4426,0,4426,0,3038,0,3038,0,5184,5184,0
9108,180000,144000,0,0,0,0,0,0,0,65236,2370,62866,0,65912,3000,62912,0,66523,3000,63523,0,67020,2588,64432
9109,50000,40000,0,0,0,0,0,1,0,0,0,0,0,0,0,0,-2,5412,5412,0,-1,6414,2000,4414
9110,230000,184000,0,1,1,1,1,1,2,212979,7598,205381,2,207759,0,207759,2,212014,8000,204014,0,225246,17000,208246
9111,80000,64000,0,0,0,0,0,0,0,51760,3305,48455,0,52650,3000,49650,0,55477,7767,47710,0,55020,7007,48013
9112,80000,64000,0,0,0,0,0,1,0,65609,2627,62982,0,49640,1697,47943,0,49685,2000,47685,0,46684,1700,44984
9113,150000,120000,0,0,0,0,0,0,-2,0,0,0,-2,0,0,0,-2,1761,1761,0,-2,18304,18306,-2
9114,170000,136000,0,0,0,0,0,0,0,124370,6375,117995,0,112589,4468,108121,0,26958,1000,25958,0,8535,1306,7229
9115,230000,184000,0,0,0,0,0,0,-1,2140,2140,0,-1,3313,3313,0,-1,3750,3750,0,-1,2491,2491,0
9116,10000,8000,0,0,0,0,0,1,2,1050,0,1050,2,1050,0,1050,3,1050,0,1050,3,1050,0,1050
9117,280000,224000,0,0,0,0,0,0,-1,1713,1726,-13,-1,1430,1430,0,-1,6877,6877,0,-1,6479,6479,0
9118,500000,400000,0,0,0,0,0,1,-2,0,0,0,-2,0,0,0,-2,0,0,0,-2,0,0,0
9119,110000,88000,0,1,0,0,0,0,0,101945,5000,96945,0,82873,4000,78873,0,68587,3000,65587,0,65648,2500,63148
9120,320000,256000,0,0,0,0,0,0,0,87765,15055,72710,0,83094,16752,66342,0,66463,10012,56451,0,63977,10071,53906
9121,310000,248000,0,0,0,0,0,0,0,10687,5002,5685,0,12754,4008,8746,0,16105,5000,11105,0,18823,5000,13823
9122,110000,88000,0,0,0,0,0,0,0,50330,2500,47830,0,50894,2000,48894,0,52175,2100,50075,0,53652,2500,51152
9123,30000,24000,0,1,0,1,1,0,2,26762,1710,25052,0,24956,1000,23956,0,25654,1100,24554,0,26177,1100,25077
9124,90000,72000,0,0,0,0,0,0,0,47590,2000,45590,0,50000,3000,47000,0,780,780,0,-1,0,0,0
9125,70000,56000,0,0,0,0,0,0,0,11512,10000,1512,0,10586,0,10586,2,20389,10000,10389,2,17369,0,17369
9126,290000,232000,0,0,0,0,0,0,-1,7620,7620,0,-1,0,0,0,-1,4788,4788,0,-1,0,0,0
9127,120000,96000,0,0,0,0,0,1,2,63154,3000,60154,2,64524,3000,61524,2,66345,3000,63345,2,68104,3000,65104
9128,200000,160000,0,0,0,0,0,0,-2,10229,10426,-197,-2,7899,8008,-109,-2,4553,4575,-22,-2,4252,4273,-21
9129,150000,120000,0,1,1,0,0,0,0,147851,5937,141914,0,151310,6500,144810,0,107033,4000,103033,0,109350,4000,105350
9130,120000,96000,0,0,0,0,0,0,-1,0,0,0,-1,0,0,0,-2,660,660,0,-1,0,0,0
9131,360000,288000,0,0,0,0,0,0,-1,0,0,0,-1,11850,11850,0,-1,150,300,-150,-1,459,459,0
9132,60000,48000,0,1,0,0,0,0,0,56539,2000,54539,0,29425,1000,28425,0,28013,1000,27013,0,29075,1500,27575
9133,280000,224000,0,0,0,0,0,0,0,34943,2950,31993,0,33892,0,33892,2,28005,792,27213,0,22011,633,21378
9134,110000,88000,0,0,0,0,0,0,0,44231,2010,42221,0,32489,3000,29489,0,26354,3000,23354,0,20221,3000,17221
9135,150000,120000,0,0,0,0,0,0,0,113152,3210,109942,0,116097,3911,112186,0,118500,3354,115146,0,120896,3400,117496
9136,120000,96000,0,0,0,0,0,0,0,73115,2276,70839,0,64398,1909,62489,0,42588,1510,41078,0,42863,1663,41200
9137,300000,240000,0,0,0,0,0,0,-2,7128,7128,0,-1,5916,5923,-7,-1,9634,9634,0,-1,0,0,0
9138,50000,40000,0,1,1,1,1,1,2,51802,4000,47802,2,50737,7,50730,2,48763,1900,46863,0,50908,3903,47005
9139,100000,80000,0,0,0,0,0,0,-1,13139,13210,-71,-1,7170,7192,-22,-1,386,386,0,-1,1617,1621,-4
9140,20000,16000,1,1,0,1,1,0,0,53069,1300,51769,0,17025,2513,14512,0,18372,2000,16372,0,19696,2000,17696
9141,30000,24000,0,0,0,0,0,0,2,15467,2000,13467,2,14913,0,14913,2,17692,3009,14683,2,16302,0,16302
9142,50000,40000,0,0,0,0,0,0,0,37420,32009,5411,0,18151,1500,16651,0,4823,1000,3823,0,6574,3012,3562
9143,10000,8000,0,0,0,0,0,1,0,2819,1054,1765,0,3828,1063,2765,0,3905,140,3765,0,4023,181,3842
9144,140000,112000,0,1,1,1,1,0,0,128445,6100,122345,0,125049,6330,118719,0,119402,4400,115002,0,123055,8700,114355
9145,60000,48000,0,0,0,0,0,1,-1,317,317,0,-1,-73,0,-73,-1,-463,0,-463,-2,7942,10000,-2058
9146,290000,232000,0,0,0,0,0,0,0,22416,2010,20406,0,17016,3000,14016,0,12567,3000,9567,0,17199,5000,12199
9147,360000,288000,0,0,0,0,0,0,-1,3906,3924,-18,-1,8413,8454,-41,-1,3079,3093,-14,-1,4075,4095,-20
9148,230000,184000,0,0,0,0,0,0,0,32211,2000,30211,0,31647,1113,30534,0,34304,5000,29304,0,36849,5000,31849
9149,10000,8000,0,0,0,0,0,1,2,2400,0,2400,2,2400,0,2400,7,2400,0,2400,7,1800,0,1800
9150,530000,424000,0,0,0,0,0,0,-2,36532,36532,0,-2,3288,3293,-5,-2,1415,1415,0,-2,448,448,0
9151,50000,40000,0,0,0,0,0,0,0,2522,2522,0,-1,1261,0,1261,0,1261,1261,0,-1,1428,1428,0
9152,150000,120000,0,0,0,0,0,0,-1,25772,25000,772,0,48635,48635,0,-1,25907,13907,12000,0,7513,1513,6000
9153,380000,304000,0,0,0,0,0,0,-1,388,389,-1,-1,388,389,-1,-1,775,776,-1,-1,387,1,386
9154,100000,80000,0,0,0,0,0,0,-2,0,156,-156,-2,33333,33333,0,-2,0,0,0,-2,0,0,0
9155,20000,16000,0,1,1,1,0,0,0,19391,1660,17731,0,20085,1300,18785,0,19938,541,19397,0,0,0,0
9156,230000,184000,0,0,0,0,0,0,-1,45742,4000,41742,0,38502,4000,34502,0,30581,3000,27581,0,32738,3000,29738
9157,70000,56000,0,0,0,0,0,0,0,18642,3000,15642,0,20011,3000,17011,0,19147,2000,17147,0,19056,2000,17056
9158,150000,120000,0,0,0,0,0,0,-1,66187,2451,63736,0,65419,2543,62876,0,61645,5000,56645,0,64189,4189,60000
9159,60000,48000,0,0,0,1,1,0,2,39068,0,39068,2,51205,12858,38347,0,54520,4166,50354,0,55964,2350,53614
9160,270000,216000,0,0,0,0,0,0,-2,24646,24679,-33,-2,1585,4893,-3308,-1,15376,15376,0,-1,497,497,0
9161,160000,128000,0,0,0,0,0,0,0,118082,10000,108082,0,112802,5022,107780,0,61178,8000,53178,0,98960,99822,-862
9162,50000,40000,0,0,0,0,0,0,0,6615,1100,5515,0,7131,1000,6131,0,6987,500,6487,0,6980,500,6480
9163,180000,144000,0,0,0,0,0,0,2,31570,1400,30170,0,33370,2200,31170,0,33370,0,33370,0,0,0,0
9164,140000,112000,0,0,0,0,0,0,-2,107,107,0,-2,107,107,0,-2,107,107,0,-2,107,107,0
9165,50000,40000,0,1,1,0,0,1,2,49235,2058,47177,0,49577,1400,48177,0,17063,762,16301,0,17634,1000,16634
9166,110000,88000,0,1,0,0,0,0,0,94708,3500,91208,0,83765,3000,80765,0,73122,3700,69422,0,74366,12488,61878
9167,180000,144000,0,0,0,0,0,1,-1,109,109,0,-1,1863,3626,-1763,-1,1763,0,1763,0,591,907,-316
9168,110000,88000,1,1,0,0,0,0,0,142622,3000,139622,0,73702,6000,67702,0,75513,3000,72513,0,77111,2935,74176
9169,20000,16000,0,1,1,1,1,0,2,16879,0,16879,2,17059,757,16302,0,17263,628,16635,0,17675,700,16975
9170,50000,40000,0,0,0,0,0,1,0,7891,2004,5887,0,4600,1000,3600,0,5554,1008,4546,0,5481,1400,4081
9171,270000,216000,0,0,0,0,0,0,0,30534,2000,28534,0,27598,3000,24598,0,26344,4000,22344,0,24641,3000,21641
9172,260000,208000,0,0,0,0,0,1,0,130369,5704,124665,0,68014,2411,65603,0,68529,2412,66117,0,69741,3100,66641
9173,180000,144000,0,0,0,0,0,1,0,94532,0,94532,2,22800,2000,20800,0,96940,75206,21734,0,99550,4110,95440
9174,130000,104000,1,1,1,1,0,0,2,145398,3300,142098,0,136115,2500,133615,0,138893,2778,136115,0,127502,130000,-2498
9175,70000,56000,0,0,0,0,0,1,2,36498,0,36498,2,37516,1929,35587,0,38587,2000,36587,0,43924,6000,37924
9176,50000,40000,0,1,0,0,0,0,0,48495,1644,46851,0,28641,1013,27628,0,28846,1044,27802,0,29024,1045,27979
9177,20000,16000,0,1,0,0,1,0,0,19930,1400,18530,0,15961,421,15540,0,20107,6000,14107,0,19275,3000,16275
9178,120000,96000,0,0,0,0,0,0,-2,0,0,0,-2,0,0,0,-2,0,0,0,-2,0,0,0
9179,50000,40000,0,0,0,0,0,0,0,4861,1081,3780,0,4958,178,4780,0,5244,366,4878,0,8134,3156,4978
9180,180000,144000,0,0,0,0,0,1,-2,0,0,0,-2,0,0,0,-2,0,0,0,-2,0,0,0
9181,50000,40000,0,1,0,0,0,0,0,47393,1500,45893,0,22944,824,22120,0,24071,1500,22571,0,24397,877,23520
9182,30000,24000,0,0,0,0,0,0,0,20723,2032,18691,0,19523,0,19523,0,4294,1000,3294,0,3974,3000,974
9183,30000,24000,0,0,0,0,0,0,2,18180,150,18030,2,15900,0,15900,0,0,0,0,0,0,0,0
9184,80000,64000,0,0,0,0,0,0,-1,3889,3889,0,-1,780,780,0,-1,390,0,390,0,390,390,0
9185,80000,64000,0,1,1,0,0,1,2,80783,4000,76783,0,75115,3000,72115,0,49420,1800,47620,0,50677,2000,48677
9186,50000,40000,0,1,0,0,0,1,2,48610,0,48610,2,17857,800,17057,0,18369,800,17569,0,19011,1000,18011
9187,160000,128000,0,0,0,0,0,0,2,47040,2000,45040,0,47807,1700,46107,0,50711,3550,47161,0,40166,0,40166
9188,360000,288000,0,0,0,0,0,0,-2,6336,6395,-59,-2,937,941,-4,-2,766,769,-3,-2,1065,1070,-5
9189,50000,40000,0,0,0,0,0,0,0,7719,2000,5719,0,8588,1000,7588,0,9291,1000,8291,0,11127,2000,9127
9190,50000,40000,0,0,0,0,0,0,-1,3287,1500,1787,0,4843,2000,2843,0,6379,2000,4379,0,6878,1000,5878
9191,50000,40000,0,0,1,1,1,0,3,41150,1900,39250,2,41670,1500,40170,2,42188,1500,40688,2,43360,2000,41360
9192,50000,40000,0,0,0,0,0,0,0,12218,2500,9718,2,13656,1980,11676,2,15918,3500,12418,0,10771,1000,9771
9193,200000,160000,0,0,0,0,0,1,2,118855,6216,112639,2,125357,10000,115357,2,121853,0,121853,2,124731,5000,119731
9194,10000,8000,0,0,1,1,0,1,0,9593,2000,7593,0,10104,1000,9104,0,9923,313,9610,0,8032,356,7676
9195,250000,200000,0,0,0,0,0,0,-2,-24,0,-24,-2,746,770,-24,-1,7146,7200,-54,-1,434,688,-254
9196,50000,40000,0,1,0,0,0,1,0,48942,1613,47329,0,27836,1484,26352,0,40346,3675,36671,0,38668,698,37970
9197,170000,136000,0,1,0,0,0,0,0,170464,7790,162674,0,127364,4587,122777,0,127024,4675,122349,0,125341,4525,120816
9198,20000,16000,0,0,0,0,1,0,0,16668,16730,-62,-1,18389,3395,14994,0,17898,1898,16000,0,18462,1000,17462
9199,180000,144000,0,0,0,0,0,0,-1,0,0,0,-1,715,715,0,-1,4079,6942,-2863,-1,0,0,0
9200,280000,224000,0,0,0,0,0,0,0,44561,2741,41820,0,45450,1630,43820,0,46715,2000,44715,0,47642,1705,45937
9201,140000,112000,0,1,1,1,1,0,2,132693,0,132693,2,135638,5200,130438,0,132105,5000,127105,0,134851,5100,129751
9202,90000,72000,0,0,0,0,0,0,0,17681,5145,12536,0,15240,1801,13439,0,19364,5024,14340,0,18828,8007,10821
9203,50000,40000,0,0,0,0,0,0,-2,0,0,0,-2,2219,2219,0,-1,390,390,0,-1,390,390,0
9204,20000,16000,0,0,0,0,0,0,0,13597,2000,11597,0,14088,1003,13085,0,13723,1000,12723,0,16318,3000,13318
9205,80000,64000,0,1,1,1,1,0,0,76163,3400,72763,0,76813,2900,73913,0,77511,2900,74611,0,79069,2841,76228
9206,20000,16000,0,1,1,1,1,0,0,17667,1293,16374,0,18187,813,17374,0,20499,2770,17729,0,20718,703,20015
9207,120000,96000,0,0,0,0,0,0,-1,396,396,0,-1,396,396,0,-1,396,396,0,-1,1100,1100,0
9208,100000,80000,0,0,0,0,0,0,0,66292,3000,63292,0,67793,2500,65293,0,67182,3000,64182,0,66132,2500,63632
9209,50000,40000,0,0,0,0,0,0,0,6879,1284,5595,0,6753,264,6489,0,5440,109,5331,0,5440,390,5050
9210,360000,288000,0,0,0,0,0,1,-2,0,0,0,-2,0,0,0,-2,0,0,0,-2,0,0,0
9211,270000,216000,0,0,0,0,0,0,-2,7500,7500,0,-2,7500,7500,0,-2,7500,7500,0,-2,7500,7500,0
9212,110000,88000,0,0,0,0,0,1,0,5496,3000,2496,0,7496,2000,5496,0,9298,2000,7298,0,3340,0,3340
9213,500000,400000,0,0,0,0,0,0,-1,34741,35157,-416,-1,20409,3000,17409,0,23804,5000,18804,0,22697,5000,17697
9214,50000,40000,0,1,0,0,0,0,0,44113,1014,43099,0,8522,170,8352,0,17948,17948,0,-1,9390,188,9202
9215,20000,16000,0,0,0,0,0,1,-2,0,0,0,-2,0,0,0,-2,0,0,0,-2,0,0,0
9216,250000,200000,0,0,0,0,0,0,0,90801,4435,86366,0,0,0,0,0,1069,1069,0,-1,919,0,919
9217,160000,128000,0,0,0,0,0,0,-1,2904,3037,-133,-1,2313,0,2313,2,2753,1000,1753,2,2191,0,2191
9218,180000,144000,0,0,0,0,0,1,2,0,0,0,-2,0,0,0,-2,0,0,0,-2,1350,1350,0
9219,200000,160000,0,0,0,0,0,0,-2,0,0,0,-2,0,0,0,-2,0,0,0,-2,0,0,0
9220,130000,104000,0,1,0,0,0,0,0,131045,6000,125045,0,94390,5000,89390,0,91111,4000,87111,0,93112,3500,89612
9221,50000,40000,0,1,1,1,1,1,2,45064,0,45064,2,45744,3400,42344,2,43123,0,43123,2,42343,1528,40815
9222,20000,16000,0,1,1,1,1,0,0,17947,1367,16580,0,18758,1178,17580,0,19292,712,18580,0,19201,742,18459
9223,100000,80000,0,0,0,0,0,1,-2,0,0,0,-2,0,0,0,-2,0,0,0,-2,0,0,0
9224,210000,168000,0,0,0,0,0,0,-1,15316,15316,0,-1,15623,15623,0,-1,11090,11090,0,-1,15316,10000,5316
9225,260000,208000,0,0,0,0,0,0,0,20158,2260,17898,0,12619,3030,9589,0,176498,170039,6459,0,172274,6227,166047
9226,240000,192000,0,1,1,0,0,0,0,236564,10001,226563,0,241075,10000,231075,0,146440,10000,136440,0,132290,5000,127290
9227,180000,144000,0,0,0,0,0,0,0,9652,2000,7652,0,10775,3000,7775,0,1943,1943,0,-1,13243,13000,243
9228,360000,288000,0,0,0,0,0,0,-2,22190,22190,0,-1,21416,21416,0,-1,6854,1545,5309,0,357,357,0
9229,360000,288000,0,0,0,0,0,0,-2,0,0,0,-2,0,0,0,-2,0,0,0,-2,0,0,0
9230,130000,104000,0,1,0,0,0,0,0,130000,3000,127000,0,0,0,0,0,0,0,0,-2,0,0,0
9231,60000,48000,0,0,0,0,0,0,-1,0,0,0,-2,0,0,0,-2,0,0,0,-2,0,0,0
9232,40000,32000,0,1,0,1,1,0,0,34605,1600,33005,0,35970,22703,13267,0,35711,1280,34431,0,39360,4632,34728
9233,140000,112000,0,0,0,0,0,1,2,-200,0,-200,2,8700,8900,-200,-1,1367,1367,0,-1,1367,0,1367
9234,360000,288000,0,0,0,0,0,0,0,153306,6059,147247,0,144485,5009,139476,0,145601,5021,140580,0,140336,5027,135309
9235,100000,80000,0,0,0,0,0,1,2,47837,3841,43996,2,48678,1900,46778,2,48420,1900,46520,2,48888,1800,47088
9236,170000,136000,0,1,1,1,1,0,2,164777,0,164777,2,166227,7400,158827,0,166199,5978,160221,0,169533,6251,163282
9237,240000,192000,0,0,0,0,0,0,-2,2062,2087,-25,-1,-1,0,-1,-1,311,312,-1,-1,2005,2015,-10
9238,190000,152000,0,0,0,0,0,0,0,158883,7000,151883,0,99255,4000,95255,0,80219,3000,77219,0,81912,3000,78912
9239,180000,144000,0,0,0,0,0,1,0,147825,6840,140985,0,145482,6700,138782,0,141846,5100,136746,0,132687,5000,127687
9240,240000,192000,0,0,0,0,0,0,0,99174,3289,95885,0,65372,2072,63300,0,28797,3018,25779,0,184922,184922,0
9241,50000,40000,0,0,0,0,0,1,-2,71,71,0,-1,71,0,71,2,3871,3800,71,2,3612,0,3612
9242,180000,144000,0,0,0,0,0,0,0,3996,1000,2996,0,6007,2011,3996,0,3260,503,2757,0,0,0,0
9243,20000,16000,0,0,0,0,0,0,2,7190,1500,5690,0,7190,0,7190,0,0,0,0,0,0,0,0
9244,70000,56000,0,0,0,0,0,1,2,22090,1400,20690,0,22723,1000,21723,0,24351,2000,22351,0,23809,0,23809
9245,50000,40000,0,0,0,0,0,0,3,18409,0,18409,2,18823,1000,17823,0,20379,2000,18379,0,18720,0,18720
9246,180000,144000,0,0,0,0,0,0,-2,1040,1040,0,-2,258,258,0,-2,0,0,0,-2,0,0,0
9247,80000,64000,0,0,0,0,0,0,0,28674,1500,27174,0,28240,1200,27040,0,28540,1300,27240,0,27934,1200,26734
9248,30000,24000,0,0,0,0,0,1,-1,165,165,0,-1,323,323,0,-1,158,0,158,2,-1027,0,-1027
9249,210000,168000,0,0,0,0,0,0,0,0,0,0,0,0,0,0,-2,0,0,0,-2,87045,87045,0
9250,500000,400000,0,0,0,0,0,0,-2,1440,1440,0,-2,600,600,0,-2,8170,8170,0,-2,600,600,0
9251,210000,168000,0,0,0,0,0,0,2,52620,2700,49920,0,7379,1300,6079,0,9083,2000,7083,0,10766,2000,8766
9252,20000,16000,0,1,1,1,1,0,2,19202,1634,17568,0,20178,1610,18568,0,20281,710,19571,0,20293,717,19576
9253,230000,184000,0,0,0,0,0,0,-2,156,156,0,-2,2403,2403,0,-2,1546,1546,0,-2,7915,7915,0
9254,210000,168000,0,1,1,0,0,0,0,205800,11000,194800,0,205590,6000,199590,0,98572,4098,94474,0,90521,3500,87021
9255,50000,40000,0,0,0,0,0,0,0,33995,1500,32495,0,29759,1050,28709,0,29766,1100,28666,0,29665,1100,28565
9256,430000,344000,0,1,1,0,0,0,0,437284,18000,419284,0,435832,16570,419262,0,345499,11803,333696,0,228818,10563,218255
9257,360000,288000,0,0,0,0,0,0,0,173353,50181,123172,0,156875,20609,136266,0,64965,30291,34674,0,36290,30121,6169
9258,130000,104000,0,0,0,0,0,0,-1,390,390,0,-1,390,390,0,-1,390,390,0,-1,390,390,0
9259,50000,40000,0,0,0,0,0,0,0,8649,1144,7505,0,9302,797,8505,0,9008,0,9008,2,9188,329,8859
9260,240000,192000,0,1,0,1,1,0,0,228735,8009,220726,0,198585,7100,191485,0,202762,7324,195438,0,202932,7200,195732
9261,320000,256000,0,0,0,0,0,1,-2,2500,2500,0,-2,0,0,0,-2,0,0,0,-2,0,0,0
9262,130000,104000,0,1,1,1,1,0,0,130112,5000,125112,0,129785,5000,124785,0,121609,5000,116609,0,123586,6000,117586
9263,60000,48000,0,0,0,0,0,0,0,20513,10709,9804,0,22123,22154,-31,-1,17094,1000,16094,0,18668,2000,16668
9264,360000,288000,0,0,0,0,0,0,-2,21669,21785,-116,-2,-3,0,-3,-2,15866,15869,-3,-2,-46,0,-46
9265,30000,24000,0,1,1,1,1,1,2,29733,1900,27833,2,29183,2600,26583,2,28082,11,28071,2,27434,1500,25934
9266,100000,80000,0,0,0,0,0,0,0,98796,103350,-4554,-1,52079,1722,50357,0,40183,1100,39083,0,35796,1300,34496
9267,270000,216000,0,1,1,1,1,0,0,270573,12000,258573,0,275560,11000,264560,0,243792,8700,235092,0,251098,11077,240021
9268,490000,392000,0,0,0,0,0,0,0,60011,8160,51851,0,49409,7000,42409,0,39945,2000,37945,0,49932,37000,12932
9269,390000,312000,0,0,0,0,0,0,0,24266,24353,-87,-1,6088,6118,-30,-1,2500,2550,-50,-1,828,828,0
9270,220000,176000,0,0,0,0,0,0,-2,328,329,-1,-2,1024,1029,-5,-2,1888,1897,-9,-2,1132,1137,-5
9271,140000,112000,0,0,0,0,0,1,0,93802,4300,89502,0,94531,3500,91031,0,96264,3600,92664,0,98135,3881,94254
9272,180000,144000,0,0,0,0,0,1,2,17752,3000,14752,2,17172,0,17172,2,18732,2000,16732,0,23389,5000,18389
9273,180000,144000,0,0,0,0,0,1,2,98680,0,98680,2,100644,3605,97039,0,102750,3731,99019,0,104792,3752,101040
9274,300000,240000,0,0,0,0,0,1,0,7854,5000,2854,0,10426,5000,5426,0,16784,10000,6784,0,4334,4334,0
9275,330000,264000,0,0,0,0,0,0,-1,25664,25000,664,0,9461,9004,457,0,6407,6000,407,0,15791,15000,791
9276,200000,160000,0,0,0,0,0,1,-1,580,580,0,-1,580,580,0,-1,580,580,0,-1,580,580,0
9277,420000,336000,0,0,0,0,0,0,-1,6346,2028,4318,0,1409,1413,-4,-1,14107,14109,-2,-1,8379,8452,-73
9278,130000,104000,0,0,0,0,0,0,-1,13853,13853,0,-1,14277,1000,13277,0,0,0,0,0,0,0,0
9279,210000,168000,0,0,0,0,0,1,-1,1403,1409,-6,-1,418,0,418,0,-16,0,-16,0,-342,0,-342
9280,280000,224000,0,0,0,0,0,0,-1,10002,10020,-18,-1,13476,10000,3476,0,23572,11000,12572,0,14603,14603,0
9281,100000,80000,0,0,0,0,0,0,2,67564,3200,64364,2,67443,2500,64943,2,65106,0,65106,2,70258,6918,63340
9282,500000,400000,0,0,0,0,0,0,-2,1462,5000,-3538,-2,6224,7000,-776,-2,0,0,0,-2,0,0,0
9283,120000,96000,0,0,0,0,0,1,-1,780,780,0,-1,337,337,0,-1,1234,1234,0,-1,0,0,0
9284,120000,96000,0,1,1,1,1,0,0,116900,4278,112622,0,119228,4308,114920,0,121805,11540,110265,0,115463,5685,109778
9285,50000,40000,0,0,0,0,0,0,2,6870,1032,5838,0,7038,200,6838,0,2268,285,1983,0,5051,3000,2051
9286,240000,192000,0,0,0,0,0,1,-1,2747,2773,-26,-1,4594,4614,-20,-1,4092,4104,-12,-1,4361,4374,-13
9287,80000,64000,0,0,0,0,0,0,2,43506,1900,41606,0,39025,1418,37607,0,40017,1800,38217,0,29797,1300,28497
9288,340000,272000,0,0,0,0,0,0,-2,-6,0,-6,-2,-6,0,-6,-2,-6,0,-6,-2,-6,0,-6
9289,80000,64000,0,0,0,0,0,0,-1,595,595,0,-1,1810,1815,-5,-1,737,737,0,-1,2555,2555,0
9290,340000,272000,0,0,0,0,0,0,-1,12247,12308,-61,-1,651,654,-3,-1,12105,12164,-59,-1,7661,7699,-38
9291,20000,16000,0,0,0,0,0,1,0,5758,0,5758,2,12619,7000,5619,2,12274,0,12274,2,15049,3000,12049
9292,140000,112000,0,0,0,0,0,1,-1,0,0,0,-1,0,0,0,-2,1186,1186,0,-1,0,0,0
9293,120000,96000,0,0,0,0,0,1,-2,0,0,0,-2,0,0,0,-2,0,0,0,-2,0,0,0
9294,20000,16000,0,1,1,0,0,1,0,19002,1400,17602,0,18982,380,18602,0,13762,0,13762,0,0,0,0
9295,150000,120000,0,0,0,0,0,0,0,6177,1262,4915,0,7215,1300,5915,0,7644,700,6944,0,8367,1000,7367
9296,70000,56000,0,1,1,1,1,0,2,64885,2950,61935,0,68164,4965,63199,0,66948,0,66948,2,71122,5289,65833
9297,240000,192000,0,0,0,0,0,0,2,106628,4650,101978,2,102650,0,102650,2,0,0,0,2,0,0,0
9298,50000,40000,0,0,0,0,0,1,0,2340,1000,1340,0,1990,40,1950,0,1377,1377,0,-1,1080,1080,0
9299,160000,128000,0,0,0,0,0,0,-2,3334,3338,-4,-1,3086,3090,-4,-1,6959,6971,-12,-1,5404,5410,-6
9300,30000,24000,0,1,1,1,1,0,0,27835,2000,25835,0,28215,1439,26776,0,28345,959,27386,0,29055,1500,27555
9301,120000,96000,0,0,0,0,0,0,0,13321,1300,12021,0,15090,2000,13090,0,16836,2000,14836,0,18554,2000,16554
9302,80000,64000,0,0,0,0,0,0,-1,7012,1000,6012,0,11009,9000,2009,0,16418,6000,10418,0,27694,12000,15694
9303,110000,88000,0,0,0,0,0,0,0,40259,3000,37259,0,41585,2000,39585,0,42913,2000,40913,0,44197,2000,42197
9304,300000,240000,0,0,0,0,0,1,0,0,0,0,0,0,0,0,-2,0,0,0,-2,2538,2538,0
9305,230000,184000,0,0,0,0,0,0,-2,19272,19272,0,-2,1172,1172,0,-2,1172,1172,0,-2,2246,2246,0
9306,50000,40000,0,0,0,0,0,0,0,29156,2021,27135,0,18891,1000,17891,0,19443,1001,18442,0,19478,1000,18478
9307,160000,128000,0,0,0,0,0,1,-2,766,766,0,-2,766,766,0,-2,0,0,0,-2,27547,27547,0
9308,300000,240000,0,0,0,0,0,0,-2,0,0,0,-2,0,0,0,-2,0,0,0,-2,0,0,0
9309,20000,16000,0,0,1,0,0,0,2,17973,3100,14873,2,31269,0,31269,2,11401,2000,9401,0,8311,1000,7311
9310,20000,16000,0,0,0,0,0,1,0,9077,1500,7577,0,10989,2225,8764,0,10529,0,10529,3,10213,0,10213
9311,150000,120000,0,0,0,0,0,0,-1,344,344,0,-1,1291,1193,98,0,1193,0,1193,0,1914,3000,-1086
9312,380000,304000,0,0,0,0,0,0,0,93480,4000,89480,0,95256,3000,92256,0,96964,5000,91964,0,71250,5000,66250
9313,240000,192000,0,0,0,0,0,0,-2,-2076,0,-2076,-2,-2076,0,-2076,-2,-2076,0,-2076,-2,-253,1823,-2076
9314,230000,184000,0,0,0,0,0,0,-1,2905,2911,-6,-1,4868,4882,-14,-1,2870,2878,-8,-1,3085,3085,0
9315,30000,24000,0,0,0,0,0,1,2,2400,0,2400,8,2400,0,2400,8,2400,0,2400,8,2400,0,2400
9316,80000,64000,0,0,1,1,1,0,0,66282,2500,63782,0,67285,2500,64785,0,68309,2500,65809,0,71830,5000,66830
9317,80000,64000,0,0,0,0,0,1,0,40550,3000,37550,0,41577,2000,39577,2,41595,1000,40595,2,43264,2500,40764
9318,30000,24000,0,0,0,0,0,0,0,11771,1500,10271,0,13032,1761,11271,0,12538,0,12538,3,12187,0,12187
9319,400000,320000,0,0,0,0,0,0,0,129580,9353,120227,0,50790,10000,40790,0,49106,49106,0,-1,40591,2000,38591
9320,140000,112000,0,1,1,1,1,0,0,141738,5100,136638,0,141524,5000,136524,0,141845,5200,136645,0,142150,5100,137050
9321,290000,232000,0,0,0,0,0,0,-1,7051,7051,0,-1,20356,20000,356,0,17803,17803,0,-1,2722,2722,0
9322,150000,120000,0,0,0,0,0,0,-1,7838,7838,0,-1,7642,7642,0,-1,8009,367,7642,0,10800,10800,0
9323,120000,96000,0,0,0,0,0,1,2,54675,1828,52847,2,52206,500,51706,2,10325,0,10325,2,8992,500,8492
9324,190000,152000,0,0,0,0,0,0,0,102229,4500,97729,0,83779,4000,79779,0,72666,2900,69766,0,63714,2800,60914
9325,200000,160000,0,0,0,0,0,0,-1,1000,1036,-36,-1,0,0,0,-1,0,0,0,-2,43527,54677,-11150
9326,140000,112000,0,1,1,1,1,1,3,137057,233,136824,2,135046,6342,128704,0,136131,4800,131331,0,135292,5100,130192
9327,10000,8000,0,0,0,0,0,1,-1,780,780,0,-1,0,0,0,-1,0,0,0,-2,0,0,0
9328,500000,400000,0,0,0,0,0,0,0,70194,10000,60194,0,68618,4,68614,0,67300,333,66967,0,1825,1831,-6
9329,360000,288000,0,0,0,0,0,0,-1,0,0,0,-1,0,0,0,-2,0,0,0,-2,0,0,0
9330,150000,120000,0,0,0,0,0,0,0,84752,3500,81252,0,84743,3000,81743,0,78987,5000,73987,0,65590,3000,62590
9331,150000,120000,1,1,1,1,1,0,0,156523,6500,150023,0,159653,5700,153953,0,162866,5700,157166,0,157759,5700,152059
9332,100000,80000,0,0,0,0,0,0,0,52520,3000,49520,0,54877,3000,51877,0,57484,3000,54484,0,59095,2000,57095
9333,300000,240000,0,0,0,0,0,0,-1,-10,0,-10,-1,-10,0,-10,-2,7805,7815,-10,-1,5738,28,5710
9334,140000,112000,0,0,0,0,0,1,2,116592,5012,111580,0,89475,5000,84475,0,83630,5000,78630,0,87733,5000,82733
9335,240000,192000,0,0,0,0,0,1,2,163332,0,163332,2,166813,6900,159913,0,170739,6000,164739,0,174532,6000,168532
9336,80000,64000,0,0,0,0,0,0,0,49965,2123,47842,0,50142,4300,45842,0,46888,0,46888,2,47592,2800,44792
9337,500000,400000,0,0,0,0,0,0,-1,4131,4131,0,-1,44588,44588,0,-1,44388,0,44388,0,5085,0,5085
9338,50000,40000,0,0,0,0,0,0,0,16158,1197,14961,0,11950,1152,10798,0,9903,495,9408,0,10224,1014,9210
9339,120000,96000,0,0,0,0,0,1,2,79757,3000,76757,2,80853,3000,77853,2,82715,3300,79415,2,84805,3600,81205
9340,90000,72000,0,0,0,0,0,0,0,20662,1315,19347,0,20715,867,19848,0,21149,896,20253,0,20078,728,19350
9341,160000,128000,0,1,1,1,1,0,0,154102,5500,148602,0,149903,7000,142903,0,148435,6000,142435,0,158498,12500,145998
9342,30000,24000,0,0,0,0,0,0,0,10153,2392,7761,0,9761,1000,8761,0,9960,199,9761,0,4010,80,3930
9343,300000,240000,0,0,0,0,0,1,-1,1080,1080,0,-1,1080,0,1080,0,0,0,0,0,0,0,0
9344,210000,168000,0,0,0,0,0,1,0,22610,15042,7568,0,10161,5000,5161,0,5933,0,5933,0,4164,4164,0
9345,410000,328000,0,0,0,0,0,0,0,270317,15325,254992,0,209076,9099,199977,0,191671,7016,184655,0,192848,7703,185145
9346,100000,80000,0,0,0,0,0,1,2,79151,3400,75751,0,80249,2900,77349,0,82405,3500,78905,0,77011,3000,74011
9347,50000,40000,0,1,0,0,0,0,0,49284,2485,46799,0,7002,1203,5799,0,6991,192,6799,0,7137,199,6938
9348,190000,152000,0,0,0,0,0,0,2,75760,3600,72160,0,76899,3000,73899,0,78761,3100,75661,0,80883,3600,77283
9349,70000,56000,0,0,0,0,0,0,2,13017,0,13017,2,14299,1500,12799,2,13927,0,13927,2,15692,2000,13692
9350,70000,56000,0,0,0,0,0,0,0,15481,1585,13896,0,15266,1500,13766,0,13489,1000,12489,0,11837,600,11237
9351,30000,24000,1,1,1,1,1,0,2,35435,1100,34335,2,31976,0,31976,2,29704,1030,28674,0,27687,1000,26687
9352,140000,112000,0,0,0,0,0,0,3,82532,0,82532,2,81236,6500,74736,2,78306,0,78306,2,72173,3000,69173
9353,30000,24000,0,1,1,1,1,0,2,28827,1517,27310,2,27299,1000,26299,0,29110,2255,26855,0,28492,0,28492
9354,100000,80000,0,0,0,0,0,0,0,82078,5000,77078,0,25991,1300,24691,0,28071,5000,23071,0,28611,6000,22611
9355,50000,40000,0,0,0,0,0,0,0,29311,2000,27311,0,27932,2000,25932,0,28274,2000,26274,0,27605,1000,26605
9356,220000,176000,0,0,0,0,0,0,0,121369,5433,115936,0,100807,6000,94807,0,104432,5000,99432,0,107209,6000,101209
9357,180000,144000,0,0,0,0,0,1,2,111108,7623,103485,2,108476,3900,104576,2,104655,11,104644,2,107338,7700,99638
9358,30000,24000,0,0,0,0,0,0,0,10624,1229,9395,0,11539,1144,10395,0,11771,376,11395,0,9075,329,8746
9359,290000,232000,0,0,0,0,0,0,0,35225,1594,33631,0,35711,1840,33871,0,35381,1378,34003,0,34468,1245,33223
9360,360000,288000,0,0,1,1,1,0,2,383030,97225,285805,2,377145,0,377145,7,370850,0,370850,6,364365,0,364365
9361,240000,192000,0,0,0,0,0,0,-1,27770,27783,-13,-1,22920,22920,0,-1,4779,4952,-173,-1,7640,7640,0
9362,150000,120000,0,1,0,0,0,0,0,147323,5598,141725,0,112904,4440,108464,0,77642,2800,74842,0,78542,3000,75542
9363,390000,312000,0,0,0,0,0,0,-1,0,0,0,-2,0,0,0,-2,343,343,0,-1,1343,1000,343
9364,360000,288000,0,0,0,0,0,0,0,23040,23154,-114,-1,5651,5679,-28,-1,7017,7052,-35,-1,6495,6527,-32
9365,140000,112000,0,0,0,0,0,0,0,25141,3000,22141,0,29701,5000,24701,0,34197,5000,29197,0,38615,5000,33615
9366,30000,24000,0,0,0,0,0,1,2,14176,1000,13176,2,14642,1000,13642,2,15397,1000,14397,0,16147,1000,15147
9367,50000,40000,0,1,1,1,1,0,0,47205,2000,45205,0,45686,2000,43686,0,43629,2000,41629,0,46909,4000,42909
9368,340000,272000,0,0,0,0,0,0,-1,10961,10012,949,0,8722,8740,-18,-1,4776,4776,0,-1,2812,0,2812
9369,50000,40000,0,0,0,0,0,0,-1,2000,0,2000,2,0,0,0,2,0,0,0,-2,0,0,0
9370,130000,104000,0,0,0,0,0,1,2,0,0,0,2,0,0,0,-2,12677,12677,0,-1,30582,30582,0
9371,100000,80000,0,0,0,0,0,1,-2,0,0,0,-2,0,0,0,-2,0,0,0,-2,281,281,0
9372,290000,232000,0,0,0,0,0,0,-2,783,783,0,-2,40720,40720,0,-2,4352,4352,0,-2,504,504,0
9373,590000,472000,0,0,0,0,0,0,-1,244,1026,-782,-1,-1469,0,-1469,-1,925,3000,-2075,-1,3319,3000,319
9374,20000,16000,0,0,0,0,1,1,3,16047,600,15447,2,15492,0,15492,2,16739,1500,15239,2,16320,0,16320
9375,120000,96000,0,0,0,0,0,1,2,67259,6000,61259,2,67659,2100,65559,2,68937,3000,65937,2,70674,3000,67674
9376,240000,192000,0,0,0,0,0,0,0,91027,2213,88814,0,51508,1030,50478,0,51127,1023,50104,0,0,6790,-6790
9377,120000,96000,0,1,1,1,1,0,0,111978,5500,106478,0,112822,4000,108822,0,114969,4300,110669,0,117949,5012,112937
9378,500000,400000,0,0,0,0,0,0,0,827,1044,-217,-1,-4571,163,-4734,-1,-4954,5,-4959,-2,1566,8007,-6441
9379,130000,104000,0,0,0,0,0,0,0,38343,1600,36743,0,37834,1300,36534,0,37429,1400,36029,0,36991,1400,35591
9380,50000,40000,0,0,0,0,0,0,-1,26646,1439,25207,0,26832,959,25873,0,27395,994,26401,0,27940,1000,26940
9381,310000,248000,0,0,0,0,0,0,0,7739,2000,5739,0,8843,2000,6843,0,12204,3500,8704,0,14520,2500,12020
9382,200000,160000,0,0,0,0,0,0,-1,1190,1194,-4,-1,527,527,0,-1,4524,4537,-13,-1,5522,5538,-16
9383,240000,192000,0,0,0,0,0,0,2,51652,6000,45652,0,54969,4059,50910,0,42373,14,42359,2,48952,10022,38930
9384,160000,128000,1,1,1,1,1,0,2,168541,0,168541,3,164310,0,164310,2,162681,6100,156581,0,163005,12300,150705
9385,30000,24000,0,0,0,0,0,1,0,17262,3000,14262,0,16690,0,16690,2,17763,1500,16263,0,18960,1500,17460
9386,20000,16000,0,1,1,1,0,0,0,18418,1803,16615,0,18915,1300,17615,0,17639,1333,16306,0,0,0,0
9387,80000,64000,0,1,1,1,1,0,2,72464,0,72464,2,76613,6000,70613,2,77908,3100,74808,2,76034,0,76034
9388,450000,360000,0,0,0,0,0,0,-2,5018,5041,-23,-2,317,1,316,-2,1614,1622,-8,-2,324,325,-1
9389,210000,168000,0,0,0,0,0,0,-1,17036,17036,0,-1,73158,73158,0,-1,46823,936,45887,0,1427,29,1398
9390,150000,120000,0,0,0,0,0,0,-1,978,982,-4,-1,1178,1007,171,0,1007,5,1002,0,2075,2075,0
9391,20000,16000,0,0,0,0,0,0,0,13455,0,13455,2,15227,2000,13227,2,14699,0,14699,3,14313,0,14313
9392,30000,24000,0,0,0,0,0,1,0,9826,1651,8175,0,9519,0,9519,2,10362,1000,9362,0,11187,1000,10187
9393,200000,160000,0,0,0,0,0,0,-2,0,0,0,-2,0,0,0,-2,0,0,0,-2,0,0,0
9394,340000,272000,0,0,0,0,0,0,0,88629,3000,85629,0,71435,11115,60320,0,69725,2052,67673,0,69714,2500,67214
9395,270000,216000,0,0,0,0,0,0,-1,5691,5691,0,-1,37526,34000,3526,0,50565,14000,36565,0,48888,8000,40888
9396,120000,96000,0,0,0,0,0,0,0,37708,1200,36508,0,4293,1000,3293,0,4305,1000,3305,0,5128,888,4240
9397,40000,32000,0,0,0,0,0,0,0,27556,2500,25056,0,27447,1500,25947,0,26254,1500,24754,0,29645,4000,25645
9398,440000,352000,0,0,0,0,0,0,-1,42045,45213,-3168,-1,400321,400972,-651,-1,229680,5456,224224,0,265404,100267,165137
9399,50000,40000,0,0,0,0,0,0,-2,1708,1708,0,-1,0,0,0,-1,0,0,0,-2,0,0,0
9400,130000,104000,0,1,0,0,0,1,2,127748,5100,122648,0,100291,4100,96191,0,93552,3392,90160,0,95521,3521,92000
9401,50000,40000,0,1,0,0,0,0,0,46578,2000,44578,0,17029,2500,14529,0,10575,500,10075,0,9478,500,8978
9402,80000,64000,0,0,0,0,0,0,-1,152,152,0,-1,9587,9587,0,-1,692,6,686,0,706,706,0
9403,170000,136000,0,0,0,0,0,0,0,55677,3000,52677,0,59096,5000,54096,0,50536,10000,40536,0,15851,5000,10851
9404,230000,184000,0,0,0,0,0,0,-2,0,0,0,-2,0,0,0,-2,0,0,0,-2,0,0,0
9405,480000,384000,0,0,0,0,0,0,0,37501,5002,32499,0,41399,5031,36368,0,35489,1006,34483,0,33081,986,32095
9406,170000,136000,0,1,1,1,1,1,2,161487,6500,154987,2,157577,0,157577,2,168094,13000,155094,2,170922,5500,165422
9407,350000,280000,0,0,0,0,0,0,-2,20482,20596,-114,-2,0,0,0,-2,0,0,0,-2,0,0,0
9408,90000,72000,0,0,0,0,0,1,2,10267,1500,8767,0,10350,550,9800,0,10564,529,10035,0,10771,531,10240
9409,80000,64000,0,0,0,0,0,0,0,25253,2000,23253,0,5549,2000,3549,0,4549,0,4549,0,4549,0,4549
9410,100000,80000,0,1,1,1,1,1,2,99898,2950,96948,2,99786,3100,96686,2,97670,5,97665,2,100959,6170,94789
9411,60000,48000,0,1,1,1,1,1,3,62075,4500,57575,2,60501,0,60501,3,61808,2400,59408,2,60668,0,60668
9412,350000,280000,0,0,0,0,0,0,-2,29178,12110,17068,-2,29180,15044,14136,-2,52550,32244,20306,-2,43538,40218,3320
9413,160000,128000,0,0,0,0,0,0,-1,-2985,0,-2985,-1,1472,4457,-2985,-1,2985,1513,1472,-1,1513,0,1513
9414,150000,120000,0,0,0,0,0,0,-1,4090,4090,0,-1,51893,51893,0,-1,52033,2000,50033,0,51188,3000,48188
9415,250000,200000,0,0,0,0,0,0,0,24196,1790,22406,0,22408,1250,21158,0,20610,700,19910,0,17978,644,17334
9416,30000,24000,0,0,0,0,0,1,4,13528,0,13528,3,13810,800,13010,2,14488,1200,13288,2,13971,0,13971
9417,290000,232000,0,0,0,0,0,0,2,-6,0,-6,-2,1217,1223,-6,-2,1055,1276,-221,-2,176,0,176
9418,210000,168000,0,0,0,0,0,0,-1,0,0,0,-2,5933,5933,0,-1,8698,3000,5698,0,11572,3000,8572
9419,80000,64000,0,0,0,0,0,0,-1,0,0,0,-2,0,0,0,-2,0,0,0,-2,0,0,0
9420,50000,40000,0,1,1,1,1,1,2,45874,0,45874,2,48326,3500,44826,2,47440,0,47440,2,50426,3758,46668
9421,130000,104000,0,0,0,0,0,0,0,0,0,0,0,0,0,0,-2,0,0,0,-2,0,0,0
9422,150000,120000,0,0,0,0,0,0,0,59830,3000,56830,0,60134,2000,58134,0,26607,0,26607,0,0,0,0
9423,20000,16000,0,0,0,0,0,1,0,14152,1234,12918,0,14435,517,13918,0,14802,600,14202,0,15256,700,14556
9424,20000,16000,0,1,1,1,1,1,0,19694,1000,18694,2,20004,1000,19004,0,20159,1000,19159,0,20059,1000,19059
9425,20000,16000,0,0,0,0,0,0,-1,3242,3242,0,-1,1206,1206,0,-1,326,326,0,-1,326,326,0
9426,200000,160000,0,0,0,0,0,0,-2,281,282,-1,-2,1105,1110,-5,-2,354,390,-36,-2,-2,0,-2
9427,160000,128000,0,0,0,0,0,0,-1,6228,6228,0,-1,6000,6000,0,-1,6000,6000,0,-1,6000,6000,0
9428,200000,160000,0,0,0,0,0,1,0,26397,11000,15397,0,12674,12674,0,-1,14068,14445,-377,-1,6468,6867,-399
9429,110000,88000,0,1,1,0,0,0,0,106974,5051,101923,0,97327,3645,93682,0,60454,1984,58470,0,59062,3000,56062
9430,180000,144000,0,0,0,0,0,0,0,50238,10017,40221,0,49461,2018,47443,0,43877,1022,42855,0,32411,2322,30089
9431,90000,72000,0,1,1,1,1,0,0,88487,0,88487,2,88201,3301,84900,0,87219,3136,84083,0,86803,3156,83647
9432,440000,352000,0,0,0,0,0,0,0,0,0,0,0,27549,27549,0,-2,77349,50000,27349,-2,10456,18956,-8500
9433,50000,40000,0,0,0,0,0,0,0,26666,1501,25165,0,27324,1501,25823,0,29596,3001,26595,0,26226,919,25307
9434,500000,400000,0,0,0,0,0,0,0,7652,7016,636,0,7187,3007,4180,0,10861,5009,5852,0,15893,7028,8865
9435,150000,120000,0,1,1,1,1,0,0,135263,4700,130563,0,137540,4306,133234,0,144786,10006,134780,0,146379,4822,141557
9436,230000,184000,0,0,0,0,0,0,-1,2608,1020,1588,0,797,799,-2,-1,-3,0,-3,-1,-3,0,-3
9437,500000,400000,0,0,0,0,0,0,-1,8570,5000,3570,0,12072,5000,7072,0,9832,5000,4832,0,984,1000,-16
9438,290000,232000,0,0,0,0,0,0,0,220787,10000,210787,0,223810,8165,215645,0,228043,9000,219043,0,234257,10000,224257
9439,680000,544000,0,0,0,0,0,1,0,10251,10296,-45,-1,25094,25219,-125,-1,7327,7341,-14,-1,167520,163123,4397
9440,70000,56000,0,0,0,0,0,0,0,10076,2000,8076,0,33079,30000,3079,0,23188,5000,18188,0,20937,20000,937
9441,200000,160000,0,0,0,0,0,0,-2,0,0,0,-2,0,0,0,-2,0,0,0,-2,0,0,0
9442,30000,24000,0,1,1,1,0,0,0,27042,2000,25042,0,27617,1400,26217,0,28546,1300,27246,0,13487,700,12787
9443,200000,160000,0,0,0,0,0,0,0,50942,2164,48778,0,50146,2500,47646,0,50235,3480,46755,0,48984,2500,46484
9444,150000,120000,0,0,0,0,0,0,0,32794,1693,31101,0,30786,2007,28779,0,24250,1007,23243,0,20052,1000,19052
9445,100000,80000,0,0,0,0,0,0,0,65668,2617,63051,0,66046,2098,63948,0,66779,1916,64863,0,45833,1707,44126
9446,210000,168000,0,0,0,0,0,0,0,152365,5400,146965,0,146625,6000,140625,0,146163,6000,140163,0,146180,6000,140180
9447,50000,40000,0,0,0,0,0,0,0,33404,4005,29399,0,18727,1000,17727,0,13793,1000,12793,0,19354,6000,13354
9448,90000,72000,0,0,0,0,0,1,0,30091,1100,28991,2,30922,1630,29292,2,34112,4000,30112,2,34280,1200,33080
9449,130000,104000,0,0,0,0,0,0,2,10212,10252,-40,-1,2486,2486,0,-1,5170,5170,0,-1,6823,3039,3784
9450,310000,248000,0,0,0,0,0,0,-2,5365,5365,0,-1,6274,1000,5274,0,7017,1000,6017,0,8893,2000,6893
9451,100000,80000,0,0,0,0,0,0,0,49234,3000,46234,0,50521,2000,48521,0,51820,2000,49820,0,53056,2200,50856
9452,50000,40000,0,0,0,0,0,0,-1,14596,14596,0,-1,19323,5000,14323,0,19728,716,19012,0,20142,742,19400
9453,240000,192000,0,0,0,0,0,0,-1,626,626,0,-1,626,626,0,-1,626,626,0,-1,626,626,0
9454,110000,88000,0,1,0,0,0,0,2,104529,6000,98529,2,81319,4000,77319,2,76549,0,76549,2,77433,4000,73433
9455,50000,40000,1,1,0,0,0,0,0,68764,4000,64764,0,14353,0,14353,2,16110,2000,14110,0,17832,2000,15832
9456,30000,24000,0,0,0,0,0,1,2,19637,0,19637,2,21705,2403,19302,2,21059,0,21059,2,23716,3000,20716
9457,170000,136000,0,0,0,0,0,0,0,39698,4500,35198,0,38330,4000,34330,0,39602,4000,35602,0,39922,3000,36922
9458,10000,8000,0,0,0,0,0,1,2,7604,1176,6428,0,7637,1000,6637,0,6056,121,5935,0,2852,57,2795
9459,60000,48000,0,0,0,0,0,0,0,51400,5000,46400,0,399,399,0,-1,500,500,0,-1,10400,10400,0
9460,110000,88000,0,0,0,0,0,0,0,0,0,0,0,0,0,0,-2,0,0,0,-2,0,0,0
9461,500000,400000,0,0,0,0,0,1,-2,0,0,0,-2,0,0,0,-2,0,0,0,-2,0,0,0
9462,260000,208000,0,0,0,0,0,1,0,60762,19002,41760,0,52402,19001,33401,0,51391,20002,31389,0,43070,18063,25007
9463,250000,200000,0,0,0,0,0,1,-2,500,500,0,-2,0,0,0,-2,0,0,0,-2,0,0,0
9464,70000,56000,0,0,0,0,0,0,0,47480,2238,45242,0,49242,3000,46242,0,29993,3000,26993,0,29618,1500,28118
9465,360000,288000,0,0,0,0,0,0,0,20384,2384,18000,0,23255,3271,19984,0,22495,2509,19986,0,380,381,-1
9466,240000,192000,0,0,0,0,0,0,-1,32384,15000,17384,0,22749,0,22749,0,7804,0,7804,0,290,300,-10
9467,500000,400000,0,0,0,0,0,0,-2,-44,0,-44,-2,-44,0,-44,-2,-44,0,-44,-2,-44,0,-44
9468,390000,312000,0,0,0,0,0,0,0,277888,11000,266888,0,175268,5600,169668,0,167781,5700,162081,0,147878,5600,142278
9469,150000,120000,0,0,0,0,0,0,-1,7444,7447,-3,-1,19997,20013,-16,-1,4095,4095,0,-1,52207,25869,26338
9470,260000,208000,0,0,0,0,0,0,-2,256,258,-2,-2,274,274,0,-2,388,388,0,-2,766,766,0
9471,280000,224000,0,0,0,0,0,0,0,9909,1200,8709,0,10420,1200,9220,0,10142,1000,9142,0,10329,350,9979
9472,60000,48000,0,1,1,1,1,1,0,61331,4941,56390,0,55566,0,55566,2,59331,4675,54656,2,60569,2361,58208
9473,150000,120000,0,0,0,0,0,1,0,84271,3490,80781,0,43832,1402,42430,0,33963,1233,32730,0,34638,1240,33398
9474,160000,128000,0,0,0,0,0,0,2,74651,3211,71440,0,70403,2505,67898,0,71890,2612,69278,0,73893,3500,70393
9475,120000,96000,0,0,0,0,0,0,-1,6313,5037,1276,0,1100,1100,0,-1,1330,1330,0,-1,830,3800,-2970
9476,230000,184000,0,0,0,0,0,0,-2,20123,20200,-77,-2,1671,1671,0,-2,1244,1244,0,-2,0,0,0
9477,20000,16000,0,0,0,0,0,1,2,11448,0,11448,3,10970,0,10970,2,11636,1000,10636,0,12442,1000,11442
9478,210000,168000,0,1,1,1,1,0,0,195739,9000,186739,0,198081,7100,190981,0,202410,7510,194900,0,206582,7700,198882
9479,360000,288000,0,0,0,0,0,0,-2,0,200,-200,-2,0,0,0,-2,69000,69000,0,-2,2500,2500,0
9480,130000,104000,0,0,0,0,0,0,-1,1248,0,1248,2,922,0,922,0,-693,0,-693,0,-2292,0,-2292
9481,360000,288000,0,0,0,0,0,0,-1,3366,4567,-1201,-1,5210,5236,-26,-1,13308,13373,-65,-1,7089,7123,-34
9482,320000,256000,0,0,0,0,0,0,0,150441,80003,70438,0,167983,174169,-6186,-1,142305,10000,132305,0,153555,15013,138542
9483,110000,88000,0,1,1,0,0,0,0,108107,4955,103152,0,96213,3446,92767,0,68003,3000,65003,0,52684,3000,49684
9484,160000,128000,0,0,0,0,0,0,-2,0,0,0,-2,0,0,0,-2,0,0,0,-2,0,0,0
9485,40000,32000,0,1,1,1,1,0,2,39982,3800,36182,2,38979,0,38979,2,39479,1200,38279,2,39329,0,39329
9486,140000,112000,0,0,0,0,0,0,2,97720,0,97720,2,98997,3800,95197,0,101439,4200,97239,0,103840,4250,99590
9487,240000,192000,0,1,1,1,0,1,2,206332,0,206332,2,214981,12014,202967,2,194817,0,194817,2,186895,5307,181588
9488,100000,80000,0,0,0,0,0,0,-1,3786,0,3786,2,3789,3809,-20,2,2195,0,2195,-2,3691,3691,0
9489,230000,184000,0,0,0,0,0,0,0,37571,2000,35571,0,38924,2000,36924,0,40027,2000,38027,0,41277,2000,39277
9490,30000,24000,0,0,0,0,0,0,-1,2462,2476,-14,-1,13019,13263,-244,-2,4679,4793,-114,-2,0,0,0
9491,50000,40000,0,0,0,0,0,0,0,142,161,-19,2,29886,74354,-44468,-1,30510,927,29583,0,31276,1089,30187
9492,360000,288000,0,0,0,0,0,0,-2,0,0,0,-2,0,0,0,-2,0,0,0,-2,0,0,0
9493,150000,120000,0,0,0,0,0,0,-2,4729,4729,0,-1,1568,1568,0,-1,4295,4295,0,-1,0,0,0
9494,50000,40000,0,1,1,0,0,0,0,49072,86,48986,2,49724,2198,47526,0,19801,1198,18603,0,14301,600,13701
9495,20000,16000,1,1,1,1,0,0,2,22422,1481,20941,0,20794,503,20291,0,19914,2019,17895,0,7476,233,7243
9496,50000,40000,0,0,0,0,0,1,-1,1305,2305,-1000,-1,1134,0,1134,2,1073,1200,-127,-1,1312,1500,-188
9497,360000,288000,0,0,0,0,0,0,-2,0,0,0,-2,0,0,0,-2,0,0,0,-2,0,0,0
9498,210000,168000,0,0,0,0,0,0,-1,0,0,0,-2,95438,95438,0,-1,96317,3393,92924,0,98400,3580,94820
9499,20000,16000,0,0,0,0,0,0,2,390,0,390,2,0,0,0,2,780,780,0,-1,0,0,0
9500,90000,72000,0,0,0,0,0,0,0,67000,4000,63000,0,45837,4000,41837,0,49959,5000,44959,0,52981,4000,48981
9501,30000,24000,0,0,0,1,1,0,0,24372,1200,23172,2,25776,2100,23676,2,25088,0,25088,3,24537,0,24537
9502,690000,552000,0,0,0,0,0,0,0,390166,19118,371048,0,360568,7415,353153,0,331674,20348,311326,0,160287,160671,-384
9503,150000,120000,0,0,0,0,0,0,-1,2777,2785,-8,-1,945,947,-2,-1,-5,0,-5,-1,1951,1956,-5
9504,200000,160000,0,0,0,0,0,0,0,162374,6061,156313,0,154234,7048,147186,0,143953,5016,138937,0,147834,10294,137540
9505,280000,224000,0,0,0,0,0,0,0,118076,4000,114076,0,101457,4000,97457,0,81124,4000,77124,0,42347,3000,39347
9506,290000,232000,0,0,0,0,0,1,-1,704,707,-3,-1,2135,2145,-10,-1,1591,1599,-8,-1,5392,5419,-27
9507,210000,168000,0,0,0,0,0,0,0,8607,1006,7601,0,9137,1500,7637,0,10637,1500,9137,0,3443,2600,843
9508,360000,288000,0,0,0,0,0,1,2,10845,10859,-14,-1,8336,380,7956,0,5878,187,5691,0,12903,12966,-63
9509,500000,400000,0,0,0,0,0,1,-1,26085,2000,24085,0,27644,2000,25644,0,28884,2000,26884,0,32930,5000,27930
9510,390000,312000,0,0,0,0,0,0,0,24947,2000,22947,0,26223,2000,24223,0,27643,2000,25643,0,29025,2000,27025
9511,120000,96000,0,0,0,0,0,0,0,5540,1200,4340,0,6442,1000,5442,0,7182,1000,6182,0,8057,1000,7057
9512,120000,96000,0,0,0,0,0,0,0,32687,1600,31087,0,32972,1200,31772,0,33559,1500,32059,0,34604,2000,32604
9513,420000,336000,0,0,0,0,0,0,0,80575,10575,70000,0,92982,15000,77982,0,98502,10000,88502,0,103200,10000,93200
9514,250000,200000,0,0,0,0,0,0,-2,278,278,0,-2,278,278,0,-2,278,278,0,-2,428,428,0
9515,30000,24000,0,0,0,0,0,0,0,18083,2500,15583,0,20275,2500,17775,0,20445,800,19645,2,20971,1000,19971
9516,60000,48000,0,0,0,0,0,1,0,41483,1572,39911,0,19394,1000,18394,0,18893,700,18193,0,19043,668,18375
9517,350000,280000,0,0,0,0,0,0,-2,4100,4100,0,-2,0,0,0,-2,0,0,0,-2,0,0,0
9518,500000,400000,0,0,0,0,0,0,-1,7527,7527,0,-1,77166,77166,0,-1,74397,3397,71000,0,77055,4055,73000
9519,360000,288000,0,0,0,0,0,0,-2,0,0,0,-2,0,0,0,-2,1070,1070,0,-2,0,0,0
9520,270000,216000,0,0,0,0,0,0,0,46512,4018,42494,0,40335,14,40321,2,37165,2051,35114,0,22156,2000,20156
9521,50000,40000,0,0,0,0,0,0,0,0,0,0,0,0,0,0,-2,0,0,0,-2,0,0,0
9522,80000,64000,0,0,0,0,0,0,0,58186,2053,56133,0,56234,1812,54422,0,53229,1819,51410,0,45519,1686,43833
9523,100000,80000,0,0,0,0,0,0,0,9749,1500,8249,0,14188,4500,9688,0,16602,5000,11602,0,19575,5000,14575
9524,150000,120000,0,0,0,0,0,0,2,940,0,940,2,965,965,0,-1,965,0,965,0,726,726,0
9525,460000,368000,0,0,0,0,0,0,0,76653,76653,0,-1,75117,20000,55117,0,76616,2481,74135,0,78248,2600,75648
9526,180000,144000,0,0,0,0,0,1,-1,1480,1000,480,0,380,0,380,0,740,740,0,-1,1100,1100,0
9527,40000,32000,0,0,0,0,0,0,0,17351,1700,15651,0,21567,6000,15567,0,18388,800,17588,0,18353,800,17553
9528,20000,16000,0,1,1,1,1,1,0,19103,1305,17798,0,19471,1277,18194,0,19225,656,18569,0,19106,1106,18000
9529,200000,160000,0,0,0,0,0,0,0,15040,2010,13030,0,14074,1000,13074,0,14758,1000,13758,0,15442,1000,14442
9530,200000,160000,0,0,0,0,0,0,-2,-4,0,-4,-2,752,756,-4,-1,0,0,0,-1,2718,2718,0
9531,70000,56000,0,1,1,1,1,0,0,71451,3400,68051,0,70654,2900,67754,0,70965,2750,68215,0,71373,3152,68221
9532,450000,360000,0,0,0,0,0,1,2,10199,2000,8199,2,0,0,0,2,0,0,0,-2,0,0,0
9533,100000,80000,0,1,0,0,0,1,2,89218,4950,84268,0,63243,2400,60843,0,42510,1200,41310,0,41221,1400,39821
9534,50000,40000,0,1,1,0,0,0,2,50382,1500,48882,2,49162,0,49162,2,40973,1275,39698,0,39671,1377,38294
9535,140000,112000,0,0,0,0,0,0,0,89365,4000,85365,0,91005,3618,87387,0,94651,5481,89170,0,97132,5000,92132
9536,30000,24000,0,0,0,0,1,1,2,23873,700,23173,2,24182,1000,23182,2,26022,2550,23472,2,27462,2013,25449
9537,80000,64000,0,0,0,0,0,0,-1,330,660,-330,-1,330,0,330,0,0,0,0,0,0,0,0
9538,230000,184000,0,0,0,0,0,0,0,172990,7000,165990,0,177963,8000,169963,0,77076,3000,74076,0,78848,3000,75848
9539,110000,88000,0,0,0,0,0,0,-2,0,0,0,-2,0,0,0,-2,0,0,0,-2,0,0,0
9540,50000,40000,0,1,1,1,1,1,0,42133,0,42133,2,43127,2000,41127,0,44210,1800,42410,0,45844,2500,43344
9541,50000,40000,0,0,0,0,0,0,0,33441,2000,31441,0,32697,1500,31197,0,33693,3000,30693,0,33029,1500,31529
9542,100000,80000,0,0,0,0,0,0,-1,964,0,964,2,365,0,365,0,0,0,0,0,0,0,0
9543,80000,64000,0,0,0,0,0,1,2,59564,2203,57361,0,56592,3006,53586,0,52766,3005,49761,0,48208,2005,46203
9544,200000,160000,0,1,1,0,0,1,2,175766,6998,168768,2,171377,4558,166819,2,163943,5921,158022,2,162195,4526,157669
9545,180000,144000,0,0,0,0,0,0,-1,0,0,0,-1,0,0,0,-2,0,0,0,-2,0,0,0
9546,20000,16000,0,1,1,1,0,0,0,18194,1400,16794,0,17759,355,17404,0,18759,1000,17759,0,5340,126,5214
9547,120000,96000,0,0,0,0,0,0,0,90066,2988,87078,0,80165,4492,75673,0,78108,2797,75311,0,77588,2991,74597
9548,30000,24000,0,1,1,1,1,0,2,29083,2000,27083,0,28313,940,27373,0,28932,1000,27932,0,29565,1106,28459
9549,20000,16000,0,1,1,1,1,1,0,19954,2859,17095,0,19259,0,19259,2,20139,1044,19095,2,19434,0,19434
9550,150000,120000,0,0,0,0,0,0,0,116541,2336,114205,0,114511,2290,112221,0,0,0,0,0,0,0,0
9551,150000,120000,0,0,0,0,0,0,-2,6203,6234,-31,-2,9808,9904,-96,-2,3267,4016,-749,-2,6662,6695,-33
9552,50000,40000,1,1,1,0,0,0,3,54902,0,54902,2,54280,1200,53080,0,18595,15000,3595,0,18838,2000,16838
9553,180000,144000,0,0,1,1,0,0,0,178143,181625,-3482,-1,181625,8350,173275,0,164914,5005,159909,0,145052,5000,140052
9554,40000,32000,0,1,1,0,0,1,0,36918,2000,34918,0,37478,1071,36407,0,20650,1500,19150,0,0,0,0
9555,200000,160000,0,0,0,0,0,0,-2,1000,1000,0,-1,34614,34614,0,-1,749,749,0,-1,0,0,0
9556,220000,176000,0,0,0,0,0,0,0,4252,1500,2752,0,6129,2000,4129,0,6423,500,5923,0,7208,1000,6208
9557,200000,160000,0,0,0,0,0,0,-1,26995,26995,0,-1,7601,7606,-5,-1,6481,380,6101,0,1610,0,1610
9558,50000,40000,0,0,0,0,0,0,0,10103,1500,8603,0,9763,1500,8263,0,9592,1500,8092,0,7797,1200,6597
9559,160000,128000,0,0,0,0,0,0,0,28052,2000,26052,0,7222,1000,6222,0,99669,99669,0,-1,84426,12600,71826
9560,200000,160000,0,0,0,0,0,0,-1,6781,6781,0,-1,12162,12162,0,-1,12410,248,12162,0,12410,0,12410
9561,490000,392000,0,0,0,0,0,0,-1,56573,56717,-144,-1,81414,81414,0,-1,62063,62063,0,-1,14122,14122,0
9562,20000,16000,0,0,0,0,0,0,0,15,0,15,0,41,26,15,0,10522,19700,-9178,-1,12340,2000,10340
9563,200000,160000,0,0,0,0,0,0,0,26750,1559,25191,0,24014,2000,22014,0,10885,390,10495,0,7371,328,7043
9564,180000,144000,0,0,0,0,0,0,0,128342,4300,124042,0,122345,4023,118322,0,109228,3785,105443,0,101428,3684,97744
9565,110000,88000,0,1,1,1,1,0,0,100316,4000,96316,0,100512,4000,96512,0,102215,3800,98415,0,103909,4000,99909
9566,270000,216000,0,0,0,0,0,0,-1,316,316,0,-1,571,571,0,-1,7711,7711,0,-1,571,571,0
9567,310000,248000,0,0,0,0,0,0,-1,430,430,0,-1,843,845,-2,-1,857,857,0,-1,-777,628,-1405
9568,200000,160000,0,1,1,0,0,0,0,180103,7512,172591,0,180647,8034,172613,0,76236,5600,70636,0,71415,0,71415
9569,450000,360000,0,0,0,0,0,0,-1,35727,35758,-31,-1,82517,90018,-7501,-1,91873,41340,50533,0,41628,20000,21628
9570,360000,288000,0,0,0,0,0,0,-2,12063,12063,0,-2,6080,6080,0,-2,0,0,0,-2,0,0,0
9571,70000,56000,0,0,0,0,0,0,0,29802,1500,28302,0,30395,1089,29306,0,31034,1130,29904,0,31668,1150,30518
9572,280000,224000,0,0,0,0,0,0,0,0,0,0,-2,4533,4533,0,-1,5533,1000,4533,0,65607,65607,0
9573,80000,64000,0,0,0,0,0,0,0,57488,5311,52177,0,47846,0,47846,2,48464,1787,46677,0,48940,1700,47240
9574,50000,40000,0,0,0,0,0,0,0,28301,0,28301,2,26829,1200,25629,0,27173,1500,25673,0,26424,943,25481
9575,10000,8000,0,0,0,0,1,0,0,6937,2000,4937,0,7946,1132,6814,0,8714,900,7814,0,8432,0,8432
9576,310000,248000,0,0,0,0,0,0,0,112374,6000,106374,0,54762,5000,49762,0,58189,5000,53189,0,57170,4000,53170
9577,480000,384000,0,0,0,0,0,0,0,71857,3000,68857,0,66673,2096,64577,0,65200,2115,63085,0,65511,2089,63422
9578,180000,144000,0,0,0,0,0,1,-1,390,390,0,-1,390,390,0,-1,390,390,0,-1,780,780,0
9579,50000,40000,0,0,0,0,0,0,-2,2118,2124,-6,-2,2259,2266,-7,-2,3527,3638,-111,-2,1100,1303,-203
9580,240000,192000,0,1,0,0,0,0,0,204121,8000,196121,0,171051,30000,141051,0,175416,6000,169416,0,179754,6000,173754
9581,200000,160000,0,0,0,0,0,0,-1,390,390,0,-1,390,390,0,-1,390,390,0,-1,390,390,0
9582,130000,104000,0,0,0,0,0,0,-1,1919,1919,0,-1,3671,3671,0,-1,13861,13861,0,-1,21782,10000,11782
9583,50000,40000,0,0,0,0,0,0,0,24278,2000,22278,0,24750,1300,23450,0,0,0,0,0,0,0,0
9584,130000,104000,0,0,0,0,0,0,0,9143,1173,7970,0,9741,1138,8603,0,9713,477,9236,0,9458,400,9058
9585,230000,184000,0,0,0,0,0,0,-1,0,0,0,-1,0,0,0,-2,0,0,0,-2,0,0,0
9586,500000,400000,0,0,0,0,0,0,0,294257,294318,-61,-1,278725,10254,268471,0,89161,7524,81637,0,87863,5009,82854
9587,300000,240000,0,1,1,1,0,0,0,252427,10505,241922,0,254160,9157,245003,0,250645,9319,241326,0,245851,9600,236251
9588,10000,8000,0,0,1,1,1,0,0,9901,2200,7701,0,9975,1000,8975,0,9736,333,9403,0,8703,311,8392
9589,360000,288000,0,0,0,0,0,1,0,1619,1002,617,0,1266,202,1064,0,1212,501,711,0,1324,502,822
9590,470000,376000,0,0,0,0,0,0,-2,0,0,0,-2,0,0,0,-2,0,0,0,-2,924,924,0
9591,20000,16000,0,1,1,1,1,1,0,18379,1759,16620,0,19020,1400,17620,0,18620,0,18620,0,19000,380,18620
9592,20000,16000,0,0,0,0,0,0,-1,-610,0,-610,-2,18990,19990,-1000,-1,390,390,0,-1,930,930,0
9593,20000,16000,0,1,0,1,1,0,2,16374,0,16374,2,16604,800,15804,0,16837,650,16187,0,17357,800,16557
9594,130000,104000,0,0,0,0,0,0,0,94050,5000,89050,0,21000,21000,0,-1,858,858,0,-1,2160,2160,0
9595,50000,40000,0,0,0,0,0,0,0,6928,6943,-15,-1,17006,17006,0,-1,17363,630,16733,0,17707,633,17074
9596,120000,96000,0,0,0,0,0,1,2,57455,2500,54955,2,58127,2200,55927,2,59367,2300,57067,2,60333,2114,58219
9597,50000,40000,0,1,0,0,0,1,0,44384,1300,43084,0,19524,642,18882,0,35268,612,34656,0,16099,1192,14907
9598,130000,104000,0,1,1,1,1,0,0,127881,2600,125281,2,133130,9000,124130,2,127159,0,127159,2,131069,6000,125069
9599,210000,168000,0,0,0,0,0,0,0,76062,3300,72762,0,76287,3000,73287,0,76971,3000,73971,0,77737,3000,74737
9600,50000,40000,0,1,1,0,0,0,2,45515,1200,44315,0,45470,155,45315,0,4220,3000,1220,0,4220,0,4220
9601,50000,40000,0,0,0,0,0,0,0,13513,0,13513,3,14388,1400,12988,2,13862,0,13862,2,14149,659,13490
9602,150000,120000,0,1,1,1,1,0,0,136915,5000,131915,0,139449,7000,132449,0,140851,5165,135686,0,142160,5500,136660
9603,230000,184000,0,0,0,0,0,0,0,6790,1200,5590,0,8171,2000,6171,0,7396,0,7396,2,7757,1000,6757
9604,340000,272000,0,0,0,0,0,0,0,228760,10000,218760,0,229404,7100,222304,0,161551,5800,155751,0,164936,5915,159021
9605,100000,80000,0,1,1,0,1,0,2,99264,4902,94362,0,90972,4118,86854,0,100306,30018,70288,0,100536,5060,95476
9606,180000,144000,0,0,0,0,0,0,2,84020,0,84020,2,97554,15000,82554,2,95878,0,95878,2,112141,18000,94141
9607,210000,168000,0,0,0,0,0,0,-2,0,0,0,-2,0,0,0,-2,4853,4853,0,-2,5190,5190,0
9608,90000,72000,0,0,0,0,0,0,-1,0,0,0,-2,0,0,0,-2,0,0,0,-2,0,0,0
9609,90000,72000,0,1,0,0,0,0,0,88344,4042,84302,0,50209,1748,48461,0,48262,1892,46370,0,49316,2000,47316
9610,90000,72000,0,0,0,0,0,0,0,46174,2393,43781,0,47193,2090,45103,0,48105,2000,46105,0,49327,2000,47327
9611,180000,144000,0,0,0,0,0,0,0,115402,7030,108372,0,105844,8000,97844,0,98396,5396,93000,0,101390,5390,96000
9612,420000,336000,0,0,0,0,0,0,0,20899,3000,17899,0,14966,1041,13925,0,5676,5676,0,-1,134038,135687,-1649
9613,80000,64000,0,1,1,0,0,1,0,79425,3055,76370,0,70583,3047,67536,0,48308,1663,46645,0,46049,1692,44357
9614,200000,160000,0,0,0,0,0,0,0,48160,2000,46160,0,49361,2000,47361,0,50564,2000,48564,0,51572,2000,49572
9615,20000,16000,0,0,0,0,0,1,2,13145,0,13145,2,15023,2087,12936,2,14510,0,14510,3,13854,550,13304
9616,180000,144000,0,0,0,0,0,0,-1,3333,3333,0,-1,3333,3333,0,-1,3333,3333,0,-1,3333,3333,0
9617,210000,168000,0,0,0,0,0,0,0,4107,1005,3102,0,5931,3208,2723,0,4665,2000,2665,0,6607,2000,4607
9618,290000,232000,0,0,0,0,0,1,-2,0,0,0,-2,0,0,0,-2,0,0,0,-2,0,0,0
9619,100000,80000,0,0,0,0,0,0,0,31498,2000,29498,0,17158,4000,13158,0,18758,2000,16758,0,17168,3000,14168
9620,90000,72000,0,0,0,0,0,0,-2,-191,0,-191,-2,-191,0,-191,-2,-191,0,-191,-2,209,550,-341
9621,20000,16000,0,0,0,1,1,1,2,15913,1600,14313,0,17033,1700,15333,0,17466,1000,16466,0,19635,2600,17035
9622,230000,184000,0,0,0,0,0,0,-1,-250,0,-250,-1,-125,0,-125,-2,609,4000,-3391,-1,362,3000,-2638
9623,20000,16000,0,1,1,1,1,1,2,18541,0,18541,2,19254,1298,17956,0,19456,1000,18456,0,19323,692,18631
9624,50000,40000,0,1,1,0,0,0,0,48102,2247,45855,0,91452,1900,89552,0,9551,382,9169,0,9746,195,9551
9625,90000,72000,0,0,0,0,0,0,0,0,0,0,0,0,0,0,-2,0,0,0,-2,0,0,0
9626,20000,16000,0,0,0,0,0,1,2,11714,1600,10114,0,13923,2726,11197,0,13405,0,13405,2,13683,643,13040
9627,390000,312000,0,0,0,0,0,0,-1,0,0,0,-1,18692,18692,0,-1,10418,1000,9418,0,8590,172,8418
9628,130000,104000,0,0,0,0,0,0,0,74624,2709,71915,0,76133,2750,73383,0,77648,2767,74881,0,79370,2961,76409
9629,30000,24000,0,0,0,0,0,1,2,8587,0,8587,2,8366,1200,7166,0,8528,1500,7028,0,7030,0,7030
9630,160000,128000,0,0,0,0,0,0,-2,-3,0,-3,-2,-3,0,-3,-2,1274,1277,-3,-2,0,0,0
9631,50000,40000,0,0,0,0,0,0,-2,0,0,0,-2,0,0,0,-2,0,0,0,-2,0,0,0
9632,30000,24000,0,1,1,0,0,1,2,26947,1800,25147,0,27529,1370,26159,0,24909,1264,23645,0,24576,2078,22498
9633,50000,40000,0,0,0,0,0,0,0,12761,2043,10718,0,7477,1000,6477,0,8372,1000,7372,0,9240,1390,7850
9634,110000,88000,0,0,0,0,0,0,0,69834,10000,59834,0,71245,3170,68075,0,72199,2735,69464,0,73711,2829,70882
9635,150000,120000,0,0,0,0,0,0,0,86738,4021,82717,0,75859,2500,73359,0,74108,3000,71108,0,75898,2800,73098
9636,120000,96000,0,0,0,0,0,0,0,75564,2741,72823,0,77242,2933,74309,0,81826,6000,75826,0,83630,3300,80330
9637,120000,96000,0,0,0,0,0,0,0,11612,3000,8612,0,12438,3000,9438,0,13099,3000,10099,0,15926,3000,12926
9638,250000,200000,0,0,0,0,0,0,0,111690,10000,101690,0,114776,10000,104776,0,110902,10000,100902,0,114018,5000,109018
9639,10000,8000,0,0,0,0,0,1,2,3978,0,3978,2,4062,150,3912,0,4196,200,3996,0,4326,200,4126
9640,460000,368000,0,0,0,0,0,0,-1,20246,20373,-127,-1,9936,10018,-82,-1,10833,12387,-1554,-1,21169,21865,-696
9641,80000,64000,0,0,0,0,0,0,0,42372,3650,38722,0,41393,0,41393,2,42275,1700,40575,0,43418,2000,41418
9642,450000,360000,0,0,0,0,0,0,0,221480,8517,212963,0,201670,7020,194650,0,181345,6821,174524,0,160000,6027,153973
9643,100000,80000,0,0,0,0,0,1,-2,800,3000,-2200,-1,410,0,410,2,20,0,20,2,-370,0,-370
9644,230000,184000,0,0,0,0,0,1,0,44532,3000,41532,0,42517,2000,40517,0,44087,2000,42087,0,40581,1242,39339
9645,500000,400000,0,0,0,0,0,1,-2,15714,15714,0,-2,5390,5390,0,-2,43386,43386,0,-2,0,0,0
9646,140000,112000,0,0,0,0,0,0,-1,2292,2292,0,-1,3365,3365,0,-1,1567,1567,0,-1,1707,1707,0
9647,500000,400000,0,0,0,0,0,0,-1,7477,7488,-11,-1,8370,8370,0,-1,8890,8890,0,-1,6424,6424,0
9648,70000,56000,0,1,1,1,1,1,2,66279,2600,63679,2,70580,6000,64580,2,69180,0,69180,3,70392,2500,67892
9649,250000,200000,0,0,0,0,0,0,-1,4192,4192,0,-1,5947,5966,-19,-1,5453,5453,0,-1,0,0,0
9650,320000,256000,0,0,0,0,0,0,0,203354,8600,194754,0,117272,5000,112272,0,38591,1900,36691,0,28400,960,27440
9651,50000,40000,0,0,0,0,0,0,-1,1677,5,1672,2,1177,1180,-3,-1,1313,1316,-3,-1,1085,1088,-3
9652,100000,80000,0,0,0,0,0,0,-1,8472,8472,0,-1,8472,0,8472,0,1768,0,1768,0,0,0,0
9653,240000,192000,0,0,0,0,0,0,0,14653,2000,12653,0,8626,0,8626,0,0,1790,-1790,0,1128,1128,0
9654,60000,48000,0,1,1,1,1,0,0,52236,2000,50236,0,54362,3000,51362,0,55458,2000,53458,0,56767,2200,54567
9655,160000,128000,0,0,0,0,0,0,0,109731,4002,105729,0,116452,8565,107887,0,114481,0,114481,2,121885,9502,112383
9656,80000,64000,0,0,0,0,0,0,-1,390,0,390,2,780,780,0,-1,390,0,390,0,390,390,0
9657,220000,176000,0,0,0,0,0,0,0,84151,4000,80151,0,83591,3500,80091,0,83789,3500,80289,0,83885,3500,80385
9658,180000,144000,0,1,1,1,1,1,0,154648,7100,147548,0,156584,6000,150584,0,166960,13100,153860,0,164012,0,164012
9659,80000,64000,0,1,1,0,0,0,0,71239,3000,68239,0,75710,6000,69710,0,63977,3008,60969,0,43385,2000,41385
9660,200000,160000,0,1,1,1,1,0,0,195011,7010,188001,0,196986,8000,188986,0,187687,7000,180687,0,193978,14500,179478
9661,20000,16000,0,0,0,0,0,0,0,13064,1225,11839,0,14888,2049,12839,0,14352,0,14352,2,14652,531,14121
9662,160000,128000,0,0,0,0,0,0,-2,2328,2378,-50,-2,1798,1798,0,-2,1000,1000,0,-2,1442,1442,0
9663,50000,40000,0,0,0,0,0,0,2,30087,0,30087,2,29610,1000,28610,0,40736,12000,28736,0,25690,2000,23690
9664,80000,64000,0,0,0,0,0,0,-1,390,390,0,-1,741,741,0,-1,390,390,0,-1,765,765,0
9665,90000,72000,0,1,1,1,1,1,0,93755,8245,85510,0,89706,0,89706,2,89221,3450,85771,0,91596,7200,84396
9666,80000,64000,0,0,0,0,0,1,0,48117,2000,46117,0,48502,2000,46502,0,48610,1800,46810,0,49650,1800,47850
9667,180000,144000,0,0,0,0,0,0,-1,3338,3338,0,-1,0,0,0,-2,0,0,0,-2,0,0,0
9668,80000,64000,0,0,0,0,0,0,0,44308,2100,42208,0,43757,1954,41803,0,42830,1500,41330,0,44038,3324,40714
9669,50000,40000,0,1,0,0,0,0,0,47080,2149,44931,0,15718,1203,14515,0,13674,2000,11674,0,15145,1716,13429
9670,210000,168000,0,0,0,0,0,0,0,34232,2000,32232,0,32331,2444,29887,0,30337,1342,28995,0,28012,1038,26974
9671,200000,160000,0,0,0,0,0,1,-1,20718,20718,0,-1,390,390,0,-1,390,390,0,-1,390,390,0
9672,220000,176000,0,0,0,0,0,0,0,143895,7000,136895,0,147039,7500,139539,0,152384,10000,142384,0,159631,10000,149631
9673,240000,192000,0,0,0,0,0,0,0,192181,6615,185566,0,189877,6401,183476,0,188205,6503,181702,0,182325,6393,175932
9674,50000,40000,0,0,0,0,0,0,0,17636,4000,13636,0,16956,1000,15956,0,17532,1000,16532,0,19078,2000,17078
9675,450000,360000,0,0,0,0,0,1,-1,3271,3271,0,-1,6271,6271,0,-1,2135,2135,0,-1,2546,2546,0
9676,200000,160000,0,0,0,0,0,1,-2,0,0,0,-2,0,0,0,-2,0,0,0,-2,665,665,0
9677,180000,144000,0,0,0,0,0,0,0,0,0,0,0,975,975,0,-1,4645,4645,0,-1,1000,1000,0
9678,210000,168000,0,0,0,0,0,0,0,119362,4500,114862,0,117766,5000,112766,0,68791,3000,65791,0,66167,3000,63167
9679,30000,24000,0,1,0,0,0,0,-1,27390,1000,26390,0,2390,2390,0,-1,780,0,780,0,24310,48620,-24310
9680,30000,24000,0,0,0,0,0,0,0,27992,4700,23292,0,16065,1000,15065,0,930,930,0,-1,780,0,780
9681,110000,88000,0,0,0,0,0,0,0,75559,3703,71856,0,74371,2700,71671,0,75126,2200,72926,0,73799,1810,71989
9682,560000,448000,0,0,0,0,0,0,0,454471,17065,437406,0,432132,14878,417254,0,285868,8505,277363,0,291140,9027,282113
9683,60000,48000,0,0,0,0,0,0,0,34117,2000,32117,0,35243,2000,33243,0,36350,2000,34350,0,37113,1500,35613
9684,70000,56000,0,1,1,1,1,1,2,70691,3400,67291,2,71692,2752,68940,2,67740,0,67740,2,68470,5156,63314
9685,20000,16000,0,0,0,0,0,0,2,7207,1500,5707,0,7351,264,7087,0,7512,280,7232,0,8380,1000,7380
9686,380000,304000,0,0,0,0,0,0,0,173199,7032,166167,0,165476,7986,157490,0,122496,4170,118326,0,117726,4205,113521
9687,30000,24000,0,1,1,1,1,0,0,29482,1300,28182,2,28712,0,28712,2,29311,1210,28101,0,30065,1391,28674
9688,80000,64000,0,1,1,0,0,0,0,77427,4000,73427,0,80700,5000,75700,0,15525,15525,0,-1,81621,81621,0
9689,100000,80000,0,0,0,0,0,0,0,67673,4000,63673,0,66292,3000,63292,0,67793,2500,65293,0,67182,3000,64182
9690,90000,72000,0,1,1,1,1,1,3,84369,0,84369,3,82117,0,82117,2,84395,3600,80795,2,85739,2900,82839
9691,30000,24000,0,1,1,1,0,1,2,29111,3974,25137,2,28325,0,28325,2,28840,600,28240,2,5450,0,5450
9692,80000,64000,0,0,0,0,0,0,-2,731,731,0,-1,55541,56000,-459,-1,56703,2055,54648,0,57833,2070,55763
9693,50000,40000,0,1,1,1,1,1,0,47121,1996,45125,0,45625,1800,43825,0,49367,4603,44764,0,46001,0,46001
9694,480000,384000,0,0,0,0,0,0,0,127402,30000,97402,0,7302,9398,-2096,-1,5155,5155,0,-1,10492,4101,6391
9695,500000,400000,0,0,0,0,0,0,0,230250,20132,210118,0,188805,20004,168801,0,192229,7714,184515,0,2786,3000,-214
9696,200000,160000,0,0,0,0,0,0,-2,0,0,0,-2,0,0,0,-2,907,907,0,-2,0,0,0
9697,70000,56000,0,0,0,0,0,1,2,32928,3400,29528,2,32100,0,32100,2,34557,3000,31557,2,35357,1500,33857
9698,130000,104000,0,1,0,0,0,1,2,129959,0,129959,2,93360,3500,89860,0,90040,3238,86802,0,89873,3216,86657
9699,300000,240000,0,0,0,0,0,0,-1,6497,6500,-3,-1,5897,0,5897,0,6005,408,5597,0,0,0,0
9700,100000,80000,0,0,0,0,0,0,0,68456,2485,65971,0,69849,2532,67317,0,71240,2549,68691,0,72736,2643,70093
9701,250000,200000,0,0,0,0,0,0,-2,772,775,-3,-2,-8,0,-8,-2,-8,0,-8,-2,1726,1734,-8
9702,100000,80000,0,0,0,0,0,0,0,33045,10000,23045,0,32346,0,32346,2,36597,5000,31597,0,46121,10000,36121
9703,500000,400000,0,0,0,0,0,1,-2,973,973,0,-2,229,229,0,-2,3330,3330,0,-2,7980,7980,0
9704,70000,56000,0,0,0,0,0,0,0,8891,1000,7891,2,9522,923,8599,2,9084,0,9084,3,8792,0,8792
9705,320000,256000,0,0,0,0,0,0,-2,648,651,-3,-2,2258,2269,-11,-2,722,725,-3,-2,15937,16014,-77
9706,50000,40000,0,0,0,0,0,0,-1,2450,2450,0,-1,248,248,0,-1,198,198,0,-1,0,0,0
9707,500000,400000,0,0,0,0,0,0,0,48832,3000,45832,0,49568,2000,47568,0,46939,2000,44939,0,49147,3000,46147
9708,180000,144000,0,1,0,0,1,0,0,165896,10092,155804,0,145300,10000,135300,0,152877,10000,142877,0,156074,10000,146074
9709,500000,400000,0,0,0,0,0,0,-1,35031,35477,-446,-1,42145,42360,-215,-1,7347,7387,-40,-1,152769,153532,-763
9710,120000,96000,0,1,1,1,1,1,0,104480,5500,98980,2,105280,4000,101280,2,106149,4100,102049,2,108381,4100,104281
9711,220000,176000,0,0,0,0,0,0,0,156136,6000,150136,0,158416,6000,152416,0,161212,6000,155212,0,156790,6000,150790
9712,50000,40000,0,0,0,0,0,0,0,17366,1308,16058,0,18325,1267,17058,0,17365,605,16760,0,17964,862,17102
9713,150000,120000,0,0,0,0,0,0,-2,0,0,0,-2,500,500,0,-2,399,399,0,-2,0,0,0
9714,20000,16000,0,0,0,0,0,0,2,13266,1600,11666,0,14340,1600,12740,0,15301,1500,13801,0,14916,0,14916
9715,180000,144000,0,0,0,0,0,0,-1,578,578,0,-1,578,578,0,-1,578,578,0,-1,438,438,0
9716,260000,208000,0,0,0,0,0,0,0,73562,2764,70798,0,65954,5431,60523,0,30948,633,30315,0,0,0,0
9717,200000,160000,0,0,0,0,0,0,-1,114770,114770,0,-1,70175,70175,0,-1,69180,69180,0,-1,44376,44376,0
9718,360000,288000,0,0,0,0,0,0,-1,458,458,0,-1,0,0,0,-1,282,282,0,-1,282,0,282
9719,360000,288000,0,0,0,0,0,0,-1,36301,36582,-281,-1,45883,46112,-229,-1,16789,16873,-84,-1,6159,6190,-31
9720,350000,280000,0,0,0,0,0,0,-2,0,0,0,-2,0,0,0,-2,0,0,0,-2,0,0,0
9721,110000,88000,0,0,0,0,0,0,0,51815,5000,46815,0,47225,1653,45572,0,34975,1500,33475,0,43725,10000,33725
9722,50000,40000,0,0,0,0,0,0,-1,3234,2904,330,0,2904,0,2904,0,0,0,0,0,0,0,0
9723,80000,64000,0,1,1,1,1,1,0,79206,3000,76206,2,78031,3000,75031,0,78293,3000,75293,0,78870,3000,75870
9724,410000,328000,0,1,1,0,0,1,0,411492,16284,395208,0,371539,16524,355015,0,308888,10320,298568,0,240970,8525,232445
9725,20000,16000,0,0,0,0,0,1,-1,0,0,0,-1,0,0,0,-2,0,0,0,-2,0,0,0
9726,30000,24000,0,0,0,0,0,0,0,21705,2000,19705,0,22537,1500,21037,0,24161,2000,22161,0,25128,1500,23628
9727,100000,80000,0,0,0,0,0,1,2,16179,3950,12229,0,17597,2000,15597,0,18499,1500,16999,0,20531,2500,18031
9728,380000,304000,0,1,1,1,1,0,0,374313,30031,344282,0,371566,27403,344163,0,362232,15168,347064,0,352161,35235,316926
9729,20000,16000,0,0,0,0,0,1,0,12374,0,12374,2,13392,1231,12161,0,14938,1777,13161,0,14557,0,14557
9730,140000,112000,0,0,0,0,0,0,0,20199,5000,15199,0,20746,1000,19746,0,2260,1260,1000,0,4180,3000,1180
9731,150000,120000,0,0,0,0,0,1,0,84905,4004,80901,0,86814,5016,81798,0,73827,5004,68823,0,60284,3000,57284
9732,50000,40000,0,0,0,0,0,0,0,17301,1000,16301,2,16486,1000,15486,0,17681,2000,15681,0,17825,1000,16825
9733,150000,120000,1,1,1,1,1,1,4,150320,0,150320,4,147989,512,147477,3,143355,0,143355,2,143131,4388,138743
9734,350000,280000,0,0,0,0,0,0,-2,5117,5136,-19,-2,6714,6735,-21,-2,18801,18801,0,-2,13604,13604,0
9735,360000,288000,0,0,0,0,0,1,2,0,0,0,2,0,0,0,-2,0,0,0,-2,0,0,0
9736,90000,72000,0,0,0,0,0,0,0,68100,2991,65109,0,33434,2655,30779,0,0,0,0,0,0,0,0
9737,40000,32000,0,1,1,1,1,0,0,40262,3292,36970,0,40370,1400,38970,0,39970,0,39970,0,39970,0,39970
9738,100000,80000,0,0,0,0,0,0,-2,1661,1665,-4,-2,1891,1894,-3,-1,3681,3689,-8,-1,870,870,0
9739,200000,160000,0,0,0,0,0,0,0,15818,8000,7818,0,21813,10000,11813,0,20890,10000,10890,0,29890,10000,19890
9740,280000,224000,0,0,0,0,0,0,2,-40,40,-80,2,-40,0,-40,-2,8160,8200,-40,-2,657,657,0
9741,200000,160000,0,0,0,0,0,0,0,0,0,0,0,0,0,0,-2,0,0,0,-2,0,0,0
9742,310000,248000,0,0,0,0,0,0,0,63399,5000,58399,0,59912,3000,56912,0,45740,25000,20740,0,44325,3000,41325
9743,500000,400000,0,0,0,0,0,0,0,134810,19000,115810,0,145182,15000,130182,0,141062,10040,131022,0,135358,15000,120358
9744,10000,8000,0,0,0,0,0,0,0,8557,1500,7057,0,7319,500,6819,0,7650,600,7050,0,8862,1500,7362
9745,70000,56000,0,0,0,0,0,1,0,34242,2000,32242,0,35668,2000,33668,0,50052,15000,35052,0,51651,3000,48651
9746,160000,128000,0,0,0,0,0,1,0,0,0,0,0,12315,12315,0,-1,0,0,0,-1,11855,11855,0
9747,80000,64000,0,0,0,0,0,0,-2,0,0,0,-2,0,0,0,-2,2115,2115,0,-2,4264,4264,0
9748,260000,208000,0,0,0,0,0,0,-1,8000,8000,0,-1,8000,8000,0,-1,24406,24406,0,-1,18043,2000,16043
9749,390000,312000,0,0,0,0,0,0,0,269703,10111,259592,0,266017,10005,256012,0,271657,11000,260657,0,245958,9007,236951
9750,80000,64000,0,1,0,0,0,1,0,79171,3667,75504,0,63448,3063,60385,0,46989,2000,44989,0,47867,2000,45867
9751,200000,160000,0,0,0,0,0,0,-1,1213,1297,-84,-1,9095,9113,-18,-1,18393,18393,0,-1,612,612,0
9752,600000,480000,0,0,0,0,0,0,0,353121,13250,339871,0,337695,12854,324841,0,297541,11191,286350,0,256158,10029,246129
9753,140000,112000,0,0,0,0,0,1,2,99961,4400,95561,2,101123,3700,97423,2,97375,0,97375,2,103044,7800,95244
9754,180000,144000,0,0,0,0,0,0,0,131039,7000,124039,0,132269,4900,127369,0,144990,15000,129990,0,152632,10000,142632
9755,280000,224000,0,0,0,0,0,1,-2,3508,3508,0,-1,3508,0,3508,0,-200,0,-200,0,-200,0,-200
9756,520000,416000,0,0,0,0,0,0,-1,5480,5487,-7,-1,5397,5397,0,-1,70137,70137,0,-1,11819,11820,-1
9757,360000,288000,0,0,0,0,0,1,-2,0,0,0,-2,0,0,0,-2,0,0,0,-2,0,0,0
9758,300000,240000,0,0,0,0,0,1,-1,-694,0,-694,-2,-694,0,-694,-2,-694,0,-694,-2,-694,0,-694
9759,220000,176000,0,0,0,0,0,0,-2,0,0,0,-2,0,0,0,-2,0,0,0,-2,0,0,0
9760,60000,48000,0,0,0,0,0,0,0,30408,4300,26108,0,30632,1000,29632,2,30021,0,30021,2,30445,2000,28445
9761,70000,56000,0,1,1,0,0,0,0,64114,4000,60114,0,66775,5000,61775,0,161,161,0,-1,5746,5800,-54
9762,90000,72000,0,0,0,0,0,0,2,52570,4116,48454,2,53614,2500,51114,3,54534,2052,52482,3,53374,0,53374
9763,180000,144000,0,0,0,0,0,0,-2,4629,4631,-2,-2,3007,3007,0,-2,5827,5827,0,-2,1118,1200,-82
9764,410000,328000,0,0,0,0,0,0,-1,2756,2756,0,-1,3560,3560,0,-1,6661,6661,0,-1,3877,3877,0
9765,310000,248000,0,1,0,1,1,1,0,278488,9834,268654,0,256962,9500,247462,0,262381,9700,252681,0,278117,20200,257917
9766,150000,120000,0,0,0,0,0,0,-1,291,291,0,-1,658,658,0,-1,441,441,0,-1,1197,1197,0
9767,70000,56000,0,0,0,0,0,0,0,15787,1263,14524,0,16100,576,15524,0,16437,596,15841,0,16764,600,16164
9768,360000,288000,0,0,0,0,0,0,-2,0,0,0,-2,0,0,0,-2,0,0,0,-2,0,0,0
9769,280000,224000,0,0,0,0,0,0,-2,-5,0,-5,-2,8164,8169,-5,-2,0,0,0,-2,1133,231133,-230000
9770,290000,232000,0,0,0,0,0,0,0,103066,7000,96066,0,104864,5000,99864,0,110151,7000,103151,0,115297,7000,108297
9771,390000,312000,0,0,0,0,0,0,0,46088,0,46088,2,47016,2000,45016,0,48332,2071,46261,0,62205,15000,47205
9772,200000,160000,0,0,0,0,0,0,-2,0,0,0,-2,0,0,0,-2,1246,1246,0,-2,-3,0,-3
9773,170000,136000,0,0,0,0,0,0,0,110163,13998,96165,0,112157,3760,108397,0,106497,4000,102497,0,108832,12212,96620
9774,150000,120000,0,0,0,1,0,0,0,4254,4508,-254,-1,145578,145578,0,-1,148012,5115,142897,0,126848,10000,116848
9775,250000,200000,0,0,0,0,0,0,0,156858,17994,138864,0,151841,0,151841,2,152803,5469,147334,0,155997,5656,150341
9776,500000,400000,0,0,0,0,0,0,0,14650,1277,13373,0,15559,1186,14373,0,14861,478,14383,0,15173,496,14677
9777,180000,144000,0,0,0,0,0,0,-2,0,0,0,-2,0,0,0,-2,0,0,0,-2,0,0,0
9778,210000,168000,0,0,0,0,0,0,0,108423,5000,103423,0,91143,3500,87643,0,82733,3000,79733,0,74125,2700,71425
9779,330000,264000,0,0,0,0,0,0,0,9369,1114,8255,0,7061,1493,5568,0,23421,20000,3421,0,21240,1000,20240
9780,50000,40000,0,0,0,0,0,1,0,27164,3500,23664,0,26429,0,26429,2,28291,2300,25991,2,27702,0,27702
9781,200000,160000,0,0,0,0,0,0,-1,2003,2003,0,-1,816,816,0,-1,4530,4530,0,-1,4245,0,4245
9782,130000,104000,0,0,0,0,0,0,0,99784,5000,94784,0,71451,4000,67451,0,67024,4000,63024,0,62655,7500,55155
9783,340000,272000,0,0,0,0,0,1,-2,-11,0,-11,-2,2894,2905,-11,-1,0,0,0,-1,530,530,0
9784,220000,176000,0,0,0,0,0,0,-2,33260,34393,-1133,-2,9142,9203,-61,-2,15687,15765,-78,-2,9148,9194,-46
9785,50000,40000,0,0,0,0,0,0,0,38126,20809,17317,0,18690,668,18022,0,19082,692,18390,0,19505,740,18765
9786,200000,160000,0,0,0,0,0,0,0,158980,7260,151720,0,157837,7367,150470,0,127528,4303,123225,0,119550,4551,114999
9787,100000,80000,0,0,0,0,0,0,-1,1200,1200,0,-1,0,0,0,-2,0,0,0,-2,1300,1300,0
9788,70000,56000,0,0,0,0,0,1,2,32203,1600,30603,0,34656,3000,31656,0,36927,3000,33927,0,38308,2000,36308
9789,100000,80000,0,0,0,0,0,0,-1,5423,5423,0,-1,29628,29628,0,-1,13252,0,13252,0,3723,0,3723
9790,120000,96000,0,0,0,0,0,0,-1,326,326,0,-1,326,326,0,-1,652,652,0,-1,326,0,326
9791,60000,48000,0,0,0,0,0,0,0,24908,1500,23408,0,26034,1500,24534,0,26655,1000,25655,0,27756,1500,26256
9792,500000,400000,0,0,0,0,0,1,0,-311,501,-812,0,6391,6892,-501,-1,420,421,-1,-1,7619,7695,-76
9793,20000,16000,0,0,1,1,1,0,2,17203,1300,15903,0,18411,1500,16911,0,18929,824,18105,0,19171,696,18475
9794,50000,40000,0,1,1,0,0,0,0,49039,2027,47012,0,49662,1650,48012,0,0,0,0,0,0,0,0
9795,320000,256000,0,0,0,0,0,1,-1,1189,1189,0,-1,0,0,0,-2,2701,2701,0,-2,2043,2043,0
9796,90000,72000,0,0,0,0,0,0,0,45515,2033,43482,0,42599,2016,40583,0,38559,2010,36549,0,36337,2010,34327
9797,80000,64000,0,1,1,0,0,0,0,77839,3328,74511,0,69534,2811,66723,0,60747,1192,59555,0,52280,1516,50764
9798,200000,160000,0,0,0,0,0,1,-1,628,628,0,-1,628,628,0,-1,1604,1604,0,-1,668,0,668
9799,60000,48000,0,0,0,0,0,0,0,8651,1001,7650,0,500,502,-2,0,29468,29468,0,-1,30201,1201,29000
9800,290000,232000,0,0,0,0,0,0,0,209697,10000,199697,0,212359,7600,204759,0,216989,8000,208989,0,221260,8000,213260
9801,200000,160000,0,0,0,0,0,0,-1,91517,3935,87582,0,72739,3759,68980,0,389,390,-1,-1,389,390,-1
9802,190000,152000,0,1,0,0,0,0,0,192422,6000,186422,2,150300,6000,144300,0,92391,4000,88391,0,93119,4000,89119
9803,110000,88000,0,1,0,0,0,0,0,93066,4295,88771,0,88823,3000,85823,0,78144,2887,75257,0,78169,3000,75169
9804,100000,80000,0,0,0,0,0,0,0,56999,2664,54335,0,57748,2700,55048,0,62489,6700,55789,0,60984,0,60984
9805,150000,120000,0,0,0,0,0,0,0,104416,4099,100317,0,86597,4000,82597,0,88276,3000,85276,0,90398,3000,87398
9806,50000,40000,0,1,0,0,0,0,0,50532,2000,48532,0,19632,1000,18632,0,18573,763,17810,0,17212,626,16586
9807,20000,16000,0,1,1,1,1,1,0,19398,1270,18128,0,18561,633,17928,0,18949,655,18294,0,17426,759,16667
9808,240000,192000,0,0,0,0,0,0,-1,380,380,0,-1,380,380,0,-1,0,0,0,-1,380,380,0
9809,210000,168000,1,1,1,1,0,0,0,227143,7613,219530,0,221126,7116,214010,0,215358,6980,208378,0,163444,5813,157631
9810,50000,40000,0,0,0,0,0,0,2,15377,5000,10377,2,12590,0,12590,2,11209,3023,8186,0,7448,5000,2448
9811,80000,64000,0,0,0,0,0,0,0,62696,3180,59516,0,27693,818,26875,0,25594,1018,24576,0,29155,10006,19149
9812,10000,8000,0,1,1,1,1,0,0,9722,1139,8583,0,10044,1241,8803,0,9856,345,9511,0,10285,580,9705
9813,130000,104000,0,0,0,0,0,0,0,4900,1000,3900,0,1235,1235,0,-1,3946,3011,935,0,2817,1008,1809
9814,280000,224000,0,0,0,0,0,0,-1,1212,1216,-4,-1,3244,3249,-5,-1,2134,4,2130,0,1270,6,1264
9815,390000,312000,0,0,0,0,0,0,-2,112316,97472,14844,-2,114797,4000,110797,-2,131601,20000,111601,-2,130295,31667,98628
9816,280000,224000,0,0,0,0,0,0,0,152132,6000,146132,0,138990,4974,134016,0,136778,5041,131737,0,137641,5215,132426
9817,110000,88000,0,0,0,0,0,0,0,81439,2972,78467,0,81425,2853,78572,0,81039,2739,78300,0,81162,2852,78310
9818,50000,40000,0,0,0,0,0,0,0,41319,2100,39219,0,25110,1609,23501,0,20478,1000,19478,0,20258,1000,19258
9819,50000,40000,0,0,0,0,0,1,2,0,0,0,-2,0,0,0,-2,0,0,0,-2,0,0,0
9820,50000,40000,0,0,0,0,0,0,-1,-290,0,-290,-1,18115,18650,-535,-1,18495,659,17836,0,18804,1000,17804
9821,100000,80000,0,0,0,0,0,0,-1,0,0,0,-2,0,0,0,-2,0,0,0,-2,0,0,0
9822,350000,280000,0,0,0,0,0,0,-2,686,691,-5,-2,430667,238241,192426,-1,161089,1009,160080,0,119339,596,118743
9823,20000,16000,0,0,0,1,0,0,0,15334,1500,13834,0,16222,1000,15222,0,17598,1500,16098,0,9950,1500,8450
9824,350000,280000,0,0,0,0,0,0,-1,16229,16229,0,-1,56929,45000,11929,0,7082,108501,-101419,-1,4640,4640,0
9825,20000,16000,0,0,0,0,0,0,2,11238,0,11238,2,12735,2000,10735,0,14359,2000,12359,0,19076,5000,14076
9826,50000,40000,0,0,0,0,0,0,0,9641,1500,8141,0,9468,500,8968,0,9294,500,8794,0,9263,500,8763
9827,500000,400000,0,0,0,0,0,0,0,989,1003,-14,0,2008,2018,-10,-1,-59,59,-118,-1,11835,11894,-59
9828,360000,288000,0,0,0,0,0,0,-1,1780,0,1780,2,2380,4760,-2380,-1,2230,0,2230,2,2275,2275,0
9829,50000,40000,0,0,0,0,0,0,0,20997,1323,19674,0,21018,734,20284,0,20556,1058,19498,0,20302,406,19896
9830,360000,288000,0,0,0,0,0,0,-1,1862,1862,0,-1,230,230,0,-1,661,661,0,-1,658,658,0
9831,170000,136000,0,0,0,0,0,0,2,18642,0,18642,2,19743,2000,17743,2,19422,0,19422,2,3644,500,3144
9832,100000,80000,0,1,1,1,1,0,0,96301,4300,92001,0,90858,4400,86458,0,92724,4000,88724,0,96030,4700,91330
9833,20000,16000,0,1,1,0,1,0,0,16635,0,16635,2,16678,600,16078,0,17268,1840,15428,0,17563,800,16763
9834,120000,96000,0,0,0,0,0,0,0,15003,5000,10003,0,9270,0,9270,2,46193,49920,-3727,-1,30774,1500,29274
9835,50000,40000,0,1,1,0,0,0,0,47637,2000,45637,0,44429,2000,42429,0,27279,944,26335,0,27318,1118,26200
9836,50000,40000,0,0,0,0,0,0,0,9868,1153,8715,0,9406,400,9006,0,9605,350,9255,0,9805,360,9445
9837,210000,168000,0,0,0,0,0,0,0,16919,6016,10903,0,11775,1000,10775,0,13275,1500,11775,0,24901,13000,11901
9838,140000,112000,0,0,0,0,0,1,0,0,0,0,-2,0,0,0,-2,0,0,0,-2,0,0,0
9839,500000,400000,0,0,0,0,0,0,-2,0,0,0,-2,1116,1116,0,-1,969,3,966,2,6745,6745,0
9840,60000,48000,0,0,0,0,0,0,0,49449,7000,42449,0,57500,10000,47500,0,4749,4749,0,-1,9749,5000,4749
9841,160000,128000,0,0,0,0,0,0,-2,0,0,0,-2,0,0,0,-2,0,0,0,-2,0,0,0
9842,20000,16000,0,0,0,0,0,0,-1,360,400,-40,-1,370,400,-30,-1,780,800,-20,-1,390,0,390
9843,60000,48000,0,0,0,0,0,0,0,47343,2245,45098,0,29164,2005,27159,0,27829,2000,25829,0,27574,1088,26486
9844,310000,248000,0,0,0,0,0,0,0,25135,1379,23756,0,25095,867,24228,0,25356,898,24458,0,25514,933,24581
9845,310000,248000,0,0,0,0,0,0,-1,11263,11321,-58,-1,2710,2710,0,-1,2371,2371,0,-1,2318,2318,0
9846,140000,112000,0,0,0,0,0,0,0,76892,4025,72867,0,79522,4924,74598,0,79623,2381,77242,2,80895,2926,77969
9847,370000,296000,0,0,0,0,0,0,-2,0,0,0,-2,0,0,0,-2,0,0,0,-2,0,0,0
9848,190000,152000,0,0,0,0,0,0,0,131661,7000,124661,0,137765,8500,129265,0,123616,5000,118616,0,125841,6000,119841
9849,80000,64000,0,0,0,0,0,0,0,0,0,0,-2,0,0,0,-2,0,0,0,-2,0,0,0
9850,50000,40000,0,0,0,0,0,0,0,33136,2000,31136,0,34475,2000,32475,0,19666,1000,18666,0,19128,1259,17869
9851,200000,160000,0,0,0,0,0,0,0,79418,3501,75917,0,80608,3501,77107,0,81297,3001,78296,0,83602,4001,79601
9852,170000,136000,0,1,1,1,1,0,0,155442,8200,147242,0,162471,11400,151071,2,158294,0,158294,2,166836,10800,156036
9853,380000,304000,0,0,0,0,0,1,-2,5947,5957,-10,-2,16735,16735,0,-2,6444,6444,0,-2,0,0,0
9854,10000,8000,0,0,0,0,0,0,0,5426,2000,3426,0,6743,2000,4743,0,8544,2000,6544,0,9858,2000,7858
9855,30000,24000,0,1,1,0,0,0,0,26712,1400,25312,0,25350,0,25350,0,17603,500,17103,0,-780,0,-780
9856,60000,48000,0,1,1,0,0,0,0,59017,3000,56017,0,59220,3008,56212,0,26607,6000,20607,0,29719,4000,25719
9857,360000,288000,0,0,0,0,0,1,-1,0,0,0,-1,0,0,0,-2,71,71,0,-1,77,77,0
9858,200000,160000,0,0,0,0,0,0,-1,7254,7254,0,-1,7164,7164,0,-1,4576,4675,-99,-1,5792,5792,0
9859,80000,64000,0,0,0,0,0,0,0,32812,2000,30812,0,25930,1100,24830,0,26414,1000,25414,0,27128,1100,26028
9860,190000,152000,0,1,1,0,0,1,2,165281,10000,155281,0,173231,15000,158231,0,132145,10091,122054,0,146854,20000,126854
9861,20000,16000,0,0,0,0,0,0,2,16990,16990,0,-1,3820,0,3820,0,4350,4350,0,-1,3180,3180,0
9862,240000,192000,0,0,0,0,0,0,-2,3545,3600,-55,-1,1338,1338,0,-1,1075,1075,0,-1,1744,1744,0
9863,350000,280000,0,0,0,0,0,0,0,90539,5116,85423,0,92941,5000,87941,0,99930,10000,89930,0,108411,10000,98411
9864,210000,168000,0,0,0,0,0,0,-2,0,0,0,-2,0,0,0,-2,0,0,0,-2,0,0,0
9865,70000,56000,0,1,1,0,0,0,0,63600,4000,59600,0,60540,2000,58540,0,26890,4030,22860,0,18923,0,18923
9866,350000,280000,0,0,0,0,0,1,0,23291,3000,20291,0,22812,0,22812,2,27418,5000,22418,0,20203,5000,15203
9867,20000,16000,0,0,0,0,0,0,0,10101,2000,8101,0,9790,0,9790,2,10632,1000,9632,2,10312,0,10312
9868,210000,168000,0,0,0,0,0,0,-1,12803,12831,-28,-1,13984,13996,-12,-1,9958,9958,0,-1,13066,13066,0
9869,280000,224000,0,0,0,0,0,0,-2,13397,13397,0,-2,20004,20004,0,-2,10571,10571,0,-2,8430,8430,0
9870,80000,64000,0,1,0,0,0,0,0,67017,3000,64017,0,65159,2244,62915,0,64152,2478,61674,0,65208,4800,60408
9871,50000,40000,0,0,0,0,0,1,0,38246,3600,34646,0,37332,0,37332,2,39702,3000,36702,2,38932,0,38932
9872,60000,48000,0,0,0,0,0,1,0,37841,1989,35852,0,38634,1782,36852,0,28811,1169,27642,0,28907,1196,27711
9873,330000,264000,0,0,0,0,0,0,-2,248,250,-2,-2,784,800,-16,-2,220,300,-80,-2,256,300,-44
9874,60000,48000,1,1,1,1,1,0,6,72225,880,71345,5,67850,528,67322,4,63073,0,63073,3,61761,0,61761
9875,150000,120000,0,0,0,0,0,1,0,7474,120000,-112526,-1,8173,823,7350,0,87500,80000,7500,0,89731,3684,86047
9876,200000,160000,0,0,0,0,0,0,0,14024,1322,12702,0,14512,2000,12512,0,16325,2000,14325,0,11905,1200,10705
9877,10000,8000,0,0,0,0,0,0,-1,2032,2032,0,-1,2150,1000,1150,0,1490,1000,490,0,390,390,0
9878,360000,288000,0,0,0,0,0,0,0,127146,60259,66887,0,103273,27208,76065,0,91933,31262,60671,0,108163,90114,18049
9879,500000,400000,0,0,0,0,0,0,-1,11525,11602,-77,-1,3228,3244,-16,-1,9146,9191,-45,-1,2430,2442,-12
9880,90000,72000,0,0,0,0,0,0,0,29985,1600,28385,0,28447,1500,26947,0,24775,1000,23775,0,25498,1500,23998
9881,200000,160000,0,0,0,0,0,0,-2,0,0,0,-2,0,0,0,-2,0,0,0,-2,0,0,0
9882,210000,168000,0,0,0,0,0,1,-2,1739,1748,-9,-1,1739,0,1739,0,475,800,-325,-1,475,475,0
9883,120000,96000,0,0,0,0,0,1,0,58743,3000,55743,0,60469,5000,55469,0,57532,0,57532,2,55702,2000,53702
9884,200000,160000,0,0,0,0,0,0,-2,664,664,0,-2,0,0,0,-2,641,641,0,-2,5506,5506,0
9885,360000,288000,0,0,0,0,0,1,-2,0,0,0,-2,0,0,0,-2,0,0,0,-2,0,0,0
9886,80000,64000,0,0,1,0,1,1,0,57722,2674,55048,0,116742,2200,114542,0,72204,14710,57494,0,79105,8000,71105
9887,420000,336000,0,0,0,0,0,0,-1,629,0,629,2,13371,13371,0,-1,12383,15,12368,0,8260,0,8260
9888,200000,160000,0,0,0,0,0,0,-2,941,945,-4,-2,2357,2366,-9,-2,2945,2947,-2,-2,1143,1143,0
9889,150000,120000,0,0,0,0,0,0,0,42652,3000,39652,0,42711,1500,41211,0,43311,1000,42311,0,48311,5000,43311
9890,50000,40000,0,0,0,0,0,0,0,8542,1142,7400,0,8711,311,8400,0,8893,322,8571,0,9070,324,8746
9891,360000,288000,0,1,0,0,0,0,0,314534,15000,299534,0,289355,19355,270000,0,274484,10000,264484,0,247998,10000,237998
9892,200000,160000,0,0,0,0,0,0,0,8000,2000,6000,0,10285,2285,8000,0,16285,6000,10285,0,4815,1500,3315
9893,50000,40000,0,1,0,0,0,0,0,48078,2000,46078,0,25869,1600,24269,0,22647,100,22547,0,2875,250,2625
9894,200000,160000,0,0,0,0,0,0,0,32253,1485,30768,0,30384,1956,28428,0,30900,1500,29400,0,0,0,0
9895,20000,16000,0,0,0,0,0,0,0,4560,1258,3302,0,4567,1000,3567,0,4060,228,3832,0,1035,1035,0
9896,230000,184000,0,0,0,0,0,0,0,83649,3000,80649,0,46513,2000,44513,0,35306,2000,33306,0,36217,1500,34717
9897,90000,72000,0,0,0,0,0,0,0,11288,1529,9759,0,10852,1113,9739,0,10519,800,9719,0,9235,0,9235
9898,70000,56000,0,0,0,0,0,0,-1,1999,1999,0,-1,0,0,0,-1,0,0,0,-2,842,842,0
9899,200000,160000,0,0,0,0,0,0,-2,7544,7574,-30,-2,9409,9497,-88,-2,57023,57023,0,-2,2770,2770,0
9900,100000,80000,0,0,0,0,0,0,0,75004,2700,72304,0,76705,5400,71305,0,78168,3500,74668,0,80347,3500,76847
9901,50000,40000,0,1,1,1,1,1,2,46424,2000,44424,2,45377,0,45377,2,48441,3800,44641,2,47511,0,47511
9902,50000,40000,0,1,1,1,1,0,0,47487,2000,45487,0,48319,2000,46319,0,48449,1746,46703,0,49656,2000,47656
9903,360000,288000,0,0,0,0,0,0,0,66062,10043,56019,0,57374,20073,37301,0,40963,30000,10963,0,100369,90000,10369
9904,60000,48000,0,1,0,0,0,0,0,58795,2148,56647,0,47818,3049,44769,0,28357,3000,25357,0,29309,3002,26307
9905,280000,224000,0,0,0,0,0,0,0,172505,12104,160401,0,175967,7002,168965,0,178548,6302,172246,0,176939,6417,170522
9906,50000,40000,0,0,0,0,0,0,0,0,0,0,-2,0,0,0,-2,0,0,0,-2,0,0,0
9907,240000,192000,0,1,1,0,0,0,0,240146,12000,228146,0,245552,10373,235179,0,91382,3403,87979,0,93177,4000,89177
9908,70000,56000,0,0,0,0,0,0,-1,390,390,0,-1,780,780,0,-1,390,0,390,0,0,0,0
9909,360000,288000,0,0,0,0,0,0,-1,6562,6562,0,-1,3730,0,3730,0,420,0,420,0,699,699,0
9910,80000,64000,0,1,1,0,0,1,0,76720,6300,70420,0,74651,0,74651,2,57109,1743,55366,0,46703,1588,45115
9911,340000,272000,0,1,1,0,1,1,0,339191,15000,324191,0,325675,15000,310675,0,285417,15000,270417,0,284834,12000,272834
9912,70000,56000,0,0,0,0,0,1,2,21142,0,21142,2,23772,3000,20772,2,24930,1700,23230,2,25709,1340,24369
9913,340000,272000,0,0,0,0,0,0,-1,30042,30084,-42,-1,28987,29033,-46,-1,13104,13120,-16,-1,59204,59273,-69
9914,90000,72000,0,1,1,1,1,0,0,87526,3505,84021,0,88924,3962,84962,0,88735,2909,85826,0,87521,3107,84414
9915,30000,24000,0,1,1,1,0,1,0,28541,1939,26602,0,28509,907,27602,0,29265,1100,28165,0,0,0,0
9916,180000,144000,0,1,1,0,0,1,2,169529,402,169127,2,153501,5166,148335,0,136920,5000,131920,0,139506,5030,134476
9917,180000,144000,0,0,0,0,0,0,-1,20924,20964,-40,-1,65041,50988,14053,0,50983,110,50873,0,48533,971,47562
9918,70000,56000,0,1,1,1,1,0,0,62004,2301,59703,0,62985,2254,60731,0,69380,7600,61780,0,70498,2500,67998
9919,80000,64000,0,0,0,0,0,1,0,64228,2500,61728,0,49103,1800,47303,0,48649,2000,46649,0,49701,1800,47901
9920,320000,256000,0,0,0,0,0,0,0,70774,4002,66772,0,70089,3000,67089,0,71994,15000,56994,0,57805,5000,52805
9921,10000,8000,0,0,0,0,0,0,0,5670,1700,3970,0,6416,1000,5416,2,7159,1000,6159,2,7904,1000,6904
9922,250000,200000,0,0,0,0,0,0,0,87836,7000,80836,0,90577,9000,81577,0,65268,8000,57268,0,63019,8000,55019
9923,290000,232000,0,1,1,0,0,0,0,286497,24000,262497,0,279146,3,279143,2,179536,10023,169513,0,79060,10000,69060
9924,20000,16000,0,0,0,1,1,0,2,15739,2000,13739,0,17168,2000,15168,0,17580,1000,16580,0,18295,1000,17295
9925,180000,144000,0,0,0,0,0,0,-1,2985,2985,0,-1,0,0,0,-1,0,0,0,-2,0,0,0
9926,100000,80000,0,1,1,0,0,1,0,92187,5000,87187,0,95030,5000,90030,0,29470,4000,25470,0,3470,3000,470
9927,110000,88000,0,1,1,1,1,0,0,109172,4000,105172,0,111940,4600,107340,0,108594,4000,104594,0,111239,4450,106789
9928,190000,152000,0,0,0,0,0,1,2,94227,4100,90127,2,91943,0,91943,2,93546,3500,90046,0,95759,3600,92159
9929,200000,160000,0,0,0,0,0,1,-2,-18,0,-18,-2,-18,0,-18,-2,-18,0,-18,-2,-18,0,-18
9930,20000,16000,0,0,0,0,0,0,-1,264,264,0,-1,264,264,0,-1,654,1044,-390,-1,654,654,0
9931,50000,40000,0,0,0,0,0,0,2,13447,1600,11847,0,13427,500,12927,0,13711,500,13211,0,14083,600,13483
9932,340000,272000,0,0,0,0,0,0,0,81480,20385,61095,0,13580,6157,7423,0,22474,22533,-59,-1,70590,60052,10538
9933,290000,232000,0,0,0,0,0,0,0,58039,2507,55532,0,3818,1500,2318,0,1318,2000,-682,-1,0,0,0
9934,150000,120000,0,0,0,0,0,0,-1,0,0,0,-2,0,0,0,-2,0,0,0,-2,0,0,0
9935,230000,184000,0,1,0,1,0,0,0,227528,9100,218428,0,121751,4600,117151,0,219354,4200,215154,0,111792,4100,107692
9936,210000,168000,0,0,0,0,0,0,0,33905,2000,31905,0,35035,2000,33035,0,37465,3000,34465,0,36713,0,36713
9937,240000,192000,0,0,0,0,0,0,-1,11204,11237,-33,-1,3403,4293,-890,-1,2223,2229,-6,-1,1761,1766,-5
9938,230000,184000,0,0,0,0,0,0,-2,0,0,0,-2,1279,1279,0,-2,0,0,0,-2,2794,2794,0
9939,50000,40000,1,1,0,0,0,0,0,52028,0,52028,2,32140,1085,31055,0,32216,2000,30216,0,31482,1226,30256
9940,360000,288000,0,0,0,0,0,0,0,45914,1760,44154,0,8835,204,8631,0,3421,17,3404,0,2391,2403,-12
9941,50000,40000,0,0,0,0,0,0,0,22611,5000,17611,0,14174,4000,10174,0,10809,3000,7809,0,9004,1000,8004
9942,50000,40000,0,0,0,0,0,0,0,37876,2234,35642,0,39984,3042,36942,2,39041,0,39041,2,40110,1700,38410
9943,290000,232000,1,1,1,1,1,0,0,315048,12012,303036,0,314085,12012,302073,0,317631,11016,306615,0,315820,11088,304732
9944,80000,64000,0,1,0,0,0,0,0,78616,2420,76196,0,49662,2000,47662,0,48867,1656,47211,0,48278,1693,46585
9945,440000,352000,0,0,0,0,0,1,2,360999,100006,260993,2,149363,0,149363,2,142757,6000,136757,0,119034,4000,115034
9946,80000,64000,0,0,0,0,0,0,0,32390,1705,30685,0,32651,2000,30651,0,32170,2000,30170,0,31493,3000,28493
9947,70000,56000,0,0,0,0,0,0,0,9949,1151,8798,0,10298,500,9798,0,10511,513,9998,0,9764,424,9340
9948,10000,8000,0,0,0,0,0,1,0,8259,1036,7223,0,0,0,0,0,0,0,0,-2,0,0,0
9949,150000,120000,0,1,1,1,1,0,2,148041,15000,133041,2,143259,0,143259,2,142519,5099,137420,0,142162,5472,136690
9950,30000,24000,0,1,1,1,1,0,3,29205,0,29205,2,29090,1013,28077,0,30121,2400,27721,0,28013,0,28013
9951,150000,120000,0,0,0,0,0,0,-1,0,0,0,-1,0,0,0,-2,6674,6674,0,-1,0,0,0
9952,170000,136000,0,0,0,0,0,0,-1,14315,1500,12815,0,15535,1542,13993,0,14453,1456,12997,0,16518,3521,12997
9953,160000,128000,0,0,0,0,0,0,-2,10550,10670,-120,-2,3566,3576,-10,-2,2453,2460,-7,-2,2673,2680,-7
9954,30000,24000,0,1,1,1,1,1,0,28047,2000,26047,0,29767,2500,27267,2,30498,1500,28998,2,29890,0,29890
9955,420000,336000,0,0,0,0,0,0,0,153092,156564,-3472,-1,111922,0,111922,0,88709,0,88709,0,36484,36484,0
9956,160000,128000,0,0,0,0,0,0,0,55814,3000,52814,0,59726,5000,54726,0,61615,3000,58615,0,65939,5000,60939
9957,160000,128000,0,1,0,0,0,0,0,152705,6004,146701,0,102160,5170,96990,0,102969,4000,98969,0,105149,4000,101149
9958,30000,24000,0,1,1,1,1,0,2,25744,0,25744,2,27504,3000,24504,2,26987,1000,25987,2,26927,1300,25627
9959,280000,224000,0,0,0,0,0,0,0,55444,15000,40444,0,57115,3026,54089,0,54076,3000,51076,0,58155,8043,50112
9960,200000,160000,0,0,0,0,0,0,0,137111,5047,132064,0,137121,4922,132199,0,139343,4926,134417,0,141859,5105,136754
9961,110000,88000,0,0,0,0,0,1,0,81485,4000,77485,0,86309,7100,79209,0,84028,0,84028,2,86114,3600,82514
9962,160000,128000,0,0,0,0,0,0,0,46575,3500,43075,0,7169,2000,5169,0,9036,2000,7036,0,8749,0,8749
9963,290000,232000,0,0,0,0,0,0,-2,2632,2632,0,-2,11767,11780,-13,-2,4684,4684,0,-2,3685,3685,0
9964,30000,24000,0,0,0,0,0,0,0,11877,1201,10676,0,12891,1215,11676,0,13960,1284,12676,0,14082,490,13592
9965,160000,128000,0,0,0,0,0,1,3,99911,5500,94411,2,103928,6700,97228,2,101540,0,101540,3,99587,27,99560
9966,230000,184000,0,0,0,0,0,0,-2,233,233,0,-1,233,0,233,2,20,20,0,-1,0,0,0
9967,220000,176000,0,0,0,0,0,0,4,163018,11,163007,3,128157,0,128157,2,131067,4561,126506,0,108683,5007,103676
9968,130000,104000,0,0,0,0,0,1,2,33071,3000,30071,2,32336,0,32336,2,34186,2600,31586,2,34588,1000,33588
9969,300000,240000,0,0,0,0,0,0,-1,0,0,0,-1,0,0,0,-2,0,0,0,-2,279,279,0
9970,480000,384000,0,0,0,0,0,0,-2,1717,1717,0,-2,1385,1390,-5,-2,0,0,0,-2,0,0,0
9971,620000,496000,0,0,0,0,0,0,0,445543,15669,429874,0,443199,16011,427188,0,451040,16000,435040,0,431316,15500,415816
9972,160000,128000,0,0,0,0,0,0,-1,1283,1283,0,-1,4404,4404,0,-1,0,0,0,-1,535,535,0
9973,80000,64000,0,1,0,0,0,0,0,72885,2500,70385,0,47663,2000,45663,0,48350,2000,46350,0,47208,2000,45208
9974,160000,128000,0,0,0,0,0,0,-1,0,0,0,-1,0,0,0,-2,0,0,0,-2,0,0,0
9975,300000,240000,0,0,0,0,0,0,0,12214,5000,7214,0,27299,21312,5987,0,0,0,0,0,0,0,0
9976,10000,8000,0,0,0,0,0,0,-2,0,0,0,-2,0,0,0,-2,0,0,0,-2,0,0,0
9977,30000,24000,0,0,0,0,0,0,3,780,0,780,2,780,0,780,0,2057,2057,0,-1,1737,0,1737
9978,170000,136000,0,0,0,0,0,0,0,10274,10274,0,-1,16446,6446,10000,0,16578,332,16246,0,20487,10487,10000
9979,210000,168000,0,0,0,0,0,0,-1,1552,1552,0,-1,776,0,776,0,776,776,0,-1,1359,1359,0
9980,60000,48000,0,0,0,0,0,0,0,26513,2000,24513,0,7028,1500,5528,0,-1073,0,-1073,0,-1073,0,-1073
9981,410000,328000,0,1,1,1,1,0,0,360396,13100,347296,0,367893,13500,354393,0,375268,13500,361768,0,383121,13900,369221
9982,280000,224000,0,0,0,0,0,0,-1,415,415,0,-1,565,565,0,-1,830,830,0,-1,415,0,415
9983,80000,64000,0,0,0,0,0,0,0,61813,2800,59013,0,30457,1200,29257,0,30477,1300,29177,0,30506,1700,28806
9984,20000,16000,0,1,1,1,0,0,0,19096,0,19096,2,19612,1000,18612,0,20164,1000,19164,0,19771,5000,14771
9985,240000,192000,0,0,0,0,0,0,-1,10062,10096,-34,-1,8662,8675,-13,-1,4566,4566,0,-1,3915,3927,-12
9986,20000,16000,0,0,0,1,1,0,2,16188,1276,14912,0,17212,1300,15912,0,19363,2443,16920,0,18771,0,18771
9987,20000,16000,0,0,0,0,0,1,2,12291,2000,10291,0,14666,2900,11766,0,14289,0,14289,2,17525,3500,14025
9988,320000,256000,0,0,0,0,0,0,-1,944,944,0,-1,473,473,0,-1,1747,5000,-3253,-1,1193,1200,-7
9989,280000,224000,0,0,0,0,0,0,0,4401,3000,1401,0,5039,3000,2039,0,6913,3000,3913,0,7350,3000,4350
9990,200000,160000,0,0,0,0,0,0,-1,0,0,0,-1,465,465,0,-1,1775,1775,0,-1,8722,8722,0
9991,60000,48000,0,0,0,0,0,1,-1,316,316,0,-1,316,316,0,-1,316,316,0,-1,316,316,0
9992,170000,136000,0,0,0,0,0,0,-2,10000,10000,0,-2,10000,10000,0,-2,9983,9983,0,-2,15846,15863,-17
9993,300000,240000,0,0,0,0,0,0,0,15576,2000,13576,0,16524,1500,15024,0,17096,1000,16096,0,12144,1000,11144
9994,140000,112000,0,0,0,0,0,0,0,65581,3014,62567,0,56271,2606,53665,0,54586,2005,52581,0,54247,2404,51843
9995,130000,104000,0,1,1,1,1,0,0,123434,4500,118934,0,122806,4400,118406,0,125287,4500,120787,0,127992,4700,123292
9996,150000,120000,0,0,1,1,1,1,0,129558,10002,119556,0,131476,5018,126458,0,133223,10006,123217,0,136004,7007,128997
9997,290000,232000,0,0,0,0,0,0,-1,9680,5000,4680,0,7860,3000,4860,0,7860,0,7860,0,8142,8142,0
9998,80000,64000,0,0,0,0,0,0,0,4603,1033,3570,0,0,0,0,0,0,0,0,-2,0,0,0
9999,440000,352000,0,0,0,0,0,0,-1,0,0,0,-1,0,0,0,-2,10961,10961,0,-1,11349,503,10846
10000,320000,256000,0,0,0,0,0,0,0,4529,1100,3429,0,5548,1100,4448,0,6450,1000,5450,0,7342,1000,6342
10001,150000,120000,0,0,0,0,0,0,0,35726,3000,32726,0,27886,3000,24886,0,32415,5000,27415,0,39531,8000,31531
10002,30000,24000,0,0,0,0,0,0,-2,3260,3260,0,-2,4311,4311,0,-2,1551,1551,0,-2,0,0,0
10003,220000,176000,0,1,1,1,0,0,2,210839,0,210839,2,216988,8275,208713,2,213824,0,213824,2,39819,800,39019
10004,130000,104000,0,0,0,0,0,0,0,77188,3400,73788,0,78304,3000,75304,0,79941,3052,76889,0,81648,3190,78458
10005,160000,128000,0,0,0,0,1,0,0,73992,3275,70717,0,73246,3000,70246,0,71321,3000,68321,0,141494,3000,138494
10006,200000,160000,0,0,0,0,0,0,-1,13868,13909,-41,-1,4094,4106,-12,-1,2247,2253,-6,-1,17794,17847,-53
10007,430000,344000,0,0,0,0,0,0,-1,12457,12799,-342,-1,26522,27888,-1366,-1,28951,29023,-72,-1,11057,12,11045
10008,100000,80000,0,0,0,0,0,0,0,53505,2094,51411,0,43371,3007,40364,0,48125,10021,38104,0,40388,3012,37376
10009,260000,208000,0,0,0,0,0,0,-1,588,0,588,2,390,390,0,-1,390,390,0,-1,540,540,0
10010,250000,200000,0,0,0,0,0,1,-1,3121,3140,-19,-1,2372,2387,-15,-1,502,504,-2,-1,1979,1989,-10
10011,170000,136000,0,0,0,0,0,0,-1,23922,1500,22422,0,24399,863,23536,0,24919,903,24016,0,26884,3000,23884
10012,270000,216000,0,1,0,0,0,0,0,225836,8000,217836,0,219426,7000,212426,0,210514,10000,200514,0,180129,7000,173129
10013,150000,120000,0,0,0,0,0,0,0,53256,15010,38246,0,60945,10015,50930,0,60720,3022,57698,0,57407,1522,55885
10014,270000,216000,0,1,1,1,1,0,2,253024,11000,242024,0,258109,11000,247109,0,243331,8900,234431,0,247504,9000,238504
10015,310000,248000,0,1,0,0,0,0,0,308006,12000,296006,0,239008,8500,230508,0,245493,10000,235493,0,250797,9000,241797
10016,150000,120000,0,0,0,0,0,0,0,6263,6263,0,-1,6824,6824,0,-1,10824,10000,824,0,14631,10000,4631
10017,130000,104000,0,1,1,1,1,0,0,121587,5000,116587,0,119784,4531,115253,0,117605,5000,112605,0,120307,4596,115711
10018,50000,40000,0,0,0,0,0,0,0,41111,2200,38911,0,-39,0,-39,0,-39,0,-39,-2,18056,20000,-1944
10019,250000,200000,0,0,0,0,0,0,0,7604,3000,4604,0,2919,3000,-81,-1,0,0,0,-1,0,0,0
10020,20000,16000,0,0,0,0,0,0,0,8353,2000,6353,0,13192,5000,8192,0,14871,2000,12871,2,11536,1000,10536
10021,50000,40000,0,0,0,0,0,0,0,11105,1071,10034,0,5960,158,5802,0,5220,500,4720,0,3024,400,2624
10022,30000,24000,0,1,1,0,0,0,0,29841,1011,28830,0,27592,301,27291,0,17569,37,17532,0,4059,17,4042
10023,20000,16000,0,1,1,1,0,0,0,19597,1400,18197,0,19589,392,19197,0,19275,386,18889,0,0,0,0
10024,130000,104000,0,0,0,0,0,0,0,30680,1793,28887,0,30797,1300,29497,0,31147,1223,29924,0,31996,1851,30145
10025,140000,112000,0,1,1,1,1,0,2,128308,8200,120108,2,125776,1000,124776,3,123659,0,123659,2,131290,9874,121416
10026,80000,64000,0,0,0,0,0,0,0,15948,2000,13948,0,17118,6000,11118,0,9883,500,9383,0,8689,304,8385
10027,260000,208000,1,1,1,0,0,1,0,288566,11000,277566,0,291597,11000,280597,0,214353,8000,206353,0,216238,8500,207738
10028,150000,120000,0,0,1,1,1,0,0,146608,77000,69608,0,148658,6000,142658,0,135768,5000,130768,0,138681,5100,133581
10029,170000,136000,0,0,0,0,0,0,0,138172,6800,131372,0,140265,6500,133765,0,112529,8300,104229,0,110318,0,110318
10030,150000,120000,0,0,0,0,0,1,-1,56544,422,56122,2,48153,2000,46153,0,49288,2041,47247,0,36872,2039,34833
10031,180000,144000,0,0,0,0,0,1,0,125258,6000,119258,0,125214,4400,120814,0,131276,9000,122276,0,114050,0,114050
10032,230000,184000,0,0,0,0,0,0,0,17150,1249,15901,2,15298,0,15298,2,18378,4000,14378,0,18281,1000,17281
10033,30000,24000,0,1,1,1,1,0,0,28048,2000,26048,0,29775,3000,26775,0,27736,3000,24736,0,26956,2000,24956
10034,150000,120000,0,1,0,0,0,0,0,133811,3857,129954,0,122606,12000,110606,0,107726,20000,87726,0,1200,0,1200
10035,400000,320000,0,0,0,0,0,0,-1,4521,4521,0,-1,20472,20500,-28,-1,76933,77000,-67,-1,173599,100000,73599
10036,130000,104000,0,0,0,0,0,1,0,-1,0,-1,0,500,501,-1,-1,0,0,0,-1,936,936,0
10037,20000,16000,0,0,0,0,0,1,0,12904,1220,11684,0,14217,1533,12684,0,14360,676,13684,0,16140,2177,13963
10038,180000,144000,0,0,0,0,0,0,-2,6997,6997,0,-2,3064,3064,0,-2,2158,2158,0,-2,9331,9331,0
10039,80000,64000,0,0,0,0,0,0,0,47925,4500,43425,0,23642,1000,22642,0,21707,933,20774,0,20544,5000,15544
10040,50000,40000,0,1,1,0,0,0,0,48589,2000,46589,0,59469,1900,57569,0,20239,1004,19235,0,20059,1600,18459
10041,10000,8000,0,0,1,1,0,1,2,10153,2374,7779,2,8999,0,8999,2,9999,1000,8999,0,0,0,0
10042,200000,160000,0,0,0,1,1,0,0,162739,5100,157639,0,163555,5000,158555,0,166452,6000,160452,0,168398,4500,163898
10043,270000,216000,0,0,0,0,0,0,-2,0,0,0,-2,0,0,0,-2,0,0,0,-2,0,0,0
10044,140000,112000,0,0,0,0,0,0,-1,0,0,0,-1,2061,2061,0,-1,0,0,0,-1,3035,3035,0
10045,300000,240000,0,0,0,0,0,1,3,4679,0,4679,2,6596,2000,4596,2,6344,0,6344,2,9067,3000,6067
10046,450000,360000,0,0,0,0,0,0,-1,5000,5000,0,-1,0,0,0,-1,0,0,0,-2,0,0,0
10047,410000,328000,0,0,0,0,0,0,0,133882,15877,118005,0,135954,30000,105954,0,134250,14250,120000,0,129971,9971,120000
10048,50000,40000,0,1,1,1,1,1,2,44326,0,44326,2,44901,1596,43305,0,45844,1655,44189,0,48385,3684,44701
10049,130000,104000,0,0,0,0,0,0,-1,836,836,0,-1,836,836,0,-1,836,836,0,-1,836,836,0
10050,230000,184000,0,0,0,0,0,0,-1,10860,10860,0,-1,10120,0,10120,0,7050,0,7050,0,740,740,0
10051,180000,144000,0,0,0,0,0,0,0,98186,3371,94815,0,59451,6940,52511,0,49956,2800,47156,0,50133,2000,48133
10052,50000,40000,0,0,0,0,0,0,0,10812,15000,-4188,-1,12237,2000,10237,0,13057,2000,11057,0,15057,2000,13057
10053,310000,248000,0,0,0,0,0,0,0,233854,9218,224636,0,219409,10029,209380,0,216540,8049,208491,0,210675,8040,202635
10054,70000,56000,0,1,1,1,1,0,0,69188,3300,65888,0,68392,2610,65782,0,69884,2750,67134,0,71284,2750,68534
10055,100000,80000,0,0,0,0,0,0,0,72820,2644,70176,0,74264,2656,71608,0,75821,2752,73069,0,77410,2850,74560
10056,150000,120000,0,0,0,0,0,0,-1,7714,7725,-11,-1,9772,9772,0,-1,13539,13539,0,-1,5819,5819,0
10057,150000,120000,0,1,1,1,1,0,0,141411,4007,137404,0,143748,5001,138747,0,147159,5003,142156,0,151185,6001,145184
10058,270000,216000,0,0,0,0,0,0,0,27846,2000,25846,0,21787,1200,20587,0,16429,330,16099,0,5488,2000,3488
10059,210000,168000,1,1,1,0,0,1,0,320167,10300,309867,0,327871,11642,316229,0,34285,1602,32683,0,30900,1500,29400
10060,150000,120000,0,0,0,0,0,0,0,83734,3136,80598,0,80569,8046,72523,0,56672,2300,54372,0,65196,9621,55575
10061,250000,200000,0,0,0,0,0,0,0,21428,2000,19428,0,22757,2000,20757,0,24382,2000,22382,0,28768,5000,23768
10062,300000,240000,0,0,0,0,0,0,-2,0,0,0,-2,0,0,0,-2,0,0,0,-2,0,0,0
10063,150000,120000,0,1,1,1,1,0,0,145978,5245,140733,0,139791,5200,134591,0,142745,5200,137545,0,146872,6500,140372
10064,80000,64000,0,0,1,0,0,0,0,75145,50000,25145,0,76846,4021,72825,0,58422,3300,55122,0,58131,2100,56031
10065,70000,56000,0,1,0,0,0,0,0,60607,2264,58343,0,28622,858,27764,0,24485,797,23688,0,18419,814,17605
10066,230000,184000,0,0,0,0,0,0,-1,1502,1502,0,-1,708,708,0,-1,2882,2896,-14,-1,1939,1939,0
10067,70000,56000,0,1,0,0,0,0,0,62595,2916,59679,0,40327,2004,38323,0,48673,15006,33667,0,46158,3000,43158
10068,270000,216000,0,0,0,0,0,0,0,100360,7000,93360,0,97583,4049,93534,0,91849,1000,90849,0,94824,5003,89821
10069,170000,136000,0,0,0,0,0,0,-2,1991,1991,0,-1,0,0,0,-1,0,0,0,-2,150,150,0
10070,130000,104000,0,0,0,0,0,1,2,955,955,0,-1,1170,1170,0,-1,1170,0,1170,0,780,0,780
10071,80000,64000,0,0,0,0,0,1,-2,298,607,-309,-2,-300,0,-300,-2,-300,0,-300,-2,-300,0,-300
10072,220000,176000,0,1,1,1,1,0,2,224414,10000,214414,0,196229,7200,189029,0,190050,7001,183049,0,183779,6900,176879
10073,300000,240000,0,0,0,0,0,0,-1,803,803,0,-1,486,8,478,2,-712,387,-1099,2,-1037,0,-1037
10074,30000,24000,0,1,1,1,1,0,2,28235,1800,26435,0,28669,1200,27469,0,29355,1300,28055,0,29913,1200,28713
10075,100000,80000,0,0,0,0,0,0,0,61392,2000,59392,2,59619,2,59617,2,59814,2007,57807,0,58571,2225,56346
10076,200000,160000,0,0,0,0,0,0,-1,3207,3210,-3,-1,3284,3284,0,-1,1111,1111,0,-1,8349,8349,0
10077,30000,24000,0,0,0,0,0,1,2,12421,0,12421,2,6105,0,6105,0,5083,0,5083,0,0,0,0
10078,300000,240000,0,0,0,0,0,0,0,116918,4000,112918,0,119929,4000,115929,0,122914,4000,118914,0,125910,4000,121910
10079,200000,160000,0,0,0,0,0,1,2,75995,0,75995,2,79781,5500,74281,2,81533,3000,78533,2,80243,0,80243
10080,30000,24000,0,0,0,0,0,1,-1,16863,2000,14863,0,7380,2000,5380,0,8580,1200,7380,0,10000,2200,7800
10081,200000,160000,0,0,0,0,0,0,-2,12888,12888,0,-1,2075,2075,0,-1,0,0,0,-1,0,0,0
10082,300000,240000,0,1,1,1,1,1,0,280337,7000,273337,2,318248,50000,268248,2,316147,12000,304147,2,303666,0,303666
10083,260000,208000,0,0,0,0,0,0,3,792,0,792,2,792,396,396,0,396,0,396,0,2289,2289,0
10084,210000,168000,0,0,0,0,0,0,-1,4366,4366,0,-1,5602,5602,0,-1,21034,21034,0,-1,1026,1026,0
10085,100000,80000,0,0,0,0,0,1,-1,390,0,390,2,0,0,0,2,780,780,0,-1,0,0,0
10086,210000,168000,0,0,0,0,0,0,0,140440,5000,135440,0,122678,5004,117674,0,120215,4500,115715,0,112973,3950,109023
10087,80000,64000,0,0,0,0,0,0,0,59744,2550,57194,0,44031,1848,42183,0,48089,6084,42005,0,44789,38,44751
10088,160000,128000,0,0,0,0,0,0,-2,0,0,0,-2,0,0,0,-2,4816,4816,0,-1,0,0,0
10089,50000,40000,0,1,1,0,0,0,0,47725,2200,45525,0,46467,2000,44467,0,14767,1000,13767,0,15085,700,14385
10090,130000,104000,0,0,0,0,0,0,-2,0,0,0,-2,0,0,0,-2,0,0,0,-2,0,0,0
10091,50000,40000,0,0,0,0,0,0,0,19387,1340,18047,0,22574,5000,17574,0,20483,0,20483,2,20121,729,19392
10092,30000,24000,0,1,1,1,1,0,2,26449,1000,25449,2,27915,2201,25714,2,27170,0,27170,2,29071,2500,26571
10093,120000,96000,0,0,0,0,0,0,0,27507,0,27507,2,27952,1200,26752,0,31136,3800,27336,0,30486,0,30486
10094,260000,208000,0,0,0,0,0,0,-2,11237,11247,-10,-2,27500,27500,0,-1,27500,0,27500,0,33880,21380,12500
10095,80000,64000,0,0,0,0,0,1,2,0,0,0,-2,0,0,0,-2,0,0,0,-2,0,0,0
10096,360000,288000,0,0,0,0,0,0,2,285707,11426,274281,0,271529,9781,261748,0,276759,10370,266389,0,279953,13899,266054
10097,50000,40000,0,0,0,0,0,0,0,10760,1155,9605,0,10973,368,10605,0,10693,372,10321,0,9888,356,9532
10098,50000,40000,0,0,0,0,0,0,0,21320,5000,16320,0,18614,2000,16614,0,19003,618,18385,0,19439,679,18760
10099,30000,24000,1,1,1,1,1,1,5,31624,8,31616,4,30683,0,30683,3,29215,0,29215,2,29900,1015,28885
10100,210000,168000,0,0,0,0,0,0,0,24717,1854,22863,0,26563,2700,23863,0,22812,0,22812,0,13620,0,13620
10101,420000,336000,0,0,0,0,0,0,0,229049,9553,219496,0,220951,7603,213348,0,210606,7830,202776,0,188108,7253,180855
10102,270000,216000,0,0,0,0,0,0,-1,2845,3000,-155,-1,-1000,1000,-2000,-1,-1000,0,-1000,-2,-1000,0,-1000
10103,50000,40000,0,1,0,0,0,1,2,46672,2213,44459,0,28478,1019,27459,0,29074,1055,28019,0,29671,1080,28591
10104,160000,128000,0,0,0,0,0,0,-1,0,0,0,-2,0,0,0,-2,0,0,0,-2,0,0,0
10105,260000,208000,0,0,0,0,0,0,0,171803,7692,164111,0,175248,7788,167460,0,175157,6267,168890,0,178850,6513,172337
10106,30000,24000,0,0,0,0,0,1,2,18321,0,18321,3,19618,1900,17718,2,19008,0,19008,2,19301,750,18551
10107,140000,112000,0,0,0,0,0,0,0,16747,3500,13247,0,16183,0,16183,2,17762,2000,15762,2,17327,0,17327
10108,320000,256000,0,1,0,0,0,0,0,295760,15993,279767,0,151783,57149,94634,0,125860,5136,120724,0,137856,40275,97581
10109,170000,136000,0,0,0,0,0,0,0,88228,4000,84228,0,91719,5000,86719,0,97759,7500,90259,0,99905,4000,95905
10110,50000,40000,0,0,0,0,0,0,-1,995,995,0,-1,1055,1055,0,-1,102,0,102,0,2110,2110,0
10111,50000,40000,0,1,0,0,0,1,2,50654,2025,48629,0,41776,2062,39714,0,17083,2016,15067,0,9412,1022,8390
10112,40000,32000,0,0,0,0,1,1,0,30145,1500,28645,2,29361,0,29361,2,33893,5000,28893,2,34487,1300,33187
10113,20000,16000,0,0,0,0,0,0,0,10198,0,10198,2,10400,600,9800,0,1150,1150,0,-1,0,0,0
10114,150000,120000,0,0,0,0,0,0,0,23772,1331,22441,0,20410,1029,19381,0,14818,353,14465,0,7565,208,7357
10115,350000,280000,0,0,0,0,0,0,0,42968,1660,41308,0,38575,1338,37237,0,34226,1300,32926,0,31026,2000,29026
10116,310000,248000,0,0,0,0,0,0,0,163384,7006,156378,0,164700,10000,154700,0,142767,9000,133767,0,125972,5000,120972
10117,160000,128000,0,1,1,1,1,0,0,157871,7225,150646,0,143690,5000,138690,0,134386,5000,129386,0,138038,5900,132138
10118,50000,40000,0,0,0,0,0,0,-2,0,0,0,-2,0,0,0,-2,0,0,0,-2,0,0,0
10119,30000,24000,0,0,0,0,0,0,2,16073,16101,-28,-1,6342,6342,0,-1,8073,1731,6342,-1,1731,0,1731
10120,120000,96000,0,0,0,0,0,0,0,39909,29,39880,2,18334,10004,8330,0,7382,6,7376,0,19801,19824,-23
10121,50000,40000,0,0,0,0,0,0,0,31992,1790,30202,0,33361,79,33282,0,100,100,0,-1,0,1200,-1200
10122,170000,136000,0,0,0,0,0,0,-1,1420,1420,0,-1,1420,1420,0,-1,1420,1420,0,-1,3464,3464,0
10123,180000,144000,0,0,0,0,0,0,-1,420,1000,-580,-1,460,500,-40,-1,460,460,0,-1,610,610,0
10124,240000,192000,0,0,0,0,0,1,0,135459,4915,130544,0,117308,4100,113208,0,107928,4000,103928,0,103799,4002,99797
10125,310000,248000,0,0,0,0,0,0,-1,2716,3146,-430,-1,824,824,0,-1,757,757,0,-1,842,842,0
10126,230000,184000,0,0,0,0,0,0,0,140467,5785,134682,0,133479,5400,128079,0,122948,4397,118551,0,125519,4548,120971
10127,170000,136000,0,0,0,0,0,0,-2,0,0,0,-2,0,0,0,-2,0,0,0,-2,0,0,0
10128,50000,40000,0,0,0,0,0,0,0,36712,5000,31712,0,33485,5000,28485,0,37712,5000,32712,0,40065,5000,35065
10129,230000,184000,0,0,0,0,0,0,0,4650,1046,3604,0,3234,1060,2174,0,4174,1000,3174,0,5100,1000,4100
10130,230000,184000,0,0,0,0,0,0,0,12543,2000,10543,0,13713,1500,12213,0,17960,5000,12960,0,650,650,0
10131,50000,40000,0,0,0,0,0,0,0,30862,10000,20862,0,26614,5000,21614,0,15571,1500,14071,0,14971,800,14171
10132,20000,16000,0,1,1,1,1,1,0,19112,0,19112,2,20223,1382,18841,2,18806,0,18806,2,20001,3000,17001
10133,440000,352000,0,0,0,0,0,0,0,54190,3000,51190,0,45962,2000,43962,0,47421,2150,45271,0,49512,3000,46512
10134,210000,168000,0,0,0,0,0,0,-1,4609,4609,0,-1,4703,94,4609,0,6324,1621,4703,0,1621,0,1621
10135,30000,24000,0,0,0,0,0,0,-2,1909,1920,-11,-2,544,544,0,-2,390,390,0,-2,954,954,0
10136,20000,16000,0,0,0,0,0,0,0,9022,1518,7504,0,5961,1000,4961,0,3970,79,3891,0,780,0,780
10137,80000,64000,0,0,0,0,0,0,0,19960,2000,17960,0,6199,2000,4199,0,5623,1000,4623,0,6880,2000,4880
10138,430000,344000,0,0,0,0,0,1,-1,0,0,0,-1,0,0,0,-2,0,0,0,-2,0,0,0
10139,360000,288000,0,0,0,0,0,0,-1,45619,46378,-759,-1,37459,46347,-8888,-1,31747,0,31747,0,26899,0,26899
10140,180000,144000,0,0,0,0,0,0,-2,0,0,0,-2,0,0,0,-2,0,0,0,-2,0,0,0
10141,110000,88000,0,1,1,0,0,0,0,92724,3656,89068,0,94573,3687,90886,0,65034,2476,62558,0,66241,2406,63835
10142,250000,200000,0,0,0,0,0,1,2,2487,0,2487,2,2487,0,2487,2,2487,0,2487,2,2487,0,2487
10143,20000,16000,0,0,1,1,1,0,0,16958,3000,13958,0,19651,3000,16651,0,37332,3772,33560,0,19225,1420,17805
10144,150000,120000,0,0,0,0,0,0,0,34867,3000,31867,0,24438,1000,23438,0,18883,2000,16883,0,14737,4500,10237
10145,20000,16000,0,0,0,0,1,0,0,16510,1000,15510,2,16566,1000,15566,0,17370,2000,15370,0,19905,3000,16905
10146,100000,80000,0,1,1,1,0,0,0,96270,5000,91270,0,97440,6000,91440,0,94518,0,94518,2,24180,484,23696
10147,30000,24000,0,0,0,0,0,0,-1,780,0,780,2,0,0,0,2,0,0,0,-2,0,0,0
10148,50000,40000,0,0,0,0,0,0,-2,401,595,-194,-2,43091,54061,-10970,-2,29842,32384,-2542,-1,30601,1234,29367
10149,350000,280000,0,0,0,0,0,0,0,8621,8621,0,-1,970,970,0,-1,1345,1000,345,0,2267,1917,350
10150,10000,8000,0,0,0,1,0,0,0,7111,1200,5911,0,8120,1200,6920,0,9120,1000,8120,0,0,0,0
10151,360000,288000,0,0,0,0,0,0,-1,1081,1081,0,-1,1538,1538,0,-1,0,0,0,-1,804,804,0
10152,250000,200000,0,0,0,0,0,1,2,28705,0,28705,2,32017,4000,28017,0,19052,3000,16052,0,9847,1500,8347
10153,20000,16000,1,1,1,1,0,0,0,27836,3273,24563,0,23480,0,23480,2,19469,389,19080,0,16310,326,15984
10154,340000,272000,0,0,0,0,0,0,0,197690,9809,187881,0,182112,7852,174260,0,166822,6525,160297,0,143166,6002,137164
10155,320000,256000,0,0,0,0,0,0,0,51223,3000,48223,0,52371,2000,50371,0,54518,3000,51518,0,56601,3000,53601
10156,70000,56000,0,1,0,0,0,1,2,63239,2910,60329,0,23163,1000,22163,0,41106,20000,21106,0,42021,1600,40421
10157,40000,32000,0,0,0,0,0,0,0,21561,4000,17561,0,18438,0,18438,2,20619,5000,15619,2,17582,0,17582
10158,260000,208000,0,0,0,0,0,0,0,77240,3000,74240,0,78856,3000,75856,0,80350,3000,77350,0,84040,5000,79040
10159,110000,88000,0,0,0,0,0,1,2,24669,0,24669,2,26738,2700,24038,2,27201,1100,26101,2,26723,0,26723
10160,180000,144000,0,0,0,0,0,1,0,4333,4337,-4,-1,3334,3334,0,-1,3334,3334,0,-1,3334,3334,0
10161,20000,16000,0,1,0,1,0,0,0,18091,1408,16683,0,19431,5000,14431,0,19478,1000,18478,0,17492,2000,15492
10162,80000,64000,0,0,0,0,0,0,-1,1672,1700,-28,-1,1672,836,836,2,836,0,836,0,836,836,0
10163,210000,168000,0,0,0,0,0,0,-1,390,390,0,-1,390,390,0,-1,390,390,0,-1,780,780,0
10164,20000,16000,0,0,0,0,0,0,2,3023,0,3023,3,2748,0,2748,2,12351,12351,0,-1,13927,4000,9927
10165,320000,256000,0,0,0,0,0,0,-1,11755,11768,-13,-1,52566,52592,-26,-1,36658,0,36658,0,42332,42332,0
10166,180000,144000,0,0,0,0,0,0,0,32033,1660,30373,0,51373,20000,31373,0,52553,2030,50523,0,53505,1951,51554
10167,20000,16000,0,0,0,0,0,0,-2,-1080,0,-1080,-2,-1470,0,-1470,-2,-1860,0,-1860,-2,-2250,0,-2250
10168,160000,128000,0,1,0,0,0,0,0,141416,6000,135416,0,112497,5000,107497,0,119511,9000,110511,0,119763,4000,115763
10169,180000,144000,0,0,0,0,0,0,-1,0,0,0,-1,390,390,0,-1,698,698,0,-1,636,636,0
10170,210000,168000,0,0,0,0,0,0,-1,8319,8369,-50,-1,5330,5346,-16,-1,1586,1590,-4,-1,4920,4934,-14
10171,150000,120000,0,0,0,0,0,0,-1,1159,0,1159,2,1159,1159,0,-1,11476,11476,0,-1,10249,0,10249
10172,90000,72000,0,1,0,0,0,0,0,88888,3500,85388,0,48534,2000,46534,0,49874,2100,47774,0,32078,1000,31078
10173,50000,40000,0,0,0,0,0,0,0,28725,1479,27246,0,29295,1049,28246,0,29902,1080,28822,0,30683,1280,29403
10174,180000,144000,0,0,0,0,0,0,-2,0,0,0,-2,0,0,0,-2,0,0,0,-2,0,0,0
10175,30000,24000,0,1,1,1,0,0,0,29366,2000,27366,0,29553,1400,28153,0,27677,554,27123,0,16364,327,16037
10176,400000,320000,1,1,1,1,0,0,0,454826,16289,438537,0,411587,14100,397487,0,368563,12958,355605,0,252669,7807,244862
10177,500000,400000,0,0,0,0,0,1,-1,550,528,22,0,286,0,286,0,22,128,-106,0,14454,15239,-785
10178,70000,56000,0,0,0,0,0,1,0,20837,1351,19486,0,22986,2500,20486,0,22319,0,22319,2,23952,2000,21952
10179,10000,8000,0,0,0,0,0,0,0,2162,1025,1137,0,2150,3028,-878,-1,-440,0,-440,-1,0,1000,-1000
10180,370000,296000,0,0,0,0,0,0,0,96133,36133,60000,0,103773,18773,85000,0,137735,37735,100000,0,234740,100000,134740
10181,160000,128000,0,0,0,0,0,0,0,19007,3000,16007,0,19392,1000,18392,0,19928,1000,18928,0,20445,1000,19445
10182,20000,16000,0,1,1,1,1,0,0,18795,1278,17517,0,18252,635,17617,0,17589,802,16787,0,17480,350,17130
10183,310000,248000,0,0,0,0,0,0,0,4488,4510,-22,-1,2630,2652,-22,-1,150,150,0,-1,335,185,150
10184,30000,24000,0,1,1,1,1,0,2,29383,0,29383,2,29823,1200,28623,0,30379,1162,29217,0,29686,1097,28589
10185,150000,120000,0,0,0,0,0,0,0,36343,1971,34372,0,45180,20000,25180,0,45694,914,44780,0,45694,0,45694
10186,250000,200000,0,0,0,0,0,0,-1,3629,3,3626,2,1570,1575,-5,-1,248,248,0,-1,1247,1247,0
10187,260000,208000,0,0,0,0,0,0,0,176088,10000,166088,0,155624,7619,148005,0,141976,7000,134976,0,141305,8000,133305
10188,30000,24000,0,0,1,1,1,0,2,26087,2441,23646,2,26184,820,25364,2,25563,0,25563,2,26099,851,25248
10189,360000,288000,0,0,0,0,0,1,-1,390,780,-390,-1,2809,2809,0,-1,390,390,0,-1,390,390,0
10190,260000,208000,0,0,0,0,0,0,0,174617,6500,168117,0,178214,6500,171714,0,182251,7000,175251,0,186144,7000,179144
10191,150000,120000,0,0,0,0,0,0,-2,0,0,0,-2,0,0,0,-2,0,0,0,-2,0,0,0
10192,50000,40000,0,0,0,0,0,0,0,6190,1000,5190,0,0,0,0,0,0,0,0,-2,0,0,0
10193,30000,24000,0,1,1,1,0,0,0,28755,0,28755,2,30720,3500,27220,0,28298,694,27604,0,9064,343,8721
10194,180000,144000,0,0,0,0,0,1,0,49475,2000,47475,0,50840,2000,48840,0,50090,2000,48090,0,48345,2000,46345
10195,200000,160000,0,0,0,0,0,1,2,80453,10000,70453,2,58257,0,58257,2,97180,40000,57180,2,95531,0,95531
10196,360000,288000,0,0,0,0,0,0,-1,14838,18022,-3184,-1,15987,6036,9951,0,13438,5005,8433,0,16935,4514,12421
10197,270000,216000,0,0,0,0,0,0,0,8156,2040,6116,0,5572,5599,-27,-1,3697,3715,-18,-1,19529,19626,-97
10198,160000,128000,0,0,0,0,0,1,-1,0,0,0,-2,150,150,0,-1,150,150,0,-1,989,989,0
10199,410000,328000,0,0,0,0,0,0,-1,15678,16076,-398,-1,40512,40203,309,0,17884,17974,-90,-1,34251,34518,-267
10200,140000,112000,0,0,0,0,0,0,0,81607,3000,78607,0,83927,4000,79927,0,84861,3500,81361,0,86556,3504,83052
10201,30000,24000,0,0,0,0,0,0,2,300,0,300,2,300,0,300,7,300,0,300,7,300,0,300
10202,300000,240000,0,0,0,0,0,0,0,8900,1322,7578,0,7099,1000,6099,0,5437,2000,3437,0,3958,1000,2958
10203,240000,192000,0,0,0,0,0,1,0,2840,1090,1750,0,3750,1000,2750,0,4750,1000,3750,0,-10,0,-10
10204,50000,40000,0,0,0,0,0,0,0,7350,1500,5850,0,7500,150,7350,0,0,0,0,0,0,0,0
10205,80000,64000,0,0,0,0,0,0,0,41986,2000,39986,0,40060,2000,38060,0,38124,2000,36124,0,37140,3000,34140
10206,200000,160000,0,0,0,0,0,0,0,104137,5000,99137,0,103422,3300,100122,0,95206,2500,92706,0,65108,2930,62178
10207,50000,40000,0,0,0,0,0,0,0,3000,3008,-8,-1,5260,5260,0,-1,1025,1025,0,-1,5900,5900,0
10208,150000,120000,0,0,0,0,0,0,0,8710,1000,7710,2,9559,1000,8559,0,10401,1000,9401,0,11069,1000,10069
10209,150000,120000,0,0,0,0,0,1,-2,0,0,0,-2,0,0,0,-2,0,0,0,-2,0,0,0
10210,90000,72000,0,0,0,0,0,0,0,68485,4017,64468,0,67000,4000,63000,0,45837,4000,41837,0,49959,5000,44959
10211,20000,16000,0,1,1,1,1,0,0,18373,1000,17373,2,18768,1000,17768,0,19315,1000,18315,0,20836,2000,18836
10212,30000,24000,0,1,1,1,1,1,0,28445,1731,26714,0,26766,1742,25024,0,27152,1128,26024,0,28355,1800,26555
10213,210000,168000,0,0,0,0,0,0,-2,-1117,0,-1117,-2,-1513,0,-1513,-2,-1909,0,-1909,-2,59017,61982,-2965
10214,190000,152000,0,0,0,0,0,0,0,130898,0,130898,2,130950,7000,123950,0,115342,4550,110792,0,115657,4600,111057
10215,270000,216000,0,0,0,0,0,0,0,26526,2000,24526,0,27778,2000,25778,0,29322,2000,27322,0,30677,2000,28677
10216,150000,120000,1,1,1,0,0,0,0,301634,7143,294491,0,314201,13700,300501,0,84135,15000,69135,0,90500,7500,83000
10217,110000,88000,0,0,0,0,0,0,0,59115,3804,55311,0,57149,1857,55292,0,54180,1840,52340,0,51796,1832,49964
10218,20000,16000,0,0,0,0,1,1,2,14663,2000,12663,2,16109,2000,14109,2,19525,4000,15525,3,18646,0,18646
10219,80000,64000,0,0,0,0,0,1,-1,390,390,0,2,390,390,0,-1,390,390,0,-1,390,390,0
10220,160000,128000,0,0,0,0,0,1,-1,390,390,0,-1,520,520,0,-1,540,560,-20,-1,390,390,0
10221,90000,72000,0,1,0,0,0,0,0,87363,4000,83363,0,74329,2500,71829,0,48451,2000,46451,0,48715,2000,46715
10222,330000,264000,0,0,0,0,0,0,-2,0,0,0,-2,0,0,0,-2,0,0,0,-2,2234,2234,0
10223,230000,184000,0,0,0,0,0,1,-1,1427,1427,0,-1,14947,14947,0,-1,13255,437,12818,0,8226,1000,7226
10224,150000,120000,0,1,0,1,1,1,2,121249,0,121249,2,124237,5000,119237,0,132252,10000,122252,0,134925,5000,129925
10225,260000,208000,0,0,0,0,0,0,-1,1620,1620,0,-1,8010,8080,-70,-1,0,0,0,-1,0,0,0
10226,400000,320000,0,0,0,0,0,0,0,31648,4000,27648,0,127340,100000,27340,0,129411,5000,124411,0,128796,4183,124613
10227,50000,40000,0,0,0,0,0,0,0,23711,5038,18673,0,8663,3000,5663,0,19596,20130,-534,-1,20082,1000,19082
10228,160000,128000,0,0,0,0,0,0,-1,20723,0,20723,2,21873,1500,20373,0,25999,4520,21479,0,26377,939,25438
10229,30000,24000,0,1,1,1,1,0,0,27460,2000,25460,0,27735,2000,25735,0,27711,2000,25711,0,28643,1500,27143
10230,20000,16000,0,0,0,0,0,1,2,12086,0,12086,3,11595,0,11595,2,13197,1800,11397,2,12700,0,12700
10231,50000,40000,0,0,0,0,0,0,0,7690,1500,6190,0,8322,1000,7322,0,5522,200,5322,0,1522,2000,-478
10232,100000,80000,0,1,0,0,0,0,0,98480,3100,95380,0,63372,2000,61372,0,39138,1600,37538,0,39857,1500,38357
10233,140000,112000,0,0,0,0,0,0,0,37344,1926,35418,0,37933,1911,36022,0,38522,1500,37022,0,38519,1541,36978
10234,470000,376000,0,0,0,0,0,0,0,218615,6000,212615,0,221365,6194,215171,0,137387,30364,107023,0,201955,100018,101937
10235,160000,128000,0,0,0,0,0,1,2,113902,9600,104302,2,115543,5000,110543,2,118353,4800,113553,2,116298,0,116298
10236,260000,208000,0,0,0,0,0,0,-2,717,717,0,-2,717,717,0,-2,2325,2325,0,-2,1117,1117,0
10237,140000,112000,0,0,0,0,0,1,-2,0,0,0,-2,0,0,0,-2,0,0,0,-2,0,0,0
10238,200000,160000,0,0,0,0,0,0,-1,461,461,0,-1,396,396,0,-1,546,546,0,-1,396,396,0
10239,30000,24000,0,0,0,1,1,1,0,23851,1500,22351,0,26067,2609,23458,0,25357,0,25357,2,25887,930,24957
10240,10000,8000,0,0,1,1,1,0,0,9355,2000,7355,0,9594,758,8836,0,8535,0,8535,2,8713,313,8400
10241,80000,64000,0,1,1,0,0,0,0,77492,3051,74441,0,78362,2600,75762,0,50001,1877,48124,0,50035,1767,48268
10242,310000,248000,0,0,1,0,0,0,0,271746,24932,246814,0,260673,10440,250233,0,199746,6265,193481,0,182994,6275,176719
10243,20000,16000,0,0,0,1,1,1,0,16448,1578,14870,0,17462,1592,15870,0,18305,1435,16870,0,17871,0,17871
10244,80000,64000,0,0,0,0,0,0,0,30210,1750,28460,0,30505,1045,29460,0,31184,1123,30061,0,28641,1038,27603
10245,20000,16000,0,0,0,0,0,1,-2,289,289,0,-1,0,0,0,-1,0,0,0,-2,0,0,0
10246,50000,40000,0,1,1,0,0,0,0,50417,2058,48359,0,48371,1683,46688,0,15417,600,14817,0,16194,1017,15177
10247,80000,64000,0,0,0,0,0,0,0,824,824,0,-1,0,0,0,-1,1000,1000,0,-1,0,0,0
10248,80000,64000,0,0,0,0,0,0,0,22033,2800,19233,0,57522,36000,21522,0,58939,2500,56439,0,60790,3000,57790
10249,360000,288000,0,0,0,0,0,0,-1,3479,3479,0,-1,3435,3446,-11,-1,8870,8870,0,-1,2020,2020,0
10250,200000,160000,0,0,0,0,0,0,-2,0,0,0,-2,0,0,0,-2,1202,1202,0,-1,84482,84482,0
10251,50000,40000,0,0,0,0,0,0,0,22252,1620,20632,0,22541,900,21641,0,22863,780,22083,0,20288,750,19538
10252,120000,96000,0,0,0,0,0,0,0,79334,9000,70334,0,80531,3000,77531,0,80944,3100,77844,0,78771,3000,75771
10253,360000,288000,0,1,0,0,0,1,0,339204,15000,324204,0,282520,15000,267520,0,290521,15004,275517,0,27792,5071,22721
10254,200000,160000,0,1,0,0,0,0,0,198577,9474,189103,0,141141,4944,136197,0,144216,5240,138976,0,144027,5214,138813
10255,230000,184000,0,1,1,1,1,1,2,197039,8500,188539,2,200300,8000,192300,2,203018,7500,195518,2,199689,0,199689
10256,230000,184000,0,0,0,0,0,0,0,13442,2000,11442,0,16164,3418,12746,0,9908,0,9908,0,9592,0,9592
10257,150000,120000,0,0,0,0,0,0,0,64047,2321,61726,0,65966,2980,62986,0,66671,2400,64271,0,68067,2468,65599
10258,80000,64000,0,1,1,0,0,0,0,78686,5086,73600,0,66217,1750,64467,0,56167,2012,54155,0,53190,1630,51560
10259,240000,192000,0,0,1,0,0,0,0,234638,120000,114638,0,239790,10000,229790,0,132697,5000,127697,0,135561,4100,131461
10260,180000,144000,0,0,0,0,0,0,0,11988,1000,10988,0,0,0,0,0,0,0,0,-2,0,0,0
10261,180000,144000,0,0,0,0,0,0,-1,4569,4569,0,-1,29635,36124,-6489,-1,6489,0,6489,0,0,0,0
10262,100000,80000,0,0,0,0,0,0,0,60734,2231,58503,0,48816,1617,47199,0,28679,1000,27679,0,30231,2000,28231
10263,250000,200000,0,1,1,1,1,0,0,240332,12000,228332,0,244688,10000,234688,0,240221,10000,230221,0,224740,9000,215740
10264,20000,16000,0,1,0,0,0,0,2,19094,1500,17594,2,12393,0,12393,2,13037,1000,12037,0,13817,1000,12817
10265,50000,40000,0,0,0,0,0,0,-1,316,316,0,-1,316,316,0,-1,316,316,0,-1,316,316,0
10266,170000,136000,0,0,0,0,0,0,-1,2087,2087,0,-1,6720,6720,0,-1,23000,23000,0,-1,0,0,0
10267,270000,216000,0,0,0,0,0,0,-1,43852,43856,-4,-1,29677,29682,-5,-1,33341,33341,0,-1,28413,28413,0
10268,390000,312000,0,0,0,0,0,0,0,28868,10000,18868,0,29661,2000,27661,0,21907,15000,6907,0,8205,5000,3205
10269,30000,24000,0,1,1,1,1,0,0,28285,1500,26785,0,28463,1500,26963,0,29303,1300,28003,0,29766,1100,28666
10270,280000,224000,0,0,0,0,0,1,-2,3898,3898,0,-1,1460,1460,0,-1,18901,18901,0,-1,0,0,0
10271,50000,40000,0,0,0,0,0,0,0,37005,1746,35259,0,20145,1289,18856,0,19620,1684,17936,0,18872,684,18188
10272,140000,112000,0,0,0,0,0,1,2,67734,0,67734,2,73079,6500,66579,2,75255,4000,71255,2,75757,2000,73757
10273,180000,144000,0,0,0,0,0,1,-2,0,0,0,-2,0,0,0,-2,0,0,0,-2,0,0,0
10274,290000,232000,0,0,0,0,0,0,0,1332,1343,-11,-1,21429,21542,-113,-1,2228,2239,-11,-1,156721,156733,-12
10275,410000,328000,0,0,0,0,0,0,0,67396,3000,64396,0,70701,4400,66301,0,74590,5000,69590,0,78380,5033,73347
10276,150000,120000,0,0,0,0,0,0,-2,32662,46128,-13466,-2,59350,60260,-910,-1,41136,30218,10918,0,28596,17000,11596
10277,180000,144000,0,1,1,0,0,0,-1,180360,8200,172160,0,177460,9607,167853,0,140738,5103,135635,0,141830,5237,136593
10278,140000,112000,0,0,0,0,0,0,0,107289,16000,91289,0,63778,0,63778,2,41334,3000,38334,0,42664,2000,40664
10279,150000,120000,0,0,0,0,0,0,0,9858,5000,4858,0,9188,2000,7188,0,7518,1000,6518,0,23574,33054,-9480
10280,210000,168000,0,0,0,0,0,1,-1,1297,1297,0,-1,326,326,0,-1,326,326,0,-1,326,326,0
10281,500000,400000,0,0,0,0,0,0,0,74767,4002,70765,0,74383,3002,71381,0,74251,3018,71233,0,61124,3352,57772
10282,360000,288000,0,0,0,0,0,0,-1,1380,1380,0,-1,0,0,0,-1,1999,1999,0,-1,-1,0,-1
10283,80000,64000,0,0,0,0,0,1,-1,0,0,0,-2,0,0,0,-2,0,0,0,-2,0,0,0
10284,140000,112000,0,0,0,0,0,0,0,32073,5000,27073,0,43129,11885,31244,0,47086,5000,42086,0,48699,3000,45699
10285,150000,120000,0,0,0,0,0,1,-1,13347,13504,-157,-1,13155,13221,-66,-1,10610,10663,-53,-1,8394,8436,-42
10286,20000,16000,0,0,0,0,0,0,-1,0,0,0,-2,0,0,0,-2,13398,13398,0,-1,7224,0,7224
10287,500000,400000,1,1,1,1,1,0,0,597415,21898,575517,0,569034,20851,548183,0,551702,19599,532103,0,568638,26000,542638
10288,120000,96000,0,1,1,1,1,0,0,116835,5847,110988,0,118053,5800,112253,0,119047,4445,114602,0,119641,4700,114941
10289,200000,160000,0,0,0,0,0,1,-1,823,0,823,2,823,0,823,0,-658,0,-658,0,1266,1924,-658
10290,80000,64000,0,0,0,0,0,0,0,22740,2124,20616,0,13099,0,13099,0,6551,0,6551,0,0,0,0
10291,160000,128000,0,0,0,0,0,0,-1,11140,11490,-350,-1,2659,2673,-14,-1,14336,14558,-222,-2,16533,16615,-82
10292,400000,320000,0,0,0,0,0,1,-1,6073,18,6055,2,8591,8591,0,-1,6611,0,6611,0,17080,10990,6090
10293,30000,24000,0,1,1,1,0,0,0,28102,3000,25102,0,29078,2000,27078,0,29201,1000,28201,0,24122,1500,22622
10294,150000,120000,0,1,1,1,1,0,0,141314,6501,134813,0,141000,5201,135799,0,142358,5501,136857,0,143358,5282,138076
10295,300000,240000,0,0,0,0,0,0,-1,2039,2039,0,-1,13926,13926,0,-1,13804,1304,12500,0,11600,0,11600
10296,90000,72000,0,0,0,0,0,1,0,2888,2888,0,-1,0,0,0,-1,0,0,0,-2,300,300,0
10297,130000,104000,0,0,0,0,0,0,-2,1485,1485,0,-1,299,0,299,2,0,0,0,2,0,0,0
10298,50000,40000,0,0,0,1,0,0,0,3800,1000,2800,0,50535,50042,493,0,50525,2505,48020,0,1473,1473,0
10299,20000,16000,0,0,0,0,0,0,0,17858,2466,15392,0,16400,555,15845,0,14711,583,14128,0,18691,4275,14416
10300,120000,96000,0,0,0,0,0,0,-2,0,0,0,-2,0,0,0,-2,4629,4629,0,-1,5551,1000,4551
10301,360000,288000,0,0,0,0,0,1,-1,7575,7600,-25,-1,3026,3049,-23,-1,1133,1138,-5,-2,3408,3414,-6
10302,70000,56000,0,1,0,0,0,0,0,63063,2726,60337,0,10879,311,10568,0,11127,343,10784,0,13004,3000,10004
10303,50000,40000,0,0,0,0,0,0,-1,1140,1140,0,-1,1530,1530,0,-1,750,750,0,-1,1140,1140,0
10304,140000,112000,0,0,0,0,0,0,0,101636,4000,97636,0,97298,3800,93498,0,77081,3000,74081,0,72592,3300,69292
10305,90000,72000,0,0,0,0,0,0,0,36150,1832,34318,0,36528,1600,34928,0,37128,1000,36128,0,37348,1000,36348
10306,110000,88000,0,0,0,0,0,0,-1,890,2,888,2,3420,3430,-10,-1,4309,4319,-10,-1,733,2,731
10307,220000,176000,0,0,0,0,0,0,0,37504,12000,25504,0,9499,15030,-5531,-1,3679,10000,-6321,-1,13232,15000,-1768
10308,200000,160000,0,0,0,0,0,0,-2,3941,3941,0,-1,16405,16405,0,-1,-150,0,-150,-1,2327,2477,-150
10309,100000,80000,0,0,0,0,0,0,0,50385,5010,45375,0,31371,10005,21366,0,54713,30326,24387,0,28347,0,28347
10310,320000,256000,0,0,0,0,0,0,0,153327,8510,144817,0,155528,5000,150528,0,158745,4500,154245,0,161937,4544,157393
10311,20000,16000,0,0,0,0,0,0,0,2840,1000,1840,0,0,0,0,0,1740,1740,0,-1,0,0,0
10312,150000,120000,0,0,0,0,0,0,0,11829,1273,10556,0,7031,1069,5962,0,7172,1683,5489,0,5833,202,5631
10313,130000,104000,0,0,0,0,0,0,-2,0,0,0,-2,0,0,0,-2,0,0,0,-2,62043,62043,0
10314,280000,224000,0,0,0,0,0,0,0,16272,10018,6254,0,10496,7011,3485,0,6876,6000,876,0,34574,37000,-2426
10315,90000,72000,0,0,0,0,0,1,0,0,0,0,0,2757,2757,0,-1,3060,500,2560,-1,2864,0,2864
10316,20000,16000,0,0,0,0,0,0,-1,883,883,0,-1,470,470,0,-1,240,240,0,-1,0,0,0
10317,20000,16000,0,0,0,1,1,1,0,15761,1264,14497,0,17497,2000,15497,0,17075,0,17075,2,19777,3000,16777
10318,280000,224000,0,0,0,0,0,0,-2,32060,32220,-160,-2,3901,3920,-19,-2,1276,1282,-6,-2,-2,2,-4
10319,10000,8000,0,0,0,0,0,1,-1,390,390,0,-1,390,390,0,-1,540,540,0,-1,150,150,0
10320,70000,56000,0,0,0,0,0,1,2,51806,4700,47106,0,55625,4700,50925,0,57072,2500,54572,2,58269,2300,55969
10321,150000,120000,0,0,0,0,0,1,-2,0,0,0,-2,0,0,0,-2,0,0,0,-2,0,0,0
10322,100000,80000,0,0,0,0,0,0,0,65119,2276,62843,0,61153,2377,58776,0,64976,5000,59976,0,66309,2411,63898
10323,60000,48000,0,0,0,0,0,0,0,27649,2800,24849,0,29718,2800,26918,0,30171,1200,28971,0,30678,1100,29578
10324,70000,56000,0,0,0,0,0,0,0,13627,3000,10627,0,10852,0,10852,2,12676,2000,10676,0,14463,3000,11463
10325,80000,64000,0,0,0,0,0,0,0,23141,1700,21441,0,22160,1000,21160,0,21478,1000,20478,0,20441,1000,19441
10326,130000,104000,0,0,0,0,0,0,-1,11440,11440,0,-1,3752,3752,0,-1,1824,1824,0,-1,390,390,0
10327,10000,8000,0,0,0,0,0,0,-1,0,0,0,-1,780,780,0,-1,0,0,0,-1,0,0,0
10328,90000,72000,0,0,0,0,0,0,-2,0,0,0,-2,0,0,0,-2,0,0,0,-2,7707,7707,0
10329,180000,144000,0,0,0,0,0,1,2,142477,6000,136477,2,141674,3000,138674,2,146312,8500,137812,2,149133,5300,143833
10330,150000,120000,0,0,0,0,0,0,-2,330,330,0,-1,330,0,330,2,990,990,0,-1,0,0,0
10331,260000,208000,0,0,0,0,0,0,-1,2123,2125,-2,-1,11774,11892,-118,-1,6166,6192,-26,-1,3583,3601,-18
10332,150000,120000,0,0,0,0,0,1,2,108706,5000,103706,2,105470,0,105470,2,111687,8000,103687,2,113747,4000,109747
10333,320000,256000,0,0,0,0,0,0,0,103701,5500,98201,0,106195,5700,100495,0,106946,4000,102946,0,109228,4000,105228
10334,280000,224000,0,0,0,0,0,0,0,85601,27785,57816,0,108984,30000,78984,0,105275,23,105252,2,117635,20000,97635
10335,80000,64000,0,1,1,1,1,0,0,68279,2500,65779,0,69674,2530,67144,0,71070,2556,68514,0,73612,3700,69912
10336,230000,184000,0,0,0,0,0,0,-2,0,0,0,-2,0,0,0,-2,100,100,0,-2,900,900,0
10337,240000,192000,0,1,1,1,1,0,0,240998,10500,230498,0,244836,10581,234255,0,233036,8000,225036,0,237938,8500,229438
10338,20000,16000,0,0,0,0,0,0,0,0,0,0,0,0,0,0,-2,0,0,0,-2,19125,19125,0
10339,120000,96000,0,0,0,0,0,0,0,23384,2000,21384,0,24268,1312,22956,0,24665,1009,23656,0,21833,1000,20833
10340,90000,72000,0,0,0,0,0,0,0,46602,1219,45383,0,47141,1164,45977,0,16114,556,15558,0,15825,595,15230
10341,310000,248000,0,0,0,1,1,0,-1,250249,10000,240249,0,254254,10000,244254,0,259960,10000,249960,0,265702,10000,255702
10342,500000,400000,0,0,0,0,0,0,0,307896,11360,296536,0,241206,9572,231634,0,242481,7110,235371,0,230232,14470,215762
10343,220000,176000,0,0,0,0,0,1,-2,-65,0,-65,-2,-65,0,-65,-2,-65,0,-65,-2,-200,0,-200
10344,130000,104000,0,1,1,1,1,0,0,127949,4800,123149,0,129357,5000,124357,0,126999,4700,122299,0,126719,5000,121719
10345,20000,16000,0,1,1,1,1,0,2,19632,1720,17912,0,20298,1754,18544,0,20337,893,19444,2,19863,0,19863
10346,110000,88000,1,1,1,0,0,0,3,112706,0,112706,2,108302,4400,103902,0,46774,2000,44774,0,48300,3000,45300
10347,30000,24000,1,1,1,1,1,1,2,33849,2000,31849,0,34522,1389,33133,0,33501,1068,32433,0,32129,3000,29129
10348,360000,288000,0,0,0,0,0,0,-2,2999,3021,-22,-2,-1,0,-1,-2,-1,0,-1,-2,-1,0,-1
10349,480000,384000,0,0,0,0,0,0,-1,13461,13469,-8,-1,9327,9327,0,-1,1368,1368,0,-1,1538,1538,0
10350,100000,80000,0,0,0,0,0,0,-2,5408,5408,0,-2,12920,12920,0,-2,9656,9656,0,-2,4737,4737,0
10351,240000,192000,0,1,1,1,1,0,0,223431,10000,213431,0,226361,8000,218361,0,223508,9000,214508,0,238587,19000,219587
10352,400000,320000,0,0,0,0,0,0,-1,247784,258900,-11116,-1,258900,20170,238730,0,225614,17000,208614,0,228219,10000,218219
10353,320000,256000,0,0,0,0,0,0,-2,4615,4615,0,-2,5256,5256,0,-2,22760,22760,0,-2,700,700,0
10354,200000,160000,0,0,0,0,0,1,-2,3614,3614,0,-1,714,721,-7,-1,0,0,0,-1,0,0,0
10355,430000,344000,0,0,0,0,0,0,0,52214,3051,49163,0,32386,1199,31187,0,32848,2000,30848,0,28557,2000,26557
10356,360000,288000,0,0,0,0,0,0,-2,0,0,0,-2,0,0,0,-2,0,0,0,-2,0,0,0
10357,70000,56000,0,1,1,1,1,0,2,68582,3005,65577,0,68361,2546,65815,0,68060,2602,65458,0,68223,2430,65793
10358,90000,72000,0,0,0,0,0,0,0,42913,2100,40813,0,44388,2500,41888,0,45348,2000,43348,0,48454,4000,44454
10359,290000,232000,0,0,0,0,0,0,-1,9562,9569,-7,-1,21312,21336,-24,-1,16875,5020,11855,0,13881,3013,10868
10360,130000,104000,0,0,0,0,0,0,0,98095,5000,93095,0,100796,5000,95796,0,102504,4000,98504,0,104089,4000,100089
10361,60000,48000,0,1,0,0,0,0,0,51400,3000,48400,0,0,0,0,0,0,0,0,-2,0,0,0
10362,170000,136000,0,0,0,0,0,0,0,53032,3426,49606,0,29086,1317,27769,0,93786,93276,510,0,92728,3197,89531
10363,400000,320000,0,0,0,0,0,0,0,11451,11451,0,-2,101,104,-3,-2,551,600,-49,-2,19982,20015,-33
10364,160000,128000,0,0,0,0,0,0,-1,0,0,0,-2,2804,2804,0,-1,403,403,0,-1,253,0,253
10365,240000,192000,0,0,0,0,0,0,0,9015,9015,0,-1,10476,2000,8476,0,20237,10000,10237,0,2011,2512,-501
10366,30000,24000,0,0,0,0,0,0,0,2964,1044,1920,0,3360,1072,2288,0,5038,1750,3288,0,4833,182,4651
10367,30000,24000,0,1,1,1,1,0,3,27248,0,27248,2,29281,2800,26481,2,28511,0,28511,2,30952,2900,28052
10368,20000,16000,1,1,1,1,0,0,4,20930,549,20381,3,20182,0,20182,4,19836,0,19836,3,11998,0,11998
10369,410000,328000,0,0,0,0,0,0,0,279484,10515,268969,0,274639,9884,264755,0,281158,11000,270158,0,288051,11425,276626
10370,310000,248000,0,0,0,0,0,0,-2,8915,8959,-44,-2,-35,0,-35,-2,7028,7063,-35,-2,-116,0,-116
10371,200000,160000,0,0,0,0,0,1,-1,10594,10623,-29,-1,7969,25,7944,0,2865,16,2849,0,5625,6000,-375
10372,500000,400000,0,0,0,0,0,0,-2,0,0,0,-2,0,0,0,-2,1899,1899,0,-1,1749,0,1749
10373,220000,176000,0,0,0,0,0,0,0,39700,2000,37700,0,40737,2000,38737,0,42743,3000,39743,0,44052,2000,42052
10374,120000,96000,0,0,0,0,0,0,0,0,0,0,-2,0,0,0,-2,0,0,0,-2,0,0,0
10375,140000,112000,0,0,0,0,0,0,0,84315,2856,81459,0,70871,2503,68368,0,70923,2378,68545,0,64202,3014,61188
10376,330000,264000,0,0,0,0,0,0,-1,10151,10183,-32,-1,60841,62619,-1778,-1,41945,1945,40000,0,21183,1183,20000
10377,210000,168000,0,0,0,0,0,0,-1,5583,5583,0,-1,5583,5583,0,-1,5583,5583,0,-1,5500,5500,0
10378,30000,24000,0,0,1,1,1,0,0,27458,5101,22357,0,26539,2002,24537,0,28556,3031,25525,0,28621,3095,25526
10379,80000,64000,0,1,1,1,1,0,0,80299,3520,76779,0,81416,3069,78347,0,81617,3271,78346,0,81607,3262,78345
10380,60000,48000,0,0,0,0,0,1,3,20909,1800,19109,2,21168,900,20268,2,21520,1000,20520,2,21805,774,21031
10381,60000,48000,0,0,0,0,0,0,0,1024,1024,0,-1,16453,16469,-16,-1,4131,131,4000,0,4006,322,3684
10382,230000,184000,0,0,0,0,0,1,-2,-46,0,-46,-2,4826,4872,-46,-1,4829,4829,0,-1,1788,1788,0
10383,50000,40000,0,0,0,0,0,0,0,16428,1589,14839,0,16986,2000,14986,0,18579,3000,15579,0,17317,0,17317
10384,100000,80000,0,0,0,0,0,1,2,34189,400,33789,2,36309,3000,33309,2,36916,1500,35416,2,36192,0,36192
10385,290000,232000,0,0,0,0,0,0,0,226755,7700,219055,0,155527,4402,151125,0,125986,3300,122686,0,107792,3100,104692
10386,400000,320000,0,0,0,0,0,0,0,162828,8000,154828,0,131433,4553,126880,0,126929,3600,123329,0,122492,3546,118946
10387,150000,120000,0,0,0,0,0,0,-1,6269,6269,0,-1,8992,8914,78,0,4314,4300,14,0,11131,11100,31
10388,160000,128000,0,0,0,0,0,1,-2,3584,3594,-10,-2,1830,2246,-416,-2,390,390,0,-2,390,390,0
10389,240000,192000,0,0,0,0,0,1,-2,0,0,0,-2,0,0,0,-2,0,0,0,-2,0,0,0
10390,160000,128000,0,0,0,0,0,0,-2,0,0,0,-2,0,0,0,-2,821,821,0,-2,0,0,0
10391,130000,104000,0,1,1,0,0,0,0,128884,5069,123815,0,124514,3634,120880,0,67739,2476,65263,0,69614,3019,66595
10392,350000,280000,0,0,0,0,0,0,-1,3229,3229,0,-1,3096,3500,-404,-1,6373,4000,2373,0,10531,5000,5531
10393,50000,40000,0,0,0,0,0,1,-2,0,0,0,-2,0,0,0,-2,0,0,0,-2,0,0,0
10394,60000,48000,0,0,0,0,0,1,2,7801,7801,0,-1,1308,1158,150,0,3058,1900,1158,0,2190,2190,0
10395,220000,176000,0,0,0,0,0,0,-1,1386,1386,0,-1,-14,0,-14,-1,6160,6174,-14,-1,1307,1307,0
10396,20000,16000,0,0,0,0,0,0,0,15931,1450,14481,0,15850,369,15481,0,16226,429,15797,0,14411,288,14123
10397,70000,56000,0,0,0,0,0,0,0,0,0,0,-2,0,0,0,-2,0,0,0,-2,0,0,0
10398,200000,160000,0,0,0,0,0,1,2,2500,0,2500,2,2500,0,2500,4,2500,0,2500,4,2500,0,2500
10399,200000,160000,0,0,0,0,0,0,0,29815,29851,-36,-1,35442,283,35159,0,8321,1387,6934,0,20718,20057,661
10400,50000,40000,0,0,0,0,0,0,0,0,0,0,0,0,0,0,-2,0,0,0,-2,0,0,0
10401,80000,64000,0,0,0,0,0,0,0,59079,2036,57043,0,30289,1215,29074,0,27415,1500,25915,0,28447,1504,26943
10402,140000,112000,0,0,0,0,0,0,-1,0,0,0,-1,584,584,0,-1,0,0,0,-1,190,190,0
10403,140000,112000,0,1,1,0,0,0,0,132765,5434,127331,0,123208,4751,118457,0,97154,3500,93654,0,97687,3500,94187
10404,10000,8000,0,0,0,0,0,0,-1,6714,0,6714,2,4432,2000,2432,0,6652,3000,3652,0,6095,0,6095
10405,130000,104000,0,0,0,0,0,0,0,105049,6000,99049,0,68154,5000,63154,0,67397,2500,64897,0,61764,3000,58764
10406,200000,160000,0,0,0,0,0,0,-2,0,0,0,-2,1545,1545,0,-1,1156,1156,0,-1,6099,5000,1099
10407,360000,288000,0,0,0,0,0,1,2,156843,0,156843,2,63861,2700,61161,0,64437,3000,61437,0,8844,1000,7844
10408,50000,40000,0,0,0,0,0,0,0,2464,1000,1464,0,2521,57,2464,0,-1,0,-1,0,167,168,-1
10409,500000,400000,0,0,0,0,0,0,-2,79424,150042,-70618,-1,77920,4790,73130,0,55625,3236,52389,0,30092,866,29226
10410,100000,80000,0,0,0,0,0,0,-1,203,203,0,-1,203,0,203,2,0,0,0,2,7856,7856,0
10411,160000,128000,0,0,0,0,0,0,-2,0,200,-200,-2,6171,6171,0,-1,0,0,0,-1,0,0,0
10412,50000,40000,0,0,0,0,0,0,2,10725,1159,9566,0,10541,365,10176,0,10052,448,9604,0,10400,600,9800
10413,20000,16000,0,1,1,0,0,0,0,18239,1000,17239,2,19094,1500,17594,2,12393,0,12393,2,13037,1000,12037
10414,30000,24000,0,0,1,1,1,0,0,25286,1500,23786,0,25807,942,24865,0,26350,959,25391,0,27409,1500,25909
10415,240000,192000,0,0,0,0,0,0,-2,497,499,-2,-2,-3,0,-3,-2,-3,0,-3,-2,-3,0,-3
10416,50000,40000,0,1,0,0,0,0,0,46640,0,46640,2,40551,811,39740,0,19398,1000,18398,0,0,0,0
10417,50000,40000,0,0,0,0,0,0,-1,18171,18171,0,-1,17051,341,16710,0,390,0,390,0,16526,16526,0
10418,450000,360000,0,0,0,0,0,1,-1,-3,0,-3,-1,646,649,-3,-1,-2,0,-2,-1,418,420,-2
10419,250000,200000,0,0,0,0,0,0,-2,12035,12046,-11,-2,33604,33718,-114,-2,0,0,0,-2,1190,1190,0
10420,290000,232000,0,0,0,0,0,0,-1,1440,1440,0,-1,1017,1017,0,-1,3798,3798,0,-1,4898,4898,0
10421,200000,160000,0,0,0,0,0,0,0,136629,14955,121674,0,139504,5143,134361,0,142269,5166,137103,0,145250,5349,139901
10422,490000,392000,0,1,0,0,0,0,0,492718,20000,472718,0,282450,12000,270450,0,287363,11000,276363,0,272578,10000,262578
10423,120000,96000,0,0,0,0,0,0,-1,2179,2319,-140,-1,1423,1423,0,-1,0,0,0,-1,1820,1820,0
10424,140000,112000,0,1,1,1,1,0,0,134651,5000,129651,0,135350,6000,129350,0,129135,4700,124435,0,132035,5000,127035
10425,30000,24000,0,0,0,0,0,1,0,11560,2000,9560,0,16611,5611,11000,0,18179,2000,16179,0,19712,2000,17712
10426,20000,16000,0,0,0,0,0,0,0,9992,2000,7992,0,10526,1000,9526,2,11049,1000,10049,0,11865,1000,10865
10427,180000,144000,0,0,0,0,0,0,0,120339,4300,116039,0,122743,4200,118543,0,124893,4487,120406,0,126390,4087,122303
10428,290000,232000,0,0,0,0,0,1,-2,2765,2765,0,-2,6116,6200,-84,-2,10462,10479,-17,-2,1052,1052,0
10429,20000,16000,0,0,0,0,0,0,0,16024,3203,12821,0,15420,0,15420,3,13929,1000,12929,2,11307,0,11307
10430,320000,256000,0,0,0,0,0,0,-1,8835,8835,0,-1,3728,3751,-23,-1,764,764,0,-1,5468,5468,0
10431,50000,40000,0,0,0,0,0,0,-1,390,390,0,-1,390,390,0,-1,390,390,0,-1,390,390,0
10432,200000,160000,0,0,0,0,0,1,0,6655,6655,0,-1,3455,3455,0,-1,0,0,0,-1,1930,1930,0
10433,230000,184000,0,0,0,0,0,0,-1,5848,2655,3193,0,6849,1919,4930,0,9331,3400,5931,0,12687,3920,8767
10434,310000,248000,0,0,0,0,0,0,-2,0,0,0,-2,123,123,0,-2,0,0,0,-2,0,0,0
10435,50000,40000,0,0,0,0,0,0,0,0,0,0,0,0,0,0,-2,0,0,0,-2,10400,10400,0
10436,20000,16000,0,1,1,1,0,0,0,20221,1973,18248,0,19627,1000,18627,2,18948,600,18348,0,0,0,0
10437,200000,160000,0,0,0,0,0,0,0,148103,7000,141103,0,148137,4000,144137,0,151505,4000,147505,0,154728,4000,150728
10438,400000,320000,0,0,0,0,0,0,0,161585,123692,37893,0,146093,7002,139091,0,129047,8167,120880,0,75427,3996,71431
10439,100000,80000,0,1,0,0,0,1,2,85391,2500,82891,0,50605,5864,44741,0,49666,0,49666,2,50689,2000,48689
10440,30000,24000,0,1,1,1,1,0,0,28472,1660,26812,0,29212,1400,27812,0,29400,588,28812,0,30000,600,29400
10441,160000,128000,0,0,0,0,0,0,-2,3315,3322,-7,-2,2645,2645,0,-2,1049,1049,0,-2,1469,1469,0
10442,130000,104000,0,0,0,0,0,1,-1,2831,2831,0,-1,2756,2756,0,-1,1585,1585,0,-1,1215,1215,0
10443,50000,40000,0,0,0,0,0,1,2,6599,0,6599,2,6577,236,6341,0,7120,650,6470,0,6857,0,6857
10444,60000,48000,0,1,0,0,0,0,0,56566,1768,54798,0,30627,3954,26673,0,30203,1000,29203,2,28648,1500,27148
10445,20000,16000,0,1,1,1,1,1,0,19318,1308,18010,0,19434,688,18746,0,19571,706,18865,0,19792,806,18986
10446,60000,48000,0,0,0,0,0,1,2,9156,1000,8156,0,10226,1226,9000,0,12041,2000,10041,0,11704,0,11704
10447,200000,160000,0,1,1,0,0,0,0,199728,7889,191839,0,195609,6600,189009,0,131981,4602,127379,0,131294,4900,126394
10448,100000,80000,0,0,0,0,0,0,0,43004,3000,40004,0,50196,8000,42196,0,79217,30000,49217,0,78771,3000,75771
10449,400000,320000,0,0,0,0,0,0,0,6181,1500,4681,0,7859,2000,5859,0,4899,1000,3899,0,1466,500,966
10450,330000,264000,0,0,0,0,0,0,-1,36,0,36,2,24699,24863,-164,-1,2912,2912,0,-1,14231,14231,0
10451,250000,200000,0,1,1,0,0,0,0,243075,8800,234275,0,245750,9011,236739,0,175005,6000,169005,0,179687,7000,172687
10452,110000,88000,0,0,0,0,0,0,0,1651,1177,474,0,1823,1000,823,0,1208,550,658,0,0,0,0
10453,180000,144000,1,1,0,0,0,0,2,262878,5000,257878,0,128739,5000,123739,0,130929,4738,126191,0,130437,4915,125522
10454,230000,184000,0,0,0,0,0,0,-1,0,0,0,-2,0,0,0,-2,0,0,0,-2,0,0,0
10455,180000,144000,0,0,0,0,0,0,-1,360,360,0,-1,0,0,0,-1,0,0,0,-2,414,414,0
10456,130000,104000,0,0,0,0,0,0,0,106524,5067,101457,0,89412,5013,84399,0,86993,5002,81991,0,87433,4002,83431
10457,30000,24000,0,0,0,0,0,1,3,13738,0,13738,2,15424,2226,13198,2,14881,0,14881,2,15894,1406,14488
10458,150000,120000,0,0,0,0,0,0,-2,-551,4,-555,-2,-1944,7,-1951,-2,-4430,4,-4434,-2,-5813,7,-5820
10459,20000,16000,0,0,0,0,0,1,0,6622,0,6622,2,6232,0,6232,0,390,0,390,0,930,930,0
10460,110000,88000,0,0,0,0,0,0,0,46187,1800,44387,0,47105,1638,45467,0,45253,1490,43763,0,46144,1957,44187
10461,90000,72000,0,1,1,0,0,0,0,87535,1947,85588,0,89335,2000,87335,0,19715,10000,9715,0,4709,4709,0
10462,140000,112000,0,0,0,0,0,0,0,41266,1500,39766,0,39634,11888,27746,0,115440,115440,0,-1,133580,23900,109680
10463,110000,88000,0,0,0,0,0,1,-2,0,0,0,-2,0,0,0,-2,0,0,0,-2,0,0,0
10464,50000,40000,0,0,0,0,0,0,0,32252,1500,30752,0,6182,1500,4682,0,17118,2500,14618,0,8922,500,8422
10465,50000,40000,0,1,1,0,0,1,0,50820,2500,48320,0,50706,3820,46886,0,30636,1636,29000,0,30501,1501,29000
10466,110000,88000,0,0,0,0,0,0,-1,1380,1380,0,-1,2760,2760,0,-1,1380,0,1380,0,1700,1700,0
10467,30000,24000,0,0,0,0,0,1,2,17224,2000,15224,2,18241,1600,16641,2,18446,800,17646,2,18009,0,18009
10468,30000,24000,1,1,1,1,1,1,0,36619,2000,34619,0,34752,1500,33252,0,33229,1500,31729,0,32211,2000,30211
10469,90000,72000,0,0,0,0,0,0,0,7235,1124,6111,0,8248,1137,7111,0,8412,301,8111,0,8589,312,8277
10470,60000,48000,0,0,0,0,0,0,0,10131,3000,7131,0,11644,2000,9644,0,14430,3000,11430,0,17180,3000,14180
10471,210000,168000,0,0,0,0,0,0,-2,0,0,0,-2,0,0,0,-2,0,0,0,-2,0,0,0
10472,130000,104000,0,0,0,0,0,0,2,21213,1700,19513,2,15443,0,15443,2,25371,15571,9800,0,4264,4264,0
10473,170000,136000,0,0,0,0,0,0,-1,4427,4427,0,-1,1459,1459,0,-1,24511,24511,0,-1,1163,1163,0
10474,150000,120000,0,0,0,0,0,0,0,108748,5500,103248,0,108116,4000,104116,0,108951,4100,104851,0,109901,4300,105601
10475,30000,24000,0,0,0,0,0,0,2,11787,1188,10599,2,11301,0,11301,2,11677,564,11113,0,11766,426,11340
10476,30000,24000,0,1,1,1,1,1,0,29785,1585,28200,0,30377,1377,29000,0,30155,1155,29000,0,31098,2600,28498
10477,80000,64000,0,0,0,0,0,0,0,45535,7000,38535,0,45954,4000,41954,0,47706,5000,42706,0,49235,5000,44235
10478,200000,160000,0,0,0,0,0,1,0,137837,6459,131378,0,140609,6550,134059,0,141896,5106,136790,0,151082,11500,139582
10479,20000,16000,0,0,0,0,0,0,-2,0,0,0,-2,0,0,0,-2,12723,12723,0,-1,30000,18000,12000
10480,80000,64000,0,0,0,0,0,0,0,4595,1121,3474,0,5172,1000,4172,0,5278,106,5172,0,3206,64,3142
10481,30000,24000,0,1,1,1,1,0,0,26620,1339,25281,0,26134,852,25282,0,26865,2067,24798,0,25752,1400,24352
10482,190000,152000,0,0,0,0,0,0,0,144484,5058,139426,0,148760,6489,142271,0,48776,1602,47174,0,49853,1716,48137
10483,100000,80000,0,0,0,0,0,1,2,41131,0,41131,2,43637,3500,40137,2,42635,0,42635,2,45440,3500,41940
10484,120000,96000,0,0,0,0,0,0,-2,-408,0,-408,-2,57392,58000,-608,-1,58805,2000,56805,0,60200,2000,58200
10485,700000,560000,0,0,0,0,0,0,0,130130,130370,-240,-1,105055,3381,101674,0,70896,145,70751,0,41509,4639,36870
10486,100000,80000,0,0,0,0,0,0,0,71007,3300,67707,0,69470,2910,66560,0,65424,2400,63024,0,64349,2340,62009
10487,220000,176000,0,0,0,0,0,0,-1,990,990,0,-1,990,990,0,-1,5538,5538,0,-1,5687,1206,4481
10488,310000,248000,0,0,0,0,0,0,0,188255,8321,179934,0,187384,7022,180362,0,184222,6021,178201,0,183544,6005,177539
10489,420000,336000,0,1,0,0,0,0,0,411637,17000,394637,0,340947,13541,327406,0,267641,10008,257633,0,214445,7705,206740
10490,30000,24000,0,0,1,1,1,0,0,25819,2390,23429,0,26409,1718,24691,0,26401,1100,25301,0,26448,1000,25448
10491,20000,16000,0,1,1,1,1,1,2,21408,4893,16515,2,20779,0,20779,4,20170,0,20170,3,19721,0,19721
10492,260000,208000,0,0,0,0,0,0,0,1593,1758,-165,-1,149,152,-3,-1,1959,1960,-1,-1,1255,1255,0
10493,10000,8000,0,1,1,1,1,1,0,9273,1235,8038,0,9774,1000,8774,0,9973,199,9774,0,9638,193,9445
10494,500000,400000,0,0,0,0,0,0,-1,301441,302961,-1520,-1,37945,38139,-194,-1,104491,104673,-182,-1,35234,35387,-153
10495,140000,112000,0,1,1,1,1,0,0,142460,6000,136460,0,142020,5500,136520,0,139879,5900,133979,0,140810,5200,135610
10496,500000,400000,0,0,0,0,0,0,0,49283,5040,44243,0,66144,17604,48540,0,75191,10000,65191,0,80619,10000,70619
10497,200000,160000,0,0,0,0,0,0,0,109495,29894,79601,0,13785,13943,-158,-1,22173,21865,308,-1,10482,0,10482
10498,550000,440000,0,0,0,0,0,0,0,55200,20000,35200,0,30000,5000,25000,0,0,0,0,0,0,0,0
10499,130000,104000,0,0,0,0,0,1,0,28974,1500,27474,0,23386,1000,22386,0,23958,1100,22858,0,24740,1337,23403
10500,140000,112000,0,1,1,0,0,0,0,136034,6405,129629,0,137524,6452,131072,0,88752,3228,85524,0,89409,3140,86269
10501,30000,24000,0,1,1,1,1,0,0,28456,2211,26245,0,29687,2000,27687,2,30690,1626,29064,2,31093,1049,30044
10502,80000,64000,0,0,0,0,0,0,2,57501,0,57501,2,60424,4500,55924,2,61811,2500,59311,2,63142,2500,60642
10503,50000,40000,0,0,0,0,0,0,0,31473,5300,26173,0,1473,1473,0,-1,1473,1473,0,-1,3873,3873,0
10504,140000,112000,0,0,0,0,0,0,0,39585,1559,38026,0,36189,2000,34189,0,21772,1003,20769,0,21417,1000,20417
10505,220000,176000,0,0,0,0,0,0,0,19292,32906,-13614,-1,18900,18900,0,-1,13580,13580,0,-1,33150,33150,0
10506,170000,136000,0,0,0,0,0,0,-1,4910,4920,-10,-1,0,0,0,-1,0,0,0,-2,1000,1000,0
10507,10000,8000,0,0,0,0,0,1,2,5728,1000,4728,0,4255,0,4255,0,2782,0,2782,0,1309,0,1309
10508,70000,56000,0,0,0,0,0,0,-1,0,0,0,-2,0,0,0,-2,0,0,0,-2,0,0,0
10509,300000,240000,0,0,0,0,0,0,0,93741,5000,88741,0,99802,8000,91802,0,97711,0,97711,2,99538,4000,95538
10510,20000,16000,0,0,0,0,0,1,-1,-1282,0,-1282,-2,1718,3000,-1282,-1,1238,0,1238,0,1831,1831,0
10511,160000,128000,0,0,0,0,0,0,0,117895,5000,112895,0,86943,2200,84743,0,23433,500,22933,0,20000,1000,19000
10512,420000,336000,0,0,0,0,0,0,-2,2977,3035,-58,-2,2987,3029,-42,-2,3624,3637,-13,-2,3165,3222,-57
10513,130000,104000,0,0,0,0,0,1,0,83975,4000,79975,0,76842,8000,68842,0,78093,6000,72093,0,67557,0,67557
10514,180000,144000,0,0,0,0,0,0,-2,5643,5643,0,-2,2285,2298,-13,-2,1498,1502,-4,-2,3092,3101,-9
10515,180000,144000,0,0,0,0,0,1,-2,0,0,0,-2,0,0,0,-2,0,0,0,-2,0,0,0
10516,140000,112000,0,0,0,0,0,0,0,50440,5007,45433,0,47945,10000,37945,0,17990,5011,12979,0,15735,5000,10735
10517,100000,80000,0,0,0,0,0,1,-1,1032,1032,0,-1,516,0,516,2,998,998,0,-1,482,0,482
10518,560000,448000,0,0,0,0,0,0,0,142391,4827,137564,0,145345,4974,140371,0,148177,4942,143235,0,139831,4573,135258
10519,400000,320000,0,0,0,0,0,0,0,50040,37505,12535,0,22072,10077,11995,0,6712,233,6479,0,5286,5312,-26
10520,80000,64000,0,0,0,0,0,0,0,173,173,0,-1,173,0,173,2,3435,3438,-3,-1,11962,10004,1958
10521,200000,160000,0,0,0,0,1,0,-1,1000,1326,-326,-1,9373,9373,0,-1,185994,192994,-7000,-1,188730,7000,181730
10522,60000,48000,0,0,0,0,0,1,0,37460,3600,33860,0,36558,0,36558,2,37945,2000,35945,0,38782,1600,37182
10523,230000,184000,0,0,0,0,0,0,2,4858,4858,0,-1,316,0,316,2,316,632,-316,-1,316,0,316
10524,70000,56000,0,0,0,0,0,1,0,19612,0,19612,2,22170,2900,19270,2,22612,942,21670,2,22101,0,22101
10525,360000,288000,0,0,0,0,0,0,-1,0,0,0,-1,0,0,0,-2,621,621,0,-1,0,0,0
10526,100000,80000,0,0,0,0,0,0,0,7911,2000,5911,0,17716,10070,7646,0,1002,1002,0,-1,1518,1000,518
10527,150000,120000,0,0,0,0,0,0,-2,-20,0,-20,-2,-20,0,-20,-2,-20,0,-20,-2,-20,0,-20
10528,160000,128000,0,0,0,0,0,0,-1,6969,6980,-11,-1,9044,9044,0,-1,2325,2325,0,-1,3998,4997,-999
10529,380000,304000,0,0,0,0,0,0,0,275057,6010,269047,0,156348,5209,151139,0,153778,5000,148778,0,139177,5000,134177
10530,180000,144000,0,0,0,0,0,1,0,57253,2200,55053,0,53736,2000,51736,0,46213,5000,41213,0,39701,2000,37701
10531,500000,400000,0,0,0,0,0,0,-2,1318,1318,0,-2,36032,36032,0,-2,0,0,0,-2,11270,11270,0
10532,30000,24000,0,1,1,0,0,0,0,29122,4500,24622,0,28277,0,28277,2,20390,900,19490,0,20555,1000,19555
10533,160000,128000,0,0,0,0,0,0,0,97291,4500,92791,0,98768,4000,94768,0,101016,4000,97016,0,103176,4000,99176
10534,100000,80000,0,0,0,0,0,0,-1,3667,3667,0,-1,2300,2300,0,-1,1132,1132,0,-1,2072,2072,0
10535,240000,192000,0,0,0,0,0,0,-1,18485,2000,16485,0,17406,2000,15406,0,19345,2000,17345,0,21134,3000,18134
10536,50000,40000,0,0,0,0,0,1,0,11664,1500,10164,0,10872,300,10572,0,9392,500,8892,0,9456,500,8956
10537,80000,64000,0,1,1,1,1,0,0,79229,3000,76229,0,77858,3000,74858,0,79566,3000,76566,0,74746,3000,71746
10538,40000,32000,0,0,0,0,0,1,2,15184,8000,7184,2,14643,0,14643,2,18385,4000,14385,2,17950,0,17950
10539,230000,184000,0,0,0,0,0,0,-2,5419,5449,-30,-2,4379,4407,-28,-2,2455,2455,0,-2,34517,34517,0
10540,710000,568000,0,0,0,0,0,0,0,62858,10008,52850,0,69207,10019,59188,0,73333,10202,63131,0,121892,70001,51891
10541,30000,24000,0,0,0,0,0,0,0,16465,0,16465,2,16977,5047,11930,0,0,0,0,0,0,0,0
10542,290000,232000,0,0,0,0,0,0,2,171993,0,171993,2,183510,14367,169143,2,179061,0,179061,2,182891,6700,176191
10543,100000,80000,0,0,0,0,0,1,2,67887,0,67887,2,72744,6000,66744,2,73932,2500,71432,2,75560,3000,72560
10544,240000,192000,0,0,0,0,0,0,0,19743,1400,18343,0,20298,1300,18998,0,15475,1000,14475,0,15852,1000,14852
10545,60000,48000,0,1,1,0,0,1,0,54941,4687,50254,0,50291,11,50280,2,35829,1500,34329,0,36602,1500,35102
10546,100000,80000,0,0,0,0,0,1,0,4743,1000,3743,0,2805,0,2805,0,354,354,0,-1,443,443,0
10547,80000,64000,0,0,0,0,0,0,0,23044,1400,21644,0,22919,2400,20519,0,21890,0,21890,2,22003,1000,21003
10548,160000,128000,0,0,0,0,0,0,0,52532,3000,49532,0,39455,1286,38169,0,26505,890,25615,0,13302,497,12805
10549,180000,144000,0,1,1,1,1,1,0,176778,7738,169040,0,172440,6200,166240,0,168914,6418,162496,0,171645,13000,158645
10550,410000,328000,0,0,0,0,0,0,-1,0,0,0,-1,0,0,0,-2,1759,1759,0,-1,2624,2624,0
10551,20000,16000,0,1,1,0,0,0,0,17980,0,17980,2,18780,1000,17780,0,0,1000,-1000,0,0,0,0
10552,50000,40000,0,0,0,0,0,0,0,10243,1000,9243,2,10826,1000,9826,0,11699,1000,10699,0,10146,2000,8146
10553,220000,176000,0,0,0,0,0,0,-2,1590,1590,0,-2,1341,1341,0,-2,8171,8171,0,-2,14253,14253,0
10554,500000,400000,0,0,0,0,0,0,0,11963,8000,3963,0,8839,3000,5839,0,2678,1000,1678,0,3028,3028,0
10555,50000,40000,0,1,1,0,0,0,0,50055,2000,48055,0,50641,2700,47941,0,40672,1700,38972,0,39960,1600,38360
10556,60000,48000,0,0,0,0,0,0,0,27036,2036,25000,0,27074,937,26137,0,25911,1911,24000,0,26431,951,25480
10557,150000,120000,0,0,0,0,0,0,-2,0,0,0,-2,0,0,0,-2,1966,1966,0,-1,500,500,0
10558,130000,104000,0,1,1,0,0,0,0,128243,20000,108243,0,115204,10009,105195,0,101158,10000,91158,0,95895,5000,90895
10559,230000,184000,0,1,1,0,0,1,0,234832,8795,226037,0,217987,8337,209650,0,169529,6015,163514,0,172143,6292,165851
10560,50000,40000,0,1,0,0,0,0,2,48363,1500,46863,0,30221,1000,29221,0,22877,2000,20877,0,22361,0,22361
10561,290000,232000,0,0,0,0,0,0,-1,3070,3078,-8,-1,1406,1406,0,-1,2196,2196,0,-1,1481,1481,0
10562,210000,168000,0,0,0,0,0,0,0,64778,13000,51778,0,65861,12340,53521,0,63794,14000,49794,0,65069,12364,52705
10563,200000,160000,1,1,1,1,0,0,0,433541,10688,422853,0,425538,10278,415260,0,419080,11567,407513,0,98840,98843,-3
10564,140000,112000,0,0,0,0,0,0,0,84587,14659,69928,0,65589,5000,60589,0,69117,8000,61117,0,65911,5000,60911
10565,30000,24000,0,0,0,0,1,0,0,23961,0,23961,4,23289,0,23289,3,22779,0,22779,2,51224,3400,47824
10566,240000,192000,0,0,0,0,0,0,-2,7182,7208,-26,-2,6398,6450,-52,-2,2498,2498,0,-2,3466,3466,0
10567,230000,184000,0,0,0,0,0,1,2,1214,1000,214,2,464,0,464,2,214,500,-286,-1,-536,0,-536
10568,30000,24000,0,0,0,0,0,0,2,9815,2000,7815,2,7576,0,7576,2,5746,144,5602,0,3900,128,3772
10569,280000,224000,0,0,0,0,0,0,-1,7936,2980,4956,-1,2932,29,2903,2,6493,6493,0,-1,4867,4867,0
10570,200000,160000,0,0,0,0,0,0,0,51341,2200,49141,0,49090,2500,46590,0,50009,3500,46509,0,51076,3000,48076
10571,70000,56000,0,0,0,0,0,0,0,31301,1500,29801,2,31980,1500,30480,0,32813,1500,31313,0,33614,1500,32114
10572,300000,240000,0,0,0,0,0,0,-2,0,0,0,-2,0,0,0,-2,0,0,0,-2,0,0,0
10573,220000,176000,0,1,0,0,0,0,0,221631,9000,212631,0,182629,6901,175728,0,165314,6000,159314,0,161971,6000,155971
10574,50000,40000,0,0,0,0,0,0,-1,0,0,0,-2,0,0,0,-2,0,0,0,-2,0,0,0
10575,500000,400000,0,0,0,0,0,0,-2,12171,12176,-5,-2,11345,11564,-219,-2,28731,29321,-590,-2,67206,67206,0
10576,70000,56000,0,0,0,0,0,0,-2,-595,100104,-100699,-2,7462,10000,-2538,-2,9390,15000,-5610,-2,5183,10000,-4817
10577,240000,192000,0,0,0,0,0,0,-1,1913,1921,-8,-1,150,150,0,-1,482,482,0,-1,5482,5000,482
10578,260000,208000,0,0,0,0,0,1,-1,0,0,0,-2,550,550,0,-1,880,880,0,-1,1287,1287,0
10579,20000,16000,0,0,1,1,1,1,0,17347,1600,15747,0,18055,1300,16755,0,18755,1000,17755,0,20299,2000,18299
10580,60000,48000,0,0,0,0,0,0,0,35435,1653,33782,0,19262,680,18582,0,19285,700,18585,0,19565,700,18865
10581,110000,88000,0,0,0,0,0,1,0,71886,3200,68686,0,76767,6000,70767,0,78462,3000,75462,2,79890,2800,77090
10582,80000,64000,0,0,0,0,0,0,-1,7905,8000,-95,-1,7905,0,7905,0,20616,20616,0,-1,7727,7727,0
10583,60000,48000,0,0,0,0,0,1,2,15043,5000,10043,0,19738,5000,14738,0,19195,0,19195,2,19473,2000,17473
10584,80000,64000,0,1,1,0,0,0,2,79496,0,79496,2,78641,3300,75341,0,48837,2000,46837,0,50592,3800,46792
10585,20000,16000,0,0,0,0,0,0,0,15927,1667,14260,0,11939,2309,9630,0,10782,2000,8782,0,12599,2000,10599
10586,240000,192000,0,0,0,0,0,1,-2,0,0,0,-2,0,0,0,-2,0,0,0,-2,0,0,0
10587,270000,216000,0,0,0,0,0,1,0,159223,7000,152223,0,165480,9000,156480,0,76144,5000,71144,0,77944,3000,74944
10588,400000,320000,0,0,0,0,0,0,-1,4168,4188,-20,-1,4049,4061,-12,-1,4566,4586,-20,-1,2578,12,2566
10589,180000,144000,0,0,0,0,0,0,0,24410,7000,17410,0,29184,7000,22184,0,7325,5000,2325,0,326,326,0
10590,70000,56000,0,1,0,0,0,0,0,65458,1604,63854,0,19087,1000,18087,0,10220,10220,0,-1,11913,11913,0
10591,30000,24000,0,0,1,1,1,0,0,29718,31509,-1791,-1,27417,1500,25917,0,28489,1502,26987,0,28427,1500,26927
10592,40000,32000,0,0,0,0,0,0,2,13102,1000,12102,2,12595,0,12595,2,14386,2000,12386,2,14005,0,14005
10593,130000,104000,0,0,0,0,0,1,-1,696,696,0,-1,1076,1076,0,-1,316,316,0,-1,696,696,0
10594,390000,312000,0,0,0,0,0,0,0,68566,5007,63559,0,65411,5000,60411,0,66597,5000,61597,0,57361,5000,52361
10595,320000,256000,0,0,0,0,0,0,0,24986,3019,21967,0,23844,2022,21822,0,20650,2000,18650,0,0,0,0
10596,450000,360000,0,0,0,0,0,0,0,17111,10000,7111,0,19585,3000,16585,0,9756,10000,-244,-1,3282,3300,-18
10597,140000,112000,0,0,0,0,0,0,0,8127,1000,7127,0,8850,2000,6850,0,9262,2000,7262,0,5789,1000,4789
10598,360000,288000,0,0,0,0,0,0,0,10730,1200,9530,0,20530,10000,10530,0,987,987,0,0,837,0,837
10599,500000,400000,0,0,0,0,0,0,0,159291,20000,139291,0,262663,106700,155963,0,308074,50000,258074,0,400050,100000,300050
10600,150000,120000,0,0,0,0,0,0,-1,5699,5699,0,-1,4644,4644,0,-1,70337,70331,6,0,67902,3000,64902
10601,360000,288000,0,0,0,0,0,0,2,60158,1399,58759,0,16672,0,16672,0,35039,35039,0,-1,8320,8320,0
10602,100000,80000,0,0,0,0,0,1,-1,89,0,89,2,0,0,0,2,356,356,0,-1,16213,16213,0
10603,110000,88000,0,1,1,1,1,1,0,103034,3804,99230,0,103112,4500,98612,0,94403,3400,91003,0,96072,3500,92572
10604,160000,128000,0,0,0,0,0,1,0,62921,3000,59921,0,64274,3000,61274,0,66198,3000,63198,0,68126,3000,65126
10605,170000,136000,0,0,0,0,0,1,0,26013,5000,21013,0,24471,2000,22471,0,23496,2000,21496,0,25333,5000,20333
10606,120000,96000,0,0,0,0,0,0,0,78971,3000,75971,0,80907,9000,71907,0,79219,0,79219,2,77809,3000,74809
10607,60000,48000,0,0,0,0,0,1,0,22334,1336,20998,0,22426,927,21499,0,22240,801,21439,0,25378,4000,21378
10608,260000,208000,0,0,0,0,0,0,-2,1302,1308,-6,-2,2752,2765,-13,-2,1114,1119,-5,-2,2212,2218,-6
10609,150000,120000,0,1,1,1,1,1,0,147635,5661,141974,0,129507,4636,124871,0,132219,4800,127419,0,134869,4850,130019
10610,20000,16000,0,0,1,1,1,0,0,18808,3190,15618,0,18302,1500,16802,0,18995,1000,17995,0,19400,860,18540
10611,230000,184000,0,0,0,0,0,0,0,23769,1602,22167,0,17270,1017,16253,0,13903,332,13571,0,1953,9,1944
10612,280000,224000,0,0,0,0,0,0,-2,0,0,0,-2,0,0,0,-2,0,0,0,-2,0,0,0
10613,340000,272000,0,0,0,0,0,0,0,612,612,0,-1,1429,1429,0,-1,19513,19513,0,-1,19650,3000,16650
10614,70000,56000,0,1,1,1,1,0,0,68530,3112,65418,0,69753,3000,66753,0,70111,2438,67673,0,70212,2500,67712
10615,10000,8000,0,0,0,0,0,0,-1,390,780,-390,-1,390,0,390,2,0,0,0,2,780,780,0
10616,80000,64000,0,0,0,0,0,0,-2,21016,21115,-99,-2,14422,14422,0,-2,5157,5157,0,-2,6579,6579,0
10617,120000,96000,0,0,0,0,0,0,-1,1252,1252,0,-1,1252,1252,0,-1,1252,0,1252,0,626,626,0
10618,20000,16000,0,1,1,1,1,0,0,20312,3000,17312,0,19696,0,19696,3,19648,408,19240,2,20154,826,19328
10619,30000,24000,0,0,0,0,0,0,0,17223,11500,5723,0,18305,2000,16305,0,0,0,0,0,0,0,0
10620,150000,120000,0,0,0,0,1,1,2,110235,0,110235,2,111376,4500,106876,0,154802,45500,109302,0,152304,0,152304
10621,240000,192000,0,0,0,0,0,0,-2,0,0,0,-2,0,0,0,-2,27670,27670,0,-1,28252,920,27332
10622,240000,192000,0,1,1,0,0,0,0,242446,10307,232139,0,207633,9014,198619,0,197644,6029,191615,0,193724,6014,187710
10623,300000,240000,0,0,0,0,0,0,0,149506,6890,142616,0,-4394,0,-4394,0,-4394,0,-4394,-2,-4394,0,-4394
10624,500000,400000,0,0,0,0,0,0,-2,1474,5359,-3885,-2,555,555,0,-2,1096,1096,0,-2,1349,1349,0
10625,50000,40000,0,0,0,0,0,0,2,17418,1000,16418,2,15004,1000,14004,0,15804,1000,14804,0,17443,4024,13419
10626,110000,88000,0,0,0,0,0,0,0,43852,3306,40546,0,39840,1108,38732,0,32801,1126,31675,0,33174,1269,31905
10627,290000,232000,0,0,0,0,0,0,0,22528,1565,20963,0,10502,212,10290,0,82823,82902,-79,-1,52624,2008,50616
10628,10000,8000,0,0,0,0,0,1,2,6111,0,6111,2,7031,1000,6031,2,6780,0,6780,2,7676,1000,6676
10629,210000,168000,0,1,1,1,1,0,0,199882,8810,191072,0,203776,9000,194776,0,205901,7300,198601,0,210006,7500,202506
10630,150000,120000,0,0,0,0,0,0,-2,390,390,0,-2,390,390,0,-2,285,285,0,-2,-105,0,-105
10631,240000,192000,0,0,0,0,0,0,0,16475,1327,15148,0,14648,1500,13148,0,9384,500,8884,0,8171,500,7671
10632,30000,24000,0,0,0,0,0,1,0,5937,5937,0,-1,5880,5888,-8,-1,1680,1680,0,-1,0,0,0
10633,180000,144000,0,0,0,0,0,0,-1,776,776,0,-1,776,776,0,-1,1552,1552,0,-1,776,0,776
10634,280000,224000,0,0,0,0,0,0,0,195598,5700,189898,0,188878,5620,183258,0,186790,5000,181790,0,180240,5014,175226
10635,500000,400000,0,0,0,0,0,0,-2,53947,54218,-271,-2,84388,84839,-451,-2,26154,26283,-129,-2,175790,175857,-67
10636,110000,88000,0,0,0,0,0,0,-1,541,541,0,-1,941,941,0,-1,6993,6993,0,-1,37264,31229,6035
10637,30000,24000,0,1,1,1,1,0,0,29915,2,29913,2,29994,1731,28263,0,27310,1093,26217,0,27778,1026,26752
10638,520000,416000,0,0,0,0,0,0,-2,7491,7494,-3,-2,2310,2310,0,-2,12000,12000,0,-2,0,0,0
10639,250000,200000,0,0,0,0,0,0,0,7099,2101,4998,0,11758,7227,4531,0,17047,7865,9182,0,16483,8485,7998
10640,240000,192000,0,1,1,1,1,0,0,203823,10000,193823,0,216971,17000,199971,0,223048,10000,213048,0,228755,10000,218755
10641,140000,112000,0,1,0,0,0,0,0,138858,5700,133158,0,97585,3600,93985,0,95447,13500,81947,0,91717,3466,88251
10642,210000,168000,0,0,0,0,0,0,-1,9850,9856,-6,-1,9905,9905,0,-1,8540,8540,0,-1,8785,8785,0
10643,20000,16000,0,0,0,0,0,0,-1,390,390,0,-1,390,390,0,-1,390,390,0,-1,390,390,0
10644,190000,152000,0,0,0,0,0,0,-1,39360,39382,-22,-1,5090,5090,0,-1,2787,2787,0,-1,23405,23405,0
10645,240000,192000,1,1,1,0,0,0,0,250169,9900,240269,0,249495,10907,238588,0,192368,7000,185368,0,196585,8000,188585
10646,120000,96000,0,1,1,0,0,0,0,118038,6500,111538,0,118805,5000,113805,0,59210,3000,56210,0,61267,3000,58267
10647,210000,168000,0,0,0,0,0,0,-2,0,0,0,-2,0,0,0,-2,0,0,0,-2,0,0,0
10648,320000,256000,0,0,0,0,0,0,-1,2064,2064,0,-1,4365,4365,0,-1,1183,1183,0,-1,3287,3287,0
10649,90000,72000,0,0,0,0,0,0,0,0,0,0,0,0,0,0,-2,0,0,0,-2,0,0,0
10650,290000,232000,0,0,0,0,0,0,0,199437,8007,191430,0,154369,4005,150364,0,110016,2500,107516,0,27774,13000,14774
10651,360000,288000,0,0,0,0,0,0,-1,4851,4851,0,-1,3255,4784,-1529,-1,8255,5000,3255,0,8411,3000,5411
10652,240000,192000,0,0,0,0,0,0,0,6646,6500,146,0,-1776,0,-1776,0,3235,5011,-1776,-1,1612,0,1612
10653,70000,56000,0,0,0,0,0,1,0,35472,1500,33972,2,38369,3500,34869,2,42729,5300,37429,2,41496,0,41496
10654,50000,40000,0,1,1,0,0,0,0,46492,2453,44039,0,47368,2329,45039,0,7988,431,7557,0,8011,300,7711
10655,430000,344000,0,0,0,0,0,0,-1,14861,14861,0,-1,13846,1400,12446,0,13451,951,12500,0,16162,14082,2080
10656,170000,136000,0,0,0,0,0,0,0,125642,6642,119000,0,48926,8926,40000,0,23381,3381,20000,0,24492,4000,20492
10657,340000,272000,0,0,0,0,0,0,-1,16498,16514,-16,-1,100928,100940,-12,-1,26083,20229,5854,0,20214,25,20189
10658,180000,144000,1,1,0,0,0,0,0,281713,11000,270713,0,242063,145000,97063,-1,122295,26000,96295,0,-1005,0,-1005
10659,60000,48000,0,1,1,1,0,1,2,58250,2100,56150,2,56352,0,56352,2,57930,2801,55129,2,16563,0,16563
10660,200000,160000,0,0,0,0,0,0,-2,57928,57928,0,-2,523,523,0,-2,223,223,0,-1,7037,7037,0
10661,120000,96000,0,0,0,0,0,1,2,165,165,0,-1,0,0,0,-1,165,165,0,-1,0,0,0
10662,180000,144000,0,0,0,0,0,0,-1,950,957,-7,-1,13408,13408,0,-1,3819,3819,0,-1,1107,1107,0
10663,150000,120000,0,1,0,0,0,0,0,144954,6704,138250,0,101342,3712,97630,0,80819,3000,77819,0,81022,3890,77132
10664,120000,96000,0,0,0,0,0,1,2,24832,5000,19832,2,24135,0,24135,2,28723,5000,23723,0,31258,3000,28258
10665,20000,16000,0,1,1,1,1,0,0,19441,1291,18150,0,18680,656,18024,0,19071,679,18392,0,19217,784,18433
10666,500000,400000,0,0,0,0,0,0,0,39489,15720,23769,0,12421,12421,0,-1,11345,11345,0,-1,11968,11968,0
10667,370000,296000,0,0,0,0,0,0,0,134782,7000,127782,0,141002,10000,131002,0,145637,7000,138637,0,149281,6000,143281
10668,130000,104000,0,0,0,0,0,0,0,88209,50577,37632,0,53958,2000,51958,0,50577,2000,48577,0,41585,1488,40097
10669,360000,288000,0,0,0,0,0,1,-2,0,0,0,-2,0,0,0,-2,0,0,0,-2,0,0,0
10670,260000,208000,0,0,0,0,0,0,-1,1973,1973,0,-1,6746,6746,0,-1,1973,1973,0,-1,1973,1973,0
10671,90000,72000,0,0,0,0,0,0,2,2121,3509,-1388,-1,3113,3113,0,-1,0,0,0,-1,0,0,0
10672,10000,8000,0,1,1,1,0,0,0,9389,800,8589,2,9111,0,9111,3,8837,0,8837,2,8135,500,7635
10673,20000,16000,0,1,1,0,0,0,0,18058,1700,16358,0,18623,1509,17114,0,15692,1000,14692,0,15215,670,14545
10674,500000,400000,0,0,0,0,0,0,0,14332,4000,10332,0,20393,6500,13893,0,22633,5000,17633,0,24318,2000,22318
10675,250000,200000,0,0,0,0,0,1,2,2487,0,2487,2,2487,0,2487,2,2487,0,2487,2,2487,0,2487
10676,90000,72000,0,0,0,0,0,1,0,60363,2200,58163,0,58142,2100,56042,0,55896,2014,53882,0,53525,1876,51649
10677,130000,104000,0,0,0,0,0,0,-2,0,0,0,-2,0,0,0,-2,0,0,0,-2,0,0,0
10678,290000,232000,0,0,0,0,0,1,-1,820,820,0,-1,60,60,0,-1,1773,1773,0,-1,3904,3904,0
10679,480000,384000,0,0,0,0,0,0,-1,3647,3652,-5,-1,7621,7626,-5,-1,1735,1740,-5,-1,302818,302823,-5
10680,210000,168000,0,0,0,0,0,1,-1,3632,3632,0,-1,1967,1967,0,-1,3952,3985,-33,-1,10330,10330,0
10681,40000,32000,0,0,0,0,0,1,0,0,0,0,0,0,0,0,-2,0,0,0,-2,7922,7922,0
10682,50000,40000,0,1,0,0,0,1,2,44546,2000,42546,0,40745,1241,39504,0,19910,633,19277,0,17786,616,17170
10683,70000,56000,0,0,0,0,0,0,0,44784,1600,43184,2,43763,0,43763,2,46646,3600,43046,2,47724,2000,45724
10684,20000,16000,0,1,1,0,0,1,0,19880,3000,16880,0,19471,590,18881,0,16211,687,15524,0,14365,524,13841
10685,250000,200000,0,0,0,0,0,0,-2,0,0,0,-2,0,0,0,-2,0,0,0,-2,0,0,0
10686,50000,40000,0,0,0,0,0,1,-2,-709,0,-709,-2,-2898,0,-2898,-2,-3272,0,-3272,-2,-3272,0,-3272
10687,300000,240000,0,0,0,0,0,0,-2,26476,26476,0,-2,27782,27782,0,-2,23325,23325,0,-2,49146,49146,0
10688,160000,128000,0,0,0,0,0,0,-2,0,0,0,-2,0,0,0,-2,0,0,0,-2,0,0,0
10689,30000,24000,0,0,0,0,0,0,2,14309,1244,13065,0,15320,1255,14065,0,15774,709,15065,0,15950,578,15372
10690,180000,144000,0,0,0,0,0,1,-1,0,0,0,-2,0,0,0,-2,0,0,0,-2,0,0,0
10691,180000,144000,0,0,0,0,0,0,0,50763,10000,40763,0,69026,23000,46026,0,32030,5000,27030,0,33679,4000,29679
10692,120000,96000,0,0,0,0,0,1,2,79889,8000,71889,0,66828,2000,64828,0,55511,1346,54165,0,21938,3000,18938
10693,100000,80000,0,0,0,0,0,0,0,49331,2000,47331,0,50508,2000,48508,0,51543,2000,49543,0,52685,2000,50685
10694,280000,224000,0,0,0,0,0,0,0,117118,6000,111118,0,116689,5000,111689,0,117757,5000,112757,0,118432,4012,114420
10695,10000,8000,0,0,0,0,0,0,2,6205,1300,4905,0,7139,1200,5939,0,7918,900,7018,0,7646,0,7646
10696,250000,200000,0,0,0,0,0,0,0,14261,1310,12951,0,7019,232,6787,0,7062,238,6824,0,7242,279,6963
10697,50000,40000,0,1,1,1,1,0,2,49157,1900,47257,0,49890,1333,48557,0,48941,0,48941,0,49940,999,48941
10698,60000,48000,0,1,1,0,0,0,0,60764,2505,58259,0,60070,2000,58070,0,40479,3003,37476,0,39871,1500,38371
10699,20000,16000,0,1,1,1,1,0,0,20154,1307,18847,0,20132,701,19431,0,20129,717,19412,0,20226,834,19392
10700,200000,160000,0,0,0,0,0,0,-1,827,0,827,2,827,827,0,-1,827,827,0,-1,827,827,0
10701,500000,400000,0,0,0,0,0,0,-2,6058,6058,0,-2,7859,7859,0,-2,126683,126683,0,-2,7440,7440,0
10702,320000,256000,0,0,0,0,0,0,0,223284,10000,213284,0,98028,5000,93028,0,102498,6000,96498,0,80469,5000,75469
10703,120000,96000,0,0,0,0,0,1,2,28615,0,28615,3,29347,1500,27847,2,30868,2300,28568,2,30099,0,30099
10704,50000,40000,0,0,0,0,0,0,0,32514,33730,-1216,-1,26479,0,26479,2,27396,1500,25896,0,27789,1000,26789
10705,70000,56000,0,0,0,0,0,0,0,39476,2000,37476,0,40818,2000,38818,0,41833,2000,39833,0,45165,4000,41165
10706,80000,64000,0,0,0,0,0,0,0,60582,2100,58482,0,61453,2349,59104,0,61858,2200,59658,0,61104,2200,58904
10707,220000,176000,0,1,1,1,1,0,2,186054,9000,177054,0,188465,7000,181465,0,192758,7500,185258,0,196493,7100,189393
10708,20000,16000,0,0,0,0,0,1,5,13403,86,13317,4,12888,0,12888,3,12019,0,12019,2,11500,435,11065
10709,360000,288000,0,0,0,0,0,0,-1,2068,2078,-10,-1,2185,2361,-176,-1,9561,9608,-47,-1,321,322,-1
10710,50000,40000,0,0,0,0,0,1,2,7925,2000,5925,2,8631,1000,7631,2,8855,500,8355,2,8585,2,8583
10711,120000,96000,0,0,0,0,0,0,-1,721,721,0,-1,444,444,0,-1,710,710,0,-1,1920,1920,0
10712,290000,232000,0,0,0,0,0,0,-2,0,0,0,-2,0,0,0,-2,0,0,0,-2,0,0,0
10713,20000,16000,0,0,0,0,0,1,0,15788,1000,14788,0,14911,1000,13911,0,11699,1000,10699,0,12224,1068,11156
10714,80000,64000,0,0,0,0,0,0,-1,600,600,0,-1,100,100,0,-1,900,900,0,-1,2934,2934,0
10715,20000,16000,0,1,0,0,0,0,0,18757,2580,16177,0,15521,1279,14242,0,13086,654,12432,0,7688,7688,0
10716,160000,128000,0,0,0,0,0,0,0,89764,3500,86264,0,87919,3000,84919,0,86279,2956,83323,0,84794,3100,81694
10717,150000,120000,0,0,0,0,0,0,-2,0,0,0,-2,0,0,0,-2,699,699,0,-1,1170,1170,0
10718,60000,48000,0,1,1,1,1,0,0,61257,2483,58774,0,62697,6084,56613,0,60816,0,60816,2,61685,1936,59749
10719,210000,168000,0,0,0,0,0,0,2,0,0,0,2,0,0,0,-2,0,0,0,-2,0,0,0
10720,120000,96000,0,0,0,0,0,1,3,85194,2700,82494,2,76326,2500,73826,2,75122,3200,71922,2,75011,2500,72511
10721,200000,160000,0,0,0,0,0,1,-1,0,0,0,-1,0,0,0,-2,0,0,0,-2,0,0,0
10722,90000,72000,0,1,0,0,0,0,0,93557,4806,88751,0,47166,1547,45619,0,48406,3000,45406,0,49695,3000,46695
10723,180000,144000,0,0,0,0,0,0,-2,0,0,0,-2,2530,2530,0,-2,0,0,0,-2,0,0,0
10724,200000,160000,0,0,0,0,0,0,0,41590,1600,39990,0,43967,2900,41067,0,44722,1600,43122,2,46032,2000,44032
10725,190000,152000,0,0,0,0,0,0,-2,-18,0,-18,-2,-18,0,-18,-2,-18,0,-18,-2,-18,0,-18
10726,360000,288000,0,0,0,0,0,1,-2,2050,2050,0,-1,754,754,0,-1,0,0,0,-2,0,0,0
10727,50000,40000,0,0,0,0,0,1,0,32631,1744,30887,0,29968,1027,28941,0,29092,1033,28059,0,29977,1345,28632
10728,210000,168000,0,0,0,0,0,0,0,57527,10000,47527,0,56655,2655,54000,0,50745,5745,45000,0,53269,3269,50000
10729,200000,160000,0,0,0,0,0,0,0,482,482,0,-1,482,482,0,-1,462,462,0,-1,446,466,-20
10730,220000,176000,0,0,0,0,0,0,-1,0,0,0,-2,0,0,0,-2,0,0,0,-2,500,500,0
10731,60000,48000,0,1,0,0,0,0,0,58227,2155,56072,0,60538,45088,15450,0,45018,1722,43296,0,38086,1523,36563
10732,100000,80000,0,0,0,0,0,0,0,4286,1080,3206,0,5302,1096,4206,0,6829,1623,5206,0,6574,0,6574
10733,50000,40000,0,0,0,0,0,1,2,21919,2000,19919,2,20828,600,20228,2,20272,0,20272,2,18816,637,18179
10734,220000,176000,0,0,0,0,0,0,0,76747,3000,73747,0,67266,3520,63746,0,60896,3000,57896,0,160731,106200,54531
10735,50000,40000,0,0,0,0,0,1,0,42097,5728,36369,0,32394,1300,31094,0,16658,1194,15464,0,17006,617,16389
10736,610000,488000,0,0,0,0,0,0,0,103624,5000,98624,0,101044,4006,97038,0,106356,10000,96356,0,92459,7000,85459
10737,210000,168000,0,0,0,0,0,0,0,12471,2200,10271,0,13684,2000,11684,0,15356,2000,13356,0,16337,2000,14337
10738,20000,16000,0,0,0,0,0,0,0,12372,5017,7355,0,0,0,0,0,-800,0,-800,-2,0,800,-800
10739,70000,56000,0,0,0,0,0,0,0,40195,1787,38408,0,48568,50314,-1746,-1,49039,1768,47271,0,50387,2541,47846
10740,110000,88000,0,0,0,0,0,0,0,84229,4000,80229,0,79288,5000,74288,0,73315,3000,70315,0,63818,3000,60818
10741,30000,24000,0,0,0,0,0,0,2,18643,4000,14643,0,19005,600,18405,0,12751,0,12751,2,10891,2500,8391
10742,80000,64000,0,0,0,0,0,0,-2,179,179,0,-1,1755,1755,0,-1,0,0,0,-1,1190,1190,0
10743,50000,40000,0,1,0,0,0,1,2,43662,14,43648,2,18115,2000,16115,0,17300,1000,16300,0,17947,1500,16447
10744,150000,120000,0,0,0,0,0,1,0,91815,2000,89815,0,0,0,0,0,0,0,0,-2,0,0,0
10745,110000,88000,0,0,0,0,0,0,-1,85924,85924,0,-1,33342,1167,32175,0,33193,1197,31996,0,32993,1180,31813
10746,150000,120000,0,0,0,0,0,1,2,112453,5800,106653,2,113318,4200,109118,2,114268,4300,109968,2,116688,4400,112288
10747,30000,24000,0,0,0,0,0,1,2,22320,1300,21020,0,23933,5000,18933,0,22742,945,21797,0,2500,1850,650
10748,30000,24000,0,1,0,0,0,0,2,27149,1500,25649,0,14930,797,14133,0,14400,680,13720,0,0,0,0
10749,50000,40000,0,1,1,1,1,0,-1,47194,1800,45394,0,48224,1700,46524,0,49416,1857,47559,0,50126,2474,47652
10750,20000,16000,1,1,1,1,1,1,2,20085,0,20085,2,20126,500,19626,0,20469,650,19819,0,20655,600,20055
10751,220000,176000,0,0,0,0,0,1,2,102996,3251,99745,2,100198,2900,97298,2,100357,5000,95357,2,95471,0,95471
10752,20000,16000,0,0,0,0,0,1,2,0,0,0,-2,0,0,0,-2,4599,4599,0,-1,4779,700,4079
10753,110000,88000,0,0,0,0,0,0,-2,0,0,0,-2,9150,9150,0,-1,1960,0,1960,0,3930,3930,0
10754,30000,24000,0,0,0,0,0,1,2,5371,0,5371,2,5833,552,5281,2,5594,0,5594,2,6074,573,5501
10755,100000,80000,0,0,0,0,0,0,0,70018,2511,67507,0,57847,1523,56324,0,43618,1292,42326,0,38715,1236,37479
10756,210000,168000,0,1,0,0,0,0,0,185587,9007,176580,0,136410,5254,131156,0,140051,6000,134051,0,142976,5500,137476
10757,20000,16000,0,0,0,0,0,0,-1,5596,5596,0,-1,0,0,0,-1,0,0,0,-2,0,0,0
10758,60000,48000,0,0,0,0,0,0,-1,111,0,111,2,411,300,111,2,261,0,261,2,6695,6500,195
10759,150000,120000,0,0,0,0,0,0,-1,63174,65748,-2574,-1,43374,1537,41837,0,43950,1585,42365,0,44501,1597,42904
10760,230000,184000,0,0,0,0,0,0,-2,0,0,0,-2,3458,3458,0,-2,499,499,0,-2,5180,5180,0
10761,110000,88000,0,0,0,0,0,0,0,16850,1300,15550,0,17568,1000,16568,0,18133,1000,17133,0,18828,1000,17828
10762,50000,40000,0,0,0,0,0,0,-1,390,390,0,-1,390,390,0,-1,28094,28094,0,-1,28263,1011,27252
10763,280000,224000,0,0,0,0,0,1,0,137109,10000,127109,0,135264,5000,130264,0,133046,5000,128046,0,126155,5000,121155
10764,70000,56000,0,0,0,0,0,0,0,26583,2000,24583,0,23593,1000,22593,0,15114,500,14614,0,11222,500,10722
10765,460000,368000,0,0,0,0,0,1,2,2650,0,2650,2,2650,0,2650,3,2650,0,2650,3,2650,0,2650
10766,50000,40000,0,0,0,0,0,0,0,11115,1500,9615,0,12915,2000,10915,0,14415,2000,12415,0,0,0,0
10767,50000,40000,0,0,0,0,0,0,3,28403,1459,26944,2,27648,0,27648,2,28202,1013,27189,0,30008,2264,27744
10768,360000,288000,0,0,0,0,0,0,-1,26648,26987,-339,-1,6707,6740,-33,-1,3450,3467,-17,-1,0,0,0
10769,60000,48000,0,0,0,0,0,1,0,21849,2000,19849,0,18474,1200,17274,0,15488,1000,14488,0,11348,0,11348
10770,50000,40000,0,0,0,0,0,0,0,19062,1299,17763,0,19443,680,18763,0,19849,703,19146,0,20287,750,19537
10771,210000,168000,0,0,0,0,0,0,0,34809,1409,33400,0,25199,886,24313,0,25395,912,24483,0,25692,1035,24657
10772,170000,136000,0,1,0,0,0,0,0,151405,6443,144962,0,127090,4617,122473,0,126388,4711,121677,0,126399,4673,121726
10773,150000,120000,0,0,0,0,0,0,-2,0,0,0,-2,0,0,0,-2,0,0,0,-2,4095,4095,0
10774,230000,184000,0,0,0,0,0,0,-2,502,502,0,-2,944,950,-6,-2,5814,5820,-6,-2,965,965,0
10775,160000,128000,0,0,0,0,0,0,0,79027,3715,75312,0,6666,6666,0,-1,6666,6666,0,-1,6666,6666,0
10776,20000,16000,0,1,1,1,1,0,3,20502,1700,18802,2,19461,0,19461,2,19244,800,18444,0,20130,1600,18530
10777,230000,184000,0,0,0,0,0,1,0,115066,5091,109975,0,87021,3307,83714,0,82460,3316,79144,0,64818,2316,62502
10778,150000,120000,0,0,0,0,0,0,0,40921,20144,20777,0,24053,14182,9871,0,25856,16819,9037,0,77913,78287,-374
10779,230000,184000,0,0,0,0,0,0,0,11657,5000,6657,0,13258,3000,10258,0,12459,669,11790,0,6886,5000,1886
10780,80000,64000,0,0,1,0,0,0,0,81571,25000,56571,0,75814,7704,68110,0,49784,8700,41084,0,51408,3000,48408
10781,230000,184000,0,0,0,0,0,0,-1,5473,5654,-181,-1,8162,12887,-4725,-1,6985,6985,0,-1,9130,9130,0
10782,120000,96000,0,0,0,0,0,1,2,28996,1800,27196,2,29321,1100,28221,2,29803,1100,28703,2,30511,1350,29161
10783,240000,192000,0,0,0,0,0,0,0,136408,5000,131408,0,139192,5057,134135,0,142111,5239,136872,0,145165,5500,139665
10784,30000,24000,0,0,0,0,0,1,2,10862,2405,8457,2,11485,1100,10385,2,11006,0,11006,2,12270,1600,10670
10785,20000,16000,0,0,0,0,0,0,0,14375,4000,10375,0,15200,1200,14000,0,20000,5000,15000,0,16560,10000,6560
10786,270000,216000,0,0,0,0,0,0,0,19114,1500,17614,0,20341,1600,18741,0,20617,830,19787,0,16223,1000,15223
10787,100000,80000,0,1,1,1,1,0,2,97522,5000,92522,0,97696,3000,94696,0,90605,2113,88492,0,85293,2995,82298
10788,650000,520000,0,0,0,0,0,0,0,1904,1904,0,-1,-61,0,-61,-1,-261,0,-261,-2,13050,13311,-261
10789,230000,184000,0,0,0,0,0,0,0,99033,7000,92033,0,237008,237008,0,-1,184695,6488,178207,0,185116,6605,178511
10790,360000,288000,0,0,0,0,0,0,0,26649,16079,10570,0,15830,5024,10806,0,20025,9032,10993,0,21404,8035,13369
10791,170000,136000,0,0,0,0,0,0,0,27654,1690,25964,0,25211,1208,24003,0,22682,462,22220,0,21787,1787,20000
10792,120000,96000,0,0,0,0,0,1,-1,2290,2299,-9,-1,780,780,0,-1,8190,8190,0,-1,4600,4600,0
10793,60000,48000,0,0,0,0,0,0,0,9479,1033,8446,0,0,0,0,0,0,0,0,-2,0,0,0
10794,80000,64000,0,0,0,0,0,1,0,52889,2000,50889,2,51520,0,51520,2,50741,1800,48941,0,50322,1850,48472
10795,20000,16000,0,1,1,1,1,0,0,18932,1593,17339,0,18749,800,17949,0,18620,700,17920,0,18668,741,17927
10796,360000,288000,0,0,0,0,0,0,-1,5307,5307,0,-1,23102,23102,0,-1,64617,64617,0,-1,10542,10542,0
10797,150000,120000,0,0,0,0,0,0,0,43747,7601,36146,0,700,701,-1,-1,64758,64758,0,-1,92966,29008,63958
10798,20000,16000,0,0,0,0,0,0,0,4150,4150,0,-1,988,988,0,-1,390,390,0,-1,1935,1935,0
10799,50000,40000,0,0,0,0,0,0,0,880,880,0,-1,0,0,0,-1,150,150,0,-1,528,528,0
10800,20000,16000,0,0,0,0,0,1,-1,0,0,0,-1,0,0,0,-2,4076,4076,0,-1,1911,1911,0
10801,50000,40000,0,0,0,0,0,0,0,0,0,0,-2,0,0,0,-2,0,0,0,-2,0,0,0
10802,70000,56000,0,1,0,0,0,0,2,58840,0,58840,2,56431,2000,54431,0,56859,4219,52640,0,54449,1700,52749
10803,150000,120000,0,0,0,0,0,0,0,109765,5019,104746,0,101179,4588,96591,0,99940,4500,95440,0,96190,5000,91190
10804,100000,80000,0,0,0,0,0,1,0,78533,2700,75833,0,75568,19782,55786,0,63637,2063,61574,0,50711,3000,47711
10805,30000,24000,0,1,0,0,0,0,2,29346,3313,26033,2,23548,108,23440,2,11790,299,11491,0,7276,325,6951
10806,400000,320000,0,0,0,0,0,0,-2,29186,30001,-815,-1,30789,2128,28661,0,7879,3009,4870,0,13928,8006,5922
10807,80000,64000,0,0,0,0,0,0,-1,1964,1964,0,-1,7541,7568,-27,-1,3201,0,3201,0,5026,5026,0
10808,80000,64000,0,0,0,0,0,0,0,44234,2000,42234,0,45276,1668,43608,0,39808,2000,37808,0,40598,1453,39145
10809,30000,24000,0,1,1,1,0,0,0,27764,1500,26264,0,27973,700,27273,0,28576,700,27876,0,12135,500,11635
10810,20000,16000,0,1,1,1,0,0,0,19302,2484,16818,0,18818,1000,17818,0,19052,475,18577,0,9097,363,8734
10811,320000,256000,0,0,0,0,0,0,0,103621,5240,98381,0,103720,3616,100104,0,100136,3770,96366,0,102167,4264,97903
10812,210000,168000,0,0,0,0,0,0,0,79989,2253,77736,0,69800,1404,68396,0,54256,1085,53171,0,48256,1652,46604
10813,130000,104000,0,0,0,0,0,0,2,38765,3000,35765,0,33349,2000,31349,0,33463,1000,32463,0,33795,666,33129
10814,340000,272000,0,0,0,0,0,0,-1,23337,23453,-116,-1,4291,4314,-23,-1,80153,80552,-399,-1,25820,25949,-129
10815,250000,200000,0,0,0,0,0,0,-1,165,165,0,-1,165,165,0,-1,165,165,0,-1,315,315,0
10816,180000,144000,0,0,0,0,0,0,0,0,0,0,-2,6398,6398,0,-1,15218,9000,6218,0,24901,10000,14901
10817,120000,96000,0,0,0,0,0,1,-1,2853,5753,-2900,-1,2896,1153,1743,0,1149,3,1146,0,1758,1759,-1
10818,30000,24000,0,0,0,0,0,0,0,26679,5022,21657,0,22972,1232,21740,0,20152,820,19332,0,11688,286,11402
10819,50000,40000,0,0,0,0,0,1,0,26858,0,26858,2,28209,1800,26409,2,29108,1500,27608,2,29980,1500,28480
10820,120000,96000,0,0,0,0,0,0,0,44208,2000,42208,0,32652,1256,31396,0,24115,1000,23115,0,20399,750,19649
10821,210000,168000,0,0,0,0,0,0,-1,6472,13966,-7494,-1,83589,80000,3589,0,73689,2326,71363,0,64854,2272,62582
10822,300000,240000,0,0,0,0,0,0,0,31501,0,31501,2,32678,2000,30678,0,36147,4000,32147,0,40503,5000,35503
10823,80000,64000,0,0,0,0,0,0,0,14919,1369,13550,0,15375,825,14550,0,-150,0,-150,0,-150,0,-150
10824,90000,72000,0,0,0,0,0,0,0,33550,3114,30436,0,34216,1223,32993,0,34933,1267,33666,0,35628,1275,34353
10825,160000,128000,0,0,0,0,0,0,-1,7918,8000,-82,-1,13780,13780,0,-1,12297,12300,-3,-1,12752,12752,0
10826,70000,56000,0,1,1,1,1,0,0,70644,3160,67484,0,70759,3100,67659,0,70352,2500,67852,0,70659,2600,68059
10827,100000,80000,0,0,0,0,0,1,-1,380,380,0,-1,380,380,0,-1,425,425,0,-1,1045,1000,45
10828,180000,144000,0,0,0,0,0,1,-1,0,0,0,-2,0,0,0,-2,0,0,0,-2,0,0,0
10829,250000,200000,0,0,0,0,0,0,0,116608,5000,111608,0,120564,5900,114664,0,121477,4400,117077,0,124115,4600,119515
10830,230000,184000,0,0,0,0,0,0,0,1665,1762,-97,-1,1228,1228,0,-1,8599,8599,0,-1,3890,3890,0
10831,260000,208000,0,0,0,0,0,0,-2,6790,6914,-124,-2,10070,10098,-28,-1,585,585,0,-1,435,435,0
10832,40000,32000,0,0,0,0,1,1,0,26974,2014,24960,0,22710,799,21911,0,37977,32001,5976,0,39347,2000,37347
10833,50000,40000,0,1,0,0,0,0,1,49555,0,49555,2,34644,1656,32988,2,28867,944,27923,2,28983,967,28016
10834,50000,40000,1,1,0,0,0,0,2,54439,2327,52112,0,9753,1072,8681,0,9952,199,9753,0,9352,9000,352
10835,50000,40000,1,1,1,1,1,0,0,53561,2668,50893,0,53283,1712,51571,0,53057,1762,51295,0,52908,1894,51014
10836,290000,232000,0,0,0,0,0,0,0,124871,6000,118871,0,118193,5000,113193,0,121283,5000,116283,0,124109,5000,119109
10837,320000,256000,0,0,0,0,0,0,0,155421,34000,121421,0,166507,12000,154507,0,170930,5000,165930,0,171359,81000,90359
10838,210000,168000,0,0,0,0,0,0,0,39332,8242,31090,0,11140,12000,-860,-1,8463,8534,-71,-1,10406,11000,-594
10839,150000,120000,0,0,0,0,0,0,-1,9160,9160,0,-1,2939,2939,0,-1,3396,3396,0,-1,1870,1870,0
10840,360000,288000,0,0,0,0,0,0,-2,1071,1071,0,-2,15584,15604,-20,-2,3195,3195,0,-2,4261,4269,-8
10841,120000,96000,0,0,0,0,0,0,0,35222,2200,33022,0,72861,39000,33861,0,74429,2500,71929,0,60783,2400,58383
10842,30000,24000,0,0,0,0,0,0,-2,0,0,0,-2,0,0,0,-2,0,0,0,-2,0,0,0
10843,50000,40000,0,0,0,0,0,1,2,23815,3000,20815,0,26418,3000,23418,0,25859,0,25859,2,29745,4500,25245
10844,180000,144000,0,0,0,0,0,0,-1,243,243,0,-1,243,243,0,-1,4889,4889,0,-1,243,243,0
10845,190000,152000,0,0,0,0,1,0,0,151905,7408,144497,0,153538,5645,147893,0,156664,5753,150911,0,160361,6370,153991
10846,30000,24000,0,0,1,1,1,0,0,28870,28872,-2,0,29391,1500,27891,-2,29724,1000,28724,-2,30400,1078,29322
10847,200000,160000,0,0,0,0,0,0,-1,6682,6682,0,-1,16045,10000,6045,0,4679,4679,0,-1,280,280,0
10848,20000,16000,0,0,1,1,1,0,0,19067,10000,9067,0,18472,0,18472,3,18037,0,18037,2,18487,900,17587
10849,200000,160000,0,0,0,0,0,0,-2,-3,0,-3,-2,360,363,-3,-2,0,0,0,-2,0,0,0
10850,130000,104000,0,0,0,0,0,0,0,18912,1700,17212,0,19960,2000,17960,0,81985,63000,18985,0,80189,2885,77304
10851,360000,288000,0,0,0,0,0,0,-1,4073,5000,-927,-1,17812,15000,2812,0,2981,3000,-19,-1,1936,2000,-64
10852,180000,144000,0,0,0,0,0,0,-1,1459,3262,-1803,-1,2178,2178,0,-1,2634,2634,0,-1,968,968,0
10853,150000,120000,0,0,0,0,0,0,-1,1371,1371,0,-1,1200,0,1200,2,0,0,0,2,0,0,0
10854,60000,48000,0,0,0,0,0,0,-1,2301,0,2301,2,6220,6227,-7,-1,2227,0,2227,0,10416,10416,0
10855,70000,56000,0,0,0,0,0,0,-1,299,299,0,-1,829,829,0,-1,338,338,0,-1,865,865,0
10856,290000,232000,0,0,0,0,0,0,-2,566,566,0,-1,12008,12008,0,-1,19820,8012,11808,0,17135,343,16792
10857,250000,200000,0,0,0,0,0,0,0,152678,5600,147078,0,157337,7200,150137,0,159719,6500,153219,0,163649,6500,157149
10858,150000,120000,0,0,0,0,0,0,-1,9160,1000,8160,0,13596,13596,0,-1,11457,11457,0,-1,29550,18550,11000
10859,150000,120000,0,0,0,0,0,0,0,63156,2000,61156,2,57147,2000,55147,0,53383,2000,51383,0,48556,2000,46556
10860,300000,240000,0,0,0,0,0,0,0,94769,25000,69769,0,112777,50007,62770,0,100323,10000,90323,0,87009,20000,67009
10861,180000,144000,0,0,0,0,0,1,2,50186,2000,48186,2,51102,2000,49102,2,52178,2000,50178,2,53213,2000,51213
10862,180000,144000,0,0,0,0,0,1,-1,7141,7141,0,-1,1304,1304,0,-2,1534,1534,0,-2,2395,2395,0
10863,20000,16000,0,1,1,1,0,0,0,19489,1500,17989,0,20200,1200,19000,0,20000,0,20000,0,0,0,0
10864,10000,8000,0,0,1,1,1,0,0,10086,2465,7621,0,18714,500,18214,0,9781,1000,8781,0,9979,500,9479
10865,630000,504000,0,0,0,0,0,0,0,81317,4300,77017,0,146005,84700,61305,0,146207,4211,141996,0,106467,4470,101997
10866,500000,400000,0,0,0,0,0,1,0,335873,12021,323852,0,320755,11428,309327,0,316650,10871,305779,0,318228,11736,306492
10867,510000,408000,0,1,1,1,1,1,7,461402,0,461402,6,452405,0,452405,5,443657,0,443657,4,437305,0,437305
10868,200000,160000,0,0,0,0,0,0,0,88327,2700,85627,0,73717,4017,69700,0,56921,7921,49000,0,48160,10160,38000
10869,340000,272000,0,0,0,0,0,0,0,30874,5874,25000,0,34939,5000,29939,0,40537,10000,30537,0,41658,2000,39658
10870,350000,280000,0,0,0,0,0,0,0,232382,9503,222879,0,234254,9015,225239,0,211309,7511,203798,0,210897,8011,202886
10871,150000,120000,0,0,0,0,0,0,0,530,530,0,-1,530,0,530,2,1696,1166,530,2,1166,0,1166
10872,160000,128000,0,0,0,0,0,0,0,82182,4000,78182,0,82586,3500,79086,0,85145,4000,81145,0,87049,4000,83049
10873,120000,96000,0,1,1,1,1,1,0,123291,6100,117191,0,121242,4603,116639,0,121403,4774,116629,0,121863,9000,112863
10874,280000,224000,0,0,0,0,0,0,-1,0,0,0,-2,0,0,0,-2,0,0,0,-2,0,0,0
10875,30000,24000,1,1,1,1,0,0,2,31827,0,31827,2,32080,1200,30880,0,30890,0,30890,0,990,990,0
10876,50000,40000,0,0,0,0,0,0,0,19621,1642,17979,0,21748,2769,18979,0,21262,0,21262,2,21682,923,20759
10877,500000,400000,0,0,0,0,0,0,0,237006,20078,216928,0,139311,30141,109170,0,128095,30000,98095,0,181304,60000,121304
10878,170000,136000,0,0,0,0,0,0,0,80131,3000,77131,0,70788,2500,68288,0,68927,3000,65927,0,70678,2900,67778
10879,280000,224000,0,0,0,0,0,0,-1,570,570,0,-1,1068,1074,-6,-1,48313,48313,0,-1,10252,10252,0
10880,50000,40000,0,0,0,0,0,1,2,0,0,0,-2,71,71,0,-1,71,0,71,2,3871,3800,71
10881,210000,168000,0,0,0,0,0,0,-1,-2,0,-2,-1,-2,0,-2,-2,918,920,-2,-1,-164,0,-164
10882,150000,120000,0,0,0,0,0,0,0,59945,2761,57184,0,60751,2400,58351,0,62120,2500,59620,0,63315,2400,60915
10883,30000,24000,0,0,0,0,0,1,2,11970,0,11970,2,12981,1214,11767,0,14077,1310,12767,0,14367,660,13707
10884,190000,152000,0,0,0,0,0,0,0,35042,1910,33132,0,35699,1558,34141,0,36410,1269,35141,0,38067,2209,35858
10885,30000,24000,0,0,0,0,0,1,-2,0,0,0,-2,0,0,0,-2,0,0,0,-2,0,0,0
10886,220000,176000,0,0,0,0,0,0,0,1744,2178,-434,-1,55164,55200,-36,-1,49967,50148,-181,-1,7839,10107,-2268
10887,30000,24000,0,0,0,0,0,0,-1,1429,1437,-8,-1,2652,2853,-201,-1,12235,12247,-12,-1,8184,119,8065
10888,100000,80000,0,0,0,0,0,0,0,11372,1303,10069,0,12092,1023,11069,0,12429,360,12069,0,22315,10000,12315
10889,230000,184000,0,0,0,0,0,0,0,127369,10000,117369,0,108702,4000,104702,0,77703,3000,74703,0,79123,5000,74123
10890,360000,288000,0,0,0,0,0,0,0,136109,5365,130744,0,114908,4664,110244,0,111274,3890,107384,0,110141,3899,106242
10891,50000,40000,0,0,0,0,0,1,0,18890,2664,16226,0,30288,31057,-769,-1,30003,1064,28939,0,29763,1073,28690
10892,90000,72000,0,1,1,1,1,0,0,88924,3962,84962,0,88735,2909,85826,0,87521,3107,84414,0,85699,3127,82572
10893,500000,400000,0,0,0,0,0,0,0,84613,5016,79597,0,89944,10055,79889,0,80339,2513,77826,0,77214,3009,74205
10894,300000,240000,0,0,0,0,0,0,-2,0,0,0,-2,0,0,0,-2,0,0,0,-2,0,0,0
10895,50000,40000,0,0,0,0,1,0,0,39671,2000,37671,0,40213,1500,38713,0,41064,1500,39564,0,43382,3000,40382
10896,80000,64000,0,0,0,0,0,0,0,0,0,0,0,0,0,0,-2,0,0,0,-2,0,0,0
10897,190000,152000,0,0,0,0,0,0,0,52394,5000,47394,0,55521,5000,50521,0,113760,60000,53760,0,116299,5000,111299
10898,50000,40000,0,0,0,0,0,1,2,10061,1500,8561,2,9751,0,9751,2,11585,2000,9585,2,11250,0,11250
10899,140000,112000,0,0,0,0,0,0,0,43923,2278,41645,0,43051,3000,40051,2,44109,1892,42217,2,43253,0,43253
10900,240000,192000,0,1,0,0,1,0,0,208870,8403,200467,0,107964,4978,102986,0,227939,220000,7939,0,232618,8638,223980
10901,360000,288000,0,0,0,0,0,0,0,16659,6688,9971,0,25302,16251,9051,0,15147,394,14753,0,5281,5307,-26
10902,20000,16000,0,0,0,0,0,1,0,14029,1233,12796,0,14308,512,13796,0,14625,547,14078,0,18245,3880,14365
10903,200000,160000,0,1,1,1,1,0,0,188169,6839,181330,0,191549,6518,185031,0,195163,6356,188807,0,194101,6441,187660
10904,150000,120000,0,1,0,0,0,0,0,130107,5000,125107,0,78623,2000,76623,0,79743,7000,72743,0,78745,15000,63745
10905,100000,80000,0,0,0,0,0,0,2,33350,1700,31650,2,34003,1500,32503,2,34647,1500,33147,2,35348,1400,33948
10906,50000,40000,0,0,0,0,0,0,0,3355,1186,2169,0,3253,500,2753,0,3640,1000,2640,0,3512,500,3012
10907,500000,400000,0,0,0,0,0,0,2,230713,0,230713,2,235401,10018,225383,0,238828,8845,229983,0,243477,8800,234677
10908,20000,16000,0,0,1,1,1,0,0,26373,26373,0,-1,26644,1000,25644,2,26079,0,26079,2,27941,2300,25641
10909,210000,168000,0,0,0,0,0,0,0,11057,12000,-943,-1,26520,27000,-480,-1,27894,30000,-2106,-1,18772,10000,8772
10910,140000,112000,0,0,0,0,0,0,0,19385,1600,17785,0,19244,800,18444,0,17185,1753,15432,0,36377,20000,16377
10911,30000,24000,0,1,1,1,1,1,0,28836,1600,27236,0,28812,576,28236,0,29400,588,28812,0,30000,600,29400
10912,140000,112000,0,0,0,0,0,0,0,39577,2211,37366,0,39465,1459,38006,0,45180,6398,38782,0,44213,1729,42484
10913,110000,88000,0,0,0,0,0,1,2,41744,1750,39994,0,42783,1750,41033,0,47476,5400,42076,0,45355,700,44655
10914,150000,120000,0,0,0,0,0,0,0,92810,3137,89673,0,74078,2700,71378,0,75564,3000,72564,0,79941,6000,73941
10915,240000,192000,0,0,0,0,0,0,-1,0,0,0,-1,2417,2417,0,-1,0,0,0,-1,0,0,0
10916,350000,280000,0,0,0,0,0,0,-2,5875,5875,0,-2,4020,4020,0,-2,33127,33127,0,-2,6877,6877,0
10917,150000,120000,0,0,0,0,0,0,-1,797,799,-2,-1,-3,0,-3,-1,-3,0,-3,-2,-3,0,-3
10918,240000,192000,0,0,0,0,0,0,2,2105,1057,1048,0,2487,1000,1487,0,777,0,777,0,5300,5300,0
10919,20000,16000,0,1,1,1,1,1,0,20844,3000,17844,0,19362,0,19362,2,19402,850,18552,0,19607,920,18687
10920,280000,224000,0,0,0,0,0,0,-1,32800,0,32800,2,131200,131200,0,-1,3950,3950,0,-1,0,0,0
10921,140000,112000,0,0,0,0,0,0,-1,6410,6736,-326,-1,4246,4246,0,-1,326,326,0,-1,326,326,0
10922,30000,24000,0,1,1,1,1,0,0,28935,2273,26662,2,28934,780,28154,2,30313,2635,27678,2,30330,1033,29297
10923,140000,112000,0,0,0,0,0,1,2,75724,3000,72724,2,73909,0,73909,2,78305,5763,72542,2,76888,0,76888
10924,120000,96000,0,0,0,0,0,0,-1,65015,3000,62015,0,66571,4000,62571,0,67632,4000,63632,0,57798,4000,53798
10925,200000,160000,0,1,1,0,0,1,0,196933,0,196933,2,187887,6451,181436,0,101278,9000,92278,0,99382,0,99382
10926,70000,56000,0,0,0,0,0,1,2,14866,0,14866,2,15611,1300,14311,0,16753,1400,15353,0,16343,0,16343
10927,20000,16000,0,0,0,0,0,0,2,15064,1157,13907,0,13605,574,13031,0,11844,423,11421,0,10152,374,9778
10928,160000,128000,0,0,0,0,0,0,0,84216,4000,80216,0,86812,4000,82812,0,87679,3200,84479,0,90264,4000,86264
10929,350000,280000,0,1,1,1,1,0,0,342288,12678,329610,0,336750,13601,323149,0,341376,12136,329240,0,348730,12771,335959
10930,500000,400000,0,0,1,0,0,0,0,486367,271636,214731,0,616836,30876,585960,0,250600,60044,190556,0,296217,50539,245678
10931,120000,96000,0,0,0,0,0,1,-1,0,0,0,-1,0,0,0,-2,0,0,0,-2,672,672,0
10932,220000,176000,0,0,0,0,0,0,-1,1969,2099,-130,-1,389,390,-1,-1,389,390,-1,-1,389,390,-1
10933,230000,184000,0,0,0,0,0,0,-1,49159,3002,46157,0,43668,1388,42280,0,42352,1511,40841,0,43099,5000,38099
10934,50000,40000,0,1,0,0,0,0,0,50630,1726,48904,0,30192,1013,29179,0,30297,1061,29236,0,28541,1135,27406
10935,330000,264000,0,0,0,0,0,1,-1,2996,0,2996,2,207,209,-2,2,-3,3,-6,-2,500,503,-3
10936,360000,288000,0,0,0,0,0,1,3,499,0,499,2,13136,13169,-33,-1,9160,2784,6376,-1,2752,12,2740
10937,360000,288000,0,0,0,0,0,0,0,493,493,0,-1,0,0,0,-1,2030,2030,0,-1,2112,2112,0
10938,150000,120000,0,0,0,0,0,0,-1,6569,6588,-19,-1,24604,24677,-73,-1,4878,4896,-18,-1,1477,1477,0
10939,300000,240000,0,0,0,0,0,1,-1,0,0,0,-2,411,411,0,-1,261,0,261,2,8561,8300,261
10940,130000,104000,0,0,0,0,0,1,-1,59892,59892,0,-1,60000,1200,58800,0,0,0,0,0,0,0,0
10941,20000,16000,0,1,1,1,1,1,0,18289,1304,16985,0,18653,668,17985,0,19195,843,18352,0,19580,853,18727
10942,220000,176000,0,0,0,0,0,0,-1,942,1006,-64,-1,5378,6031,-653,-1,126,1003,-877,-1,3419,4003,-584
10943,290000,232000,0,0,0,0,0,0,0,46484,1800,44684,0,36232,1400,34832,0,32149,1000,31149,0,24004,1000,23004
10944,110000,88000,0,0,0,0,0,0,0,19742,3500,16242,0,23886,5500,18386,0,29949,10000,19949,0,34969,6000,28969
10945,50000,40000,0,0,0,0,0,1,2,2400,0,2400,2,2400,0,2400,7,2400,0,2400,7,2400,0,2400
10946,80000,64000,0,1,1,0,0,0,0,76280,4009,72271,0,71790,3006,68784,0,49835,1879,47956,0,48880,2000,46880
10947,50000,40000,0,0,0,0,0,0,-2,-5,0,-5,-2,2809,2814,-5,-2,0,0,0,-2,0,0,0
10948,90000,72000,0,1,1,0,0,1,0,89242,2,89240,2,82784,5085,77699,0,53609,5000,48609,0,49048,3000,46048
10949,110000,88000,0,1,1,1,1,0,0,107420,5540,101880,0,107325,5361,101964,0,108545,4500,104045,0,105341,4000,101341
10950,500000,400000,0,0,0,0,0,0,-1,22376,22398,-22,-1,39018,39041,-23,-1,4233,4233,0,-1,397,397,0
10951,50000,40000,0,0,0,0,0,0,0,27741,1760,25981,0,27982,1001,26981,0,28589,1057,27532,0,29157,1063,28094
10952,50000,40000,0,0,0,0,0,0,0,2207,1000,1207,0,0,0,0,0,0,0,0,-2,0,0,0
10953,140000,112000,0,1,1,0,0,0,0,133763,6600,127163,0,133195,4225,128970,0,101298,3800,97498,0,101601,3816,97785
10954,70000,56000,0,0,0,0,0,0,2,35089,3500,31589,2,34225,0,34225,2,36663,3000,33663,2,35921,0,35921
10955,500000,400000,0,0,0,0,0,0,0,321094,11684,309410,0,317546,15000,302546,0,279250,8995,270255,0,239172,9457,229715
10956,20000,16000,0,0,0,0,0,1,2,8114,900,7214,2,7835,0,7835,2,8605,900,7705,0,10948,2500,8448
10957,170000,136000,0,0,0,0,0,1,2,18104,0,18104,2,19050,1060,17990,2,18783,0,18783,2,8042,807,7235
10958,180000,144000,0,0,0,0,0,0,-1,2526,1074,1452,0,3452,1000,2452,0,3522,70,3452,0,4909,1387,3522
10959,120000,96000,0,0,0,0,0,0,-2,0,0,0,-2,0,0,0,-2,0,0,0,-2,0,0,0
10960,30000,24000,0,0,0,0,0,0,-1,390,390,0,-1,1389,1389,0,-1,3684,3684,0,-1,2744,0,2744
10961,450000,360000,0,0,0,0,0,0,-1,419,419,0,-1,0,0,0,-1,0,0,0,-2,0,0,0
10962,80000,64000,0,0,0,0,0,1,0,54909,2000,52909,0,56035,2039,53996,0,57598,2500,55098,0,59164,2500,56664
10963,30000,24000,0,0,0,0,0,0,0,1754,1757,-3,-1,666,2,664,0,1339,1443,-104,-1,1748,1949,-201
10964,140000,112000,0,1,1,1,1,0,0,140700,5000,135700,0,137365,5000,132365,0,137209,5120,132089,0,138934,5200,133734
10965,390000,312000,0,0,0,0,0,0,0,7391,1036,6355,0,948,952,-4,-1,4592,4601,-9,-1,2777,13,2764
10966,110000,88000,0,0,0,0,0,1,0,1320,1000,320,0,1270,100,1170,0,63697,63697,0,-1,51866,2427,49439
10967,350000,280000,0,0,0,0,0,1,-2,693,0,693,-2,1144,1144,0,-2,-4618,4279,-8897,-2,-8026,0,-8026
10968,160000,128000,0,0,0,0,0,1,-1,12829,12014,815,0,10801,8000,2801,0,10351,5000,5351,0,3366,0,3366
10969,20000,16000,0,1,1,1,0,0,0,19703,1400,18303,0,19697,394,19303,0,17303,346,16957,0,1554,31,1523
10970,200000,160000,0,0,0,0,0,0,-2,2358,2358,0,-2,2477,2477,0,-2,958,958,0,-2,11312,11312,0
10971,190000,152000,0,0,0,0,0,0,0,99789,4000,95789,0,102131,4000,98131,0,104491,4000,100491,0,106755,4000,102755
10972,100000,80000,0,0,0,0,0,1,0,32099,1733,30366,0,18811,1000,17811,0,9960,1149,8811,0,10000,10000,0
10973,150000,120000,0,0,0,0,0,0,-2,0,0,0,-2,3564,3564,0,-2,0,0,0,-2,0,0,0
10974,170000,136000,0,0,0,0,0,1,-2,30000,30000,0,-2,0,0,0,-2,0,0,0,-2,1532,1532,0
10975,300000,240000,0,0,0,0,0,1,-1,3408,1914,1494,0,1908,0,1908,0,1108,1108,0,-1,530,530,0
10976,230000,184000,0,0,0,0,0,0,-2,0,0,0,-2,0,0,0,-2,0,0,0,-2,0,0,0
10977,230000,184000,0,0,0,0,0,0,0,142435,6500,135935,0,136502,6020,130482,0,122572,4056,118516,0,110839,4000,106839
10978,290000,232000,0,1,1,0,0,0,0,278924,20326,258598,0,235368,44,235324,2,232117,10035,222082,0,230763,10034,220729
10979,30000,24000,0,0,0,0,0,1,2,19590,0,19590,2,21261,2000,19261,2,20783,0,20783,2,22081,1800,20281
10980,220000,176000,0,0,0,0,0,0,0,152765,7000,145765,0,152953,6500,146453,0,156065,5573,150492,0,145846,7000,138846
10981,50000,40000,0,0,0,0,0,1,0,38347,1362,36985,0,32496,1002,31494,0,23477,840,22637,0,24094,995,23099
10982,150000,120000,0,0,0,0,0,0,0,74485,3200,71285,0,71935,2700,69235,0,71757,2711,69046,0,71844,2800,69044
10983,290000,232000,0,0,0,0,0,0,0,10409,10460,-51,-1,118253,118299,-46,-1,111765,2794,108971,0,13294,13358,-64
10984,200000,160000,0,0,0,0,0,0,0,150977,6007,144970,0,140358,5000,135358,0,130373,5000,125373,0,131885,5000,126885
10985,200000,160000,0,0,0,1,1,0,0,158279,5000,153279,0,161934,5000,156934,0,165447,5000,160447,0,168802,4917,163885
10986,350000,280000,0,0,0,0,0,0,0,197689,20023,177666,0,207984,20014,187970,0,183208,20000,163208,0,190436,20000,170436
10987,60000,48000,0,1,1,0,0,1,0,60841,2600,58241,0,58902,2107,56795,0,19352,1000,18352,0,19523,1000,18523
10988,180000,144000,0,0,0,0,0,0,-2,0,0,0,-2,300,300,0,-1,300,0,300,3,150,0,150
10989,50000,40000,0,1,0,0,0,0,0,50262,1726,48536,0,20304,710,19594,0,20319,724,19595,0,20330,733,19597
10990,350000,280000,0,0,0,0,0,0,-2,2424,2424,0,-2,4582,4584,-2,-2,5600,5610,-10,-2,2927,2927,0
10991,250000,200000,0,0,0,0,0,0,-1,23850,23938,-88,-1,8220,8220,0,-1,0,0,0,-1,8420,8420,0
10992,30000,24000,0,0,0,1,1,1,0,22142,2000,20142,0,25438,4000,21438,0,28453,3600,24853,0,27699,0,27699
10993,100000,80000,0,0,0,0,0,0,-1,40000,21000,19000,0,1133,1133,0,-1,22579,22579,0,-1,2834,2834,0
10994,130000,104000,0,0,0,0,0,0,-2,6244,6244,0,-1,11108,5000,6108,0,11428,500,10928,0,12233,1000,11233
10995,200000,160000,0,0,0,0,0,0,-1,0,0,0,-2,0,0,0,-2,0,0,0,-2,0,0,0
10996,500000,400000,0,0,0,0,0,0,0,262467,10851,251616,0,254307,9005,245302,0,249106,9074,240032,0,242741,8501,234240
10997,20000,16000,0,1,1,1,1,0,0,20298,1326,18972,0,19269,1287,17982,0,19254,662,18592,0,19484,903,18581
10998,200000,160000,0,0,0,0,0,1,0,20926,5000,15926,0,20260,0,20260,2,24754,5000,19754,0,29383,5054,24329
10999,400000,320000,0,0,0,0,0,0,0,111150,5646,105504,0,112444,5000,107444,0,97523,3000,94523,0,84858,5000,79858
11000,80000,64000,0,0,0,0,0,0,-1,4700,4700,0,-1,2350,0,2350,0,2350,2350,0,-1,2350,2350,0
11001,120000,96000,0,0,0,0,0,0,2,1250,0,1250,2,1250,0,1250,5,1250,0,1250,5,650,0,650
11002,140000,112000,0,0,0,0,0,1,-2,1650,1650,0,-2,0,0,0,-2,2226,2226,0,-2,0,0,0
11003,150000,120000,0,0,0,0,0,0,0,1187,1187,0,-1,1182,0,1182,4,882,0,882,3,441,0,441
11004,150000,120000,0,0,0,0,0,1,3,51169,0,51169,2,53979,4000,49979,2,52639,0,52639,2,58508,7127,51381
11005,70000,56000,0,0,0,0,0,0,2,5954,5954,0,-1,1069,0,1069,0,4711,4514,197,0,4514,0,4514
11006,20000,16000,0,0,0,0,0,0,0,14137,1500,12637,0,13737,0,13737,0,12680,0,12680,0,12067,1067,11000
11007,140000,112000,0,0,0,0,0,1,2,46468,1775,44693,2,45422,0,45422,2,46371,1833,44538,0,47297,1850,45447
11008,50000,40000,0,0,0,0,0,0,0,3750,1000,2750,0,0,0,0,0,0,0,0,-2,0,0,0
11009,350000,280000,0,0,0,0,0,1,-2,563,569,-6,-2,7535,7572,-37,-2,0,0,0,-2,1522,1522,0
11010,200000,160000,0,0,0,0,0,0,0,157356,7470,149886,0,123271,4460,118811,0,123831,4583,119248,0,124070,4376,119694
11011,30000,24000,0,1,1,1,1,1,0,27512,2000,25512,0,27831,1240,26591,0,28795,1200,27595,0,29285,1100,28185
11012,50000,40000,0,1,1,0,0,1,0,50056,2313,47743,0,49735,2082,47653,0,14240,677,13563,0,890,890,0
11013,100000,80000,0,0,0,0,0,0,-1,10487,1000,9487,0,780,780,0,-1,0,0,0,-1,0,0,0
11014,90000,72000,0,1,0,0,0,1,0,92400,4500,87900,0,0,0,0,0,0,0,0,-2,0,0,0
11015,210000,168000,0,0,0,0,0,0,0,48957,2109,46848,0,49848,2000,47848,0,59060,10000,49060,0,60420,6032,54388
11016,90000,72000,1,1,0,0,0,1,2,91211,0,91211,2,38041,1170,36871,0,42605,5000,37605,0,41396,18000,23396
11017,30000,24000,0,0,0,0,0,0,0,13817,1500,12317,0,14983,1400,13583,0,15525,1000,14525,0,0,0,0
11018,60000,48000,0,0,0,0,0,0,0,218,218,0,-1,12716,12723,-7,-1,10686,483,10203,0,10400,600,9800
11019,120000,96000,0,0,0,0,0,0,0,47195,3200,43995,0,12432,37432,-25000,-1,13226,1000,12226,0,14258,1258,13000
11020,310000,248000,0,0,0,0,0,0,0,9022,0,9022,2,-422,0,-422,2,6214,6900,-686,-1,2360,0,2360
11021,300000,240000,0,0,0,0,0,0,-2,334,334,0,-2,780,780,0,-2,2590,2590,0,-2,1490,1490,0
11022,60000,48000,0,0,0,0,0,0,0,29757,1630,28127,0,30122,3000,27122,0,30498,2000,28498,0,28647,2000,26647
11023,390000,312000,0,0,0,0,0,1,0,244361,9110,235251,0,243287,10000,233287,0,247613,9200,238413,0,246330,9000,237330
11024,50000,40000,0,0,0,0,0,0,0,31036,2224,28812,0,20061,19691,370,0,19710,1000,18710,0,19687,725,18962
11025,270000,216000,0,0,0,0,0,0,-1,5794,329,5465,2,19857,20218,-361,-1,3681,3699,-18,-1,3188,3204,-16
11026,220000,176000,0,0,0,0,0,0,-1,7069,1229,5840,0,43957,43957,0,-1,30693,614,30079,0,13264,13264,0
11027,20000,16000,0,0,0,1,0,1,0,16327,1500,14827,0,17970,2000,15970,0,18819,1000,17819,0,16642,1000,15642
11028,400000,320000,0,0,0,0,0,0,0,171087,32000,139087,0,172732,18000,154732,0,156830,5000,151830,0,139816,4000,135816
11029,220000,176000,0,0,0,0,0,0,0,105226,3820,101406,0,107476,4000,103476,0,109746,4000,105746,0,111920,4000,107920
11030,150000,120000,0,0,0,0,0,0,-1,10252,10253,-1,-1,20618,11000,9618,-1,10457,11500,-1043,-1,9624,10000,-376
11031,20000,16000,0,1,1,1,1,0,2,18317,1300,17017,0,19525,1500,18025,0,19084,0,19084,2,19601,1600,18001
11032,70000,56000,0,0,0,0,0,0,0,8638,2000,6638,0,1230,1230,0,-1,390,390,0,-1,890,890,0
11033,40000,32000,0,0,0,0,0,1,2,326,326,0,-1,26370,26370,0,-1,24572,886,23686,0,24918,1075,23843
11034,290000,232000,0,0,0,0,0,0,0,67146,10000,57146,0,68063,5005,63058,0,63910,8000,55910,0,73553,15000,58553
11035,230000,184000,0,0,0,0,0,0,0,0,0,0,-2,0,0,0,-2,0,0,0,-2,0,0,0
11036,100000,80000,0,1,1,1,1,0,0,100657,4507,96150,0,101565,3936,97629,0,101116,3982,97134,0,101764,4135,97629
11037,80000,64000,0,0,0,0,0,0,0,2312,2000,312,0,1156,0,1156,0,1156,1156,0,-1,1469,1469,0
11038,340000,272000,0,1,0,1,1,0,0,325675,15000,310675,0,285417,15000,270417,0,284834,12000,272834,0,284549,12500,272049
11039,180000,144000,0,0,0,0,0,0,-1,0,0,0,-1,0,0,0,-2,0,0,0,-2,0,0,0
11040,500000,400000,0,0,0,0,0,0,-2,0,0,0,-2,0,0,0,-2,0,0,0,-2,0,0,0
11041,70000,56000,0,1,1,0,0,0,2,72596,3300,69296,2,70467,0,70467,2,48129,2000,46129,0,47751,2000,45751
11042,20000,16000,0,1,1,1,1,0,0,18655,2200,16455,0,17687,0,17687,2,18023,1000,17023,0,18169,1000,17169
11043,230000,184000,0,0,0,0,0,0,0,31226,0,31226,2,15568,5000,10568,0,10000,10000,0,-1,0,0,0
11044,70000,56000,0,0,0,0,0,1,3,30658,600,30058,2,31850,2000,29850,2,31207,0,31207,2,32037,1500,30537
11045,420000,336000,0,0,0,0,0,0,0,17709,1608,16101,0,18801,1700,17101,0,20328,2500,17828,0,25065,5065,20000
11046,30000,24000,0,1,0,1,0,1,2,24031,0,24031,2,25001,1600,23401,2,24531,0,24531,2,21743,2000,19743
11047,50000,40000,0,1,1,1,0,0,0,48456,2016,46440,0,44546,2009,42537,0,43256,2092,41164,0,13342,1020,12322
11048,80000,64000,0,0,0,0,0,1,2,8498,0,8498,2,9155,800,8355,2,8864,0,8864,2,9215,500,8715
11049,50000,40000,0,1,0,0,0,1,0,50934,2343,48591,0,7728,1137,6591,0,8390,799,7591,0,48679,41933,6746
11050,20000,16000,0,0,0,0,0,1,0,9519,1500,8019,0,10469,1415,9054,0,14272,4000,10272,0,15033,1000,14033
11051,300000,240000,0,0,0,0,0,0,-2,20477,20477,0,-2,27206,27206,0,-1,37191,177202,-140011,-1,7543,7543,0
11052,200000,160000,0,0,0,0,0,0,0,85698,5114,80584,0,64423,1613,62810,0,49432,1402,48030,0,34814,3055,31759
11053,150000,120000,0,0,0,0,0,1,-2,0,0,0,-2,0,0,0,-2,0,0,0,-2,0,0,0
11054,430000,344000,0,0,0,0,0,0,0,34499,5000,29499,0,28300,10000,18300,0,24237,0,24237,2,12860,4000,8860
11055,280000,224000,0,0,0,0,0,0,-1,25351,25362,-11,-1,17900,18684,-784,-1,3529,3529,0,-1,892,892,0
11056,120000,96000,0,0,0,0,0,0,-2,0,0,0,-2,0,0,0,-2,0,0,0,-2,0,0,0
11057,80000,64000,0,0,0,0,0,1,0,8818,3347,5471,0,8471,0,8471,2,8644,173,8471,0,8820,176,8644
11058,30000,24000,0,0,1,1,1,0,0,25023,1755,23268,0,25768,1500,24268,0,26410,1000,25410,0,27960,1909,26051
11059,360000,288000,0,0,0,0,0,0,0,7968,8007,-39,-1,1816,1825,-9,-1,5549,5563,-14,-1,1234,1240,-6
11060,70000,56000,0,0,0,0,0,0,0,39493,1700,37793,0,39879,1408,38471,0,40314,1448,38866,0,40725,1456,39269
11061,20000,16000,0,0,0,0,0,0,0,8279,0,8279,2,8444,284,8160,0,8621,294,8327,0,8868,371,8497
11062,210000,168000,0,0,0,0,0,0,-2,980,980,0,-2,0,0,0,-2,0,0,0,-2,0,0,0
11063,110000,88000,0,0,0,0,0,0,-1,63032,63032,0,-1,33228,1100,32128,0,31073,1100,29973,0,25035,1000,24035
11064,230000,184000,0,0,0,0,0,0,0,191795,191795,0,-1,192255,10000,182255,0,187755,8000,179755,0,187740,8000,179740
11065,500000,400000,0,0,0,0,0,0,-1,14557,14576,-19,-1,53328,53850,-522,-1,58052,58332,-280,-1,37435,37616,-181
11066,370000,296000,0,0,0,0,0,0,0,114073,6367,107706,0,57660,5100,52560,0,23093,2000,21093,0,18436,3000,15436
11067,80000,64000,0,0,0,0,0,1,0,73855,10000,63855,0,41003,7003,34000,0,29690,4700,24990,0,27596,3600,23996
11068,130000,104000,0,0,0,0,0,0,-2,70042,70505,-463,-2,20739,20749,-10,-2,7469,7469,0,-2,5963,5997,-34
11069,90000,72000,0,1,1,1,1,0,0,92412,4331,88081,0,91297,3218,88079,0,91790,3613,88177,0,91377,3300,88077
11070,30000,24000,0,1,1,1,0,0,0,29200,1500,27700,0,29400,600,28800,0,50000,600,49400,0,0,0,0
11071,360000,288000,0,0,0,0,0,1,0,23707,1800,21907,0,24145,1000,23145,0,24068,1649,22419,0,24350,1003,23347
11072,30000,24000,0,1,1,1,1,0,0,30411,2517,27894,0,28805,4006,24799,0,26895,2000,24895,0,27162,1000,26162
11073,180000,144000,0,0,0,0,0,0,-2,0,0,0,-2,0,0,0,-2,0,0,0,-2,0,0,0
11074,140000,112000,0,1,1,1,1,0,0,126749,6100,120649,0,127244,4518,122726,0,129495,4694,124801,0,126663,4745,121918
11075,60000,48000,0,1,1,1,1,0,0,55079,2100,52979,0,55525,2000,53525,0,56634,2000,54634,0,57052,2100,54952
11076,150000,120000,0,0,0,0,0,0,-2,5306,5306,0,-2,8240,8240,0,-2,1686,1686,0,-2,149,149,0
11077,240000,192000,0,0,0,0,0,0,-1,464,464,0,-1,1316,1316,0,-2,1102,1104,-2,-1,3381,3384,-3
11078,80000,64000,0,0,0,0,0,1,0,31456,9200,22256,0,40111,9200,30911,0,48633,9200,39433,0,56740,9200,47540
11079,370000,296000,0,1,1,1,0,1,0,340152,12004,328148,0,345904,12362,333542,0,322168,12006,310162,0,272461,9555,262906
11080,50000,40000,0,0,0,0,0,0,0,26669,5000,21669,0,29876,4800,25076,0,29257,1002,28255,0,28071,2000,26071
11081,200000,160000,0,0,0,0,0,0,-2,2317,2317,0,-1,7588,7588,0,-1,7606,7614,-8,-1,14053,14053,0
11082,170000,136000,0,0,0,0,0,0,-1,5447,3000,2447,0,416,5,411,0,7509,7509,0,-1,6387,6387,0
11083,230000,184000,0,0,0,0,0,0,-1,858,858,0,-1,5505,5505,0,-1,2263,2263,0,-1,10352,10352,0
11084,250000,200000,0,0,0,0,0,0,0,132714,5000,127714,0,135829,5000,130829,0,138959,5000,133959,0,140779,3779,137000
11085,200000,160000,0,0,0,0,0,0,-1,0,0,0,-2,0,0,0,-2,0,0,0,-2,0,0,0
11086,50000,40000,0,0,0,0,0,1,2,116,116,0,-1,116,0,116,3,9982,10040,-58,2,8143,400,7743
11087,30000,24000,0,1,1,1,1,0,0,30451,1600,28851,0,29391,1500,27891,0,30042,1095,28947,0,28436,1500,26936
11088,50000,40000,0,0,0,0,0,0,-1,725,730,-5,-1,21423,21423,0,-1,6308,6308,0,-1,12651,12651,0
11089,50000,40000,0,0,0,0,0,0,0,5639,1250,4389,0,6389,1000,5389,0,7130,1000,6130,0,7857,1000,6857
11090,210000,168000,0,0,0,0,0,1,0,96993,10000,86993,0,94537,0,94537,2,97968,5000,92968,0,100387,4000,96387
11091,340000,272000,0,0,0,0,0,0,0,252180,9780,242400,0,250359,9425,240934,0,203580,7500,196080,0,192415,6800,185615
11092,30000,24000,0,0,0,0,0,1,0,22492,2100,20392,0,22819,1000,21819,2,24441,2000,22441,2,23910,0,23910
11093,130000,104000,0,0,0,0,0,1,2,7898,3000,4898,2,7021,0,7021,2,46431,40200,6231,2,45891,0,45891
11094,210000,168000,0,0,0,0,0,0,-1,2684,2684,0,-1,0,0,0,-1,10652,10652,0,-1,326,326,0
11095,370000,296000,0,0,0,0,0,1,-1,1259,1263,-4,-1,3661,3665,-4,-1,4484,4488,-4,-1,24233,24262,-29
11096,260000,208000,0,0,0,0,0,0,0,59635,5000,54635,0,63624,5000,58624,0,67563,5000,62563,0,69812,5000,64812
11097,140000,112000,0,0,0,0,0,0,0,73318,3336,69982,0,70523,2372,68151,0,55318,1453,53865,0,50236,1536,48700
11098,60000,48000,0,0,0,0,0,0,0,390,10390,-10000,-1,390,390,0,-1,780,780,0,-1,390,0,390
11099,300000,240000,0,0,0,0,0,0,0,68856,2496,66360,0,69392,1678,67714,0,70798,1702,69096,0,72252,1746,70506
11100,150000,120000,0,0,0,0,0,0,-1,0,0,0,-1,0,0,0,-2,0,0,0,-2,16877,16877,0
11101,310000,248000,0,0,0,0,0,0,0,7426,1200,6226,0,6092,1100,4992,0,5074,1000,4074,0,3865,300,3565
11102,30000,24000,0,1,1,1,0,0,0,29367,5000,24367,0,28108,0,28108,2,26717,1003,25714,0,11693,1000,10693
11103,500000,400000,0,0,0,0,0,0,0,170201,10051,160150,0,162212,6119,156093,0,145184,7303,137881,0,118467,15090,103377
11104,210000,168000,0,0,0,0,0,0,-1,16114,16114,0,-1,3353,3353,0,-2,10775,10775,0,-2,2938,3000,-62
11105,220000,176000,0,0,0,0,0,1,2,149839,38024,111815,0,142404,8105,134299,0,120918,10117,110801,0,87005,37,86968
11106,50000,40000,0,0,0,0,0,1,-2,0,0,0,-2,0,0,0,-2,0,0,0,-2,0,0,0
11107,70000,56000,0,1,1,1,1,0,0,69534,3166,66368,0,67399,2609,64790,0,66963,2574,64389,0,66797,3000,63797
11108,30000,24000,0,0,0,0,0,0,0,9646,1100,8546,0,9995,419,9576,0,10371,600,9771,0,5139,500,4639
11109,20000,16000,0,0,0,0,0,0,-1,4098,4098,0,-1,14899,14899,0,-1,10170,10170,0,-1,7151,427,6724
11110,260000,208000,0,0,0,0,0,0,-1,326,326,0,-1,326,326,0,-1,326,326,0,-1,326,326,0
11111,180000,144000,0,0,0,0,0,0,-1,-820,3,-823,-1,-1140,0,-1140,-2,0,2000,-2000,-2,0,0,0
11112,20000,16000,0,1,1,0,0,0,2,19327,1500,17827,0,20000,1000,19000,0,0,0,0,0,0,0,0
11113,70000,56000,0,0,0,0,0,1,0,18903,2332,16571,0,18443,0,18443,2,10139,365,9774,0,10141,364,9777
11114,270000,216000,0,0,0,0,0,0,0,18533,2000,16533,0,8855,2000,6855,0,3140,1000,2140,0,5140,2000,3140
11115,30000,24000,0,0,0,0,0,0,2,9258,0,9258,2,11096,2000,9096,2,11165,392,10773,2,10837,0,10837
11116,50000,40000,0,0,0,0,0,0,-2,0,0,0,-2,0,0,0,-2,0,0,0,-2,0,0,0
11117,440000,352000,0,0,0,0,0,0,-2,278956,279048,-92,-1,274859,10758,264101,0,99618,5000,94618,0,103884,5080,98804
11118,50000,40000,0,0,0,0,0,0,0,8763,0,8763,2,9924,1313,8611,0,9967,356,9611,0,10176,369,9807
11119,80000,64000,0,1,1,1,1,0,0,71912,3500,68412,0,69776,3000,66776,0,70985,2500,68485,0,72444,2500,69944
11120,50000,40000,0,1,0,0,0,0,0,48592,2832,45760,0,-22108,39,-22147,0,45709,91983,-46274,-1,39188,1570,37618
11121,90000,72000,0,0,0,0,0,0,0,0,0,0,0,3708,3708,0,-1,3503,0,3503,2,9097,5693,3404
11122,20000,16000,0,0,0,0,0,1,-1,5677,4078,1599,0,688,1237,-549,-1,1688,1000,688,0,61,61,0
11123,390000,312000,0,0,0,0,0,0,0,43996,20000,23996,0,47532,5006,42526,0,49414,5006,44408,0,51380,5008,46372
11124,50000,40000,0,0,0,0,0,1,0,21076,1371,19705,0,20578,2000,18578,0,19046,2000,17046,0,18998,1000,17998
11125,50000,40000,0,1,1,0,1,0,2,51135,2500,48635,0,48371,2271,46100,0,56294,50000,6294,0,61259,10100,51159
11126,180000,144000,0,0,0,0,0,0,0,51753,2000,49753,0,53619,3000,50619,0,53881,2000,51881,0,54760,2000,52760
11127,120000,96000,0,0,0,0,0,0,2,15611,15611,0,-1,7628,3000,4628,-1,7361,0,7361,2,9200,2000,7200
11128,150000,120000,0,0,0,0,0,0,0,31578,2000,29578,0,26089,2000,24089,0,16624,5000,11624,0,5107,6000,-893
11129,170000,136000,0,0,0,0,0,0,0,24644,5000,19644,0,25739,5000,20739,0,30372,5000,25372,0,34924,5000,29924
11130,120000,96000,0,0,0,0,0,0,-1,1077,1077,0,-1,902,902,0,-1,1077,1077,0,-1,1271,1271,0
11131,390000,312000,0,0,0,0,0,0,0,10373,10411,-38,-1,6803,6830,-27,-1,2601,2608,-7,-1,2979,2987,-8
11132,170000,136000,0,0,0,0,0,1,-1,4380,4380,0,-1,316,0,316,0,6131,6131,0,-1,5612,0,5612
11133,440000,352000,0,0,0,0,0,0,-2,2942,2942,0,-2,2948,2948,0,-2,0,0,0,-2,942,942,0
11134,60000,48000,0,0,1,1,1,1,2,52222,4763,47459,2,52777,2000,50777,2,51332,0,51332,2,55489,5000,50489
11135,360000,288000,0,0,0,0,0,0,-2,5384,5405,-21,-2,499,500,-1,-2,596,597,-1,-2,2338,2340,-2
11136,130000,104000,0,0,0,0,0,0,0,0,0,0,0,0,0,0,-2,0,0,0,-2,0,0,0
11137,60000,48000,0,0,0,0,0,1,0,25702,2500,23202,0,26961,2000,24961,0,28509,2000,26509,0,29546,1500,28046
11138,170000,136000,0,0,0,0,0,0,-1,552,552,0,-1,552,552,0,-1,552,552,0,-1,0,0,0
11139,180000,144000,0,0,0,0,0,0,0,26260,2000,24260,0,26805,2000,24805,0,8992,1000,7992,0,10906,2000,8906
11140,60000,48000,0,0,0,0,0,0,-1,826,0,826,2,22662,22662,0,-1,38211,38211,0,-1,19671,19671,0
11141,20000,16000,0,1,1,1,1,0,2,17789,1281,16508,0,17419,771,16648,0,17628,640,16988,0,18125,790,17335
11142,110000,88000,0,1,0,0,0,0,0,92103,3500,88603,0,87049,3000,84049,0,66820,2342,64478,0,65823,2390,63433
11143,50000,40000,0,1,1,0,0,1,2,51696,2346,49350,0,50422,2155,48267,0,30145,1046,29099,0,30203,1073,29130
11144,420000,336000,0,0,0,0,0,0,0,30099,20016,10083,0,66049,40015,26034,0,61043,30004,31039,0,62054,3000,59054
11145,100000,80000,0,0,0,0,0,1,0,42455,3500,38955,0,45173,3420,41753,0,46134,2000,44134,2,45263,0,45263
11146,50000,40000,0,1,0,0,0,0,0,48321,1739,46582,0,30281,1033,29248,0,30380,1058,29322,0,28852,1041,27811
11147,40000,32000,0,0,0,0,0,1,-2,-930,0,-930,-2,-1320,0,-1320,-2,-1710,0,-1710,-2,-2100,0,-2100
11148,80000,64000,0,1,0,0,0,0,0,80081,3500,76581,0,29437,1205,28232,0,29195,1200,27995,0,28675,1100,27575
11149,500000,400000,0,0,0,0,0,0,0,37860,27878,9982,0,42572,22572,20000,0,47200,17200,30000,0,59843,19843,40000
11150,220000,176000,0,0,0,0,0,1,0,161256,7200,154056,0,157028,5800,151228,0,159971,5900,154071,0,168805,12000,156805
11151,220000,176000,0,0,0,0,0,1,2,187033,14179,172854,2,171021,0,171021,2,167789,7000,160789,0,168417,10000,158417
11152,50000,40000,0,0,0,0,0,1,0,5757,1244,4513,0,5869,356,5513,0,5838,212,5626,0,5971,230,5741
11153,20000,16000,0,0,0,0,0,0,-1,10464,10464,0,-1,0,0,0,-1,1690,1690,0,-1,18156,18156,0
11154,240000,192000,0,0,0,0,1,0,0,141894,6500,135394,0,143270,5000,138270,0,201082,60000,141082,0,215709,17464,198245
11155,120000,96000,0,0,0,0,0,0,2,57538,7200,50338,2,56019,0,56019,2,60135,5200,54935,2,61298,2300,58998
11156,260000,208000,0,0,0,0,0,0,-1,582,582,0,-1,291,291,0,-1,4471,4471,0,-1,5394,1000,4394
11157,250000,200000,0,0,0,0,0,0,0,46332,3330,43002,0,40974,2000,38974,0,26683,2000,24683,0,26887,2000,24887
11158,170000,136000,0,0,0,0,0,0,0,74707,2671,72036,0,75626,3100,72526,0,75845,3286,72559,0,25140,1100,24040
11159,200000,160000,0,0,0,0,0,0,-2,0,0,0,-2,0,0,0,-2,0,0,0,-2,0,0,0
11160,300000,240000,0,0,0,0,0,1,-2,0,0,0,-2,0,0,0,-2,0,0,0,-2,0,0,0
11161,50000,40000,0,0,0,0,0,1,2,13859,0,13859,2,14032,700,13332,0,14852,1200,13652,0,14464,0,14464
11162,180000,144000,0,0,0,0,0,0,-1,0,0,0,-2,0,0,0,-2,0,0,0,-2,0,0,0
11163,30000,24000,0,1,0,0,0,0,0,28285,2000,26285,0,14729,2000,12729,0,12935,500,12435,0,13333,500,12833
11164,90000,72000,0,0,0,0,0,0,2,11988,1525,10463,2,32658,35011,-2353,-1,30885,3000,27885,-1,26639,0,26639
11165,170000,136000,0,0,0,0,0,0,-1,8794,5004,3790,0,2301,2301,0,-1,0,0,0,-1,0,0,0
11166,140000,112000,0,1,1,1,1,1,2,137328,10707,126621,2,136280,5014,131266,2,136247,5091,131156,2,134089,4608,129481
11167,80000,64000,0,1,1,0,0,1,0,81811,5800,76011,0,80250,1000,79250,2,61467,600,60867,0,10662,400,10262
11168,160000,128000,0,0,0,0,0,0,-2,0,0,0,-2,0,0,0,-2,741,741,0,-2,0,0,0
11169,30000,24000,0,0,0,1,1,0,0,22974,1388,21586,0,24586,2000,22586,0,25675,1500,24175,0,30765,5541,25224
11170,30000,24000,0,0,0,0,0,1,0,11595,3000,8595,0,11112,0,11112,2,12923,2000,10923,2,12566,0,12566
11171,220000,176000,0,0,0,0,0,1,2,3055,4000,-945,-1,1375,0,1375,2,3338,3338,0,-1,3032,0,3032
11172,50000,40000,0,1,1,0,0,1,0,46653,3260,43393,0,43143,1200,41943,0,19003,1000,18003,0,-317,0,-317
11173,140000,112000,0,0,0,0,0,1,0,111799,6000,105799,0,107375,3910,103465,0,104299,3936,100363,0,106280,3871,102409
11174,80000,64000,0,0,0,0,0,0,0,55122,2063,53059,0,54006,1779,52227,0,50779,2087,48692,0,50257,1743,48514
11175,330000,264000,0,0,0,0,0,0,-2,-910,0,-910,-2,-1878,594,-2472,-1,252686,256662,-3976,-1,72401,3000,69401
11176,70000,56000,0,0,0,0,0,1,2,25930,1600,24330,2,26206,1000,25206,2,26477,1000,25477,2,27404,1500,25904
11177,100000,80000,0,0,0,0,0,0,-1,6632,6633,-1,-1,6150,18,6132,0,10122,10152,-30,-1,2689,2697,-8
11178,280000,224000,0,0,0,0,0,1,0,139417,100000,39417,0,144087,7000,137087,0,147694,6000,141694,0,155284,10000,145284
11179,210000,168000,0,0,0,0,0,0,-1,1864,2234,-370,-1,932,0,932,0,932,932,0,-1,1014,1014,0
11180,290000,232000,0,1,1,1,1,0,0,283202,11000,272202,0,283401,10000,273401,0,285291,10000,275291,0,287510,11000,276510
11181,240000,192000,0,0,0,0,0,0,-2,6984,6984,0,-2,0,0,0,-2,0,0,0,-2,0,0,0
11182,50000,40000,0,1,1,1,1,1,2,45354,0,45354,2,49086,4500,44586,2,48027,0,48027,2,49037,1751,47286
11183,230000,184000,0,0,0,0,0,0,0,121697,6000,115697,0,119772,5000,114772,0,115730,5000,110730,0,111222,5000,106222
11184,250000,200000,0,0,0,0,0,0,0,134445,5200,129245,0,136219,10000,126219,0,117625,4014,113611,0,107642,4057,103585
11185,10000,8000,0,1,1,1,1,1,0,9489,1136,8353,0,9237,1144,8093,0,9422,329,9093,0,9619,340,9279
11186,200000,160000,0,0,0,0,0,0,-1,87121,5000,82121,0,87857,4000,83857,0,88766,4000,84766,0,90228,4000,86228
11187,200000,160000,0,1,0,0,0,0,0,186878,10000,176878,0,140743,6000,134743,0,129806,10000,119806,0,121623,10000,111623
11188,90000,72000,0,0,0,0,0,0,0,29756,2007,27749,0,27751,1429,26322,0,20292,1092,19200,0,14937,412,14525
11189,50000,40000,0,0,0,0,0,0,0,16099,1268,14831,0,16418,587,15831,0,16765,611,16154,0,17484,1000,16484
11190,210000,168000,0,0,0,0,0,0,0,62769,2026,60743,0,62683,2000,60683,0,63663,2000,61663,0,46549,2000,44549
11191,140000,112000,0,0,0,0,0,0,-2,1490,1490,0,-2,0,0,0,-2,3938,3938,0,-2,0,1160,-1160
11192,360000,288000,0,0,0,0,0,0,-2,12595,12657,-62,-2,223,224,-1,-2,222,223,-1,-2,490,492,-2
11193,50000,40000,0,0,0,0,0,0,0,32774,1800,30974,0,23113,1000,22113,0,19852,700,19152,0,17308,1000,16308
11194,200000,160000,0,0,0,0,0,0,-2,4292,4974,-682,-2,0,0,0,-2,0,0,0,-2,0,0,0
11195,50000,40000,0,1,1,0,0,0,2,47956,0,47956,2,43578,2004,41574,0,35126,3500,31626,0,34420,0,34420
11196,340000,272000,0,0,0,0,0,0,0,17164,10326,6838,0,15821,5000,10821,0,12317,10000,2317,0,14850,5000,9850
11197,150000,120000,0,1,0,0,0,0,2,147038,0,147038,2,122498,5000,117498,0,75782,3000,72782,0,71306,3000,68306
11198,30000,24000,0,1,1,1,1,0,2,28654,1200,27454,2,27897,0,27897,2,29587,2300,27287,2,30152,1200,28952
11199,30000,24000,1,1,1,1,0,0,0,30394,0,30394,2,29994,0,29994,0,29834,0,29834,0,15960,0,15960
11200,180000,144000,0,0,0,0,0,0,-1,16379,16466,-87,-1,9795,9844,-49,-1,8414,8456,-42,-1,6557,6589,-32
11201,50000,40000,0,0,0,0,0,1,-1,390,390,0,-1,390,390,0,-1,780,780,0,-1,390,0,390
11202,180000,144000,0,0,0,0,0,0,2,35989,1800,34189,0,36013,1230,34783,0,36164,1200,34964,0,31637,1350,30287
11203,500000,400000,0,0,0,0,0,0,-2,13570,13587,-17,-2,10000,10000,0,-2,10000,10000,0,-2,10000,10000,0
11204,90000,72000,0,0,0,0,0,1,-2,0,0,0,-2,0,0,0,-2,1805,1805,0,-2,0,0,0
11205,170000,136000,0,0,0,0,0,0,-1,4592,4592,0,-1,3798,3798,0,-1,8717,8774,-57,-1,4362,4362,0
11206,200000,160000,0,0,0,0,0,0,0,46126,15000,31126,0,63720,20000,43720,0,80736,20000,60736,0,93354,15000,78354
11207,50000,40000,0,0,0,0,0,0,0,12625,5000,7625,0,0,0,0,0,0,0,0,-2,0,0,0
11208,60000,48000,0,0,0,0,0,0,3,495,330,165,2,330,0,330,0,165,0,165,0,340,340,0
11209,90000,72000,0,0,0,0,0,0,0,50780,2200,48580,0,50929,2200,48729,0,48735,1944,46791,0,49746,2200,47546
11210,200000,160000,0,1,0,0,0,0,0,196537,8339,188198,0,76167,5004,71163,0,76810,2961,73849,0,72039,2579,69460
11211,500000,400000,0,1,1,1,1,0,0,460317,30000,430317,0,472621,20000,452621,0,484993,20000,464993,0,496915,20000,476915
11212,360000,288000,0,0,0,0,0,0,-2,1564,1571,-7,-2,4941,4965,-24,-2,2666,2679,-13,-2,588,590,-2
11213,180000,144000,0,0,0,0,0,1,2,52372,2000,50372,2,52917,2000,50917,2,54123,2200,51923,2,55176,2100,53076
11214,220000,176000,0,0,0,0,0,1,2,33117,3400,29717,2,32286,0,32286,2,34320,2576,31744,2,33634,0,33634
11215,180000,144000,0,0,0,0,0,0,-2,0,0,0,-2,0,0,0,-2,0,0,0,-2,0,0,0
11216,210000,168000,0,0,0,0,0,1,-1,12466,12466,0,-1,16870,6004,10866,0,17741,6000,11741,0,13049,7282,5767
11217,70000,56000,0,0,0,0,0,0,0,26363,1435,24928,0,22587,1294,21293,0,21770,1000,20770,0,19525,1000,18525
11218,230000,184000,0,0,0,0,0,0,-1,5703,5703,0,-1,6560,1000,5560,0,11560,5000,6560,0,0,0,0
11219,260000,208000,0,0,0,0,0,0,0,59369,3000,56369,0,63215,5400,57815,0,64087,5000,59087,0,130579,2222,128357
11220,70000,56000,0,1,1,1,1,0,0,68623,3000,65623,0,68867,2250,66617,0,70179,2400,67779,0,67976,2350,65626
11221,230000,184000,0,0,0,0,0,0,0,32029,2500,29529,0,31397,1200,30197,0,27834,2000,25834,0,28153,18000,10153
11222,150000,120000,1,1,1,1,1,1,7,155821,0,155821,6,153075,0,153075,5,151269,0,151269,4,149723,0,149723
11223,50000,40000,0,1,1,1,1,0,0,49299,3000,46299,0,48103,2200,45903,0,48669,2000,46669,0,48507,2000,46507
11224,20000,16000,0,1,1,0,0,0,0,17285,1110,16175,0,18683,1500,17183,0,9121,500,8621,0,14374,300,14074
11225,130000,104000,0,0,0,0,0,0,0,0,0,0,-2,0,0,0,-2,0,0,0,-2,0,0,0
11226,20000,16000,0,0,0,0,0,0,-1,1261,0,1261,2,780,780,0,-1,390,0,390,0,1320,1320,0
11227,60000,48000,0,0,0,0,0,0,-2,-781,0,-781,-2,389,1950,-1561,-1,389,0,389,-1,609,1000,-391
11228,340000,272000,0,0,0,0,0,0,-1,11271,11337,-66,-1,6559,6591,-32,-1,1924,1933,-9,-1,10057,10072,-15
11229,180000,144000,0,0,0,0,0,1,-1,2886,2886,0,-1,840,840,0,-1,2052,2052,0,-1,1443,1443,0
11230,220000,176000,0,0,0,0,0,0,-1,380,380,0,-1,380,380,0,-1,56663,56663,0,-1,57436,2000,55436
11231,80000,64000,0,0,0,0,0,0,-1,53655,2386,51269,0,50279,2000,48279,0,41166,2000,39166,0,28657,3000,25657
11232,80000,64000,0,0,0,0,0,1,0,47831,0,47831,2,57000,10000,47000,2,55489,0,55489,3,57450,3000,54450
11233,70000,56000,0,0,0,0,0,0,2,46281,6500,39781,2,47026,1800,45226,2,45971,0,45971,2,47573,2500,45073
11234,350000,280000,0,0,0,0,0,1,0,205636,9219,196417,0,203844,8797,195047,0,204114,8004,196110,0,207448,10012,197436
11235,340000,272000,0,0,0,0,0,0,0,74530,2962,71568,0,66897,2500,64397,0,64699,1800,62899,0,35540,1000,34540
11236,90000,72000,0,0,0,0,0,0,-1,-390,0,-390,-2,-780,0,-780,-2,780,1560,-780,-1,0,0,0
11237,500000,400000,0,0,0,0,0,1,-1,396,396,0,-1,396,396,0,-1,396,396,0,-1,396,396,0
11238,20000,16000,0,0,0,0,1,0,0,15700,2000,13700,0,16346,1000,15346,0,16837,1000,15837,0,18298,2000,16298
11239,100000,80000,0,1,1,1,1,0,0,85688,3307,82381,0,86643,2581,84062,0,88280,2502,85778,0,90054,2525,87529
11240,50000,40000,0,1,1,1,1,0,0,47748,3000,44748,0,46987,2000,44987,0,47462,2000,45462,0,48104,1859,46245
11241,340000,272000,0,0,0,0,0,0,-2,0,0,0,-2,0,0,0,-2,0,0,0,-2,0,0,0
11242,500000,400000,0,0,0,0,0,0,0,341673,14783,326890,0,76519,3000,73519,0,77223,3000,74223,0,76684,2853,73831
11243,500000,400000,0,0,0,0,0,0,-2,2299,2299,0,-2,1251,1251,0,-1,1206,1206,0,-1,1151,1151,0
11244,200000,160000,0,1,1,0,1,0,0,194205,9000,185205,0,195154,8000,187154,0,166778,6900,159878,0,167833,6000,161833
11245,70000,56000,0,0,0,0,0,0,-1,47161,3000,44161,-1,27534,0,27534,2,26660,946,25714,0,27022,1424,25598
11246,50000,40000,0,0,0,0,0,1,2,13555,103,13452,2,0,0,0,2,0,0,0,-2,0,0,0
11247,440000,352000,0,0,0,0,0,0,0,324109,11129,312980,0,287932,10300,277632,0,287892,11098,276794,0,276902,11200,265702
11248,310000,248000,0,0,0,0,0,1,-2,0,0,0,-2,0,0,0,-2,0,0,0,-2,0,0,0
11249,190000,152000,0,1,1,1,1,1,2,159386,6600,152786,2,161870,6500,155370,2,165725,6500,159225,2,169928,7000,162928
11250,30000,24000,0,0,0,0,0,1,0,17153,1500,15653,0,17351,780,16571,0,19509,2600,16909,0,18900,0,18900
11251,90000,72000,0,0,0,0,0,0,0,34443,1810,32633,0,31223,1300,29923,0,31723,1152,30571,0,32505,1310,31195
11252,50000,40000,0,0,0,0,0,0,0,11650,1000,10650,0,7457,149,7308,0,3115,0,3115,0,7725,5000,2725
11253,50000,40000,0,0,0,0,0,0,0,26223,1787,24436,0,25791,1295,24496,0,19476,825,18651,0,19066,684,18382
11254,20000,16000,1,1,1,1,1,1,4,27009,0,27009,3,27170,924,26246,2,26295,0,26295,2,34171,9648,24523
11255,80000,64000,0,0,0,0,0,0,0,59495,2800,56695,0,58832,2100,56732,0,57677,2181,55496,0,58066,2500,55566
11256,50000,40000,0,1,0,0,0,0,0,42621,2198,40423,0,21734,1300,20434,0,18775,655,18120,0,19590,1100,18490
11257,90000,72000,0,0,0,0,0,0,0,45385,1800,43585,0,46331,1700,44631,0,47494,2000,45494,0,48433,1746,46687
11258,80000,64000,0,0,0,0,0,0,0,8254,1350,6904,0,5144,5144,0,-1,15365,15365,0,-1,2250,2250,0
11259,240000,192000,0,1,1,1,1,0,0,222929,9000,213929,0,215858,6600,209258,0,210887,6400,204487,0,205828,6382,199446
11260,180000,144000,0,0,0,0,0,0,0,67227,2600,64627,0,68398,2000,66398,0,70409,3000,67409,0,71408,2025,69383
11261,450000,360000,0,0,0,0,0,0,0,9983,3109,6874,0,4904,4904,0,-1,45338,45338,0,-1,51646,7570,44076
11262,10000,8000,0,1,1,1,1,0,0,8794,0,8794,2,9604,1192,8412,0,9604,0,9604,0,9800,196,9604
11263,130000,104000,0,0,0,0,0,0,-1,2450,1000,1450,0,0,0,0,0,1089,1089,0,-1,2249,2249,0
11264,20000,16000,0,0,0,0,0,0,2,16232,1300,14932,0,16555,573,15982,0,16104,576,15528,0,16055,600,15455
11265,80000,64000,0,0,0,0,0,0,0,100,504,-404,-1,600,500,100,0,1438,1000,438,0,1919,500,1419
11266,80000,64000,0,0,0,0,0,1,0,31594,1200,30394,2,30787,0,30787,2,34513,4246,30267,2,34995,1200,33795
11267,60000,48000,0,0,0,0,0,0,-1,59271,59274,-3,-1,28101,1500,26601,0,29724,2013,27711,0,25664,1000,24664
11268,100000,80000,0,0,0,0,0,1,2,40298,1500,38798,2,40835,1500,39335,2,41529,1500,40029,2,42697,2000,40697
11269,80000,64000,0,0,0,0,0,1,0,40910,2000,38910,0,40969,1600,39369,0,41275,1500,39775,0,41637,1550,40087
11270,380000,304000,0,0,0,0,0,1,-2,0,0,0,-2,0,0,0,-2,0,0,0,-2,0,0,0
11271,360000,288000,0,0,0,0,0,0,-1,0,0,0,-2,0,0,0,-2,0,0,0,-2,0,0,0
11272,50000,40000,0,0,0,0,0,1,-1,1072,1072,0,-1,1713,1713,0,-1,651,651,0,-1,646,646,0
11273,20000,16000,0,0,0,1,1,0,0,16191,1270,14921,0,16512,591,15921,0,16858,612,16246,0,17193,615,16578
11274,100000,80000,0,0,1,1,0,0,0,85154,10200,74954,0,84914,2100,82814,0,83097,2850,80247,0,1308,0,1308
11275,460000,368000,0,0,0,0,0,0,-1,1670,1800,-130,-1,6425,6500,-75,-1,4897,5000,-103,-1,8401,5000,3401
11276,180000,144000,0,0,0,0,0,0,-2,-77,0,-77,-2,-77,0,-77,-2,1823,1900,-77,-2,227,230,-3
11277,290000,232000,0,0,0,0,0,0,0,39769,3500,36269,0,35058,2500,32558,0,36965,2500,34465,0,38863,2500,36363
11278,30000,24000,0,1,1,1,1,0,2,26393,0,26393,2,29646,3712,25934,2,30390,1363,29027,2,29755,0,29755
11279,180000,144000,0,0,0,0,0,0,-2,0,0,0,-2,0,0,0,-2,45,45,0,-2,0,0,0
11280,200000,160000,0,0,0,0,0,0,-2,0,0,0,-2,0,0,0,-2,1680,1680,0,-1,0,0,0
11281,360000,288000,0,0,0,0,0,0,-1,17584,17631,-47,-1,17354,17741,-387,-1,37703,25203,12500,0,22490,10000,12490
11282,240000,192000,0,0,0,0,0,0,0,27970,2081,25889,0,187880,169267,18613,0,169261,5062,164199,0,148519,4608,143911
11283,130000,104000,0,0,0,0,0,0,0,70672,2389,68283,0,64530,2368,62162,0,63041,5000,58041,0,56493,1964,54529
11284,50000,40000,0,0,0,0,0,0,0,27438,1600,25838,0,4786,624,4162,0,768,768,0,-1,-579,173,-752
11285,280000,224000,0,0,0,0,0,0,-2,1592,1592,0,-2,1312,1312,0,-2,486,486,0,-2,886,1036,-150
11286,300000,240000,0,0,0,0,0,0,-1,27754,27968,-214,-1,10534,10597,-63,-1,1954,1954,0,-1,2140,2140,0
11287,120000,96000,0,0,0,0,0,0,0,58882,18000,40882,0,59862,1857,58005,0,51172,1723,49449,0,52533,2075,50458
11288,50000,40000,0,0,0,0,0,0,0,-100,100,-200,0,-100,0,-100,-2,-100,0,-100,-2,650,750,-100
11289,220000,176000,0,0,0,0,0,0,2,212,538,-326,-1,2886,3089,-203,-1,3794,1630,2164,2,4673,2000,2673
11290,70000,56000,0,0,0,0,0,1,0,8361,2000,6361,0,10208,2000,8208,0,11038,1000,10038,0,11848,1000,10848
11291,270000,216000,0,0,0,0,0,0,-2,26069,26134,-65,-2,36630,36650,-20,-2,37390,37390,0,-2,19816,19816,0
11292,210000,168000,0,0,0,0,0,0,0,2821,1069,1752,0,2935,1000,1935,0,1895,38,1857,0,1078,1078,0
11293,200000,160000,0,0,0,0,0,0,0,130930,4500,126430,0,130775,4532,126243,0,128752,5451,123301,0,122695,5000,117695
11294,100000,80000,0,0,0,0,0,0,0,25272,1000,24272,0,0,0,0,0,0,0,0,-2,0,0,0
11295,200000,160000,0,0,0,0,0,0,-2,15146,15682,-536,-2,11575,11633,-58,-2,11564,11622,-58,-2,13744,13813,-69
11296,220000,176000,0,0,0,0,0,0,-2,0,0,0,-2,0,0,0,-2,0,0,0,-2,0,0,0
11297,80000,64000,0,0,0,0,0,0,-1,5741,7741,-2000,-1,6143,500,5643,0,7039,1000,6039,0,26799,20000,6799
11298,50000,40000,0,1,1,0,1,1,0,46991,2607,44384,0,47276,3312,43964,0,47870,13107,34763,0,47865,2648,45217
11299,60000,48000,0,0,0,0,0,0,0,20641,2000,18641,0,22229,2229,20000,0,24708,3000,21708,0,27255,3000,24255
11300,440000,352000,0,0,0,0,0,0,0,287932,10300,277632,0,287892,11098,276794,0,276902,11200,265702,0,221866,12000,209866
11301,30000,24000,0,1,1,1,1,1,0,28771,2005,26766,0,27744,1000,26744,0,28302,1000,27302,0,29725,2250,27475
11302,150000,120000,0,1,1,1,1,0,0,126733,4533,122200,0,130241,5000,125241,0,132466,3724,128742,0,134808,3829,130979
11303,320000,256000,0,1,1,1,1,0,2,304025,12001,292024,2,308421,10500,297921,2,315291,13000,302291,2,310339,1,310338
11304,120000,96000,0,1,1,0,0,1,0,119395,5900,113495,0,108802,4100,104702,0,99988,7100,92888,0,84253,0,84253
11305,140000,112000,0,0,1,1,1,1,0,122612,15000,107612,2,120270,1100,119170,4,118091,0,118091,3,122963,7000,115963
11306,290000,232000,0,0,0,0,0,0,0,29636,1539,28097,0,24104,1290,22814,0,33814,10000,23814,0,32530,5000,27530
11307,30000,24000,0,1,1,1,1,1,2,31295,1700,29595,2,29929,954,28975,2,27744,0,27744,2,28117,2253,25864
11308,410000,328000,0,0,0,0,0,0,0,74122,6000,68122,0,72363,4000,68363,0,68703,5000,63703,0,66710,6000,60710
11309,230000,184000,0,0,0,0,0,0,-2,846,846,0,-2,846,846,0,-2,0,0,0,-2,846,846,0
11310,230000,184000,0,0,0,0,0,0,-1,1599,1599,0,-1,378,378,0,-1,756,756,0,-1,0,0,0
11311,150000,120000,0,0,0,0,0,0,0,109160,5450,103710,0,109859,4000,105859,0,112314,4227,108087,0,114614,4321,110293
11312,200000,160000,0,0,0,0,0,0,-1,389,390,-1,-1,389,390,-1,-2,389,390,-1,-2,389,390,-1
11313,130000,104000,0,0,0,0,0,0,0,7267,4300,2967,0,2518,2000,518,0,16202,16202,0,-1,2505,2505,0
11314,50000,40000,0,0,0,0,0,0,-1,15590,200,15390,2,10610,10610,0,-1,0,0,0,-1,0,0,0
11315,50000,40000,0,0,0,0,0,0,0,25042,1429,23613,0,21947,1294,20653,0,19198,1000,18198,0,19610,705,18905
11316,60000,48000,0,0,0,0,0,1,0,37220,1600,35620,0,37963,1336,36627,0,38875,1500,37375,0,39184,1448,37736
11317,50000,40000,0,0,0,0,0,1,0,12065,2588,9477,0,10199,0,10199,2,9261,284,8977,0,6816,1000,5816
11318,250000,200000,0,0,0,0,0,0,0,24585,1553,23032,0,16753,1000,15753,0,17113,1000,16113,0,17298,1000,16298
11319,50000,40000,0,0,0,0,0,1,2,10928,1200,9728,2,10456,0,10456,2,11279,1000,10279,0,12095,1000,11095
11320,280000,224000,0,1,0,0,0,0,0,243515,10500,233015,0,215853,8010,207843,0,189911,7000,182911,0,161830,6000,155830
11321,20000,16000,0,0,0,0,0,0,-2,2983,1201,1782,2,2790,0,2790,2,3589,1000,2589,2,3388,0,3388
11322,100000,80000,0,1,1,0,0,1,2,90169,4458,85711,0,84714,2973,81741,0,69482,2606,66876,0,70226,2696,67530
11323,210000,168000,0,0,0,0,0,0,0,130769,5032,125737,0,95962,3783,92179,0,49839,2021,47818,0,46824,3000,43824
11324,500000,400000,0,0,0,0,0,0,0,244517,15006,229511,0,243132,10000,233132,0,243869,10000,233869,0,251540,12000,239540
11325,200000,160000,0,1,0,0,0,1,0,197888,6210,191678,0,145078,4500,140578,0,137272,4200,133072,0,131447,6200,125247
11326,90000,72000,0,1,0,0,0,0,0,87014,2500,84514,0,46293,2000,44293,0,47576,2000,45576,0,46663,2000,44663
11327,110000,88000,0,0,0,0,0,0,-1,0,0,0,-1,0,0,0,-2,0,0,0,-2,0,0,0
11328,200000,160000,1,1,0,0,0,0,0,214321,9300,205021,0,134517,6500,128017,0,54711,3000,51711,0,23611,856,22755
11329,270000,216000,0,0,0,0,0,0,-2,9076,9076,0,-2,5424,5424,0,-2,9577,9577,0,-2,8130,8130,0
11330,290000,232000,0,0,0,0,0,0,-1,0,0,0,-1,302,302,0,-1,390,390,0,-1,1278,1278,0
11331,70000,56000,0,1,1,0,0,0,0,63529,4000,59529,0,61778,3000,58778,0,42092,5000,37092,0,36751,5000,31751
11332,90000,72000,0,0,0,0,0,0,2,20667,3300,17367,2,20042,0,20042,2,20408,1000,19408,0,22073,2000,20073
11333,220000,176000,0,0,0,0,0,0,-1,17257,5000,12257,0,21624,5000,16624,0,26246,5000,21246,0,30781,5000,25781
11334,50000,40000,0,1,0,0,0,1,0,47862,1407,46455,0,20246,704,19542,0,20321,730,19591,0,20387,796,19591
11335,360000,288000,0,0,0,0,0,0,-1,795,799,-4,-1,1000,1005,-5,-1,6398,6398,0,-1,9418,3020,6398
11336,250000,200000,0,0,0,0,0,1,2,59530,2150,57380,0,60668,2116,58552,0,59786,65,59721,0,130890,72460,58430
11337,50000,40000,0,0,0,0,0,0,0,0,0,0,-2,0,0,0,-2,0,0,0,-2,0,0,0
11338,470000,376000,0,0,0,0,0,0,0,182687,15000,167687,0,153366,5052,148314,0,114451,5000,109451,0,122489,10000,112489
11339,20000,16000,0,1,1,0,0,0,0,19598,2000,17598,0,19701,1000,18701,0,3486,400,3086,0,199,199,0
11340,140000,112000,0,0,0,0,0,1,-1,4705,4705,0,-1,1710,1710,0,-1,0,0,0,-1,6096,6096,0
11341,50000,40000,0,0,0,0,0,0,0,25692,2000,23692,0,24336,1410,22926,0,20243,1000,19243,0,18995,1000,17995
11342,100000,80000,0,1,1,0,0,1,0,101007,3711,97296,0,97862,3685,94177,0,79099,2797,76302,0,79812,2897,76915
11343,30000,24000,0,0,0,0,0,0,0,220,220,0,-1,1705,1705,0,-1,0,0,0,-1,0,0,0
11344,270000,216000,0,0,0,0,0,0,-2,0,0,0,-2,0,0,0,-2,0,0,0,-2,0,0,0
11345,290000,232000,0,0,0,0,0,1,0,116828,4630,112198,0,119857,4857,115000,0,122243,4251,117992,0,124885,4485,120400
11346,250000,200000,0,0,0,0,0,0,0,31707,10011,21696,0,13630,1000,12630,0,10000,10000,0,-1,10000,10000,0
11347,170000,136000,0,1,0,0,0,0,0,162330,8138,154192,0,110034,4206,105828,0,97018,3366,93652,0,96056,3421,92635
11348,250000,200000,0,0,0,0,0,1,-2,0,0,0,-2,0,0,0,-2,0,0,0,-2,0,0,0
11349,30000,24000,0,0,0,1,0,0,0,18905,0,18905,2,24817,10000,14817,0,29220,5000,24220,0,17260,1700,15560
11350,10000,8000,0,1,1,1,1,1,2,8813,0,8813,2,10066,1400,8666,0,10017,1100,8917,0,9705,0,9705
11351,180000,144000,0,0,0,0,0,0,0,138654,7000,131654,0,130773,6600,124173,0,121293,4700,116593,0,123947,5100,118847
11352,50000,40000,0,1,1,0,0,1,0,48764,1829,46935,0,47109,1924,45185,0,39415,1308,38107,0,39920,1480,38440
11353,20000,16000,0,0,0,0,1,1,2,14907,1600,13307,0,15853,1500,14353,0,17776,2500,15276,0,17352,0,17352
11354,640000,512000,0,0,0,0,0,0,0,119211,10000,109211,0,118722,10535,108187,0,105197,15000,90197,0,93921,5000,88921
11355,20000,16000,0,0,0,0,0,1,0,17228,1340,15888,0,16923,1171,15752,0,10467,402,10065,0,10526,600,9926
11356,80000,64000,0,0,0,0,0,1,2,42719,2000,40719,2,43018,1300,41718,2,44013,2000,42013,2,45058,1900,43158
11357,100000,80000,0,1,1,1,1,0,2,90018,6800,83218,2,91151,3500,87651,3,89429,0,89429,3,91185,3400,87785
11358,290000,232000,0,0,0,0,0,1,-2,640,643,-3,-2,526,528,-2,-2,336,337,-1,-2,527,529,-2
11359,80000,64000,0,0,0,0,0,0,0,66342,2519,63823,0,60514,1838,58676,0,48965,1434,47531,0,29648,1015,28633
11360,360000,288000,0,0,0,0,0,0,-2,0,0,0,-2,0,0,0,-2,0,0,0,-2,0,0,0
11361,250000,200000,0,0,0,1,1,0,0,202571,7478,195093,0,226423,27349,199074,0,221296,0,221296,2,234762,17000,217762
11362,30000,24000,0,1,1,0,0,0,0,28425,1560,26865,0,29233,1350,27883,0,21575,1000,20575,0,22029,801,21228
11363,340000,272000,0,0,0,0,0,0,0,112515,4000,108515,0,114951,4000,110951,0,117849,4500,113349,0,120739,5000,115739
11364,50000,40000,0,0,0,0,0,1,2,39689,1345,38344,0,29422,2074,27348,0,12856,238,12618,0,0,0,0
11365,30000,24000,0,0,0,0,0,0,0,12354,1514,10840,0,13840,2000,11840,0,13320,0,13320,2,14501,1400,13101
11366,120000,96000,0,0,0,0,0,0,0,34481,2000,32481,0,30102,2000,28102,0,30220,3000,27220,0,33523,6000,27523
11367,50000,40000,0,0,0,0,0,0,0,18068,1301,16767,0,18426,659,17767,0,18812,682,18130,0,19275,775,18500
11368,90000,72000,0,0,0,0,0,1,0,36334,4000,32334,0,34214,1100,33114,2,30789,0,30789,2,28994,1050,27944
11369,80000,64000,0,1,1,0,0,0,0,72602,3341,69261,0,72525,1850,70675,0,56951,1499,55452,0,21952,933,21019
11370,270000,216000,0,0,0,0,0,0,0,127423,4795,122628,0,126824,4470,122354,0,115961,3847,112114,0,112929,3943,108986
11371,390000,312000,0,0,0,0,0,0,-1,827,827,0,-1,1036,1036,0,-1,15209,15000,209,-1,15156,1000,14156
11372,70000,56000,0,1,1,1,1,0,0,69843,3200,66643,0,70834,2800,68034,0,70405,2458,67947,0,71004,2800,68204
11373,360000,288000,0,0,0,0,0,0,-2,0,0,0,-2,0,0,0,-2,0,0,0,-2,0,0,0
11374,370000,296000,0,0,0,0,0,0,-2,0,0,0,-2,361,422,-61,-1,211,0,211,2,3659,3448,211
11375,240000,192000,0,0,0,0,0,0,0,75959,3200,72759,0,80473,6100,74373,0,78883,0,78883,2,80625,2900,77725
11376,70000,56000,0,0,0,0,0,0,0,9353,5353,4000,0,15282,6282,9000,0,20400,6342,14058,0,12915,2055,10860
11377,290000,232000,0,0,0,0,0,0,0,216488,10006,206482,0,152892,7000,145892,0,150051,5000,145051,0,146287,5200,141087
11378,200000,160000,0,0,0,0,0,0,-2,1613,1621,-8,-2,2193,2213,-20,-2,2698,2711,-13,-2,3812,3831,-19
11379,200000,160000,0,0,0,0,0,0,-1,316,316,0,-1,8386,8386,0,-1,316,8896,-8580,-1,10104,10104,0
11380,50000,40000,1,1,1,1,0,1,2,51056,0,51056,2,49515,2174,47341,0,42189,2000,40189,0,19938,6473,13465
11381,200000,160000,0,0,0,0,0,0,-2,820,820,0,-2,820,820,0,-2,590,590,0,-2,2099,2099,0
11382,20000,16000,0,0,0,0,0,0,-2,2712,2720,-8,-2,2882,2890,-8,-2,9235,9263,-28,-2,1719,1824,-105
11383,20000,16000,0,0,1,0,0,1,2,17657,1700,15957,0,20000,3000,17000,0,0,0,0,0,0,0,0
11384,40000,32000,0,0,0,0,0,0,0,9369,92,9277,2,22949,15000,7949,2,11188,0,11188,2,13306,3000,10306
11385,50000,40000,0,0,0,0,0,0,-1,7161,7161,0,-1,5351,5351,0,-1,791,791,0,-1,47774,46983,791
11386,200000,160000,0,0,0,0,0,0,-1,103360,100057,3303,0,77818,292,77526,0,26276,10019,16257,0,3235,16,3219
11387,350000,280000,0,0,0,0,0,0,-2,2448,2460,-12,-2,4590,4616,-26,-2,0,0,0,-2,430,430,0
11388,460000,368000,0,0,0,0,0,0,0,15418,3000,12418,0,22465,8000,14465,0,25546,4000,21546,0,36452,16000,20452
11389,590000,472000,0,0,0,0,0,0,0,68573,68753,-180,-1,61065,10000,51065,0,30510,15033,15477,0,25887,25965,-78
11390,150000,120000,0,1,1,1,1,0,0,143548,6714,136834,0,146332,6705,139627,0,145993,5181,140812,0,146600,5437,141163
11391,150000,120000,0,0,0,0,0,0,0,24535,3280,21255,0,23778,0,23778,2,24255,1000,23255,0,24630,750,23880
11392,50000,40000,0,0,0,0,0,1,0,31051,3100,27951,0,31542,1300,30242,2,32185,1300,30885,2,32900,1400,31500
11393,150000,120000,0,0,0,0,0,0,0,19890,1602,18288,2,19271,0,19271,2,19037,1000,18037,0,20448,1709,18739
11394,210000,168000,0,0,0,0,0,0,0,157358,7600,149758,0,3561,1019,2542,0,34600,36500,-1900,-1,32581,3000,29581
11395,50000,40000,0,1,1,0,0,0,0,48059,3000,45059,0,48097,3000,45097,0,8107,3000,5107,0,6934,3600,3334
11396,200000,160000,0,0,0,0,0,0,0,62286,5700,56586,0,61305,2000,59305,2,62846,3000,59846,0,42634,2000,40634
11397,80000,64000,0,1,1,1,1,0,0,72932,2100,70832,0,74422,2109,72313,0,75920,2131,73789,0,77490,2195,75295
11398,140000,112000,0,0,0,0,0,1,0,61732,3000,58732,0,62411,2300,60111,0,64372,3000,61372,0,70015,6700,63315
11399,380000,304000,0,0,0,0,0,0,0,97979,3385,94594,0,100599,4074,96525,0,81087,2592,78495,0,82793,2696,80097
11400,210000,168000,0,0,0,0,0,0,2,11896,2524,9372,0,8097,1311,6786,0,7902,1000,6902,0,7917,291,7626
11401,190000,152000,0,0,0,0,0,0,0,79321,3500,75821,0,80401,3000,77401,0,80872,3083,77789,0,77377,3000,74377
11402,30000,24000,0,1,1,1,1,0,0,28827,1500,27327,0,29412,1000,28412,0,26199,1000,25199,0,27116,1351,25765
11403,150000,120000,0,0,0,0,0,0,-2,-17,0,-17,-2,3996,4013,-17,-2,2278,2278,0,-2,1132,1132,0
11404,480000,384000,0,0,0,0,0,0,-1,96977,96989,-12,-1,67030,4,67026,0,24334,241,24093,0,28699,15819,12880
11405,50000,40000,0,1,0,0,0,0,0,45549,2106,43443,0,40043,1600,38443,0,39844,1606,38238,0,39599,1581,38018
11406,50000,40000,0,0,0,0,0,0,0,18297,1183,17114,0,20114,2000,18114,0,13235,1200,12035,0,12482,0,12482
11407,230000,184000,0,0,0,0,0,0,-1,0,0,0,-1,11211,11211,0,-1,0,0,0,-1,0,0,0
11408,20000,16000,0,0,0,0,0,0,-1,832,832,0,-1,0,0,0,-1,832,832,0,-1,1486,1486,0
11409,210000,168000,0,0,0,0,0,0,-1,0,0,0,-1,0,0,0,-2,0,0,0,-2,0,0,0
11410,50000,40000,0,0,0,0,0,0,0,29233,3000,26233,0,23340,1000,22340,0,-300,0,-300,0,31031,31331,-300
11411,60000,48000,0,0,0,0,0,0,-2,-64,0,-64,-2,-64,0,-64,-2,-64,0,-64,-2,16759,17000,-241
11412,210000,168000,0,0,0,0,0,0,-2,7600,7735,-135,-2,5546,5551,-5,-2,1241,1241,0,-2,1801,1801,0
11413,280000,224000,0,0,0,0,0,0,-1,2110,5000,-2890,-1,2121,2121,0,-1,6789,6789,0,-1,14959,14959,0
11414,470000,376000,0,0,0,0,0,0,0,120318,10020,110298,0,129281,40069,89212,0,113437,25005,88432,0,164377,100000,64377
11415,70000,56000,0,0,0,0,0,0,0,16854,4000,12854,0,16741,3000,13741,0,15154,3007,12147,0,6060,6060,0
11416,50000,40000,0,0,0,0,0,0,-2,0,0,0,-2,0,0,0,-2,0,0,0,-2,181,181,0
11417,360000,288000,0,0,0,0,0,0,-2,0,0,0,-2,0,0,0,-2,691,691,0,-1,7020,7020,0
11418,100000,80000,0,0,0,0,0,0,0,0,0,0,0,0,0,0,-2,0,0,0,-2,0,0,0
11419,50000,40000,0,0,0,0,0,0,0,24720,2375,22345,0,26370,2375,23995,0,29332,3547,25785,0,28574,0,28574
11420,120000,96000,0,0,0,0,0,0,0,78068,4000,74068,0,78589,12242,66347,0,77213,0,77213,2,82567,6894,75673
11421,160000,128000,0,0,0,1,0,0,0,73246,3000,70246,0,71321,3000,68321,0,141494,3000,138494,0,72913,3500,69413
11422,310000,248000,0,0,0,0,0,0,-2,993,1005,-12,-2,993,1000,-7,-2,1495,1502,-7,-2,995,1000,-5
11423,20000,16000,0,0,0,1,1,0,-1,595,597,-2,-1,18628,21722,-3094,-1,19324,1000,18324,0,19208,697,18511
11424,100000,80000,0,0,0,0,0,0,-1,5695,2695,3000,0,3480,3480,0,-1,2949,2949,0,-1,477,477,0
11425,230000,184000,0,0,0,0,0,0,0,3900,3900,0,-1,870,870,0,-1,0,0,0,-1,0,0,0
11426,170000,136000,0,0,0,0,0,0,-2,1408,1408,0,-2,1434,1434,0,-2,264,264,0,-2,264,264,0
11427,500000,400000,0,0,0,0,0,0,-1,1316,1316,0,-1,4941,5000,-59,-1,8539,5000,3539,0,3842,2000,1842
11428,20000,16000,0,1,1,1,1,0,2,18055,0,18055,2,20578,3000,17578,2,19813,0,19813,2,20197,1001,19196
11429,150000,120000,0,0,0,0,0,0,-1,18301,18305,-4,-1,15858,15861,-3,-1,2744,2744,0,-1,2144,0,2144
11430,170000,136000,0,0,0,0,0,0,0,45987,2000,43987,0,35377,1514,33863,0,29141,1006,28135,0,21955,1000,20955
11431,300000,240000,0,1,1,1,1,1,2,293497,9003,284494,2,293046,8114,284932,2,291883,4403,287480,2,297169,8838,288331
11432,390000,312000,0,0,0,0,0,0,-2,2041,2041,0,-2,4582,4582,0,-2,2070,2070,0,-2,0,0,0
11433,140000,112000,0,0,0,0,0,0,0,96273,4000,92273,0,91059,4000,87059,0,92609,3500,89109,0,95184,8000,87184
11434,160000,128000,0,0,0,0,0,0,-1,2460,2460,0,-1,6460,4000,2460,0,5360,107,5253,0,0,0,0
11435,190000,152000,0,0,0,0,0,1,2,109678,5200,104478,2,110887,4500,106387,2,111871,4300,107571,2,114223,4300,109923
11436,30000,24000,0,0,0,0,0,1,3,13289,0,13289,2,14068,1000,13068,2,14596,900,13696,2,14212,0,14212
11437,170000,136000,0,0,0,0,0,0,0,120582,4278,116304,0,112819,4021,108798,0,113932,3828,110104,0,107776,3843,103933
11438,150000,120000,0,0,0,0,0,0,0,39743,10000,29743,0,48971,10003,38968,0,38291,0,38291,0,569,0,569
11439,200000,160000,0,0,0,0,0,0,-2,0,0,0,-2,0,0,0,-2,0,0,0,-2,0,0,0
11440,290000,232000,0,0,0,0,0,1,2,227698,18000,209698,2,232468,10000,222468,2,227226,0,227226,2,241556,18000,223556
11441,50000,40000,0,0,0,0,0,0,4,38151,2000,36151,4,37264,0,37264,4,36396,0,36396,3,35659,0,35659
11442,260000,208000,0,0,0,0,0,0,0,82868,2400,80468,0,80715,2000,78715,0,76377,2000,74377,0,44627,1464,43163
11443,430000,344000,0,0,0,0,0,1,-2,4119,4120,-1,-2,4390,535,3855,-2,20952,20990,-38,-2,15562,2506,13056
11444,230000,184000,0,0,0,0,0,0,0,20755,3000,17755,0,23278,3000,20278,0,24083,4000,20083,0,25145,4000,21145
11445,90000,72000,0,0,0,0,0,0,0,63070,0,63070,2,1184,1000,184,0,4154,4000,154,0,3502,3502,0
11446,350000,280000,0,0,0,0,0,0,-1,652,652,0,-1,326,0,326,2,3817,3817,0,-1,2802,2802,0
11447,230000,184000,0,0,0,0,0,1,-1,1292,1292,0,-1,885,885,0,-1,1292,1292,0,-1,795,795,0
11448,20000,16000,0,0,0,0,1,1,2,14983,2000,12983,0,16197,1780,14417,0,18932,3000,15932,0,18271,0,18271
11449,150000,120000,0,0,0,0,0,0,0,6067,1040,5027,0,4823,1378,3445,0,6208,1560,4648,2,4824,128,4696
11450,170000,136000,0,0,0,0,0,0,0,97286,5000,92286,0,97196,3000,94196,0,97227,4000,93227,0,101272,8000,93272
11451,70000,56000,0,0,0,0,0,0,0,23283,1278,22005,0,11523,1000,10523,0,23516,235,23281,0,1600,1600,0
11452,110000,88000,0,0,0,0,0,0,0,74760,3899,70861,0,63520,3000,60520,0,62529,1800,60729,0,58228,3000,55228
11453,90000,72000,0,0,0,0,0,0,-1,0,200,-200,-1,3199,3199,0,-1,1888,0,1888,0,0,0,0
11454,90000,72000,0,1,1,1,1,0,0,88330,3223,85107,0,83948,3172,80776,0,82168,2743,79425,0,82304,3051,79253
11455,50000,40000,0,0,0,0,0,1,0,16756,1278,15478,0,17089,611,16478,0,17446,632,16814,0,17825,668,17157
11456,120000,96000,0,0,0,0,0,0,2,10834,10834,0,-1,2016,280,1736,0,3589,3589,0,-1,1569,1569,0
11457,150000,120000,0,0,0,0,0,0,0,100645,3630,97015,0,103006,4337,98669,0,52251,1894,50357,0,46581,1522,45059
11458,50000,40000,0,0,0,0,0,1,0,3853,1200,2653,0,4768,1020,3748,0,-52,0,-52,0,-52,0,-52
11459,280000,224000,0,0,0,0,0,1,3,130168,6000,124168,2,131222,4500,126722,2,132758,5000,127758,2,135654,5000,130654
11460,140000,112000,0,0,0,0,0,0,0,6266,6284,-18,-2,4379,4392,-13,-2,420,420,0,-1,0,0,0
11461,240000,192000,0,1,0,0,0,0,0,202513,7539,194974,0,198720,8267,190453,0,192574,7012,185562,0,195682,8010,187672
11462,130000,104000,0,0,0,0,0,1,0,19478,2600,16878,0,19862,1000,18862,2,19403,0,19403,2,21070,2000,19070
11463,120000,96000,0,0,0,0,0,0,-1,10293,10363,-70,-1,3600,3600,0,-1,0,0,0,-1,0,0,0
11464,20000,16000,0,1,1,1,1,0,2,20319,4000,16319,2,19543,0,19543,2,19534,391,19143,0,19320,386,18934
11465,130000,104000,0,1,1,1,1,0,2,123503,5000,118503,2,124578,4600,119978,2,127434,5000,122434,2,130285,5100,125185
11466,230000,184000,0,0,0,0,0,0,-1,476,476,0,-1,476,476,0,-1,476,476,0,-1,4145,4145,0
11467,80000,64000,0,1,1,1,1,0,0,74773,3500,71273,0,76908,4000,72908,0,77068,3200,73868,0,78434,4000,74434
11468,200000,160000,0,0,0,0,0,0,0,10537,10023,514,0,5552,27,5525,2,2506,2614,-108,-1,9443,9454,-11
11469,450000,360000,0,0,0,0,0,0,0,0,0,0,0,0,0,0,-2,0,0,0,-2,0,0,0
11470,420000,336000,0,0,0,0,0,0,0,315822,11230,304592,0,275393,10000,265393,0,278745,8091,270654,0,244543,6965,237578
11471,180000,144000,0,0,0,0,0,0,0,124553,6000,118553,0,127096,6100,120996,0,128992,5500,123492,0,131660,4900,126760
11472,50000,40000,0,1,0,0,0,0,2,47976,2100,45876,0,39703,2000,37703,0,19777,1000,18777,0,19162,1000,18162
11473,50000,40000,0,0,0,0,0,1,2,2400,0,2400,2,2400,0,2400,7,2400,0,2400,7,2400,0,2400
11474,50000,40000,0,0,0,0,0,0,2,17621,3200,14421,2,17839,800,17039,2,17257,0,17257,2,17826,1000,16826
11475,130000,104000,0,0,0,0,0,0,0,43812,3000,40812,0,42132,3000,39132,0,44190,4000,40190,0,44636,4000,40636
11476,390000,312000,0,0,0,0,0,0,0,75614,3000,72614,0,77358,3000,74358,0,86007,10000,76007,0,88601,4000,84601
11477,120000,96000,0,0,0,0,0,0,0,32048,2000,30048,0,29131,2000,27131,0,30288,3000,27288,0,30192,3000,27192
11478,30000,24000,0,0,0,0,0,0,0,19698,1096,18602,0,17855,514,17341,0,13784,1021,12763,0,6616,151,6465
11479,200000,160000,0,0,0,0,0,0,0,93099,3400,89699,0,94949,3400,91549,0,96929,3512,93417,0,98909,3586,95323
11480,140000,112000,0,0,0,0,0,0,0,79449,3411,76038,0,45514,1523,43991,0,42155,1352,40803,0,42812,1526,41286
11481,230000,184000,0,1,0,0,0,0,0,235149,9500,225649,0,166637,6000,160637,0,165699,6150,159549,0,163858,6000,157858
11482,50000,40000,0,0,0,0,0,1,0,18064,0,18064,3,19462,2000,17462,2,18854,0,18854,2,20380,2000,18380
11483,150000,120000,0,1,1,0,0,1,0,150145,6114,144031,0,150500,3500,147000,0,0,0,0,0,0,0,0
11484,50000,40000,0,0,0,0,0,1,-1,3220,3224,-4,-1,6592,6621,-29,-1,5085,5396,-311,-1,1050,1050,0
11485,310000,248000,0,0,0,0,0,0,0,47426,0,47426,2,48621,2000,46621,0,49743,1895,47848,0,50824,2000,48824
11486,20000,16000,0,0,0,0,0,1,-1,13936,14523,-587,-1,2816,2816,0,-1,7419,7419,0,-1,165,0,165
11487,260000,208000,0,1,0,0,0,0,0,226538,13805,212733,0,202887,7100,195787,0,195364,6952,188412,0,181206,12812,168394
11488,300000,240000,0,0,0,0,0,0,-2,0,0,0,-2,0,0,0,-2,0,0,0,-2,0,0,0
11489,10000,8000,0,0,0,1,1,0,0,7683,1143,6540,0,9040,1500,7540,0,9222,324,8898,0,9580,500,9080
11490,200000,160000,0,0,0,0,0,0,-1,9427,9427,0,-1,2040,2240,-200,-1,16338,16000,338,0,2076,2076,0
11491,30000,24000,0,0,0,0,0,0,0,17769,1300,16469,0,18107,1000,17107,0,18541,1200,17341,0,4770,2000,2770
11492,200000,160000,0,0,0,0,0,0,0,0,0,0,-2,0,0,0,-2,3533,3533,0,-1,4053,1000,3053
11493,420000,336000,0,0,0,0,0,0,-1,9090,9100,-10,-1,9622,9628,-6,-1,10223,10223,0,-1,3942,3942,0
11494,50000,40000,0,0,0,0,0,1,0,39455,4630,34825,0,38564,0,38564,3,37842,0,37842,2,40342,3105,37237
11495,60000,48000,0,1,1,1,1,0,0,59244,7000,52244,0,57889,0,57889,3,59017,2013,57004,2,56637,7577,49060
11496,70000,56000,0,0,0,0,0,0,0,40538,2449,38089,0,39489,2400,37089,0,11590,414,11176,0,11835,431,11404
11497,30000,24000,0,0,0,0,0,0,2,22478,3000,19478,2,24111,2300,21811,2,23447,0,23447,3,24951,2500,22451
11498,260000,208000,0,0,0,0,0,0,-2,825,1000,-175,-2,644,644,0,-2,819,1000,-181,-2,1294,1300,-6
11499,230000,184000,0,0,0,0,0,0,-2,248,248,0,-2,248,248,0,-2,248,248,0,-2,248,248,0
11500,10000,8000,0,1,1,1,1,0,0,10228,1153,9075,0,10432,357,10075,0,9839,501,9338,0,9859,429,9430
11501,240000,192000,0,0,0,0,0,1,-1,2632,2637,-5,-1,904,2,902,0,5559,5567,-8,-1,2748,8,2740
11502,70000,56000,0,0,0,0,0,0,0,51766,1800,49966,0,51757,2000,49757,0,50013,3140,46873,0,49946,2000,47946
11503,260000,208000,0,0,0,0,0,0,0,211483,10044,201439,0,153072,6000,147072,0,156149,5576,150573,0,144646,6000,138646
11504,130000,104000,0,1,1,0,0,0,0,129558,6000,123558,2,126907,5800,121107,0,99773,5800,93973,0,98086,2895,95191
11505,20000,16000,0,1,1,1,1,0,0,18942,1300,17642,0,20179,1500,18679,0,20204,2500,17704,0,20239,1000,19239
11506,360000,288000,0,0,0,0,0,0,-2,-59,0,-59,-2,11868,11927,-59,-2,-2,0,-2,-2,450,452,-2
11507,160000,128000,0,0,0,0,0,1,0,130038,5600,124438,0,79027,3715,75312,0,6666,6666,0,-1,6666,6666,0
11508,100000,80000,0,1,1,0,0,0,0,84998,1100,83898,2,85627,3000,82627,2,78245,3000,75245,0,79929,3100,76829
11509,50000,40000,0,1,1,0,0,0,0,48353,22,48331,2,47264,2154,45110,0,29325,1200,28125,0,31100,3450,27650
11510,20000,16000,0,0,1,1,1,0,2,19098,3200,15898,2,18397,0,18397,2,18696,700,17996,0,38282,700,37582
11511,30000,24000,0,1,1,1,0,1,0,25933,1800,24133,0,26319,1100,25219,0,28754,3000,25754,0,17491,500,16991
11512,150000,120000,0,0,0,1,1,0,-2,-4661,133122,-137783,-2,129847,136320,-6473,-1,131969,5001,126968,0,134515,5000,129515
11513,80000,64000,0,1,0,0,0,0,0,67337,3170,64167,0,60807,1940,58867,0,59088,2200,56888,0,47829,1700,46129
11514,180000,144000,0,1,1,0,0,1,0,166994,7758,159236,0,150812,5188,145624,0,123957,4570,119387,0,55778,1876,53902
11515,290000,232000,0,0,0,0,0,1,0,24815,3213,21602,0,24120,0,24120,2,25218,1616,23602,2,24855,0,24855
11516,240000,192000,0,1,1,0,0,0,0,242191,8000,234191,0,212879,7000,205879,0,185490,6000,179490,0,188850,6000,182850
11517,260000,208000,0,0,0,0,0,0,0,78041,1765,76276,0,55871,1304,54567,0,28775,772,28003,0,27497,930,26567
11518,80000,64000,0,1,0,0,0,0,0,72626,3003,69623,0,29012,2003,27009,0,28653,1146,27507,0,28398,1403,26995
11519,360000,288000,0,0,0,0,0,0,-2,0,0,0,-2,0,0,0,-2,0,0,0,-2,0,0,0
11520,130000,104000,0,1,0,0,0,1,0,113689,4600,109089,0,59473,3000,56473,0,-1518,0,-1518,0,-1518,0,-1518
11521,30000,24000,0,1,1,1,1,1,0,27822,1577,26245,0,28481,1626,26855,0,28265,800,27465,0,28852,814,28038
11522,300000,240000,0,0,0,0,0,0,-1,165,165,0,-1,165,165,0,-1,1759,1759,0,-1,1394,1394,0
11523,60000,48000,0,0,0,0,0,0,2,18862,19061,-199,-1,18145,20089,-1944,-1,20934,23019,-2085,-1,22146,22181,-35
11524,210000,168000,0,0,0,0,0,0,-2,0,0,0,-2,0,0,0,-2,0,0,0,-2,0,0,0
11525,20000,16000,0,1,1,1,1,0,0,17589,1300,16289,0,18945,1650,17295,0,36552,850,35702,0,18797,1500,17297
11526,260000,208000,0,0,0,0,0,1,0,24836,3000,21836,0,32816,10000,22816,0,42816,10000,32816,0,8938,8938,0
11527,140000,112000,0,0,0,0,0,1,-1,1446,1500,-54,-1,2880,3000,-120,-1,1914,1914,0,-1,968,0,968
11528,480000,384000,0,0,0,0,0,0,0,242500,30902,211598,0,185344,7410,177934,0,164256,6368,157888,0,168433,7323,161110
11529,50000,40000,0,0,0,0,0,0,0,36023,1426,34597,0,28967,1001,27966,0,29829,1432,28397,0,30046,1062,28984
11530,180000,144000,0,0,0,0,0,0,-1,4815,5860,-1045,-1,10060,11470,-1410,-1,49264,49613,-349,-1,5983,5983,0
11531,230000,184000,0,0,0,0,0,0,0,78875,3020,75855,0,76117,3000,73117,0,75428,2500,72928,0,150130,80000,70130
11532,130000,104000,0,0,0,0,0,0,-1,390,390,0,-1,390,390,0,-1,390,390,0,-1,390,390,0
11533,100000,80000,0,0,0,0,0,0,0,35828,1894,33934,0,36126,1582,34544,0,36587,1433,35154,0,36957,1486,35471
11534,210000,168000,0,0,0,0,0,0,-1,2429,1200,1229,-1,823,0,823,2,1089,1089,0,-1,1451,1201,250
11535,20000,16000,0,0,0,0,0,0,0,7832,1208,6624,0,8624,1000,7624,0,8800,176,8624,0,9300,500,8800
11536,10000,8000,0,0,0,0,0,1,0,4116,1073,3043,0,5280,1237,4043,0,5543,500,5043,0,5605,300,5305
11537,210000,168000,0,0,0,0,0,0,0,712,712,0,-1,1025,1000,25,0,4584,4000,584,0,0,0,0
11538,210000,168000,0,0,0,0,0,0,0,90648,4000,86648,0,93164,4000,89164,0,94167,10000,84167,0,97672,5000,92672
11539,20000,16000,0,1,1,1,1,0,0,18788,1700,17088,0,19177,1000,18177,0,21109,2400,18709,0,20474,0,20474
11540,150000,120000,0,0,0,0,0,0,-1,2232,2000,232,0,0,0,0,0,0,0,0,-2,0,0,0
11541,160000,128000,0,0,0,0,0,0,-1,697,697,0,-1,697,697,0,-1,895,895,0,-1,1341,1341,0
11542,80000,64000,0,0,0,0,0,0,0,55618,2019,53599,0,50345,2000,48345,0,52031,2500,49531,0,53141,2095,51046
11543,120000,96000,0,0,0,0,0,1,0,10861,1500,9361,0,10055,0,10055,2,11040,1100,9940,0,10466,550,9916
11544,50000,40000,0,0,0,0,0,0,0,30285,3053,27232,0,14225,2005,12220,0,12668,550,12118,0,10880,400,10480
11545,50000,40000,0,0,0,0,0,0,-1,7029,1459,5570,0,1734,1000,734,0,916,18,898,0,18864,18784,80
11546,170000,136000,0,0,0,0,0,0,-1,3967,3967,0,-1,592,0,592,2,864,864,0,-1,1738,1738,0
11547,20000,16000,0,0,1,1,1,0,2,18550,4675,13875,2,17867,0,17867,2,18072,701,17371,0,17899,563,17336
11548,200000,160000,0,0,0,0,0,0,0,9592,1411,8181,0,9585,2531,7054,0,8177,5007,3170,0,7136,507,6629
11549,90000,72000,0,0,0,0,0,1,2,28514,1800,26714,0,29733,2000,27733,0,30138,1200,28938,0,33248,3600,29648
11550,70000,56000,0,0,0,0,0,1,3,8611,0,8611,2,8879,400,8479,0,9746,1000,8746,0,8710,0,8710
11551,160000,128000,0,0,0,0,0,0,-2,0,0,0,-2,0,0,0,-2,0,0,0,-2,0,0,0
11552,30000,24000,0,0,0,0,0,0,-1,20517,1154,19363,0,13167,413,12754,0,10686,372,10314,0,10074,500,9574
11553,30000,24000,0,0,0,0,0,0,0,20430,3376,17054,0,25130,5076,20054,0,7746,8009,-263,-1,10583,6017,4566
11554,470000,376000,1,1,1,1,1,1,2,494290,20600,473690,0,470617,19000,451617,0,398523,14000,384523,0,389927,13600,376327
11555,480000,384000,0,0,0,0,0,1,-1,1759,1759,0,-1,1759,1759,0,-1,1759,1759,0,-1,1759,1759,0
11556,20000,16000,0,1,0,0,0,1,0,18083,1231,16852,0,15096,1244,13852,0,15396,544,14852,0,15720,565,15155
11557,200000,160000,0,0,0,0,0,0,-1,11657,11657,0,-1,9423,9423,0,-1,9726,9726,0,-1,11070,11070,0
11558,20000,16000,0,1,1,1,0,0,-2,21408,2000,19408,-2,21974,1200,20774,-2,22391,1000,21391,-2,27189,12000,15189
11559,180000,144000,0,0,0,0,0,0,-2,750,750,0,-2,1576,1576,0,-2,1504,1504,0,-2,0,0,0
11560,190000,152000,0,0,0,0,0,1,0,134379,5000,129379,0,142323,10000,132323,0,140120,0,140120,2,150052,12118,137934
11561,210000,168000,0,0,0,0,0,0,-1,28428,28428,0,-1,0,0,0,-1,0,0,0,-2,12000,12000,0
11562,70000,56000,0,1,0,0,0,0,0,69521,10128,59393,0,45001,4086,40915,0,37214,1348,35866,0,23807,13032,10775
11563,200000,160000,0,0,0,0,0,0,-2,-200,0,-200,-2,0,200,-200,-2,60800,60800,0,-2,0,0,0
11564,500000,400000,0,0,0,0,0,1,2,4957,0,4957,2,4957,0,4957,2,4957,0,4957,2,4957,0,4957
11565,290000,232000,0,0,0,0,0,1,0,238490,12915,225575,0,86202,2962,83240,0,83155,2863,80292,0,84927,2996,81931
11566,390000,312000,0,0,0,0,0,0,-1,70133,70159,-26,-1,63177,1264,61913,0,63670,493,63177,0,22407,22505,-98
11567,230000,184000,0,0,0,0,0,0,-1,3036,4000,-964,-1,4806,4806,0,-1,-1,0,-1,-1,1699,1700,-1
11568,80000,64000,0,0,0,0,0,0,0,57827,2050,55777,0,46390,1684,44706,0,45354,1564,43790,0,43112,1558,41554
11569,160000,128000,0,1,0,0,0,0,0,154012,25409,128603,0,151403,30000,121403,0,115731,5000,110731,0,113635,5000,108635
11570,200000,160000,0,0,0,0,0,0,-2,0,0,0,-2,0,0,0,-2,1675,1675,0,-2,69,69,0
11571,430000,344000,0,0,0,0,0,0,0,116749,6000,110749,0,118319,5000,113319,0,121351,5000,116351,0,125225,6000,119225
11572,500000,400000,0,0,0,0,0,0,0,386053,14000,372053,0,389008,14003,375005,0,392650,14011,378639,0,391336,15003,376333
11573,50000,40000,0,0,0,0,0,1,0,36272,1284,34988,0,11521,1060,10461,0,2678,100,2578,0,5468,99,5369
11574,500000,400000,0,0,0,0,0,0,0,107965,3789,104176,0,89339,3942,85397,0,67854,2433,65421,0,54918,10000,44918
11575,200000,160000,0,0,0,0,0,0,-1,670,673,-3,-1,0,0,0,-1,0,0,0,-2,868,868,0
11576,500000,400000,0,0,0,0,0,0,-1,1267,1267,0,-1,155951,155000,951,-1,159749,6000,153749,0,167416,10000,157416
11577,480000,384000,0,0,0,0,0,0,0,296399,15000,281399,0,314867,25000,289867,0,331653,22000,309653,0,324093,5000,319093
11578,50000,40000,0,0,0,0,0,0,-1,25998,1435,24563,0,26579,1406,25173,0,26710,927,25783,0,26871,952,25919
11579,80000,64000,0,0,0,0,0,0,0,12720,3000,9720,0,14169,2030,12139,0,13828,3000,10828,0,1664,1000,664
11580,240000,192000,0,0,0,0,0,0,0,55634,2400,53234,0,56628,2300,54328,0,58228,2300,55928,0,59985,2500,57485
11581,230000,184000,0,0,0,0,0,0,0,231164,130223,100941,0,120523,9953,110570,0,117102,4014,113088,0,116718,3307,113411
11582,230000,184000,0,0,0,0,0,0,-2,0,0,0,-2,0,0,0,-2,0,0,0,-2,300,300,0
11583,500000,400000,0,0,0,0,0,0,-1,380,380,0,-1,-270,22,-292,-2,2305,2575,-270,-1,2733,3009,-276
11584,130000,104000,0,1,0,0,0,0,0,105382,0,105382,2,49643,7000,42643,2,46812,0,46812,2,45914,2000,43914
11585,270000,216000,0,0,0,0,0,0,0,32602,5000,27602,0,9462,5000,4462,0,8835,5000,3835,0,8054,5000,3054
11586,200000,160000,0,0,0,0,0,0,-1,396,396,0,-1,396,396,0,-1,396,396,0,-1,396,396,0
11587,160000,128000,0,1,1,1,1,0,0,152714,4844,147870,0,141957,6368,135589,0,140605,3961,136644,0,143519,4086,139433
11588,80000,64000,0,0,0,0,0,0,-1,69841,79200,-9359,-1,59075,2108,56967,0,58998,2200,56798,0,61038,3006,58032
11589,160000,128000,0,0,0,0,0,0,-2,0,0,0,-2,0,0,0,-2,0,0,0,-2,0,0,0
11590,500000,400000,0,0,0,0,0,0,0,1558,1558,0,-1,310852,310852,0,-1,301854,10000,291854,0,133761,5000,128761
11591,20000,16000,0,0,0,0,0,0,2,1650,0,1650,4,1650,0,1650,4,1650,0,1650,4,1650,0,1650
11592,210000,168000,0,0,0,0,0,0,-1,7971,7994,-23,-1,-8,0,-8,-1,-8,0,-8,-2,-8,0,-8
11593,80000,64000,0,0,0,0,0,0,0,52472,2401,50071,0,53674,2581,51093,0,7886,1238,6648,0,16432,1816,14616
11594,240000,192000,0,1,1,1,1,0,0,238769,8922,229847,0,235603,8519,227084,0,233374,8499,224875,0,230897,8418,222479
11595,20000,16000,0,0,0,0,0,1,2,12738,1005,11733,2,11207,0,11207,2,6720,511,6209,0,5071,1283,3788
11596,360000,288000,0,0,0,0,0,0,-1,6085,6179,-94,-1,90872,90872,0,-1,81622,0,81622,0,11576,11576,0
11597,280000,224000,0,0,0,0,0,0,0,199360,6000,193360,0,193888,5334,188554,0,193132,5397,187735,0,188016,5400,182616
11598,130000,104000,0,0,0,0,0,0,0,66351,5000,61351,0,73399,10000,63399,0,71007,3000,68007,0,71253,3000,68253
11599,210000,168000,0,0,0,0,0,0,0,110716,3700,107016,0,97168,3505,93663,0,94524,3400,91124,0,96777,3769,93008
11600,390000,312000,0,0,0,0,0,0,0,79875,3500,76375,0,82853,4502,78351,0,82747,3518,79229,0,44143,2003,42140
11601,100000,80000,0,0,0,0,0,0,0,1261,4000,-2739,-1,1044,1044,0,-1,-217,0,-217,-1,522,2000,-1478
11602,280000,224000,0,0,0,0,0,0,-2,0,0,0,-2,1075,1075,0,-1,141246,141246,0,-1,146349,6349,140000
11603,40000,32000,0,0,0,0,0,1,2,9733,1172,8561,2,9375,0,9375,2,6003,500,5503,0,2435,1015,1420
11604,230000,184000,0,0,0,0,0,0,-2,399,399,0,-2,665,665,0,-2,576,576,0,-2,613,613,0
11605,200000,160000,0,0,0,0,0,0,-2,0,0,0,-2,0,0,0,-2,0,0,0,-2,0,0,0
11606,180000,144000,0,0,0,0,0,0,-2,0,0,0,-2,0,0,0,-2,0,0,0,-2,0,0,0
11607,330000,264000,0,0,0,0,0,0,-2,-10,0,-10,-2,-10,0,-10,-2,-10,0,-10,-2,-10,0,-10
11608,230000,184000,0,0,0,0,0,0,0,65380,2515,62865,0,66520,2370,64150,0,66343,2180,64163,0,63498,2500,60998
11609,60000,48000,0,0,0,0,0,1,0,18628,1290,17338,0,19002,664,18338,0,19715,1003,18712,0,18900,693,18207
11610,80000,64000,0,0,0,0,0,0,0,49457,1898,47559,0,49071,1985,47086,0,48242,1629,46613,0,47746,1655,46091
11611,80000,64000,0,0,0,0,0,0,0,51810,2355,49455,0,28964,1500,27464,0,13059,1000,12059,0,13488,646,12842
11612,120000,96000,0,0,0,0,0,0,0,74310,5000,69310,0,75710,3000,72710,0,77503,3000,74503,0,73945,4000,69945
11613,500000,400000,0,0,0,0,0,0,0,119701,5000,114701,0,121296,5000,116296,0,122477,5000,117477,0,125279,5000,120279
11614,420000,336000,0,0,0,0,0,0,-1,4352,4360,-8,-1,1440,2064,-624,-1,1486,1486,0,-1,2290,2290,0
11615,80000,64000,0,1,1,0,0,0,0,71532,2700,68832,0,71222,2200,69022,0,47538,2000,45538,0,48879,3443,45436
11616,50000,40000,0,0,0,0,1,0,0,36620,1950,34670,0,40767,5100,35667,0,41495,1700,39795,2,42377,1700,40677
11617,250000,200000,0,0,0,0,0,0,0,118668,0,118668,2,95735,3543,92192,0,96509,3700,92809,0,97089,3547,93542
11618,200000,160000,0,0,0,0,0,0,-1,735,735,0,-2,2301,2301,0,-1,3139,3139,0,-1,316,316,0
11619,130000,104000,0,0,0,0,0,0,0,65715,3000,62715,0,67523,5500,62023,0,68131,3000,65131,0,68140,3000,65140
11620,290000,232000,0,0,0,0,0,0,0,65710,5000,60710,0,69452,5000,64452,0,73627,5000,68627,0,77890,5000,72890
11621,300000,240000,0,0,0,0,0,0,2,1896,5,1891,2,1523,1527,-4,-1,2559,2569,-10,-1,2881,2889,-8
11622,320000,256000,0,0,0,0,0,0,0,7500,7500,0,-1,7500,7500,0,-1,7500,7500,0,-1,7500,7500,0
11623,560000,448000,0,0,0,0,0,1,0,379652,13510,366142,0,387706,14292,373414,0,334908,11553,323355,0,341884,12130,329754
11624,180000,144000,0,0,0,0,0,1,0,59497,3000,56497,0,60356,3000,57356,0,60209,2500,57709,0,60522,2500,58022
11625,80000,64000,0,0,0,0,0,0,-1,17709,3015,14694,0,15631,2008,13623,0,13402,1009,12393,0,13197,2005,11192
11626,160000,128000,0,0,0,0,0,0,-1,0,0,0,-1,0,0,0,-2,0,0,0,-2,150,150,0
11627,50000,40000,0,0,0,0,0,0,0,23627,2000,21627,0,24827,2000,22827,0,25521,1500,24021,0,26523,2000,24523
11628,50000,40000,0,0,0,0,0,0,0,9847,1106,8741,0,5892,1000,4892,0,6413,1000,5413,0,6915,1000,5915
11629,60000,48000,0,0,0,1,1,0,0,48293,6803,41490,0,49311,1821,47490,0,50290,1800,48490,0,51346,1866,49480
11630,50000,40000,0,0,0,0,0,0,0,20279,1360,18919,0,19816,1233,18583,0,18711,601,18110,0,17598,591,17007
11631,360000,288000,0,0,0,0,0,0,-1,658,661,-3,-1,1095,1100,-5,-1,4948,4953,-5,-1,3861,19,3842
11632,160000,128000,0,0,0,0,0,1,-2,0,0,0,-2,0,0,0,-2,0,0,0,-2,0,0,0
11633,50000,40000,0,1,1,1,1,1,2,48082,1000,47082,2,51969,5000,46969,2,50865,0,50865,3,49611,0,49611
11634,20000,16000,0,0,0,0,0,0,0,4988,0,4988,2,11680,102,11578,0,6590,1500,5090,0,0,0,0
11635,100000,80000,0,0,0,0,0,0,-2,0,0,0,-2,1378,1378,0,-1,1209,0,1209,2,3174,2000,1174
11636,120000,96000,0,1,1,0,0,0,0,103108,5369,97739,0,100953,4014,96939,0,83739,1000,82739,0,51424,1000,50424
11637,320000,256000,0,0,0,0,0,0,0,0,0,0,0,2615,2615,0,-1,221073,228975,-7902,-1,225361,8176,217185
11638,360000,288000,0,0,0,0,0,0,-1,9744,3001,6743,0,89215,80000,9215,0,98256,10500,87756,0,99145,5000,94145
11639,20000,16000,0,0,1,1,1,0,0,17012,1299,15713,0,17992,1279,16713,0,18350,637,17713,0,18738,663,18075
11640,20000,16000,0,0,1,1,1,0,0,16628,1277,15351,0,16958,607,16351,0,17314,629,16685,0,17664,638,17026
11641,270000,216000,0,0,0,0,0,0,0,132405,7028,125377,0,131241,4728,126513,0,127080,5037,122043,0,122213,4530,117683
11642,230000,184000,0,0,0,0,0,0,-1,14019,14019,0,-1,1045,1045,0,-1,12525,12525,0,-1,12219,244,11975
11643,50000,40000,0,0,0,0,0,0,-2,190,190,0,-1,0,0,0,-1,36059,36059,0,-1,32851,0,32851
11644,80000,64000,0,0,0,0,0,0,0,1155,1155,0,-1,-144,0,-144,-1,57245,59000,-1755,-1,49947,2061,47886
11645,250000,200000,0,0,0,0,0,1,2,108995,0,108995,2,84196,3100,81096,0,95286,12500,82786,0,93613,0,93613
11646,170000,136000,0,0,0,0,0,0,-1,3732,3732,0,-1,3732,3732,0,-1,4239,4239,0,-1,3910,3910,0
11647,280000,224000,0,0,0,0,0,0,-2,5612,6100,-488,-1,6917,4000,2917,0,10247,3500,6747,0,11822,2500,9322
11648,50000,40000,0,0,0,0,0,0,-1,697,697,0,-1,364,364,0,-1,0,0,0,-2,760,760,0
11649,80000,64000,0,1,0,0,0,0,0,78102,3177,74925,0,58501,2600,55901,0,51042,3000,48042,0,19036,1691,17345
11650,80000,64000,0,0,0,0,0,0,-1,4822,4822,0,-1,4918,324,4594,0,5188,500,4688,0,5797,700,5097
11651,500000,400000,0,0,0,0,0,0,-2,0,0,0,-2,989,989,0,-2,0,0,0,-2,0,0,0
11652,80000,64000,0,0,0,0,0,0,0,47950,2100,45850,0,48869,2001,46868,0,49445,2001,47444,0,49979,2000,47979
11653,240000,192000,0,1,0,0,0,0,0,231230,12000,219230,0,196471,7000,189471,0,190004,8000,182004,0,161867,6000,155867
11654,300000,240000,0,0,0,0,0,0,-2,0,0,0,-2,0,0,0,-2,0,0,0,-2,0,0,0
11655,210000,168000,0,0,0,0,0,0,0,73874,5000,68874,0,73219,5000,68219,0,96844,30000,66844,0,94731,4500,90231
11656,50000,40000,0,0,0,0,0,1,2,27483,0,27483,2,27728,1000,26728,0,29681,2400,27281,0,29053,0,29053
11657,30000,24000,0,1,1,1,1,0,0,29437,1436,28001,0,27738,1120,26618,0,27268,995,26273,0,27409,989,26420
11658,20000,16000,0,1,1,1,0,0,0,19907,1500,18407,0,19349,607,18742,0,17484,1360,16124,0,-1216,1300,-2516
11659,20000,16000,0,0,0,0,0,1,0,2060,1000,1060,0,780,780,0,-1,1000,1000,0,-1,0,0,0
11660,240000,192000,0,1,1,1,1,1,0,214642,9150,205492,0,207642,8008,199634,0,210375,8000,202375,0,214694,8009,206685
11661,200000,160000,0,0,0,0,0,0,-2,0,0,0,-2,0,0,0,-2,0,0,0,-2,0,0,0
11662,100000,80000,0,0,0,0,0,0,0,47184,1728,45456,0,46836,1641,45195,0,46529,1673,44856,0,47070,1689,45381
11663,400000,320000,0,0,0,0,0,0,2,52727,4500,48227,2,51286,0,51286,2,55077,4800,50277,2,55500,1600,53900
11664,10000,8000,0,0,0,0,0,1,0,4525,500,4025,2,5450,1000,4450,2,5073,0,5073,3,4843,0,4843
11665,240000,192000,0,0,0,0,0,1,2,264,264,0,-1,264,264,0,-1,264,264,0,-1,414,414,0
11666,200000,160000,0,0,0,0,0,0,0,14328,6000,8328,0,16222,3000,13222,0,9915,2003,7912,0,11226,3101,8125
11667,30000,24000,0,1,1,1,1,0,0,29698,1466,28232,0,31157,2501,28656,0,31714,1759,29955,2,30496,0,30496
11668,320000,256000,0,0,0,0,0,0,0,100407,6000,94407,0,88717,7000,81717,0,179,2,177,0,-336,0,-336
11669,190000,152000,0,0,0,0,0,0,2,89722,4413,85309,0,69861,2942,66919,0,49894,2000,47894,0,49727,1583,48144
11670,50000,40000,0,1,0,0,0,0,0,49175,2158,47017,0,21944,927,21017,0,20142,696,19446,0,18728,1000,17728
11671,60000,48000,0,0,0,0,0,1,-1,34812,3000,31812,0,15768,3020,12748,0,25915,25915,0,-1,25058,1500,23558
11672,30000,24000,0,0,0,0,0,0,-2,2605,2610,-5,-1,893,18,875,0,895,2,893,0,2328,2333,-5
11673,240000,192000,0,0,0,0,0,0,-1,48595,49000,-405,-1,37573,37573,0,-1,26296,26296,0,-1,15788,7000,8788
11674,310000,248000,0,0,0,0,0,0,0,66624,5500,61124,0,48213,4000,44213,0,144758,100000,44758,0,601,601,0
11675,130000,104000,0,0,0,1,0,1,0,103618,5600,98018,0,107525,7800,99725,0,104042,0,104042,2,100190,3900,96290
11676,130000,104000,0,0,0,0,0,0,0,100455,0,100455,2,38632,1500,37132,0,35826,1395,34431,0,36730,1500,35230
11677,10000,8000,0,0,0,0,0,0,0,7540,1022,6518,0,8164,1036,7128,0,6963,0,6963,2,5923,2700,3223
11678,100000,80000,0,1,1,0,0,1,2,97624,8806,88818,2,94316,0,94316,2,2065,2065,0,-1,0,0,0
11679,180000,144000,0,0,0,0,0,0,-1,7184,7184,0,-1,7184,7184,0,-1,7344,7344,0,-1,7184,7184,0
11680,550000,440000,0,0,1,0,0,1,0,548020,167622,380398,0,530672,14000,516672,0,155083,4300,150783,0,165975,158064,7911
11681,50000,40000,0,1,1,1,1,1,0,46394,2275,44119,0,47865,2398,45467,0,47455,1336,46119,0,48426,1366,47060
11682,20000,16000,0,0,0,0,0,0,-1,390,390,0,-1,540,540,0,-1,540,540,0,-1,540,540,0
11683,280000,224000,0,0,0,0,0,0,-1,3190,3203,-13,-1,1982,1992,-10,-1,3590,3608,-18,-1,3590,3600,-10
11684,70000,56000,0,0,0,0,0,0,2,37026,0,37026,8,38922,2500,36422,7,38318,0,38318,7,38133,1000,37133
11685,50000,40000,0,0,0,0,0,0,0,6595,1000,5595,2,8400,2000,6400,0,4041,1000,3041,0,4815,1000,3815
11686,50000,40000,0,0,0,0,0,0,2,14308,2000,12308,0,14769,1000,13769,0,15925,1542,14383,0,15441,764,14677
11687,500000,400000,0,0,0,0,0,0,-2,9073,9083,-10,-2,5714,6105,-391,-2,31868,31868,0,-2,3663,3663,0
11688,200000,160000,0,0,0,0,0,0,2,74015,8024,65991,0,54472,5000,49472,0,50540,8000,42540,0,46486,1821,44665
11689,20000,16000,0,0,0,0,0,0,0,15292,1500,13792,0,16509,1506,15003,0,12261,452,11809,0,14550,2500,12050
11690,30000,24000,0,0,0,0,0,1,-1,264,264,0,-1,0,0,0,-1,528,528,0,-1,0,0,0
11691,300000,240000,0,1,0,0,0,1,0,279570,9483,270087,0,241030,8172,232858,0,228125,8081,220044,0,215438,7707,207731
11692,370000,296000,0,0,0,0,0,0,0,204503,9599,194904,0,201259,8683,192576,0,157159,6970,150189,0,152357,56032,96325
11693,50000,40000,0,0,0,0,0,0,2,34519,1466,33053,0,33965,1282,32683,0,33273,1293,31980,0,31960,1257,30703
11694,200000,160000,0,0,0,0,0,0,0,0,0,0,-2,0,0,0,-2,1000,1000,0,-1,0,0,0
11695,20000,16000,0,0,0,0,0,1,0,11834,0,11834,3,11180,0,11180,2,780,0,780,0,1170,0,1170
11696,120000,96000,0,1,0,0,0,0,0,120013,3538,116475,0,77539,3000,74539,0,77333,3000,74333,0,79113,3000,76113
11697,70000,56000,0,0,0,0,0,0,0,21859,1600,20259,0,22445,949,21496,0,22935,1000,21935,0,23404,1000,22404
11698,340000,272000,0,0,0,0,0,0,-2,-212,0,-212,-2,-212,0,-212,-2,-212,0,-212,-2,-212,0,-212
11699,330000,264000,0,0,0,0,0,0,0,175958,6386,169572,0,178468,6435,172033,0,181544,7000,174544,0,184338,6688,177650
11700,290000,232000,0,0,0,0,0,0,0,107735,4005,103730,0,100195,4000,96195,0,84268,3000,81268,0,76356,2928,73428
11701,180000,144000,0,0,0,0,0,0,0,30820,1735,29085,0,23852,1385,22467,0,17902,30,17872,0,7784,23,7761
11702,400000,320000,0,0,0,0,0,0,-1,8744,8853,-109,-1,11640,11816,-176,-1,41432,41432,0,-1,20075,20974,-899
11703,50000,40000,0,0,0,0,0,1,-1,416,0,416,2,3285,3285,0,-1,2685,0,2685,2,2270,190,2080
11704,100000,80000,0,0,0,0,0,1,2,59478,4817,54661,2,54336,6,54330,2,50640,1700,48940,0,49113,3650,45463
11705,180000,144000,0,0,0,0,0,0,0,99127,5000,94127,0,100581,4000,96581,0,102800,4000,98800,0,104931,4000,100931
11706,350000,280000,0,0,0,0,0,0,-2,36140,36532,-392,-2,34022,34022,0,-2,26366,20000,6366,-2,67650,117650,-50000
11707,80000,64000,0,1,0,0,0,0,0,79183,2418,76765,0,64862,2118,62744,0,58651,2066,56585,0,55230,2150,53080
11708,30000,24000,0,1,1,1,1,0,2,28609,3500,25109,2,28945,1100,27845,2,28181,0,28181,2,29329,1600,27729
11709,60000,48000,0,0,0,0,0,0,-2,0,0,0,-2,0,0,0,-2,0,0,0,-2,0,0,0
11710,100000,80000,0,0,0,0,0,0,2,36537,0,36537,2,37474,2000,35474,0,38732,2000,36732,0,39234,1000,38234
11711,330000,264000,0,0,0,0,0,0,0,222040,8100,213940,0,218852,8500,210352,0,203312,7400,195912,0,196266,7200,189066
11712,160000,128000,0,0,0,0,0,0,0,79129,3800,75329,0,80710,3500,77210,0,82749,3500,79249,0,84871,3500,81371
11713,20000,16000,0,1,1,1,0,0,0,19763,1306,18457,0,20240,2000,18240,0,18955,0,18955,2,15255,800,14455
11714,150000,120000,0,0,0,0,0,0,0,94545,3516,91029,0,93810,3003,90807,0,82668,2578,80090,0,64924,2300,62624
11715,400000,320000,0,0,0,0,0,1,-1,8834,8834,0,-1,57959,50000,7959,-1,49590,0,49590,2,22972,8695,14277
11716,90000,72000,0,0,0,0,0,0,-1,628,628,0,-1,284,284,0,-1,1055,1055,0,-1,2607,2607,0
11717,180000,144000,0,0,0,0,0,0,0,15737,2000,13737,0,16603,1500,15103,0,17395,1003,16392,0,17182,1003,16179
11718,60000,48000,0,1,1,1,1,0,4,59111,3601,55510,4,59595,2000,57595,5,58079,0,58079,4,56892,0,56892
11719,50000,40000,0,1,1,0,0,1,0,51060,2412,48648,0,50033,5178,44855,0,9298,5500,3798,0,7877,500,7377
11720,40000,32000,0,0,0,1,1,0,2,32183,390,31793,2,38897,8000,30897,2,40234,2500,37734,2,40536,1500,39036
11721,190000,152000,0,1,1,1,1,0,0,181463,8008,173455,0,178984,6700,172284,0,175131,6800,168331,0,170136,6324,163812
11722,30000,24000,0,0,0,0,0,0,2,13892,900,12992,2,14369,1000,13369,2,15333,1200,14133,0,16289,1200,15089
11723,270000,216000,0,0,0,0,0,0,0,171057,7009,164048,0,163865,7506,156359,0,167289,10007,157282,0,167928,6007,161921
11724,20000,16000,0,0,0,0,0,1,3,16511,2000,14511,2,15953,0,15953,2,16190,800,15390,0,16777,1000,15777
11725,20000,16000,0,0,0,0,0,0,-1,460,460,0,-1,360,360,0,-1,1520,1520,0,-1,1160,0,1160
11726,360000,288000,0,0,0,0,0,0,-2,390,780,-390,-1,540,540,0,-1,540,540,0,-1,390,390,0
11727,220000,176000,0,0,0,0,0,0,0,131090,5892,125198,0,121259,5000,116259,0,117003,4369,112634,0,116902,4178,112724
11728,360000,288000,0,0,0,0,0,1,2,2500,0,2500,2,2500,0,2500,2,2500,0,2500,2,2500,0,2500
11729,240000,192000,0,0,0,0,0,1,2,0,0,0,-2,0,0,0,-2,0,0,0,-2,0,0,0
11730,140000,112000,1,1,1,0,0,0,5,144280,0,144280,4,139701,0,139701,3,90756,0,90756,2,92935,3000,89935
11731,480000,384000,0,0,0,0,0,0,0,71931,2602,69329,0,73362,2618,70744,0,74897,2709,72188,0,76461,2800,73661
11732,280000,224000,0,0,0,0,0,0,0,146652,7200,139452,0,132527,5886,126641,0,70421,3000,67421,0,60235,5000,55235
11733,10000,8000,0,0,0,0,0,0,0,-10,0,-10,0,6390,6400,-10,-1,6682,400,6282,0,7271,700,6571
11734,80000,64000,0,0,0,0,0,1,0,33696,2000,31696,0,40092,7000,33092,0,40946,1482,39464,0,41588,2501,39087
11735,180000,144000,0,0,0,0,0,0,0,94808,5002,89806,0,89137,3153,85984,0,88637,5000,83637,0,84966,3037,81929
11736,160000,128000,0,0,0,0,0,0,-2,0,0,0,-2,0,0,0,-2,0,0,0,-2,0,0,0
11737,230000,184000,0,0,0,0,0,0,-2,-73,0,-73,-2,-73,0,-73,-2,7723,7796,-73,-2,0,0,0
11738,50000,40000,0,0,0,0,0,0,0,12592,1099,11493,0,5022,1009,4013,0,780,10000,-9220,0,390,0,390
11739,300000,240000,0,0,0,0,0,1,0,2318,0,2318,2,3792,3792,0,-1,11977,11977,0,-1,29127,29127,0
11740,80000,64000,0,1,1,1,1,1,0,78206,3700,74506,0,72040,3000,69040,0,73733,3000,70733,0,75309,2793,72516
11741,140000,112000,0,0,0,0,0,1,0,22940,2000,20940,0,19068,2198,16870,0,16409,1000,15409,0,16383,3000,13383
11742,110000,88000,0,0,0,0,0,0,-2,-18,0,-18,-2,-18,0,-18,-2,-18,0,-18,-2,-18,0,-18
11743,160000,128000,0,0,0,0,0,0,-1,622,700,-78,-1,-10,0,-10,-1,326,652,-326,-1,326,0,326
11744,60000,48000,1,1,1,0,0,1,0,66510,3000,63510,0,58622,2292,56330,0,47317,1526,45791,0,48726,2000,46726
11745,90000,72000,0,0,0,0,0,0,0,9940,1176,8764,0,11264,1500,9764,0,12774,2000,10774,0,13038,609,12429
11746,130000,104000,0,0,0,0,0,0,-1,206,206,0,-1,3265,3265,0,-1,5661,3000,2661,0,7026,2000,5026
11747,280000,224000,0,0,0,0,0,0,-1,44707,3045,41662,0,39607,5028,34579,0,37542,5034,32508,0,34812,5024,29788
11748,360000,288000,0,0,0,1,0,0,2,284059,0,284059,2,294308,15000,279308,2,297916,5800,292116,2,279503,0,279503
11749,50000,40000,0,0,0,0,0,0,0,17678,2000,15678,0,18658,1290,17368,0,18784,806,17978,0,18779,824,17955
11750,130000,104000,0,0,0,0,0,1,0,10467,2000,8467,0,10067,0,10067,0,12567,2500,10067,0,12567,0,12567
11751,230000,184000,0,0,0,0,0,0,-1,8508,8508,0,-1,-853,0,-853,-1,13909,19000,-5091,-1,29160,19160,10000
11752,50000,40000,0,1,1,1,1,0,0,44899,2100,42799,0,46346,2500,43846,0,47273,2000,45273,0,48357,2000,46357
11753,300000,240000,0,0,0,0,0,0,-1,-200,0,-200,-2,-200,0,-200,-2,-200,0,-200,-2,-200,0,-200
11754,500000,400000,0,0,0,0,0,0,0,20424,19629,795,0,7840,157,7683,0,846,0,846,0,790,790,0
11755,80000,64000,0,0,0,0,0,0,0,4802,1075,3727,0,3086,1000,2086,0,1726,35,1691,0,1015,1015,0
11756,50000,40000,0,1,1,0,1,0,0,49293,1595,47698,0,47154,1526,45628,0,50069,13000,37069,0,50442,1569,48873
11757,250000,200000,0,0,0,0,0,1,0,71453,3000,68453,0,54063,2000,52063,0,52723,3500,49223,0,56752,5000,51752
11758,50000,40000,0,0,0,0,0,0,0,21904,3264,18640,0,21243,0,21243,2,20225,846,19379,0,19850,856,18994
11759,130000,104000,0,0,0,0,0,0,0,26491,10048,16443,0,19038,8000,11038,0,22297,5000,17297,0,25986,6000,19986
11760,150000,120000,0,0,0,0,0,0,0,11145,5000,6145,0,15690,5000,10690,0,17875,7875,10000,0,24590,13000,11590
11761,60000,48000,0,0,0,0,0,0,-2,780,780,0,-1,0,0,0,-1,0,0,0,-2,0,0,0
11762,180000,144000,0,0,0,0,0,0,0,8441,1500,6941,0,7142,7500,-358,-1,-679,679,-1358,-1,8321,9000,-679
11763,100000,80000,1,1,0,0,0,1,0,100818,247,100571,2,75860,3000,72860,0,77656,3000,74656,0,78274,3000,75274
11764,60000,48000,0,0,0,0,0,0,0,43427,2000,41427,0,30408,4300,26108,0,30632,1000,29632,2,30021,0,30021
11765,100000,80000,0,1,1,1,1,0,0,86400,3881,82519,0,87275,2500,84775,0,89082,2519,86563,0,91030,2700,88330
11766,80000,64000,0,0,0,0,0,0,2,47522,2000,45522,2,48373,2000,46373,2,47442,0,47442,2,50501,4000,46501
11767,450000,360000,0,0,0,0,0,0,-1,0,0,0,-1,0,0,0,-2,0,0,0,-2,144,144,0
11768,20000,16000,1,1,1,1,1,1,0,20057,2,20055,2,19583,687,18896,0,19991,709,19282,0,20446,965,19481
11769,500000,400000,0,0,0,0,0,0,-2,0,0,0,-2,0,0,0,-2,0,0,0,-2,200,200,0
11770,100000,80000,0,0,0,0,0,0,0,8197,1500,6697,0,9203,2000,7203,0,3815,1000,2815,0,5493,2493,3000
11771,260000,208000,0,0,0,0,0,0,-1,0,0,0,-2,0,0,0,-2,0,0,0,-2,0,0,0
11772,150000,120000,0,0,1,1,1,0,-1,151996,156292,-4296,-1,152753,4700,148053,0,153844,5019,148825,0,151252,5300,145952
11773,230000,184000,0,0,0,0,0,0,0,31917,1600,30317,0,33361,2000,31361,0,34056,1500,32556,0,32353,1500,30853
11774,300000,240000,0,0,0,0,0,0,0,11970,11979,-9,-1,10292,206,10086,0,10116,10,10106,0,829,4,825
11775,50000,40000,0,0,0,0,0,0,0,19819,6000,13819,0,18567,0,18567,2,23535,5630,17905,0,28620,6000,22620
11776,150000,120000,0,0,0,0,0,0,-2,0,0,0,-2,0,0,0,-2,0,0,0,-2,0,0,0
11777,30000,24000,0,0,0,0,0,0,2,300,0,300,7,300,0,300,7,300,0,300,7,300,0,300
11778,150000,120000,0,0,0,0,0,0,2,2756,2772,-16,2,0,0,0,-2,2430,2430,0,-1,4840,4844,-4
11779,100000,80000,0,0,0,0,0,0,2,14967,3000,11967,0,16773,2000,14773,0,16427,0,16427,2,19053,3000,16053
11780,360000,288000,0,0,0,0,0,1,-2,0,0,0,-2,0,0,0,-2,0,0,0,-2,0,0,0
11781,140000,112000,0,0,0,0,0,0,0,64018,3221,60797,0,64656,2066,62590,0,65341,1864,63477,0,66277,1895,64382
11782,20000,16000,0,0,0,0,0,0,0,11789,2000,9789,0,11200,1200,10000,0,13244,2244,11000,0,13539,506,13033
11783,70000,56000,0,1,1,1,1,0,2,71307,6124,65183,2,71977,2500,69477,2,70306,0,70306,2,71161,5300,65861
11784,150000,120000,0,1,1,1,1,0,0,128706,3700,125006,0,131333,3719,127614,0,133974,3756,130218,0,136907,4031,132876
11785,140000,112000,0,0,0,0,0,1,0,81545,3700,77845,0,81454,2000,79454,0,60176,3000,57176,0,79728,20000,59728
11786,160000,128000,0,0,0,0,0,0,-1,-928,0,-928,-1,1619,2547,-928,-1,928,0,928,0,0,0,0
11787,30000,24000,0,0,0,0,0,0,2,13225,3000,10225,0,16952,5000,11952,0,11920,1000,10920,0,0,0,0
11788,120000,96000,0,0,0,0,0,0,-1,3858,3858,0,-1,6849,6849,0,-1,2616,2616,0,-1,2805,2805,0
11789,100000,80000,0,0,0,0,0,0,0,36030,1673,34357,0,37173,1816,35357,0,35875,1213,34662,0,36263,1248,35015
11790,80000,64000,0,1,1,0,0,0,0,73953,3501,70452,0,69366,2500,66866,0,57435,2000,55435,0,39322,2000,37322
11791,80000,64000,0,1,1,1,1,1,2,71459,5000,66459,2,73690,4000,69690,3,71908,0,71908,3,76294,5700,70594
11792,60000,48000,0,1,1,1,1,0,2,52817,3000,49817,0,57954,8500,49454,0,56556,0,56556,2,55220,4000,51220
11793,130000,104000,0,0,0,0,0,0,0,61156,2908,58248,0,62377,2129,60248,0,63832,2354,61478,0,65099,2366,62733
11794,50000,40000,0,0,0,0,0,0,0,23927,1507,22420,0,0,0,0,0,83,83,0,-1,20083,20000,83
11795,320000,256000,0,0,0,0,0,0,0,125866,4919,120947,0,130067,6246,123821,0,131128,4395,126733,0,124469,4524,119945
11796,360000,288000,0,0,0,0,0,0,-1,15452,15485,-33,-1,9990,9995,-5,-1,6515,6515,0,-1,5694,5694,0
11797,100000,80000,0,0,0,0,0,0,0,18306,0,18306,2,18239,1274,16965,2,17053,0,17053,2,16753,754,15999
11798,80000,64000,0,0,0,0,0,1,2,50051,1828,48223,0,51123,1900,49223,0,52175,1900,50275,0,53337,2000,51337
11799,240000,192000,0,0,0,0,0,0,-2,9625,9625,0,-2,8864,0,8864,-2,9248,9248,0,-2,23353,23353,0
11800,170000,136000,0,0,0,0,0,0,-1,6779,6779,0,-1,3416,2000,1416,0,2941,97,2844,0,3518,1002,2516
11801,180000,144000,0,0,0,0,0,0,-1,29366,29366,0,-1,5400,54,5346,0,0,0,0,0,1599,1599,0
11802,200000,160000,0,0,0,0,0,1,-2,0,0,0,-2,0,0,0,-2,2330,2330,0,-1,0,0,0
11803,220000,176000,0,0,0,0,0,0,0,29254,1500,27754,0,24875,1100,23775,0,20329,1000,19329,0,15602,600,15002
11804,260000,208000,0,0,0,0,0,1,-1,208,208,0,-1,208,208,0,-1,208,208,0,-1,208,208,0
11805,260000,208000,0,0,0,0,0,0,0,91908,6000,85908,0,90857,5020,85837,0,-81334,81569,-162903,0,142645,331788,-189143
11806,230000,184000,0,0,0,0,0,0,0,11748,1300,10448,0,12269,1200,11069,0,12102,500,11602,0,12414,500,11914
11807,160000,128000,0,0,0,0,0,0,-2,997,1003,-6,-2,1798,1804,-6,-1,800,202,598,0,0,0,0
11808,500000,400000,0,0,0,0,0,0,0,77282,5000,72282,0,80977,5000,75977,0,84609,5000,79609,0,88073,5000,83073
11809,20000,16000,0,0,0,0,0,0,0,6870,1000,5870,0,0,0,0,0,2734,1367,1367,-1,0,0,0
11810,290000,232000,0,0,0,0,0,0,-1,83289,83289,0,-1,82889,0,82889,0,82889,0,82889,0,1964,0,1964
11811,20000,16000,1,1,1,1,1,1,0,35110,1320,33790,0,19495,2260,17235,0,19019,784,18235,0,18134,1000,17134
11812,50000,40000,0,1,1,0,0,1,0,44121,1632,42489,0,43360,1113,42247,0,40555,1336,39219,0,31309,3142,28167
11813,50000,40000,0,1,0,0,0,0,0,44765,3000,41765,0,31240,2000,29240,0,20343,3007,17336,0,12349,1003,11346
11814,170000,136000,0,0,0,0,0,0,-1,500,500,0,-1,2499,2499,0,-1,1500,1500,0,-1,600,600,0
11815,50000,40000,0,0,0,0,0,0,0,21549,3000,18549,0,26163,5000,21163,0,26684,956,25728,0,27753,1500,26253
11816,50000,40000,0,1,0,0,0,0,0,49350,2248,47102,0,26499,1332,25167,0,21071,544,20527,0,18713,713,18000
11817,80000,64000,0,0,0,0,0,0,0,38141,1905,36236,0,38190,1350,36840,0,38586,1388,37198,0,39962,2401,37561
11818,10000,8000,0,0,0,0,0,1,0,0,0,0,-2,0,0,0,-2,0,0,0,-2,0,0,0
11819,100000,80000,0,0,0,0,0,0,-2,1531,1531,0,-1,0,4886,-4886,-1,1799,1799,0,-1,0,0,0
11820,110000,88000,0,0,0,0,0,1,2,56279,2056,54223,0,24271,1200,23071,0,52040,2300,49740,0,25453,0,25453
11821,50000,40000,0,1,0,0,0,0,2,45385,82,45303,2,17912,1500,16412,0,31278,10000,21278,0,14818,1062,13756
11822,360000,288000,0,0,0,0,0,0,-2,0,0,0,-2,2580,2580,0,-1,2580,0,2580,0,6941,6941,0
11823,50000,40000,0,0,0,0,0,0,0,31924,1699,30225,0,19682,1600,18082,0,19989,901,19088,0,20452,1500,18952
11824,240000,192000,0,0,0,0,0,0,0,66323,3000,63323,0,70422,5200,65222,0,69170,0,69170,2,71018,3000,68018
11825,20000,16000,0,0,0,0,1,1,0,14870,1300,13570,0,16116,1500,14616,0,16436,588,15848,0,16781,610,16171
11826,220000,176000,0,0,0,0,0,0,-2,81677,220230,-138553,-1,46177,7308,38869,0,3308,0,3308,0,2912,2912,0
11827,90000,72000,0,0,0,0,0,1,2,29364,1500,27864,2,28596,0,28596,2,30120,2000,28120,0,31285,1650,29635
11828,20000,16000,0,1,0,0,0,0,0,18000,1000,17000,0,20000,20000,0,-1,0,0,0,-1,780,390,390
11829,150000,120000,0,0,0,0,0,0,-2,3960,7920,-3960,-1,10410,10426,-16,-1,2361,0,2361,0,2868,2868,0
11830,430000,344000,0,1,0,1,0,0,0,399755,15140,384615,0,357082,15000,342082,0,363968,12565,351403,0,346718,15000,331718
11831,360000,288000,0,0,0,0,0,0,0,246380,10500,235880,0,236139,8500,227639,0,241056,8750,232306,0,246297,9200,237097
11832,50000,40000,0,0,0,0,1,0,0,38931,4000,34931,0,38006,0,38006,2,44357,7000,37357,2,43516,0,43516
11833,130000,104000,0,0,0,0,0,0,0,0,0,0,0,0,0,0,-2,0,0,0,-2,0,0,0
11834,20000,16000,0,1,1,1,1,0,0,19864,2000,17864,0,20181,1000,19181,0,20210,710,19500,0,20043,1043,19000
11835,420000,336000,0,0,0,0,0,0,-1,21610,1118,20492,0,10654,10658,-4,-1,4427,6341,-1914,-1,1800,0,1800
11836,150000,120000,1,1,0,0,0,0,0,239410,5419,233991,0,39584,1009,38575,0,32815,1120,31695,0,35626,5000,30626
11837,80000,64000,0,0,0,0,0,0,-1,0,0,0,-1,0,0,0,-2,0,0,0,-2,0,0,0
11838,20000,16000,0,0,0,0,0,0,0,10162,1811,8351,0,9852,0,9852,2,10418,876,9542,2,10102,0,10102
11839,400000,320000,0,0,0,0,0,0,-1,2375,2387,-12,-1,1211,1127,84,0,6661,6694,-33,-1,517,519,-2
11840,80000,64000,0,1,1,1,1,0,0,77025,4000,73025,0,76991,3000,73991,0,79066,3500,75566,0,75356,3100,72256
11841,90000,72000,0,0,0,0,0,0,0,38448,1866,36582,0,37612,1347,36265,0,36174,1065,35109,0,33769,1041,32728
11842,70000,56000,0,0,0,0,0,0,0,30777,3000,27777,0,30155,1005,29150,0,14298,2000,12298,0,1579,1579,0
11843,150000,120000,0,0,0,0,0,1,0,17118,3000,14118,0,16546,0,16546,2,20052,3800,16252,2,20385,800,19585
11844,110000,88000,0,0,0,0,0,0,-2,0,0,0,-2,0,0,0,-2,0,0,0,-2,0,0,0
11845,200000,160000,0,0,0,0,0,0,-1,14122,14122,0,-1,27413,23007,4406,0,35377,7212,28165,-1,29922,29922,0
11846,340000,272000,0,0,0,0,0,0,0,20391,5012,15379,0,22104,5000,17104,0,26361,5006,21355,0,34333,10010,24323
11847,500000,400000,0,0,0,0,0,0,0,19892,10000,9892,0,20377,1200,19177,0,32177,12000,20177,0,41677,10000,31677
11848,130000,104000,0,0,0,0,0,1,0,72197,3095,69102,0,49654,1630,48024,0,28065,561,27504,0,27500,600,26900
11849,290000,232000,0,0,0,0,0,0,-1,1752,0,1752,2,3710,2000,1710,0,3848,200,3648,0,4285,500,3785
11850,500000,400000,0,0,0,0,0,0,-2,13258,13337,-79,-2,4562,4562,0,-2,893,893,0,-2,2030,2030,0
11851,490000,392000,0,0,0,0,0,1,-1,467,481,-14,-1,78,1,77,-1,399,711,-312,-1,10,1,9
11852,170000,136000,0,0,0,0,0,0,-2,-807,0,-807,-2,-807,0,-807,-2,-1169,0,-1169,-2,-1531,0,-1531
11853,50000,40000,0,0,0,0,0,1,2,30895,1600,29295,2,31589,1500,30089,2,32071,1300,30771,2,32709,1300,31409
11854,50000,40000,0,1,0,0,0,0,0,50744,2097,48647,0,41232,2224,39008,0,14459,1000,13459,0,17225,3000,14225
11855,30000,24000,0,0,0,0,0,0,-2,0,0,0,-2,0,0,0,-2,0,0,0,-2,0,0,0
11856,70000,56000,0,0,0,0,0,1,0,9484,2000,7484,0,11317,2000,9317,0,13125,2000,11125,0,14742,2000,12742
11857,20000,16000,0,1,1,1,1,0,-1,20459,1576,18883,0,19493,2000,17493,0,17289,600,16689,0,17684,1000,16684
11858,180000,144000,0,0,0,0,0,0,-2,0,0,0,-2,0,0,0,-2,0,0,0,-2,10970,10970,0
11859,100000,80000,0,0,0,0,0,0,-1,2208,2208,0,-1,1823,1823,0,-1,1516,1516,0,-1,3378,3378,0
11860,70000,56000,0,1,1,1,1,0,0,63949,4500,59449,0,63699,4042,59657,0,64718,2500,62218,0,65970,2800,63170
11861,90000,72000,0,0,0,0,0,1,-2,0,0,0,-2,2146,2146,0,-1,2452,2452,0,-1,6990,6990,0
11862,130000,104000,0,0,0,0,0,1,0,102729,3823,98906,0,104761,3836,100925,0,87660,3345,84315,0,92123,9116,83007
11863,260000,208000,0,0,0,0,0,0,0,194161,8000,186161,0,197287,7150,190137,0,172561,7057,165504,0,165409,7396,158013
11864,120000,96000,0,0,0,0,0,1,0,24067,2400,21667,0,24372,1000,23372,2,24670,1000,23670,0,25617,1500,24117
11865,30000,24000,0,1,1,1,1,0,2,27293,2000,25293,2,26551,0,26551,2,30223,4400,25823,2,30592,1600,28992
11866,270000,216000,0,0,0,0,0,0,-2,-12,0,-12,-2,-12,0,-12,-2,-12,0,-12,-2,-12,0,-12
11867,50000,40000,0,1,1,0,0,0,0,49200,3000,46200,0,49763,3003,46760,0,18373,5000,13373,0,19187,2000,17187
11868,430000,344000,0,0,0,0,0,0,0,25645,2399,23246,0,25045,884,24161,0,25568,914,24654,0,26144,987,25157
11869,180000,144000,0,1,1,1,1,1,2,152785,5667,147118,0,168657,18483,150174,0,165872,0,165872,2,173667,11000,162667
11870,30000,24000,0,0,0,0,0,1,2,20930,1500,19430,2,21291,1000,20291,2,20651,0,20651,2,22110,1801,20309
11871,110000,88000,0,0,0,0,0,0,0,25171,1800,23371,0,26200,1750,24450,0,26567,1100,25467,0,26990,1000,25990
11872,50000,40000,0,0,0,0,0,0,0,33219,1851,31368,0,31688,1820,29868,0,29425,1057,28368,0,29747,3300,26447
11873,40000,32000,0,0,0,0,0,0,0,19977,1427,18550,0,20650,1100,19550,0,0,0,0,0,0,0,0
11874,50000,40000,0,1,1,0,1,0,0,45718,1731,43987,0,44142,1955,42187,0,40981,1454,39527,0,43634,3300,40334
11875,180000,144000,0,0,0,0,0,0,2,33627,3042,30585,0,128051,109470,18581,0,106834,4000,102834,0,105551,4000,101551
11876,100000,80000,0,0,0,0,0,0,0,9390,1227,8163,0,5781,1000,4781,0,8065,5914,2151,0,17277,10000,7277
11877,10000,8000,0,0,0,0,0,0,2,5275,0,5275,2,0,0,0,2,0,0,0,-2,150,150,0
11878,180000,144000,0,0,0,0,0,0,0,24956,5100,19856,0,24262,0,24262,2,24782,1058,23724,0,26208,2000,24208
11879,300000,240000,0,0,0,0,0,0,0,115453,5000,110453,0,118522,5013,113509,0,118586,4514,114072,0,118179,4220,113959
11880,320000,256000,0,1,1,1,1,0,0,332945,13004,319941,0,327229,13004,314225,0,320032,11120,308912,0,290003,11004,278999
11881,300000,240000,0,1,0,0,0,0,0,300153,13274,286879,0,9250,1010,8240,0,6088,185,5903,0,2497,2497,0
11882,200000,160000,0,0,0,0,0,0,-2,3930,3930,0,-2,0,0,0,-2,0,0,0,-2,0,0,0
11883,400000,320000,0,0,0,0,0,0,1,15882,5014,10868,1,12599,3,12596,2,18599,7040,11559,0,12284,2006,10278
11884,80000,64000,0,0,0,0,0,1,0,27045,1751,25294,0,22843,1500,21343,0,20578,1000,19578,0,19049,779,18270
11885,440000,352000,0,1,0,0,0,0,0,413605,18000,395605,0,355274,18003,337271,0,361170,15000,346170,0,338732,13000,325732
11886,30000,24000,0,1,1,1,1,0,0,29851,2000,27851,0,29978,2000,27978,0,29378,1200,28178,0,29230,1500,27730
11887,80000,64000,0,0,0,0,0,0,0,11628,3100,8528,0,12008,1000,11008,2,11658,0,11658,2,12603,1000,11603
11888,160000,128000,0,0,0,0,0,0,-1,840,840,0,-1,840,840,0,-1,0,0,0,-1,0,0,0
11889,200000,160000,0,0,0,0,0,0,0,89643,3250,86393,0,90938,3250,87688,0,92505,3500,89005,0,94031,3560,90471
11890,50000,40000,0,0,0,0,0,0,0,18683,1500,17183,0,19055,651,18404,0,19462,682,18780,0,19343,680,18663
11891,360000,288000,0,0,0,0,0,0,-1,1019,1030,-11,-1,320,321,-1,-1,5817,5846,-29,-1,907,911,-4
11892,70000,56000,0,0,0,0,0,0,-1,2253,2253,0,-1,17743,17804,-61,-1,8210,8210,0,-1,0,0,0
11893,180000,144000,0,0,0,0,0,0,-1,163,1000,-837,-1,163,0,163,2,1772,2000,-228,-1,148,0,148
11894,460000,368000,0,0,0,0,0,0,0,160894,7000,153894,0,165246,7002,158244,0,169983,8007,161976,0,173330,8038,165292
11895,30000,24000,0,0,0,0,0,1,-1,-120,0,-120,-2,-120,0,-120,-2,-120,0,-120,-2,6675,6795,-120
11896,50000,40000,0,0,0,0,0,0,0,16097,1500,14597,0,16337,800,15537,0,16330,700,15630,0,16708,650,16058
11897,80000,64000,0,0,0,0,0,0,0,-11,0,-11,-2,-11,0,-11,-2,2429,2440,-11,-1,905,905,0
11898,190000,152000,0,0,0,0,0,0,0,21811,0,21811,2,2921,2921,0,-1,107441,107441,0,-1,108642,4000,104642
11899,360000,288000,0,0,0,0,0,0,0,82386,10090,72296,0,50887,50006,881,0,52249,20000,32249,0,35311,5000,30311
11900,360000,288000,0,0,0,0,0,0,2,2420,2420,0,-1,2540,2540,0,-1,0,0,0,-1,346,346,0
11901,300000,240000,0,0,0,0,0,0,-1,27838,28773,-935,-1,4184,0,4184,2,856,856,0,-1,6781,6781,0
11902,120000,96000,0,0,0,0,0,0,0,29029,1789,27240,0,26523,2037,24486,0,20554,659,19895,0,19348,802,18546
11903,20000,16000,0,0,0,0,0,1,-1,900,900,0,-1,900,0,900,0,0,0,0,0,0,0,0
11904,290000,232000,0,0,0,0,0,0,0,17742,1500,16242,0,17530,1021,16509,0,8135,185,7950,0,7559,387,7172
11905,300000,240000,0,0,0,0,0,0,-1,0,0,0,-2,0,0,0,-2,0,0,0,-2,477,477,0
11906,90000,72000,0,0,0,0,0,0,0,43710,2100,41610,0,45474,2500,42974,0,46369,1650,44719,0,47623,2000,45623
11907,30000,24000,0,1,1,1,1,0,0,28247,2973,25274,0,28884,1500,27384,0,29523,1100,28423,0,30672,2000,28672
11908,30000,24000,0,0,0,0,0,1,2,11862,2000,9862,0,12104,242,11862,0,12351,247,12104,0,8000,2000,6000
11909,160000,128000,0,1,1,1,1,1,2,159676,0,159676,2,166893,11558,155335,2,170098,5800,164298,2,153800,0,153800
11910,280000,224000,0,0,0,0,0,0,0,213900,5069,208831,0,5202,109,5093,0,4282,97,4185,0,1000,25,975
11911,60000,48000,0,0,0,0,0,1,0,10232,0,10232,2,11237,1483,9754,0,11427,673,10754,0,20973,10000,10973
11912,240000,192000,0,0,0,0,0,0,-1,6904,7104,-200,-1,15980,15980,0,-1,0,0,0,-1,9060,9060,0
11913,220000,176000,0,0,0,0,0,0,0,92036,4846,87190,0,93935,3000,90935,0,94607,3000,91607,0,93903,3000,90903
11914,500000,400000,0,0,0,0,0,1,-2,0,0,0,-2,0,0,0,-2,0,0,0,-2,0,0,0
11915,130000,104000,0,0,0,0,0,0,0,60955,5000,55955,0,62038,2142,59896,0,62393,5000,57393,0,65439,4000,61439
11916,470000,376000,0,1,1,1,1,0,0,451090,17400,433690,0,442237,15360,426877,0,450924,31000,419924,0,428239,0,428239
11917,330000,264000,0,0,0,0,0,0,-1,500,1500,-1000,-1,1226,1226,0,-1,-1121,0,-1121,-1,1879,3000,-1121
11918,270000,216000,0,0,0,0,0,0,-1,-61,0,-61,-1,-61,0,-61,-2,20207,20268,-61,-1,538,538,0
11919,200000,160000,0,0,0,0,0,0,0,148682,0,148682,2,146505,7000,139505,0,150963,7000,143963,0,146553,6500,140053
11920,70000,56000,0,1,1,1,1,0,0,68412,2500,65912,0,69016,2456,66560,0,69701,2500,67201,0,70898,3000,67898
11921,150000,120000,0,0,0,0,0,0,0,87308,4000,83308,0,89316,3500,85816,0,91458,3500,87958,0,89063,3500,85563
11922,200000,160000,0,0,0,0,0,0,-1,6666,6666,0,-1,6666,6666,0,-1,11862,11862,0,-1,12501,7501,5000
11923,80000,64000,0,0,0,0,0,0,-1,5333,1500,3833,0,7136,2500,4636,0,7599,1000,6599,0,7554,500,7054
11924,50000,40000,0,0,0,0,0,1,2,2400,0,2400,7,2400,0,2400,7,2400,0,2400,7,2400,0,2400
11925,130000,104000,0,0,0,0,0,1,0,9910,1969,7941,0,12909,131000,-118091,-1,0,0,0,-1,0,0,0
11926,120000,96000,0,0,0,0,0,0,0,-975,0,-975,-2,-1625,0,-1625,-2,2561,4186,-1625,-1,4187,2000,2187
11927,110000,88000,0,1,0,0,0,0,0,111795,5000,106795,0,54358,3000,51358,0,58499,5000,53499,0,61445,6000,55445
11928,60000,48000,0,0,0,0,0,0,0,19289,2000,17289,0,19033,2000,17033,0,20793,2000,18793,0,23530,3000,20530
11929,60000,48000,0,1,1,1,1,1,0,60877,5924,54953,0,56138,0,56138,2,56806,2200,54606,0,57935,2200,55735
11930,280000,224000,0,0,0,0,0,0,-2,0,0,0,-2,428,428,0,-1,0,0,0,-1,0,0,0
11931,260000,208000,0,0,0,0,0,0,-2,0,0,0,-2,0,0,0,-2,0,0,0,-2,0,0,0
11932,140000,112000,0,0,0,0,0,0,-2,0,0,0,-2,0,0,0,-2,0,0,0,-2,0,0,0
11933,200000,160000,0,0,0,0,0,0,0,132534,5000,127534,0,116331,4500,111831,0,111178,5000,106178,0,105907,5000,100907
11934,240000,192000,0,0,0,0,0,0,0,133047,4800,128247,0,132264,4737,127527,0,130372,4667,125705,0,133170,4900,128270
11935,350000,280000,0,0,0,0,0,0,0,22752,2010,20742,0,21010,1082,19928,0,4470,10506,-6036,0,6838,7034,-196
11936,240000,192000,0,0,0,0,0,0,0,172217,8400,163817,0,163786,7000,156786,0,81611,3000,78611,0,79817,2900,76917
11937,140000,112000,0,0,0,0,0,0,0,109570,3965,105605,0,100086,3211,96875,0,76125,2772,73353,0,77720,2817,74903
11938,500000,400000,0,0,0,0,0,0,0,0,0,0,-2,0,0,0,-2,0,0,0,-2,0,0,0
11939,210000,168000,0,0,0,0,0,0,0,94347,3658,90689,0,-342,0,-342,0,658,1000,-342,-1,1758,1800,-42
11940,200000,160000,0,0,0,0,0,1,0,12475,3000,9475,0,14208,2083,12125,0,15270,10000,5270,0,14880,0,14880
11941,340000,272000,0,0,0,0,0,0,0,39234,2000,37234,0,20960,3000,17960,0,360,360,0,-1,360,360,0
11942,220000,176000,0,0,0,0,0,0,0,36720,5000,31720,0,40729,5000,35729,0,44762,5000,39762,0,48914,5000,43914
11943,140000,112000,0,0,0,0,0,0,0,79173,2894,76279,0,43370,2000,41370,0,28850,1500,27350,0,17896,1000,16896
11944,120000,96000,0,1,1,1,1,0,0,107945,4000,103945,0,111622,5500,106122,0,115301,5500,109801,0,117873,5500,112373
11945,80000,64000,0,0,0,0,0,0,-1,1147,1147,0,-1,1147,1147,0,-1,1100,1100,0,-1,5053,5100,-47
11946,110000,88000,0,0,0,0,0,1,0,67431,2378,65053,0,64534,2458,62076,0,65873,2530,63343,0,66974,2338,64636
11947,50000,40000,0,0,0,0,0,0,0,0,0,0,-2,0,0,0,-2,0,0,0,-2,0,0,0
11948,80000,64000,0,0,0,0,0,1,0,62160,3438,58722,0,64714,4400,60314,2,62420,0,62420,2,62990,2400,60590
11949,60000,48000,0,1,0,0,0,0,0,57006,2156,54850,0,28198,3017,25181,0,23888,2009,21879,0,24083,3000,21083
11950,160000,128000,0,1,0,0,0,0,0,153378,4600,148778,0,93971,4800,89171,0,96587,5000,91587,0,96623,3000,93623
11951,500000,400000,0,0,0,0,0,1,-2,994,994,0,-2,3342,3342,0,-2,1240,1240,0,-2,700,700,0
11952,490000,392000,0,0,0,0,0,0,0,392670,15049,377621,0,390031,14500,375531,0,396687,14000,382687,0,404885,15021,389864
11953,20000,16000,0,0,0,0,0,0,0,9301,1321,7980,0,10440,1460,8980,0,11193,1213,9980,0,10575,1,10574
11954,260000,208000,0,0,0,0,0,0,0,67341,3002,64339,0,54725,2000,52725,0,36117,2000,34117,0,35144,2464,32680
11955,110000,88000,0,0,0,0,0,0,0,88334,80004,8330,0,53978,1500,52478,0,23687,12013,11674,0,26567,7000,19567
11956,110000,88000,0,0,0,0,0,0,2,56386,31,56355,2,44181,3000,41181,0,35538,1500,34038,0,25417,2000,23417
11957,160000,128000,0,0,0,0,0,0,-1,3300,1000,2300,0,10770,10770,0,-1,11800,11800,0,-1,10043,10043,0
11958,170000,136000,0,0,0,0,0,0,-1,5436,5436,0,-1,1229,1229,0,-1,93787,93970,-183,-1,95816,4000,91816
11959,30000,24000,0,0,0,0,0,0,0,5873,1000,4873,0,5993,120,5873,0,0,0,0,0,0,0,0
11960,320000,256000,0,0,0,0,0,0,0,4980,4995,-15,-1,7774,7834,-60,-1,2582,2589,-7,-1,3762,3773,-11
11961,20000,16000,0,0,0,0,0,0,-1,0,0,0,-1,0,0,0,-2,0,0,0,-2,0,0,0
11962,360000,288000,0,0,0,0,0,0,0,7672,1161,6511,0,8380,1026,7354,0,4581,1523,3058,0,3853,3872,-19
11963,120000,96000,0,0,0,0,0,0,0,3040,1000,2040,0,0,0,0,0,0,0,0,-2,0,0,0
11964,200000,160000,0,0,0,0,0,0,-1,5020,5020,0,-1,5451,5451,0,-1,2619,2619,0,-1,5188,5188,0
11965,490000,392000,0,0,0,0,0,0,0,215628,10000,205628,0,217883,10000,207883,0,223541,10000,213541,0,224889,8000,216889
11966,240000,192000,0,0,0,0,0,1,0,110084,0,110084,2,112272,4019,108253,0,114779,4317,110462,0,116920,4204,112716
11967,240000,192000,1,1,1,1,1,0,0,286048,15002,271046,0,369693,9000,360693,0,243198,10000,233198,0,243498,8600,234898
11968,160000,128000,0,0,0,0,0,0,0,114531,5555,108976,0,106467,4000,102467,0,106967,4000,102967,0,109245,4000,105245
11969,30000,24000,0,0,0,0,0,0,0,11797,3000,8797,0,11972,4000,7972,0,16482,5000,11482,0,9082,5000,4082
11970,200000,160000,0,0,0,0,0,0,0,130952,0,130952,2,132290,5000,127290,0,159160,29160,130000,0,162928,6500,156428
11971,490000,392000,0,0,0,0,0,0,-1,28800,28800,0,-1,27870,0,27870,0,27540,0,27540,0,27630,6136,21494
11972,60000,48000,0,0,0,0,0,0,0,9479,9479,0,-1,10213,1000,9213,0,10000,200,9800,0,11832,1832,10000
11973,270000,216000,0,0,0,0,0,0,2,1250,0,1250,5,1250,0,1250,5,650,0,650,4,350,0,350
11974,210000,168000,0,0,0,0,0,0,0,29209,2000,27209,0,28326,1500,26826,0,26198,1000,25198,0,25020,1500,23520
11975,130000,104000,0,0,0,0,0,0,0,61466,2034,59432,0,48288,1710,46578,0,48898,1765,47133,0,49699,2000,47699
11976,280000,224000,1,1,1,0,0,0,0,311081,10472,300609,0,313242,11334,301908,0,151292,10010,141282,0,152318,6000,146318
11977,50000,40000,0,0,0,0,0,0,-2,0,0,0,-2,0,0,0,-2,0,0,0,-2,0,0,0
11978,500000,400000,0,0,0,0,0,0,0,25581,11725,13856,0,15406,15406,0,-1,6196,6903,-707,-1,45045,45045,0
11979,20000,16000,0,0,0,1,0,0,0,492,990,-498,0,23150,23965,-815,-1,17883,371,17512,0,7729,7738,-9
11980,110000,88000,0,1,0,0,0,1,0,106354,4250,102104,0,79154,2946,76208,0,69988,2506,67482,0,69018,2458,66560
11981,150000,120000,0,0,0,0,0,0,-1,0,0,0,-2,0,0,0,-2,0,0,0,-2,0,0,0
11982,280000,224000,0,1,0,0,0,0,0,231025,5501,225524,0,182159,4293,177866,0,80747,2079,78668,0,51689,1892,49797
11983,280000,224000,0,0,0,0,0,0,0,131048,6000,125048,0,119654,4000,115654,0,115808,4000,111808,0,115116,5000,110116
11984,300000,240000,0,0,0,0,0,0,0,75385,4266,71119,0,76864,3087,73777,0,124477,49195,75282,0,192001,70000,122001
11985,210000,168000,0,0,0,0,0,0,-1,718,718,0,-1,424,424,0,-1,631,631,0,-1,843,843,0
11986,360000,288000,0,0,0,0,0,0,0,12272,12280,-8,-1,34345,25007,9338,0,36777,25008,11769,0,30,1767,-1737
11987,270000,216000,0,0,0,0,0,0,0,197854,8929,188925,0,173743,7265,166478,0,149095,5400,143695,0,145068,5300,139768
11988,50000,40000,0,0,0,0,0,0,0,10483,1000,9483,0,4697,94,4603,0,4793,96,4697,0,4891,98,4793
11989,180000,144000,0,0,0,0,0,0,-2,0,0,0,-2,0,0,0,-2,0,0,0,-2,0,0,0
11990,80000,64000,0,0,0,0,0,0,0,17576,1000,16576,0,5616,4554,1062,0,25439,21000,4439,0,25833,1000,24833
11991,20000,16000,0,1,1,1,1,1,2,19539,2000,17539,0,20080,841,19239,0,18855,696,18159,0,20130,1600,18530
11992,260000,208000,0,0,0,0,0,1,0,140829,5375,135454,0,117445,4227,113218,0,114581,4052,110529,0,111726,3941,107785
11993,50000,40000,0,0,0,0,0,0,0,31932,1812,30120,0,25300,2000,23300,0,18902,664,18238,0,18920,700,18220
11994,300000,240000,0,0,0,0,0,1,-1,2615,2615,0,-1,10170,10170,0,-1,7200,0,7200,0,7200,0,7200
11995,220000,176000,0,0,0,0,0,0,0,90013,4500,85513,0,91191,4006,87185,0,86139,3000,83139,0,83743,3000,80743
11996,170000,136000,0,1,0,0,0,0,0,147798,6520,141278,0,120811,5700,115111,0,117680,4300,113380,0,118907,4500,114407
11997,390000,312000,0,0,0,0,0,0,0,119175,5028,114147,0,115922,5045,110877,0,101725,3012,98713,0,90334,3000,87334
11998,50000,40000,0,1,0,0,0,0,0,49493,2000,47493,0,48497,20567,27930,0,18930,1000,17930,0,19329,664,18665
11999,10000,8000,0,0,0,0,0,0,0,7335,1310,6025,0,9025,2000,7025,0,7886,269,7617,0,8382,1000,7382
12000,250000,200000,0,0,0,0,0,0,0,43194,2020,41174,0,41381,1510,39871,0,33246,1000,32246,0,32948,1000,31948
12001,230000,184000,0,0,0,0,0,0,-1,316,316,0,-1,316,316,0,-1,316,316,0,-1,466,466,0
12002,50000,40000,0,1,0,0,0,0,0,48083,1500,46583,0,30205,1690,28515,0,29747,1200,28547,0,30042,1200,28842
12003,100000,80000,0,0,0,0,0,1,2,326,650,-324,-1,324,324,0,-1,174,0,174,-2,1367,1367,0
12004,180000,144000,0,0,0,0,0,0,0,92868,4000,88868,0,94243,3501,90742,0,94888,2690,92198,0,95819,3000,92819
12005,220000,176000,0,1,1,1,1,1,2,189149,0,189149,2,187531,7000,180531,0,187856,7000,180856,0,186532,7200,179332
12006,40000,32000,0,1,1,1,1,0,0,38246,2000,36246,0,39289,2000,37289,0,39882,1500,38382,0,39650,1500,38150
12007,130000,104000,0,0,0,0,0,1,-1,1310,1310,0,-1,1310,1310,0,-1,2046,2046,0,-1,1574,574,1000
12008,500000,400000,0,0,0,0,0,0,-2,-5,0,-5,-2,1012,1017,-5,-2,500,500,0,-2,0,0,0
12009,50000,40000,0,1,1,0,1,0,3,41126,0,41126,3,40165,0,40165,2,42683,3200,39483,2,43843,2000,41843
12010,120000,96000,0,0,0,0,0,1,-2,12162,12162,0,-1,1553,1553,0,-1,0,0,0,-1,0,0,0
12011,50000,40000,0,0,0,0,0,0,0,10184,1508,8676,0,6279,1000,5279,0,7693,1500,6193,0,15083,1000,14083
12012,20000,16000,0,0,0,0,0,0,0,10594,1092,9502,0,11002,500,10502,0,11608,1000,10608,0,9186,500,8686
12013,190000,152000,0,1,1,1,1,1,2,177663,3000,174663,2,180312,7100,173212,2,185910,8700,177210,2,191895,9300,182595
12014,20000,16000,0,1,1,1,1,0,0,18051,1603,16448,0,18759,1311,17448,0,19132,684,18448,0,19684,860,18824
12015,200000,160000,0,0,0,0,0,0,-1,5477,5477,0,-1,623,623,0,-1,623,623,0,-1,773,773,0
12016,50000,40000,0,0,0,0,0,0,0,37252,1624,35628,0,38254,1626,36628,0,38445,1377,37068,0,39273,1448,37825
12017,50000,40000,0,1,1,1,1,0,0,43296,2000,41296,0,44187,1608,42579,0,49132,5684,43448,0,48191,0,48191
12018,240000,192000,0,0,0,0,0,0,0,190288,8300,181988,0,186770,7000,179770,0,180458,7000,173458,0,178722,7000,171722
12019,90000,72000,0,1,1,1,1,0,2,87070,6500,80570,2,87961,3200,84761,2,86445,0,86445,2,91520,6500,85020
12020,260000,208000,0,0,0,0,0,0,-2,7364,7364,0,-2,8144,8144,0,-2,8422,8422,0,-2,7740,7740,0
12021,80000,64000,0,1,0,0,0,0,0,81619,2048,79571,0,30095,1300,28795,0,20639,1700,18939,0,7849,401,7448
12022,290000,232000,0,0,0,0,0,1,-2,0,0,0,-2,2262,2262,0,-1,5205,3000,2205,0,8114,3000,5114
12023,110000,88000,0,1,1,1,1,1,2,111661,5300,106361,2,112299,4000,108299,2,113035,4000,109035,2,109678,0,109678
12024,360000,288000,0,0,0,0,0,1,-2,0,0,0,-2,0,0,0,-2,0,0,0,-2,0,0,0
12025,170000,136000,0,0,0,0,0,1,-1,11277,11477,-200,-1,11277,0,11277,0,14277,3000,11277,0,-47,0,-47
12026,40000,32000,0,1,0,0,0,1,0,35647,1000,34647,0,0,0,0,0,0,0,0,-2,0,0,0
12027,180000,144000,0,0,0,0,0,0,0,0,0,0,0,0,0,0,-2,0,0,0,-2,0,0,0
12028,130000,104000,0,0,0,0,0,0,0,7106,1500,5606,0,7106,0,7106,0,8106,1000,7106,0,9106,1000,8106
12029,360000,288000,0,0,0,0,0,0,-1,0,0,0,-1,0,0,0,-2,0,0,0,-2,0,0,0
12030,260000,208000,0,0,0,0,0,0,-2,-9,0,-9,-2,1935,1944,-9,-2,999,999,0,-1,0,0,0
12031,20000,16000,0,1,1,1,1,0,0,18141,1600,16541,0,18239,1000,17239,0,18302,663,17639,0,18337,654,17683
12032,230000,184000,0,0,0,0,0,0,0,70299,3000,67299,0,40299,1284,39015,0,33112,1000,32112,0,18009,1000,17009
12033,330000,264000,0,0,0,0,0,0,0,118891,5000,113891,0,107722,5000,102722,0,96842,5000,91842,0,85015,3500,81515
12034,300000,240000,0,0,0,0,0,0,-2,2417,2417,0,-2,470,470,0,-2,4690,4690,0,-2,0,0,0
12035,250000,200000,0,0,0,0,0,0,0,35722,4000,31722,0,29492,3000,26492,0,23522,3000,20522,0,16815,2000,14815
12036,210000,168000,0,0,0,0,0,0,-2,0,0,0,-2,0,0,0,-2,0,0,0,-2,0,0,0
12037,190000,152000,0,1,0,0,0,0,0,172914,6303,166611,0,130139,4137,126002,0,115494,3502,111992,0,117465,4027,113438
12038,60000,48000,0,0,0,0,0,0,0,33598,1998,31600,0,20904,1304,19600,0,18705,771,17934,0,19345,1045,18300
12039,80000,64000,0,0,0,0,0,0,-2,0,0,0,-2,0,0,0,-2,0,0,0,-2,0,0,0
12040,250000,200000,1,1,1,0,0,1,2,252087,0,252087,2,246649,8065,238584,0,177663,5404,172259,0,125960,5000,120960
12041,360000,288000,0,0,0,0,0,0,-1,187734,188000,-266,-1,17328,17384,-56,-1,10658,20000,-9342,-1,77898,78000,-102
12042,320000,256000,0,0,0,0,0,0,-1,4206,4206,0,-1,15610,15610,0,-1,10556,10556,0,-1,11863,8000,3863
12043,150000,120000,1,1,1,1,1,0,0,238438,10000,228438,0,232570,10000,222570,0,226808,8000,218808,0,220586,8000,212586
12044,80000,64000,0,0,0,0,0,0,0,63914,3002,60912,0,54382,2202,52180,0,48834,2000,46834,0,49756,2000,47756
12045,50000,40000,0,0,1,1,1,0,1,46881,52000,-5119,-1,47832,2000,45832,2,46783,0,46783,2,47890,2000,45890
12046,280000,224000,0,0,0,0,0,0,0,196314,18000,178314,0,170380,10000,160380,0,187450,20000,167450,0,204331,20000,184331
12047,450000,360000,0,0,0,0,0,0,-2,0,0,0,-2,0,0,0,-2,0,0,0,-2,0,0,0
12048,50000,40000,0,0,0,0,0,0,0,12905,1522,11383,0,13498,1505,11993,0,13993,1000,12993,0,13854,1000,12854
12049,30000,24000,0,1,1,1,1,0,0,29775,3000,26775,0,27736,3000,24736,0,26956,2000,24956,0,28142,2000,26142
12050,240000,192000,0,0,0,0,0,0,0,84945,3385,81560,0,65601,2377,63224,0,66901,2387,64514,0,68086,2472,65614
12051,190000,152000,0,1,1,1,1,1,2,170001,8000,162001,2,165797,0,165797,2,167654,6100,161554,0,178044,13100,164944
12052,60000,48000,0,0,0,0,0,0,0,39547,2000,37547,0,39555,1500,38055,0,40216,2000,38216,0,41039,2200,38839
12053,20000,16000,0,0,0,0,0,1,2,6274,0,6274,2,6470,300,6170,0,7366,1000,6366,0,8044,800,7244
12054,180000,144000,0,0,0,0,0,1,-2,3300,3312,-12,-1,0,0,0,-1,0,0,0,-2,0,0,0
12055,100000,80000,0,0,0,0,0,0,-1,102996,111784,-8788,-1,70626,4000,66626,0,69473,3000,66473,0,55004,2000,53004
12056,30000,24000,0,1,1,1,1,1,2,25429,1100,24329,2,25714,1000,24714,2,26353,1200,25153,2,26868,1100,25768
12057,20000,16000,1,1,0,0,0,0,0,38730,1400,37330,0,-210,400,-610,0,690,1290,-600,-1,150,0,150
12058,220000,176000,0,0,0,0,0,1,-2,0,0,0,-2,0,0,0,-2,0,0,0,-2,0,0,0
12059,50000,40000,0,0,0,0,0,0,-1,2576,2576,0,-1,12576,10000,2576,0,22397,10000,12397,0,15944,685,15259
12060,330000,264000,0,0,0,0,0,0,-2,3080,3080,0,-2,3119,3119,0,-2,0,0,0,-2,7255,7255,0
12061,500000,400000,0,0,0,0,0,0,-1,32269,34545,-2276,-1,8974,8981,-7,-1,1349,1349,0,-1,7867,7867,0
12062,30000,24000,0,1,1,1,1,1,0,30900,1600,29300,0,30480,1500,28980,0,31124,1100,30024,0,29333,1053,28280
12063,230000,184000,0,0,0,0,0,0,-1,1741,1741,0,-1,107,214,-107,-1,107,0,107,0,0,0,0
12064,230000,184000,0,0,0,0,0,0,0,84076,2965,81111,0,77766,3500,74266,0,70066,2600,67466,0,62865,2500,60365
12065,150000,120000,0,0,0,0,0,1,0,3425,1000,2425,0,3425,0,3425,0,0,0,0,0,0,0,0
12066,280000,224000,0,0,0,0,0,0,-1,27000,29000,-2000,-1,27000,27000,0,-1,0,0,0,-1,30460,30460,0
12067,30000,24000,0,1,1,1,1,1,2,27385,2217,25168,2,27834,1200,26634,2,28241,1000,27241,2,28130,500,27630
12068,290000,232000,0,0,0,0,0,0,0,7106,5035,2071,0,8901,8925,-24,-1,16813,11030,5783,0,15723,5077,10646
12069,30000,24000,0,0,0,0,0,1,-1,3767,3770,-3,-1,4151,4151,0,-1,3940,3940,0,-1,3697,3697,0
12070,110000,88000,0,0,0,0,0,0,-2,0,0,0,-2,0,0,0,-2,0,0,0,-2,0,0,0
12071,200000,160000,0,1,1,1,1,1,2,175905,6000,169905,2,178528,7000,171528,2,175581,0,175581,2,180145,7500,172645
12072,110000,88000,0,0,0,0,0,0,0,63853,63853,0,-1,59308,1500,57808,2,60576,2062,58514,2,42784,0,42784
12073,30000,24000,0,1,1,1,1,0,2,29918,0,29918,2,29071,1148,27923,0,29527,1034,28493,0,30480,2667,27813
12074,100000,80000,0,0,0,0,0,1,2,46764,2200,44564,0,48298,3000,45298,0,49137,2000,47137,0,49576,1800,47776
12075,340000,272000,0,0,0,0,0,0,0,80831,4000,76831,0,81589,3000,78589,0,83546,3300,80246,0,85362,3300,82062
12076,130000,104000,0,0,0,0,0,0,-2,0,0,0,-2,0,0,0,-2,0,0,0,-2,0,0,0
12077,180000,144000,0,0,0,0,0,0,0,3435,1099,2336,0,5345,2009,3336,0,2018,2024,-6,0,164,164,0
12078,190000,152000,0,0,0,0,0,1,-2,400,400,0,-1,579,579,0,-1,579,0,579,0,-421,421,-842
12079,280000,224000,0,0,0,0,0,1,-2,1735,1735,0,-1,1735,0,1735,0,1714,1700,14,0,843,1000,-157
12080,20000,16000,0,0,0,0,0,0,-2,0,0,0,-2,780,780,0,-1,0,0,0,-1,0,0,0
12081,70000,56000,0,0,0,0,0,0,-1,0,0,0,-2,0,0,0,-2,0,0,0,-2,26529,26529,0
12082,280000,224000,0,0,0,0,0,0,-2,0,0,0,-2,679,679,0,-2,3047,3047,0,-2,5742,5742,0
12083,200000,160000,0,0,0,0,0,0,0,166668,17014,149654,0,159513,15019,144494,0,150852,15000,135852,0,151996,15000,136996
12084,20000,16000,0,0,0,0,0,0,0,10325,1393,8932,0,10378,446,9932,0,7085,390,6695,0,6542,422,6120
12085,330000,264000,0,0,0,0,0,0,-2,8952,8996,-44,-2,2732,2745,-13,-2,2732,2745,-13,-2,2732,2745,-13
12086,130000,104000,0,0,0,0,0,0,0,0,0,0,0,0,0,0,-2,0,0,0,-2,0,0,0
12087,140000,112000,0,1,1,1,1,0,0,123504,4500,119004,0,126441,5000,121441,0,129345,5000,124345,0,137539,10490,127049
12088,360000,288000,0,0,0,0,0,1,-2,0,0,0,-2,0,0,0,-2,0,0,0,-2,0,0,0
12089,50000,40000,0,1,1,0,0,1,0,47361,2300,45061,0,44293,3064,41229,0,17807,1799,16008,0,18324,790,17534
12090,30000,24000,0,1,1,1,0,0,0,30485,1574,28911,0,30274,1300,28974,0,29967,886,29081,0,23477,1000,22477
12091,50000,40000,0,0,0,0,0,0,0,29922,1498,28424,0,30517,1093,29424,0,31164,1139,30025,0,32677,2039,30638
12092,200000,160000,0,0,0,0,0,1,2,73548,1966,71582,2,44234,12,44222,2,42599,1604,40995,0,46192,5164,41028
12093,90000,72000,0,0,0,0,0,1,0,27593,1500,26093,0,25833,1500,24333,0,25318,1500,23818,2,22684,0,22684
12094,180000,144000,0,0,0,0,0,0,0,82947,4000,78947,0,84379,3100,81279,0,85789,3100,82689,0,94088,10000,84088
12095,320000,256000,0,0,0,0,0,0,-1,13104,13227,-123,-2,2621,2621,0,-2,9075,9075,0,-2,6564,6564,0
12096,130000,104000,0,1,1,1,0,0,0,129159,3497,125662,0,127727,2875,124852,0,130334,2607,127727,0,0,0,0
12097,90000,72000,0,1,0,0,0,0,0,86360,4000,82360,0,67145,3000,64145,0,30834,2500,28334,0,50585,42200,8385
12098,260000,208000,0,1,0,0,0,0,0,238314,8117,230197,0,219634,14044,205590,0,186841,5410,181431,0,189010,5855,183155
12099,290000,232000,0,0,0,0,0,0,-1,2791,2803,-12,-1,4644,4680,-36,-1,2936,2956,-20,-1,2245,2254,-9
12100,50000,40000,0,0,0,0,0,1,2,23417,1400,22017,0,21969,920,21049,0,21179,1700,19479,0,18711,0,18711
12101,320000,256000,0,0,0,0,0,0,-1,-1327,0,-1327,-1,28484,29811,-1327,-1,47711,20000,27711,0,34755,2386,32369
12102,260000,208000,0,0,0,0,0,0,0,180957,5088,175869,0,165911,4138,161773,0,169863,4789,165074,0,71403,2450,68953
12103,60000,48000,0,1,1,0,0,0,0,58057,2250,55807,0,59006,2060,56946,0,39578,1506,38072,0,38973,1500,37473
12104,60000,48000,0,0,0,0,0,1,-1,22760,22066,694,0,17032,5032,12000,0,6808,1565,5243,0,8741,8500,241
12105,250000,200000,0,0,0,0,0,0,-1,25959,26036,-77,-1,6354,6373,-19,-1,2994,3000,-6,-1,5360,4376,984
12106,140000,112000,0,0,0,0,0,1,2,66606,3000,63606,2,64940,0,64940,2,73677,10000,63677,2,75316,3000,72316
12107,50000,40000,1,1,1,0,0,0,3,50101,0,50101,2,49527,1200,48327,0,10147,400,9747,0,9965,400,9565
12108,500000,400000,0,0,0,0,0,0,2,18261,18261,0,-1,16456,0,16456,0,11225,0,11225,0,36770,40270,-3500
12109,50000,40000,0,1,0,0,0,1,0,48763,1815,46948,0,35038,2389,32649,0,27839,3003,24836,0,27872,2800,25072
12110,110000,88000,0,1,1,1,1,0,0,97712,4422,93290,0,99687,4493,95194,0,100937,3800,97137,0,103138,3975,99163
12111,220000,176000,0,0,0,0,0,0,0,2102,2102,0,-1,4707,4000,707,0,7216,7216,0,-1,6565,6565,0
12112,50000,40000,0,1,1,0,0,0,2,48503,2100,46403,0,49517,2500,47017,0,19592,800,18792,0,19868,1000,18868
12113,90000,72000,0,0,0,0,0,0,-1,13878,13882,-4,-1,6556,6556,0,-1,2947,2947,0,-1,4808,4808,0
12114,100000,80000,0,1,1,0,0,1,0,91078,5514,85564,0,86433,2500,83933,2,65149,3000,62149,0,64810,4000,60810
12115,50000,40000,0,0,0,0,0,1,0,32979,2000,30979,2,32152,0,32152,2,34668,3200,31468,2,33961,0,33961
12116,50000,40000,0,0,0,0,0,0,0,22790,1800,20990,0,23372,1300,22072,0,22216,1000,21216,0,19586,1000,18586
12117,140000,112000,0,0,0,0,0,0,0,107837,5000,102837,0,96546,3400,93146,0,95489,3617,91872,0,97347,3600,93747
12118,360000,288000,0,0,0,0,0,0,0,220826,7800,213026,0,191655,6665,184990,0,162435,5670,156765,0,132093,4461,127632
12119,20000,16000,0,1,1,1,1,1,2,17251,1000,16251,2,17672,1000,16672,2,17250,0,17250,2,18305,1500,16805
12120,20000,16000,0,1,1,1,1,0,0,18255,1600,16655,0,18468,813,17655,0,19715,1700,18015,0,19250,0,19250
12121,30000,24000,0,0,0,0,0,1,-1,390,390,0,-1,390,390,0,-1,390,390,0,-1,1320,1320,0
12122,20000,16000,0,0,0,0,0,0,-1,20330,17000,3330,-1,13463,0,13463,2,9192,0,9192,0,7315,0,7315
12123,50000,40000,0,0,0,0,0,0,2,34554,2000,32554,2,35690,2000,33690,2,34817,0,34817,2,36252,2000,34252
12124,80000,64000,0,0,0,0,0,0,0,15631,2008,13623,0,13402,1009,12393,0,13197,2005,11192,0,11624,507,11117
12125,30000,24000,0,0,0,0,1,0,0,23574,1696,21878,0,24583,1705,22878,0,24915,1037,23878,0,25280,915,24365
12126,20000,16000,0,0,0,0,0,0,0,14212,1000,13212,2,14694,1000,13694,0,13807,700,13107,0,14412,1000,13412
12127,210000,168000,0,0,0,0,0,0,0,54331,2600,51731,0,55827,3000,52827,0,57295,3000,54295,0,58571,2200,56371
12128,40000,32000,0,0,0,0,0,1,0,27794,1772,26022,0,29333,2311,27022,0,29816,1100,28716,2,30577,1400,29177
12129,360000,288000,0,0,0,0,0,0,-2,0,0,0,-2,0,0,0,-2,0,0,0,-2,0,0,0
12130,180000,144000,0,0,0,0,0,0,-1,7843,5000,2843,0,13084,6022,7062,0,926,2566,-1640,-1,711,711,0
12131,110000,88000,0,0,0,0,0,1,-2,0,0,0,-2,0,0,0,-2,0,0,0,-2,0,0,0
12132,160000,128000,0,1,0,0,0,0,0,160336,5000,155336,0,92820,15000,77820,0,91449,5000,86449,0,89559,7000,82559
12133,20000,16000,0,1,1,0,0,1,0,18871,1292,17579,0,17700,1166,16534,0,390,390,0,-1,1320,1320,0
12134,30000,24000,1,1,1,1,1,0,2,36775,2206,34569,0,36914,1500,35414,0,33305,2000,31305,0,33688,6000,27688
12135,250000,200000,0,1,1,1,1,0,0,210513,8000,202513,0,214696,7682,207014,0,219218,7979,211239,0,228900,13350,215550
12136,360000,288000,1,1,1,0,0,1,2,380523,16500,364023,2,372735,6,372729,2,290210,10306,279904,0,290551,10876,279675
12137,30000,24000,0,1,0,0,0,0,0,27987,2000,25987,0,1812,2000,-188,-1,0,0,0,-1,0,0,0
12138,200000,160000,0,0,0,0,0,0,-1,1890,1890,0,-1,1260,0,1260,0,630,0,630,0,630,630,0
12139,30000,24000,0,0,0,0,0,1,2,390,0,390,2,390,390,0,-1,390,390,0,-1,390,390,0
12140,360000,288000,0,0,0,0,0,0,-1,68117,50154,17963,0,39105,39105,0,-1,54456,54456,0,-1,46153,46153,0
12141,50000,40000,0,0,0,0,0,0,0,4400,1000,3400,0,0,0,0,0,1704,1704,0,-1,3715,2011,1704
12142,500000,400000,0,0,0,0,0,0,0,306661,15000,291661,0,306438,10000,296438,2,298068,10003,288065,0,293489,10000,283489
12143,150000,120000,0,0,0,0,0,0,0,116684,4235,112449,0,101581,3161,98420,0,77741,2647,75094,0,77264,2669,74595
12144,100000,80000,0,1,1,0,0,1,2,100337,5000,95337,0,100585,2623,97962,0,52041,2500,49541,0,70731,32000,38731
12145,250000,200000,0,0,0,0,0,0,0,56412,2012,54400,0,37764,72791,-35027,-1,23876,16891,6985,0,16891,0,16891
12146,160000,128000,0,1,0,0,0,1,0,132275,4026,128249,0,57318,1492,55826,0,42978,860,42118,0,0,0,0
12147,100000,80000,0,0,0,0,0,0,0,27865,2049,25816,0,11166,1045,10121,0,32261,23610,8651,0,7961,4000,3961
12148,30000,24000,0,0,0,0,0,0,0,19563,2000,17563,0,20929,2000,18929,0,21280,1000,20280,0,21724,787,20937
12149,100000,80000,0,1,1,0,0,0,2,98503,0,98503,2,98949,3900,95049,0,48552,1801,46751,0,49545,1800,47745
12150,50000,40000,0,1,1,1,1,1,2,46872,2000,44872,2,49974,4200,45774,2,50023,1170,48853,3,53367,4300,49067
12151,70000,56000,0,0,1,1,1,1,0,61285,7064,54221,2,59727,0,59727,4,60669,2500,58169,3,59442,0,59442
12152,80000,64000,0,0,0,0,0,1,-1,5655,5655,0,-1,1670,1676,-6,-1,3096,3096,0,-1,4590,4590,0
12153,80000,64000,0,0,0,0,0,0,0,0,0,0,0,492,492,0,-1,0,0,0,-1,0,0,0
12154,240000,192000,0,0,0,0,0,1,0,38257,5000,33257,0,37607,0,37607,2,40924,4000,36924,0,43546,3000,40546
12155,60000,48000,0,0,0,0,0,0,0,31684,2000,29684,0,31837,2000,29837,0,32246,2000,30246,0,32122,1500,30622
12156,320000,256000,0,0,0,0,0,0,0,62680,3000,59680,0,62597,3017,59580,0,60080,2100,57980,0,55314,3000,52314
12157,150000,120000,0,0,0,0,0,1,-2,0,0,0,-2,0,0,0,-2,552,552,0,-1,252,0,252
12158,300000,240000,0,0,0,0,0,0,2,159556,7063,152493,0,32897,1005,31892,0,20992,1045,19947,0,12621,1004,11617
12159,70000,56000,0,0,0,0,0,1,2,43135,2000,41135,2,43924,1800,42124,2,44700,1800,42900,2,45634,1800,43834
12160,140000,112000,0,0,0,0,0,1,2,13818,600,13218,2,13994,700,13294,2,14222,600,13622,2,14537,700,13837
12161,70000,56000,0,0,0,0,0,0,-1,157,157,0,-1,157,157,0,-1,307,307,0,-1,507,507,0
12162,60000,48000,0,0,0,0,0,1,0,28227,1447,26780,0,28393,1393,27000,0,29149,1200,27949,0,28819,1000,27819
12163,30000,24000,0,1,1,1,1,0,2,27541,2000,25541,0,27785,1000,26785,0,28839,1500,27339,0,29412,1052,28360
12164,20000,16000,0,1,1,1,1,0,0,18483,1313,17170,0,19079,1299,17780,0,19060,670,18390,0,19061,686,18375
12165,230000,184000,0,0,0,0,0,0,-1,165,0,165,2,5908,5908,0,-1,283,283,0,-1,283,133,150
12166,90000,72000,0,0,1,1,1,1,2,75670,15000,60670,2,83772,10000,73772,3,83401,1500,81901,5,81487,0,81487
12167,230000,184000,0,0,0,0,0,0,-2,0,0,0,-2,0,0,0,-2,0,0,0,-2,0,0,0
12168,60000,48000,0,1,1,1,1,0,2,55709,2500,53209,0,54173,3200,50973,0,54065,1000,53065,2,57499,4500,52999
12169,170000,136000,0,0,0,0,0,0,-2,0,0,0,-2,0,0,0,-2,0,0,0,-2,2485,2485,0
12170,50000,40000,0,0,0,0,0,0,0,0,0,0,-2,0,0,0,-2,0,0,0,-2,0,0,0
12171,100000,80000,0,1,0,0,0,0,0,94247,4046,90201,0,62919,4752,58167,0,10492,4000,6492,0,4809,4500,309
12172,130000,104000,0,0,0,0,0,0,0,15621,1000,14621,0,0,0,0,0,0,0,0,-2,0,0,0
12173,150000,120000,0,0,0,0,0,0,0,58158,1500,56658,0,24856,1000,23856,0,704,704,0,-1,1899,1899,0
12174,80000,64000,0,0,0,0,0,1,0,43232,1964,41268,0,32361,3428,28933,0,22382,7,22375,2,20509,1000,19509
12175,180000,144000,0,1,0,0,0,1,0,171079,8500,162579,0,126724,4600,122124,0,125786,5000,120786,0,127419,4600,122819
12176,80000,64000,0,1,1,1,0,0,0,70906,5000,65906,0,71474,3000,68474,0,72936,3000,69936,0,63912,3000,60912
12177,160000,128000,0,1,1,1,1,0,0,144978,5300,139678,0,141639,5053,136586,0,138383,5010,133373,0,134951,4850,130101
12178,30000,24000,0,1,1,1,0,0,0,29105,0,29105,2,58840,1060,57780,0,28840,1091,27749,0,1319,1319,0
12179,110000,88000,0,0,0,0,0,0,0,71796,3187,68609,0,73253,3244,70009,0,74138,2700,71438,0,75691,2748,72943
12180,100000,80000,0,0,0,0,0,1,2,77084,3600,73484,2,78308,3100,75208,2,79901,3000,76901,2,81630,3200,78430
12181,340000,272000,0,1,0,0,0,1,0,332032,12747,319285,0,280450,9582,270868,0,282510,20070,262440,0,281197,18092,263105
12182,70000,56000,0,1,0,0,0,0,0,60975,3000,57975,0,38546,1341,37205,0,37843,1359,36484,0,38632,1403,37229
12183,20000,16000,0,0,0,0,0,0,3,2250,0,2250,2,1500,0,1500,0,750,0,750,0,1650,1650,0
12184,200000,160000,0,0,0,0,0,0,-1,1560,1560,0,-1,0,0,0,-1,0,0,0,-2,0,0,0
12185,140000,112000,0,0,0,0,0,0,-1,190,190,0,-1,3260,3269,-9,-1,32617,32617,0,-1,20506,5000,15506
12186,230000,184000,0,0,0,0,0,0,0,127797,6500,121297,0,130490,6513,123977,0,110153,4601,105552,0,112253,5000,107253
12187,10000,8000,0,0,1,1,0,0,0,10398,2398,8000,0,10000,0,10000,2,10000,0,10000,0,0,0,0
12188,500000,400000,0,0,0,0,0,0,0,113409,5571,107838,0,114191,4152,110039,0,117285,5000,112285,0,120388,5000,115388
12189,150000,120000,0,0,0,0,0,0,2,122498,5000,117498,0,75782,3000,72782,0,71306,3000,68306,0,69737,3000,66737
12190,110000,88000,0,0,0,0,0,0,0,40091,2111,37980,0,40659,3009,37650,0,38529,1725,36804,0,30900,1500,29400
12191,90000,72000,0,0,0,0,0,0,-2,0,0,0,-2,0,0,0,-2,0,0,0,-2,0,0,0
12192,450000,360000,0,0,0,0,0,0,2,0,0,0,-2,0,0,0,-2,0,0,0,-2,0,0,0
12193,210000,168000,0,0,0,0,0,0,-1,8475,8475,0,-1,5499,5499,0,-1,2960,2960,0,-1,670,670,0
12194,210000,168000,0,0,0,0,0,0,0,4168,4521,-353,-1,23067,24000,-933,-1,19972,10000,9972,0,45864,30000,15864
12195,20000,16000,0,0,0,0,0,0,0,7399,2000,5399,0,8574,2580,5994,0,7833,600,7233,0,6342,0,6342
12196,500000,400000,0,0,0,0,0,0,0,373137,25025,348112,0,316654,20000,296654,0,324049,15010,309039,0,294926,20000,274926
12197,500000,400000,0,0,0,0,0,0,-1,355,355,0,-1,1204,1204,0,-1,2378,2378,0,-1,6344,6344,0
12198,130000,104000,0,0,0,0,0,0,0,92857,4300,88557,0,95351,7400,87951,0,95525,3600,91925,0,96980,4000,92980
12199,90000,72000,0,0,0,0,0,0,0,37135,1800,35335,0,35141,1150,33991,0,33502,1200,32302,0,34173,1150,33023
12200,170000,136000,0,1,1,0,0,0,-1,168955,6409,162546,0,161351,7335,154016,0,126198,4448,121750,0,124746,4519,120227
12201,30000,24000,0,1,1,1,1,0,0,30475,5026,25449,0,27808,0,27808,2,31208,4000,27208,2,30582,0,30582
12202,130000,104000,0,0,0,0,0,1,-1,0,0,0,-1,497,497,0,-1,0,0,0,-1,186,186,0
12203,200000,160000,0,0,0,0,0,1,-2,0,0,0,-2,0,0,0,-2,0,0,0,-2,0,0,0
12204,20000,16000,0,1,1,0,0,1,2,20148,1200,18948,0,19845,397,19448,0,0,0,0,0,0,0,0
12205,240000,192000,0,0,0,0,0,0,0,67444,3038,64406,0,68461,3057,65404,0,69423,3000,66423,0,70843,3000,67843
12206,500000,400000,0,0,0,0,0,0,0,43838,2000,41838,0,25588,3000,22588,0,24648,2000,22648,0,23773,2657,21116
12207,140000,112000,0,0,0,0,0,0,0,56175,3888,52287,0,57666,2800,54866,0,59604,2800,56804,0,62480,3800,58680
12208,490000,392000,0,0,0,0,0,0,0,156094,9071,147023,0,159376,18944,140432,0,158235,10000,148235,0,163963,8030,155933
12209,50000,40000,0,0,0,0,0,0,-1,3506,1000,2506,0,19792,19286,506,0,19422,664,18758,0,19830,689,19141
12210,30000,24000,0,0,0,0,0,1,0,0,0,0,0,0,0,0,-2,0,0,0,-2,0,0,0
12211,50000,40000,0,1,0,0,0,1,3,49967,0,49967,2,20036,2000,18036,0,20076,1000,19076,0,37615,1000,36615
12212,500000,400000,0,0,0,0,0,0,-1,285138,285138,0,-1,249445,4989,244456,0,222831,100,222731,0,200,200,0
12213,370000,296000,0,0,0,0,0,0,-1,6823,6000,823,0,26501,27011,-510,-1,32774,15004,17770,0,32645,10000,22645
12214,50000,40000,1,1,0,0,0,0,0,53278,2353,50925,0,19437,39886,-20449,-1,19845,704,19141,0,19911,730,19181
12215,150000,120000,0,0,0,0,0,0,0,66432,0,66432,2,73312,8023,65289,2,72015,0,72015,2,76521,5700,70821
12216,20000,16000,1,1,0,0,0,0,0,49562,2420,47142,0,4410,88,4322,0,0,0,0,0,0,0,0
12217,50000,40000,0,0,0,0,0,0,-1,5095,5095,0,-1,14867,14867,0,-1,8037,8037,0,-1,2642,2642,0
12218,200000,160000,0,0,0,0,0,1,2,120005,5812,114193,0,121023,4500,116523,0,128387,9352,119035,0,130960,4700,126260
12219,200000,160000,0,1,0,0,0,0,0,183255,7000,176255,0,147612,5500,142112,0,148088,6000,142088,0,99985,4220,95765
12220,70000,56000,0,0,0,1,0,0,0,56480,3000,53480,0,57253,2500,54753,0,59150,3000,56150,0,0,0,0
12221,70000,56000,0,0,0,0,0,0,0,39357,1700,37657,0,40302,1600,38702,0,41202,1700,39502,0,41865,1500,40365
12222,90000,72000,1,1,0,0,0,0,0,94475,4000,90475,0,39368,1000,38368,0,34884,698,34186,0,424,424,0
12223,110000,88000,0,0,0,0,0,1,2,2625,1000,1625,0,2625,0,2625,0,0,0,0,0,0,0,0
12224,140000,112000,0,0,0,0,0,1,3,18104,1300,16804,2,17516,0,17516,2,18721,1500,17221,2,18280,0,18280
12225,50000,40000,0,0,0,0,0,0,0,0,0,0,0,5369,5369,0,-1,3746,0,3746,0,9408,9000,408
12226,70000,56000,0,0,0,0,0,0,0,3810,1500,2310,0,2790,0,2790,0,0,0,0,0,4513,4513,0
12227,260000,208000,0,0,0,0,0,0,0,112014,5000,107014,0,107404,3000,104404,0,46866,2000,44866,0,11950,433,11517
12228,70000,56000,1,1,1,0,0,1,0,131412,2523,128889,0,63823,2441,61382,0,52339,3038,49301,0,40836,2029,38807
12229,50000,40000,0,1,1,0,0,0,0,47151,5300,41851,0,47251,1500,45751,0,20515,1100,19415,0,19404,1000,18404
12230,300000,240000,0,0,0,0,0,0,0,206885,26531,180354,0,169901,10017,159884,0,170540,9123,161417,0,152188,10259,141929
12231,310000,248000,0,0,0,0,0,0,-2,780,1003,-223,-2,0,0,0,-2,0,0,0,-2,291,291,0
12232,20000,16000,0,1,1,1,1,0,0,18333,0,18333,2,18848,820,18028,0,30190,1025,29165,0,19664,1113,18551
12233,30000,24000,0,0,0,0,0,0,0,0,0,0,0,0,0,0,-2,0,0,0,-2,0,0,0
12234,90000,72000,0,0,0,0,0,1,-1,1897,1897,0,-1,1190,0,1190,0,0,0,0,0,0,0,0
12235,60000,48000,0,0,0,0,0,0,0,35850,5000,30850,0,37165,2000,35165,0,39490,2898,36592,0,25854,0,25854
12236,230000,184000,0,0,0,0,0,0,-1,0,0,0,-1,0,0,0,-2,0,0,0,-2,0,0,0
12237,210000,168000,0,0,0,0,0,0,0,27180,1500,25680,0,27035,1000,26035,0,27390,1500,25890,0,28045,2000,26045
12238,80000,64000,0,0,0,0,0,0,-2,798,800,-2,-2,-2,0,-2,-2,748,750,-2,-2,708,810,-102
12239,90000,72000,0,0,0,0,0,0,0,45868,2052,43816,0,47535,2719,44816,0,40920,0,40920,2,38622,1600,37022
12240,30000,24000,0,0,0,0,0,1,0,19965,1500,18465,0,20865,1400,19465,0,23465,3000,20465,0,24465,1000,23465
12241,500000,400000,0,0,0,0,0,0,-2,15734,16392,-658,-2,-101,470,-571,-2,27145,27916,-771,-2,1479,1994,-515
12242,250000,200000,0,0,0,0,0,0,0,33227,10000,23227,0,33732,3000,30732,0,32245,3000,29245,0,37589,8000,29589
12243,220000,176000,0,0,1,1,0,1,3,183158,10000,173158,2,183890,6300,177590,2,179764,0,179764,2,181627,6118,175509
12244,20000,16000,0,0,1,1,1,1,0,18667,5000,13667,0,18072,0,18072,2,18120,640,17480,0,19329,1497,17832
12245,30000,24000,0,0,0,0,0,0,2,1736,1736,0,-1,1170,0,1170,2,780,0,780,0,780,0,780
12246,80000,64000,0,0,0,0,0,1,2,34144,0,34144,2,34820,1243,33577,0,35553,1291,34262,0,36258,1297,34961
12247,400000,320000,0,0,0,0,0,0,-1,6725,6742,-17,-1,6016,1435,4581,0,8985,9030,-45,-1,14705,14778,-73
12248,160000,128000,0,0,0,0,0,0,0,34983,3000,31983,0,26514,2000,24514,0,17602,1000,16602,0,9308,2000,7308
12249,320000,256000,0,0,0,0,0,0,0,189018,189018,0,-1,131916,132846,-930,-1,258800,130400,128400,0,96900,193800,-96900
12250,260000,208000,0,0,0,0,0,0,-1,-604,1236,-1840,-2,-920,316,-1236,-2,-1236,316,-1552,-2,-1552,316,-1868
12251,100000,80000,0,0,0,0,0,0,2,21904,0,21904,2,23531,2000,21531,0,24636,1500,23136,0,25592,1500,24092
12252,20000,16000,0,1,1,1,1,0,0,18589,2000,16589,0,18607,2001,16606,0,19892,2001,17891,0,24338,100,24238
12253,100000,80000,0,0,0,0,0,1,2,31407,1100,30307,2,30603,0,30603,2,31411,1300,30111,0,32089,1200,30889
12254,270000,216000,0,0,0,0,0,1,2,164009,0,164009,2,161843,3451,158392,0,151862,5004,146858,0,0,0,0
12255,80000,64000,0,1,0,0,0,0,0,71029,4000,67029,0,67915,10000,57915,0,69190,11700,57490,0,53606,53606,0
12256,270000,216000,0,0,0,0,0,0,0,53401,2028,51373,0,51401,5010,46391,0,36177,5000,31177,0,29209,5000,24209
12257,140000,112000,0,1,1,1,1,1,2,128116,5000,123116,0,136956,11000,125956,0,134665,0,134665,2,142199,10000,132199
12258,360000,288000,0,0,0,0,0,0,0,182886,7565,175321,0,109556,4100,105456,0,111286,4027,107259,0,90580,3445,87135
12259,180000,144000,0,0,0,0,0,0,-1,1099,1099,0,-1,1099,1099,0,-1,0,0,0,-1,1099,1099,0
12260,500000,400000,0,0,0,0,0,0,0,117606,6000,111606,0,18343,1889,16454,0,15737,3781,11956,0,203291,208122,-4831
12261,450000,360000,0,0,0,0,0,0,-2,3581,3581,0,-1,3654,73,3581,0,0,0,0,0,0,0,0
12262,260000,208000,0,0,0,0,0,0,-1,316,316,0,-1,316,316,0,-1,316,316,0,-1,466,466,0
12263,400000,320000,0,0,0,0,0,0,-2,0,0,0,-2,0,0,0,-2,0,0,0,-2,0,0,0
12264,400000,320000,0,0,0,0,0,0,-2,2651,2651,0,-2,0,0,0,-2,644,644,0,-2,636,636,0
12265,290000,232000,0,0,0,0,0,0,2,1814,1814,0,-1,8537,8537,0,-1,25576,25576,0,-1,13475,13475,0
12266,30000,24000,0,1,1,1,1,0,0,28133,1597,26536,0,28780,1634,27146,0,28756,1000,27756,0,29566,1124,28442
12267,310000,248000,0,0,0,0,0,0,0,245458,10500,234958,0,249435,14000,235435,0,240521,10000,230521,0,246525,10000,236525
12268,20000,16000,0,1,0,0,0,0,0,19701,1000,18701,0,3486,400,3086,0,199,199,0,-1,0,0,0
12269,260000,208000,0,0,0,0,0,0,-1,558,558,0,-1,218,218,0,-1,0,0,0,-1,0,0,0
12270,90000,72000,0,0,0,0,0,0,0,72163,2271,69892,0,27124,1400,25724,0,27724,1000,26724,0,28724,1000,27724
12271,80000,64000,1,1,1,0,0,1,0,108486,2698,105788,0,94119,2172,91947,0,18809,376,18433,0,40619,40619,0
12272,90000,72000,0,0,0,0,0,1,0,14895,1200,13695,0,25195,10500,14695,0,23769,7000,16769,0,2269,1000,1269
12273,320000,256000,0,0,0,0,0,0,0,33674,2020,31654,0,34259,1605,32654,0,62546,30039,32507,0,106857,65000,41857
12274,430000,344000,0,0,0,0,0,1,-1,29199,0,29199,2,30267,2000,28267,0,49268,20000,29268,0,48241,15000,33241
12275,230000,184000,0,0,0,0,0,0,0,164602,6264,158338,0,136569,10000,126569,0,139522,5028,134494,0,132239,5000,127239
12276,260000,208000,0,0,0,0,0,0,0,103745,3650,100095,0,90818,5000,85818,0,92640,3640,89000,0,94338,3500,90838
12277,60000,48000,0,0,0,0,0,1,-1,948,0,948,3,632,0,632,2,316,0,316,0,316,316,0
12278,70000,56000,0,0,0,0,0,0,0,7514,1132,6382,0,8582,1200,7382,0,9038,600,8438,0,9490,600,8890
12279,50000,40000,0,0,0,0,0,0,0,9923,1200,8723,0,10126,350,9776,0,10113,400,9713,0,10130,360,9770
12280,100000,80000,0,0,0,0,0,1,-2,0,0,0,-2,0,0,0,-2,150,1323,-1173,-2,167,167,0
12281,380000,304000,0,0,0,0,0,0,0,2302,2300,2,0,20798,9947,10851,-1,16394,16400,-6,-1,26002,18000,8002
12282,210000,168000,0,0,0,0,0,0,0,9825,1173,8652,0,10838,1186,9652,0,12652,2000,10652,0,13060,1000,12060
12283,50000,40000,0,0,0,0,0,1,3,15888,2000,13888,2,15335,0,15335,2,16485,1400,15085,2,16070,0,16070
12284,80000,64000,0,0,0,0,0,1,0,0,0,0,0,0,0,0,-2,0,0,0,-2,0,0,0
12285,340000,272000,1,1,1,1,1,0,0,534137,20137,514000,0,466565,16565,450000,0,466774,16774,450000,0,471573,21573,450000
12286,150000,120000,0,0,0,0,0,0,0,69790,3001,66789,0,71535,3001,68534,0,73131,3013,70118,0,72502,3133,69369
12287,300000,240000,0,0,0,0,0,0,-2,-14998,33,-15031,-2,10980,30044,-19064,-2,1123,12,1111,-2,4665,11493,-6828
12288,420000,336000,0,0,0,0,0,0,0,119543,4600,114943,0,122851,5000,117851,0,126007,5000,121007,0,129144,5000,124144
12289,50000,40000,0,0,0,0,0,0,0,17516,1590,15926,0,17926,1000,16926,0,18487,1000,17487,0,19029,1000,18029
12290,320000,256000,0,0,0,0,0,0,-1,20012,20012,0,-1,34438,15000,19438,0,1082,1082,0,-1,8807,8807,0
12291,230000,184000,0,0,0,0,0,0,-2,29977,29989,-12,-2,5608,5608,0,-2,0,0,0,-2,0,0,0
12292,80000,64000,0,0,0,0,0,1,2,17834,1500,16334,2,17250,0,17250,2,18470,1500,16970,2,18023,0,18023
12293,20000,16000,0,0,0,0,0,1,0,12520,1600,10920,0,12714,700,12014,0,13059,700,12359,0,13193,500,12693
12294,360000,288000,0,0,0,0,0,0,-2,-2,2,-4,-2,468,470,-2,-2,-8,0,-8,-2,2496,2504,-8
12295,180000,144000,0,0,0,0,0,1,2,0,0,0,2,8941,8941,0,-1,5181,0,5181,0,5181,0,5181
12296,60000,48000,0,0,0,0,0,0,-1,0,0,0,-2,0,0,0,-2,0,0,0,-2,0,0,0
12297,20000,16000,0,1,1,1,1,1,0,20601,4500,16101,0,19952,0,19952,2,19586,671,18915,0,18528,700,17828
12298,150000,120000,1,1,0,0,0,0,0,314201,13700,300501,0,84135,15000,69135,0,90500,7500,83000,0,0,0,0
12299,230000,184000,0,1,0,0,0,0,2,223872,3600,220272,2,98219,0,98219,2,100276,3628,96648,0,102263,3643,98620
12300,180000,144000,0,0,0,0,0,0,-1,3430,3430,0,-1,8430,5000,3430,0,92925,92925,0,-1,88283,5000,83283
12301,40000,32000,0,1,1,1,1,0,0,38582,0,38582,2,39478,1858,37620,0,39620,1500,38120,0,38687,5000,33687
12302,180000,144000,0,0,0,0,0,1,0,60790,1807,58983,0,50479,2000,48479,0,28739,4000,24739,0,18037,0,18037
12303,150000,120000,0,0,0,0,0,0,0,37713,2000,35713,0,35592,2000,33592,0,35808,1300,34508,0,36730,1500,35230
12304,300000,240000,0,1,1,1,1,0,0,308038,13116,294922,0,306154,11000,295154,0,295664,11000,284664,0,290329,12000,278329
12305,500000,400000,0,0,0,0,0,0,-1,24754,24902,-148,-1,21443,21479,-36,-1,13892,11465,2427,0,11241,11356,-115
12306,300000,240000,0,0,0,0,0,0,-2,2541,2541,0,-2,730,730,0,-2,1350,1350,0,-2,2100,2100,0
12307,250000,200000,0,0,0,0,0,0,-1,6282,6282,0,-1,4140,4140,0,-1,5211,5211,0,-1,5211,5211,0
12308,120000,96000,0,0,0,0,0,0,0,36175,1908,34267,0,15833,566,15267,0,16170,591,15579,0,16897,1000,15897
12309,60000,48000,0,1,0,0,0,0,0,56167,6000,50167,0,28609,17000,11609,0,27660,1984,25676,0,27059,1100,25959
12310,230000,184000,0,0,0,0,0,0,0,86954,5000,81954,0,76098,3000,73098,0,76501,4000,72501,0,64763,5000,59763
12311,20000,16000,0,0,1,1,1,1,0,17963,2200,15763,2,17386,0,17386,3,16809,0,16809,2,18137,1600,16537
12312,140000,112000,0,0,0,0,0,0,0,26141,2000,24141,0,24958,2000,22958,0,27574,3000,24574,0,27151,1661,25490
12313,20000,16000,0,0,0,1,1,0,0,808,404,404,-1,18910,19000,-90,-1,19306,677,18629,0,19809,800,19009
12314,50000,40000,0,1,0,0,0,0,0,42725,2206,40519,0,40802,3000,37802,0,42422,3000,39422,0,47912,8000,39912
12315,120000,96000,0,1,1,1,1,0,0,105326,4000,101326,0,111987,10000,101987,0,112652,4000,108652,0,114337,5000,109337
12316,140000,112000,0,1,1,1,1,0,0,135505,5000,130505,0,137629,5000,132629,0,120147,4300,115847,0,122247,5000,117247
12317,360000,288000,0,0,0,0,0,1,-1,106276,100000,6276,0,73331,73427,-96,-1,7759,7759,0,-1,31840,31840,0
12318,70000,56000,0,0,0,0,0,1,0,340,340,0,-1,1430,1480,-50,-1,930,0,930,2,4110,4110,0
12319,160000,128000,0,0,0,0,0,0,-2,1945,1945,0,-2,1934,1934,0,-2,2045,2056,-11,-2,1938,1938,0
12320,30000,24000,0,0,0,0,0,1,2,-1170,0,-1170,-2,-1560,0,-1560,-2,-1950,0,-1950,-2,-1620,1620,-3240
12321,100000,80000,0,0,0,0,0,0,2,17514,0,17514,2,20207,3000,17207,2,19745,0,19745,2,20263,1000,19263
12322,270000,216000,0,0,0,0,0,0,-2,0,0,0,-2,0,0,0,-2,0,0,0,-2,0,0,0
12323,360000,288000,0,0,0,0,0,0,-1,3588,3588,0,-1,2589,0,2589,0,1549,0,1549,0,1278,1278,0
12324,400000,320000,0,0,0,0,0,1,-2,7017,7018,-1,-2,10525,10542,-17,-2,13295,13378,-83,-2,11024,11045,-21
12325,300000,240000,0,0,0,0,0,0,0,220004,7117,212887,0,18715,1285,17430,0,18675,702,17973,0,18693,810,17883
12326,320000,256000,0,0,0,0,0,0,-2,5406,5406,0,-2,3144,3157,-13,-2,1644,1644,0,-2,1925,1925,0
12327,80000,64000,0,0,0,0,0,0,-2,0,0,0,-2,0,0,0,-2,0,0,0,-2,0,0,0
12328,120000,96000,0,0,0,0,0,1,-2,-1050,0,-1050,-2,-1910,0,-1910,-2,240,2150,-1910,-1,1010,1200,-190
12329,170000,136000,0,0,0,0,0,0,-1,360,360,0,-1,360,360,0,-1,360,360,0,-1,870,870,0
12330,220000,176000,0,0,0,0,0,0,-1,5874,5874,0,-1,416,416,0,-1,416,416,0,-1,416,416,0
12331,20000,16000,0,0,0,0,0,0,-1,2257,1267,990,0,2641,1648,993,0,5041,4041,1000,0,248,0,248
12332,500000,400000,0,0,0,0,0,0,0,76452,5331,71121,0,20965,10000,10965,0,50466,30000,20466,0,61566,12000,49566
12333,330000,264000,0,0,0,0,0,0,-2,-2437,0,-2437,-2,95131,102680,-7549,-1,46017,1728,44289,0,46470,1695,44775
12334,150000,120000,0,0,0,0,0,1,-2,131,131,0,-2,987,987,0,-2,0,400,-400,-2,14001,14001,0
12335,160000,128000,0,0,0,0,0,0,-1,316,316,0,-1,316,316,0,-1,316,316,0,-1,316,316,0
12336,20000,16000,0,0,0,0,0,0,-2,0,0,0,-2,0,0,0,-2,17330,17330,0,-1,16066,738,15328
12337,160000,128000,0,0,0,0,0,0,0,89120,5000,84120,0,88854,3096,85758,0,84598,3100,81498,0,86309,4000,82309
12338,50000,40000,0,1,0,0,0,0,0,48345,1735,46610,0,20079,700,19379,0,20656,876,19780,0,19818,711,19107
12339,190000,152000,0,0,0,1,1,0,0,157663,7000,150663,0,161039,10000,151039,0,161907,7000,154907,0,161729,6500,155229
12340,120000,96000,0,0,0,0,0,0,-1,390,390,0,-1,390,390,0,-1,390,390,0,-1,0,0,0
12341,100000,80000,0,1,1,1,0,0,2,88883,4107,84776,0,90710,4204,86506,0,92471,4200,88271,0,79318,3071,76247
12342,50000,40000,0,0,0,0,0,1,-1,780,780,0,-1,797,797,0,-1,1166,1166,0,-1,0,0,0
12343,30000,24000,0,0,0,0,0,1,-1,2946,1473,1473,0,1473,0,1473,0,1473,1473,0,-1,28058,28058,0
12344,200000,160000,0,0,0,0,0,1,2,2443,0,2443,2,2443,0,2443,7,2443,0,2443,7,2443,0,2443
12345,80000,64000,0,0,0,0,0,0,0,54029,2200,51829,0,51497,1817,49680,0,28250,1200,27050,0,28073,1200,26873
12346,490000,392000,0,0,0,0,0,0,0,52074,2647,49427,0,118595,88595,30000,0,93461,3203,90258,0,86682,3142,83540
12347,20000,16000,0,0,0,0,0,0,-1,0,0,0,-1,0,0,0,-2,0,0,0,-2,0,0,0
12348,20000,16000,0,0,0,0,0,0,2,14040,1253,12787,0,13796,2232,11564,0,12909,402,12507,0,12015,393,11622
12349,130000,104000,0,0,0,0,0,0,0,0,0,0,0,0,0,0,-2,0,0,0,-2,0,0,0
12350,330000,264000,0,0,0,0,0,1,-2,15360,15360,0,-2,0,0,0,-2,12923,12923,0,-2,1816,1816,0
12351,160000,128000,0,1,1,0,0,1,2,156898,4000,152898,2,154725,8000,146725,0,115841,4000,111841,0,111615,4000,107615
12352,90000,72000,0,0,0,1,1,1,0,75036,3300,71736,0,77094,5500,71594,0,75708,1600,74108,2,76610,3950,72660
12353,80000,64000,0,1,1,1,1,1,2,73462,2600,70862,2,71681,0,71681,2,73375,2850,70525,0,74794,2800,71994
12354,480000,384000,0,0,1,1,1,0,0,401982,18000,383982,0,410694,15000,395694,0,407436,15000,392436,0,407809,14000,393809
12355,130000,104000,0,0,0,0,0,0,0,0,0,0,0,0,0,0,-2,0,0,0,-2,0,0,0
12356,90000,72000,0,0,0,0,0,0,0,4387,3400,987,0,35670,36139,-469,0,41995,618,41377,0,35912,3200,32712
12357,50000,40000,0,1,1,0,0,0,0,46776,2000,44776,0,48218,2300,45918,0,41037,2100,38937,0,9288,470,8818
12358,290000,232000,0,0,0,0,0,0,0,171699,7839,163860,0,133147,4706,128441,0,135147,5400,129747,0,127087,4604,122483
12359,220000,176000,0,1,1,1,1,0,0,216849,10000,206849,0,214030,7000,207030,0,213678,6568,207110,0,190469,6000,184469
12360,50000,40000,0,1,0,0,0,0,0,47602,2400,45202,0,37280,1000,36280,0,18678,18678,0,0,18602,600,18002
12361,500000,400000,0,0,0,0,0,0,0,161342,7031,154311,0,154127,10100,144027,0,149472,5663,143809,2,139130,0,139130
12362,500000,400000,0,0,0,0,0,0,-1,384973,384986,-13,-1,349790,7017,342773,0,315125,6342,308783,0,16576,16576,0
12363,70000,56000,0,1,1,0,0,0,0,65353,2400,62953,0,84184,2500,81684,0,47686,1800,45886,0,49276,2400,46876
12364,80000,64000,0,0,0,0,0,0,0,15290,2000,13290,0,4456,2000,2456,0,33661,30000,3661,0,34275,12000,22275
12365,30000,24000,0,0,0,0,0,1,2,17149,2000,15149,0,18362,1500,16862,0,18919,1000,17919,2,19161,700,18461
12366,360000,288000,0,0,0,0,0,0,-1,-7,0,-7,-1,-7,0,-7,-2,-7,0,-7,-2,-7,0,-7
12367,50000,40000,0,0,0,0,0,0,0,36939,1515,35424,0,29500,3076,26424,0,19655,20693,-1038,-1,20067,679,19388
12368,280000,224000,0,0,0,0,0,0,-1,3266,3284,-18,-1,10501,11001,-500,-1,10131,8,10123,0,8471,6,8465
12369,50000,40000,0,0,0,0,0,0,0,34514,1400,33114,0,23610,472,23138,0,21760,435,21325,0,6398,128,6270
12370,210000,168000,0,0,0,0,0,1,-2,0,0,0,-2,486,486,0,-1,836,836,0,-1,836,0,836
12371,50000,40000,0,0,0,0,0,0,0,-43,0,-43,0,1757,1800,-43,-1,-765,0,-765,-1,18032,19000,-968
12372,80000,64000,0,0,0,0,0,1,0,42573,1411,41162,0,43386,1224,42162,0,13513,491,13022,0,13781,493,13288
12373,80000,64000,0,0,0,0,0,0,2,57525,50000,7525,0,54990,2000,52990,0,52458,2000,50458,0,54093,2344,51749
12374,320000,256000,0,0,0,0,0,0,-2,-5700,0,-5700,-2,197300,203000,-5700,-2,-2300,400,-2700,-2,227835,310135,-82300
12375,120000,96000,0,0,0,0,0,0,0,27827,1040,26787,0,3228,265,2963,0,3294,66,3228,0,0,0,0
12376,80000,64000,0,0,0,0,0,0,0,28870,1514,27356,0,25049,1505,23544,0,23881,1005,22876,0,23668,2026,21642
12377,20000,16000,0,0,0,0,0,1,0,9621,1189,8432,0,10485,1053,9432,0,10700,268,10432,0,10922,277,10645
12378,260000,208000,0,0,0,0,0,0,-2,-7,0,-7,-2,1544,1551,-7,-2,-43,0,-43,-2,-43,0,-43
12379,30000,24000,0,0,0,0,0,1,-1,780,780,0,-1,780,0,780,0,0,0,0,0,0,0,0
12380,250000,200000,0,0,0,0,0,0,-2,5291,1000,4291,-2,4671,1010,3661,-2,4400,2000,2400,-2,6011,6011,0
12381,70000,56000,0,0,0,0,0,0,0,62703,20000,42703,0,28945,10000,18945,0,16345,6000,10345,0,21163,5000,16163
12382,160000,128000,0,0,0,0,0,0,-1,637,638,-1,-1,2667,2670,-3,-1,16746,16746,0,-1,23591,7069,16522
12383,100000,80000,0,1,1,1,0,0,0,96865,2746,94119,0,99196,3156,96040,0,101000,3000,98000,0,0,0,0
12384,180000,144000,0,0,0,0,0,1,-1,546,546,0,-1,546,546,0,-1,546,546,0,-1,1225,1225,0
12385,260000,208000,0,0,0,0,0,0,0,69466,3000,66466,0,71310,3000,68310,0,73124,3000,70124,0,74949,3000,71949
12386,50000,40000,0,1,1,1,1,1,2,47341,1800,45541,2,45527,0,45527,2,48358,4100,44258,2,47442,0,47442
12387,360000,288000,0,0,0,0,0,0,-2,7062,7065,-3,-2,-3,0,-3,-2,1178,1181,-3,-2,-2,0,-2
12388,250000,200000,0,0,0,0,0,0,-2,826,830,-4,-2,2044,2054,-10,-2,-16,0,-16,-2,-16,0,-16
12389,70000,56000,0,0,0,0,0,0,0,37858,3028,34830,0,29660,1026,28634,0,29519,1195,28324,0,29457,1060,28397
12390,300000,240000,0,0,0,0,0,0,-1,2228,2228,0,-1,452,452,0,-1,0,0,0,-1,0,0,0
12391,120000,96000,0,0,0,0,0,0,-2,554,554,0,-1,4131,4131,0,-1,930,930,0,-1,0,0,0
12392,50000,40000,0,0,0,0,0,0,0,18446,1639,16807,2,17852,0,17852,2,18236,672,17564,0,20524,2602,17922
12393,200000,160000,0,0,0,0,0,0,2,9306,9306,0,-1,9306,9306,0,-1,9000,9000,0,-1,9000,9000,0
12394,400000,320000,0,0,0,0,0,0,0,21264,5002,16262,0,29811,10004,19807,0,58472,70001,-11529,-1,101092,84003,17089
12395,280000,224000,0,0,0,0,0,0,0,48190,10018,38172,0,48758,10026,38732,0,49219,5000,44219,0,58412,10000,48412
12396,360000,288000,0,0,0,0,0,0,-2,0,0,0,-2,0,0,0,-2,0,0,0,-2,0,0,0
12397,120000,96000,0,0,0,0,0,0,2,69825,2700,67125,2,70891,2800,68091,2,72213,2600,69613,2,73786,2900,70886
12398,80000,64000,0,1,0,0,0,0,0,76681,2333,74348,0,34197,3032,31165,0,27398,28298,-900,-1,28646,2000,26646
12399,100000,80000,0,1,1,1,1,1,2,99983,4000,95983,2,100555,3100,97455,2,103300,4500,98800,2,101471,0,101471
12400,10000,8000,0,0,0,0,0,1,-1,4790,2000,2790,0,390,390,0,-1,0,0,0,-1,780,780,0
12401,360000,288000,0,0,0,0,0,0,-2,28823,28982,-159,-2,51120,51379,-259,-2,2222,2233,-11,-2,-34,0,-34
12402,180000,144000,0,0,0,0,0,0,-1,0,0,0,-1,0,0,0,-2,0,0,0,-2,0,0,0
12403,140000,112000,0,0,0,0,0,0,0,18862,3000,15862,0,19996,3000,16996,0,21214,3500,17714,0,21085,2000,19085
12404,120000,96000,0,0,0,0,0,1,0,41256,2000,39256,0,44063,3500,40563,0,46686,3500,43186,0,48768,3000,45768
12405,140000,112000,0,0,0,0,0,0,-1,2620,2620,0,-1,2073,2077,-4,-1,4732,4732,0,-1,1131,1131,0
12406,50000,40000,0,0,0,0,0,1,2,17614,0,17614,2,18630,1310,17320,0,19000,680,18320,0,19421,727,18694
12407,160000,128000,0,0,0,0,0,0,0,32691,3000,29691,0,31490,3000,28490,0,28324,3000,25324,0,30798,3000,27798
12408,100000,80000,0,0,0,0,0,0,0,37913,2000,35913,0,38582,1600,36982,0,39408,1600,37808,0,40593,2000,38593
12409,30000,24000,0,1,1,1,1,0,2,29826,2000,27826,0,29997,1500,28497,0,29789,1000,28789,0,29967,2000,27967
12410,50000,40000,0,0,0,0,0,0,0,18835,1278,17557,0,18475,638,17837,0,18135,654,17481,0,17777,659,17118
12411,120000,96000,0,0,0,0,0,0,0,53375,2000,51375,0,54620,1700,52920,0,56170,2000,54170,0,57240,1700,55540
12412,200000,160000,0,0,0,0,0,0,-2,0,0,0,-2,0,0,0,-2,0,0,0,-2,0,0,0
12413,230000,184000,0,0,0,0,0,0,-1,806,806,0,-1,1467,1500,-33,-1,9192,9216,-24,-1,4388,4388,0
12414,30000,24000,0,0,0,0,0,0,0,15897,2700,13197,0,16340,1000,15340,2,15780,0,15780,2,16127,600,15527
12415,50000,40000,0,1,1,1,1,0,0,47633,2500,45133,0,47482,2000,45482,0,48162,2000,46162,0,48926,1685,47241
12416,280000,224000,0,0,0,0,0,0,-2,5214,5240,-26,-2,17187,17273,-86,-2,2848,2861,-13,-2,5287,5313,-26
12417,270000,216000,0,0,0,0,0,0,0,57875,5000,52875,0,57456,3300,54156,0,33334,1337,31997,0,31723,1500,30223
12418,70000,56000,0,0,0,0,0,0,0,6720,1049,5671,0,8171,1500,6671,0,7127,500,6627,0,9044,2000,7044
12419,210000,168000,0,0,0,0,0,0,-1,736,0,736,2,270,270,0,-1,-466,0,-466,-1,1798,3000,-1202
12420,20000,16000,0,0,0,0,0,0,-1,17213,17221,-8,-1,4781,1203,3578,0,3178,3178,0,-1,15834,15834,0
12421,250000,200000,0,0,0,0,0,1,2,160658,0,160658,2,180382,24000,156382,2,182914,7000,175914,2,186838,7000,179838
12422,30000,24000,1,1,1,1,1,1,2,32931,1100,31831,2,30727,0,30727,2,29679,1000,28679,0,30088,2327,27761
12423,120000,96000,0,0,0,0,0,0,-1,2047,0,2047,2,8568,14150,-5582,-1,8814,9000,-186,-1,17180,17000,180
12424,170000,136000,0,0,0,0,0,0,0,140450,6000,134450,0,116293,4000,112293,0,118759,4000,114759,0,108766,3200,105566
12425,90000,72000,0,0,0,0,0,0,-2,0,0,0,-2,0,0,0,-2,0,0,0,-2,0,0,0
12426,120000,96000,0,0,0,0,0,0,2,716,716,0,-1,926,926,0,-1,0,0,0,-1,0,0,0
12427,100000,80000,0,0,0,0,0,0,-2,0,0,0,-2,53,53,0,-1,4009,4328,-319,-1,316,0,316
12428,20000,16000,0,0,0,0,0,0,2,0,0,0,2,3041,3041,0,-1,3041,0,3041,0,1326,1326,0
12429,50000,40000,0,0,0,0,0,0,0,0,0,0,0,0,0,0,-2,0,0,0,-2,0,0,0
12430,400000,320000,0,0,0,0,0,0,0,89128,1502,87626,0,39276,2026,37250,0,23440,1015,22425,0,59922,52100,7822
12431,180000,144000,0,0,0,0,0,0,-2,0,0,0,-2,0,0,0,-2,0,0,0,-2,0,0,0
12432,180000,144000,0,0,0,0,0,0,-2,14270,14396,-126,-2,11878,11936,-58,-2,12920,12965,-45,-2,10190,10220,-30
12433,230000,184000,0,0,0,0,0,0,-2,2508,2508,0,-2,976,976,0,-2,416,416,0,-2,416,416,0
12434,210000,168000,0,0,0,0,0,0,-1,3712,3719,-7,-1,3091,3091,0,-1,90817,90817,0,-1,308,308,0
12435,360000,288000,0,0,0,0,0,0,-1,944,944,0,-1,1219,1219,0,-1,2216,2216,0,-1,1440,2000,-560
12436,10000,8000,0,0,0,1,1,0,0,8583,1588,6995,0,9156,1274,7882,0,9727,1235,8492,0,8706,303,8403
12437,180000,144000,0,0,0,0,0,0,0,5488,3003,2485,0,1635,1635,0,-1,1680,1680,0,-1,782,782,0
12438,200000,160000,0,0,0,0,0,0,0,5366,1000,4366,0,2141,2141,0,-1,0,0,0,-1,0,0,0
12439,50000,40000,0,0,0,0,0,0,2,33688,3200,30488,2,32849,0,32849,2,34950,2795,32155,2,35658,1431,34227
12440,200000,160000,0,0,0,0,0,1,-2,0,0,0,-2,0,0,0,-2,0,0,0,-2,476,476,0
12441,120000,96000,0,0,0,0,0,0,0,93392,5005,88387,0,93609,5006,88603,0,95055,5014,90041,0,96761,5008,91753
12442,100000,80000,0,1,1,0,0,1,2,99734,0,99734,2,99973,3000,96973,2,71008,103000,-31992,-1,66735,2500,64235
12443,230000,184000,0,0,0,0,0,0,0,29582,20000,9582,0,38426,10000,28426,0,42500,5000,37500,0,43531,5000,38531
12444,500000,400000,0,0,0,0,0,1,0,176947,8341,168606,0,178647,6600,172047,0,176380,6925,169455,0,172666,7225,165441
12445,160000,128000,0,0,0,0,0,0,-2,0,0,0,-2,0,0,0,-2,2920,2920,0,-2,0,0,0
12446,310000,248000,0,0,0,0,0,0,0,189210,7044,182166,0,181491,9072,172419,0,176661,11210,165451,0,173532,6116,167416
12447,210000,168000,0,0,0,0,0,0,-1,1349,1349,0,-1,10368,10368,0,-1,0,0,0,-1,0,0,0
12448,230000,184000,0,0,0,0,0,0,-1,4987,4987,0,-1,6222,6222,0,-1,15121,15121,0,-1,17425,17425,0
12449,280000,224000,0,0,0,0,0,0,0,0,0,0,-2,0,0,0,-2,0,0,0,-2,0,0,0
12450,610000,488000,0,0,0,0,0,0,0,392776,14100,378676,0,399343,14144,385199,0,402432,17100,385332,0,409912,17500,392412
12451,90000,72000,0,0,0,0,0,1,2,54727,1984,52743,0,55506,2004,53502,0,58529,4251,54278,0,57157,0,57157
12452,320000,256000,0,0,0,0,0,0,0,0,0,0,0,0,0,0,-2,0,0,0,-2,0,0,0
12453,50000,40000,0,0,0,0,0,0,0,13552,3000,10552,0,0,0,0,0,28105,28105,0,-1,29684,2000,27684
12454,100000,80000,0,0,0,0,0,0,-2,8090,8090,0,-2,5524,5549,-25,-2,4973,4973,0,-2,1000,1000,0
12455,340000,272000,0,1,1,0,0,0,0,343792,15000,328792,0,301895,12000,289895,0,198944,8120,190824,0,197439,7720,189719
12456,70000,56000,0,1,0,0,0,0,0,67916,3000,64916,0,56766,3000,53766,0,50395,3000,47395,0,42214,7000,35214
12457,20000,16000,0,0,0,0,0,0,-1,780,780,0,-1,780,0,780,2,0,0,0,2,0,0,0
12458,150000,120000,0,0,0,0,0,0,0,9299,2000,7299,0,10299,1000,9299,0,759,759,0,-1,0,0,0
12459,100000,80000,0,1,1,1,1,0,0,94799,5000,89799,0,97861,5000,92861,0,104634,9000,95634,0,92537,10000,82537
12460,470000,376000,0,0,0,0,0,0,0,59307,3000,56307,0,61500,3016,58484,0,59563,2200,57363,0,57368,3000,54368
12461,20000,16000,0,0,1,1,0,0,0,19495,3600,15895,0,18845,0,18845,2,19023,700,18323,0,17928,4500,13428
12462,30000,24000,0,0,1,1,1,1,2,26400,3600,22800,2,25682,0,25682,2,26155,1200,24955,0,27972,2400,25572
12463,150000,120000,0,0,0,0,0,0,-1,1682,1682,0,-1,7898,7898,0,-1,3336,3336,0,-1,975,975,0
12464,50000,40000,0,1,0,1,1,1,2,40416,0,40416,2,41395,1650,39745,0,44063,3505,40558,0,44587,1400,43187
12465,30000,24000,0,0,1,1,1,0,0,56262,36444,19818,0,59113,4360,54753,0,58016,4,58012,2,30900,2204,28696
12466,10000,8000,0,0,1,1,1,0,0,9145,3000,6145,0,8854,0,8854,3,8563,0,8563,2,9918,1500,8418
12467,280000,224000,0,1,0,0,0,0,0,281327,10059,271268,0,189287,5201,184086,0,185398,5211,180187,0,184414,5500,178914
12468,30000,24000,0,1,1,1,1,0,4,29991,0,29991,3,29192,0,29192,2,28210,1100,27110,0,28543,1300,27243
12469,60000,48000,0,0,0,0,0,0,0,28330,1800,26530,0,28136,1088,27048,0,26752,1200,25552,0,27357,1200,26157
12470,360000,288000,0,0,0,0,0,0,0,55135,3452,51683,0,54645,1912,52733,0,54859,2000,52859,0,55112,2091,53021
12471,70000,56000,0,1,1,1,0,1,0,68200,2518,65682,0,72972,5950,67022,0,71248,0,71248,2,50610,1782,48828
12472,30000,24000,0,0,0,0,0,1,0,10094,1000,9094,0,10300,206,10094,0,10300,0,10300,0,0,0,0
12473,160000,128000,0,0,0,0,0,0,0,0,0,0,-2,0,0,0,-2,0,0,0,-2,0,0,0
12474,300000,240000,0,0,0,0,0,0,2,0,0,0,2,0,0,0,-2,0,0,0,-2,0,0,0
12475,30000,24000,0,0,0,0,0,1,-2,2230,2238,-8,-2,561,561,0,-2,2230,2238,-8,-2,565,565,0
12476,80000,64000,0,0,0,0,0,1,0,0,0,0,-2,0,0,0,-2,0,0,0,-2,0,0,0
12477,210000,168000,0,0,0,0,0,0,0,39210,1985,37225,0,38986,1300,37686,0,689,0,689,2,2040,2040,0
12478,420000,336000,0,0,0,0,0,0,0,75353,20002,55351,0,78322,7096,71226,0,77048,20261,56787,0,23007,3068,19939
12479,250000,200000,0,0,1,0,0,0,0,140069,10000,130069,0,292404,10000,282404,0,175050,60000,115050,0,181766,15000,166766
12480,150000,120000,0,0,0,0,0,0,-2,0,0,0,-2,600,600,0,-1,-150,0,-150,-1,-150,0,-150
12481,160000,128000,0,0,0,0,0,0,0,35673,3030,32643,0,28880,2000,26880,0,27678,5000,22678,0,25518,4000,21518
12482,230000,184000,0,0,0,0,0,0,0,186698,8638,178060,0,181156,6500,174656,0,129441,50000,79441,0,135383,8008,127375
12483,20000,16000,0,1,1,1,1,0,2,19707,0,19707,2,20899,1800,19099,2,20450,0,20450,2,20197,1000,19197
12484,50000,40000,0,1,1,1,1,1,2,46573,3000,43573,2,47510,2000,45510,2,48425,2000,46425,2,49502,2000,47502
12485,20000,16000,0,0,0,0,0,1,2,8215,1215,7000,0,9200,1200,8000,0,10280,1280,9000,0,16130,6000,10130
12486,110000,88000,0,0,0,0,0,0,0,58489,3300,55189,0,57800,2044,55756,2,57312,2100,55212,0,57188,2000,55188
12487,230000,184000,0,0,0,0,0,0,-1,8400,8485,-85,-1,1900,1900,0,-1,0,0,0,-1,9198,9198,0
12488,90000,72000,0,0,0,0,0,0,-1,7608,7608,0,-1,1720,1720,0,-1,45000,45000,0,-1,0,15000,-15000
12489,180000,144000,0,0,0,0,0,0,-1,900,900,0,-1,923,923,0,-1,922,922,0,-1,900,900,0
12490,150000,120000,0,0,0,0,0,0,2,220,220,0,-1,693,693,0,-1,0,0,0,-1,0,0,0
12491,130000,104000,0,0,0,0,0,0,0,59839,2606,57233,0,0,0,0,0,0,0,0,-2,0,0,0
12492,70000,56000,0,0,0,0,0,0,0,23169,8009,15160,0,23337,10004,13333,0,18265,5000,13265,0,18001,5000,13001
12493,80000,64000,0,1,1,1,1,1,0,79915,3508,76407,0,81371,3405,77966,0,79916,3359,76557,0,79227,3108,76119
12494,120000,96000,0,0,0,0,0,0,-1,820,820,0,-1,820,820,0,-1,2870,2870,0,-1,970,970,0
12495,360000,288000,0,0,0,0,0,0,-1,1955,1955,0,-1,5316,5316,0,-1,2265,2265,0,-1,6594,6594,0
12496,90000,72000,0,1,1,1,1,1,2,87510,4000,83510,2,85188,0,85188,2,87112,4200,82912,0,169533,3285,166248
12497,100000,80000,0,0,0,0,0,1,-2,0,0,0,-2,0,0,0,-2,0,0,0,-2,0,0,0
12498,150000,120000,0,0,0,0,0,0,0,37424,6086,31338,0,36446,0,36446,2,39193,5200,33993,2,38297,0,38297
12499,20000,16000,0,0,0,0,0,0,2,1898,1198,700,0,2558,1500,1058,0,2498,500,1998,0,4074,2000,2074
12500,190000,152000,0,1,0,0,0,0,0,172506,6500,166006,0,89806,3500,86306,0,91744,3500,88244,0,93903,3800,90103
12501,160000,128000,0,0,0,0,0,0,-1,30258,30348,-90,-1,1036,1044,-8,-1,21572,21636,-64,-1,9528,9556,-28
12502,290000,232000,0,0,0,0,0,0,0,107325,3286,104039,0,108805,3133,105672,0,105375,2822,102553,0,105710,3212,102498
12503,80000,64000,0,0,0,0,0,0,0,19664,2000,17664,0,19258,1000,18258,0,20842,2000,18842,0,16386,1500,14886
12504,110000,88000,0,1,1,1,1,0,0,105714,5500,100214,0,105998,5300,100698,0,105080,4000,101080,0,105638,4100,101538
12505,230000,184000,0,0,0,0,0,0,0,51535,11000,40535,0,24607,15000,9607,0,28279,13000,15279,0,48934,36000,12934
12506,190000,152000,0,0,0,0,0,0,2,13415,0,13415,2,14590,1400,13190,2,14216,0,14216,2,14823,1000,13823
12507,60000,48000,0,0,0,0,0,0,-1,699,699,0,-1,699,0,699,0,0,0,0,0,1000,1430,-430
12508,30000,24000,0,0,0,0,0,1,2,21889,0,21889,2,22721,1500,21221,0,23401,1200,22201,0,25000,2000,23000
12509,160000,128000,1,1,0,0,0,0,0,210143,6263,203880,0,75166,2394,72772,0,68355,2274,66081,0,69602,2172,67430
12510,70000,56000,0,0,0,0,0,0,2,22793,1637,21156,0,23156,1000,22156,0,24810,2000,22810,0,27433,3007,24426
12511,30000,24000,0,1,0,0,0,0,2,30121,1200,28921,0,12787,256,12531,0,6840,137,6703,0,2250,45,2205
12512,50000,40000,0,0,0,0,0,0,2,30246,1500,28746,0,26953,1000,25953,0,27249,986,26263,0,27521,986,26535
12513,50000,40000,0,1,0,0,0,0,0,49929,2525,47404,0,-596,283,-879,0,28348,29334,-986,-1,30530,3000,27530
12514,360000,288000,0,0,0,0,0,0,0,30580,5000,25580,0,34985,5000,29985,0,39585,5000,34585,0,49735,10150,39585
12515,290000,232000,0,0,0,0,0,1,-1,1922,1922,0,-1,550,550,0,-1,550,550,0,-1,3810,3810,0
12516,30000,24000,0,0,0,0,0,0,-1,780,780,0,-1,0,0,0,-1,0,0,0,-2,0,0,0
12517,340000,272000,0,0,0,0,0,1,0,92112,3300,88812,0,75710,5000,70710,0,63870,10000,53870,0,52671,10000,42671
12518,250000,200000,0,0,0,0,0,0,-2,4420,4423,-3,-2,18311,18311,0,-2,2887,2887,0,-2,4768,4768,0
12519,80000,64000,0,0,0,0,0,0,0,19098,2000,17098,0,14269,1090,13179,0,14612,2300,12312,0,16945,4500,12445
12520,200000,160000,0,0,0,0,0,0,-2,14771,14771,0,-2,1973,1973,0,-2,9500,9500,0,-2,40647,40647,0
12521,20000,16000,0,0,0,0,0,0,0,14362,1600,12762,0,14821,1000,13821,0,15143,710,14433,0,15737,1000,14737
12522,120000,96000,0,0,0,0,0,1,-1,2457,2459,-2,-1,2192,0,2192,0,2655,2655,0,-1,0,0,0
12523,100000,80000,0,0,0,0,0,1,2,73859,3400,70459,0,75427,3400,72027,0,76587,3000,73587,0,78711,3500,75211
12524,260000,208000,0,0,0,0,0,0,0,90183,4000,86183,0,89846,4005,85841,0,101034,14066,86968,0,84152,3017,81135
12525,20000,16000,0,1,1,1,1,1,0,18939,1650,17289,0,19150,823,18327,0,19549,857,18692,0,20073,1000,19073
12526,210000,168000,0,0,0,0,0,0,-1,4202,4000,202,0,5152,1208,3944,0,5444,500,4944,0,5786,400,5386
12527,270000,216000,0,0,0,0,0,0,-2,1205,1205,0,-2,0,0,0,-2,0,0,0,-2,0,0,0
12528,500000,400000,0,1,0,0,1,1,0,478965,17414,461551,0,401635,12000,389635,0,423136,30000,393136,0,422271,18000,404271
12529,140000,112000,0,0,0,1,1,1,0,113272,4500,108772,0,115685,4287,111398,0,118171,4500,113671,0,120550,4500,116050
12530,200000,160000,0,0,0,0,0,0,-1,5966,5966,0,-1,3348,3348,0,-1,5051,5061,-10,-1,7128,7128,0
12531,130000,104000,0,1,1,0,0,1,0,124530,8970,115560,0,115800,5239,110561,0,98268,5234,93034,0,83729,4000,79729
12532,330000,264000,0,0,0,0,0,0,0,20467,5467,15000,0,25200,5200,20000,0,35000,10000,25000,0,0,0,0
12533,110000,88000,0,1,1,1,1,0,0,109494,4000,105494,0,111954,4300,107654,0,111771,4164,107607,0,111703,4500,107203
12534,150000,120000,0,0,0,0,0,0,0,36772,3000,33772,0,4521,3000,1521,0,6452,2000,4452,0,6742,378,6364
12535,200000,160000,0,0,0,0,0,0,0,65265,2473,62792,0,66234,2161,64073,0,62356,2075,60281,0,55080,1973,53107
12536,240000,192000,0,0,0,0,0,1,-1,1479,1479,0,-1,1479,1479,0,-1,1479,1479,0,-1,1240,1240,0
12537,170000,136000,0,0,0,0,0,0,-1,2910,2910,0,-1,0,0,0,-1,0,0,0,-2,0,0,0
12538,180000,144000,0,0,0,0,0,1,-1,375,375,0,-1,750,750,0,-1,375,0,375,0,399,399,0
12539,520000,416000,0,0,0,0,0,0,-1,8290,8309,-19,-1,35024,35026,-2,-1,10881,10883,-2,-1,7208,7310,-102
12540,210000,168000,0,0,0,0,0,0,0,10749,2500,8249,0,5125,2000,3125,0,5732,1000,4732,0,9297,4000,5297
12541,20000,16000,0,1,1,1,1,0,0,19477,1300,18177,0,20210,1000,19210,0,20077,800,19277,0,20022,700,19322
12542,20000,16000,0,0,1,1,0,0,0,17139,1700,15439,0,17979,1500,16479,0,18518,1000,17518,0,15243,1000,14243
12543,50000,40000,0,1,0,0,0,0,0,47722,1871,45851,0,32920,1800,31120,0,28471,1100,27371,0,28834,1200,27634
12544,200000,160000,0,0,0,0,0,0,-1,2991,2991,0,-1,390,0,390,0,1211,1211,0,-1,390,390,0
12545,300000,240000,0,0,0,0,0,0,-1,0,0,0,-2,0,0,0,-2,0,0,0,-2,0,0,0
12546,380000,304000,0,0,0,0,0,0,-1,19947,10007,9940,-1,22529,24012,-1483,-1,3885,3906,-21,-1,23616,24018,-402
12547,140000,112000,0,0,0,0,0,0,-2,1066,1076,-10,-1,0,0,0,-1,0,0,0,-2,0,0,0
12548,150000,120000,0,0,0,0,0,0,-1,0,0,0,-2,1298,1298,0,-1,359,359,0,-1,6100,6100,0
12549,60000,48000,0,0,0,0,0,0,0,17321,1400,15921,0,17421,500,16921,0,18421,1000,17421,0,891,900,-9
12550,150000,120000,0,0,0,0,0,0,0,0,0,0,-2,0,0,0,-2,0,0,0,-2,0,0,0
12551,20000,16000,0,1,1,1,1,0,2,18976,2000,16976,0,19804,1600,18204,0,19204,0,19204,0,18210,1150,17060
12552,60000,48000,0,1,0,0,0,0,0,59268,6100,53168,0,17967,621,17346,0,20309,2609,17700,0,17867,0,17867
12553,400000,320000,0,0,0,0,0,0,-2,-5,0,-5,-2,1299,1304,-5,-1,4374,4375,-1,-1,4986,1025,3961
12554,130000,104000,0,0,0,0,0,0,0,88423,3100,85323,0,90235,3100,87135,0,92154,3200,88954,0,85510,3000,82510
12555,150000,120000,0,0,0,0,0,1,2,55768,3000,52768,2,56266,2000,54266,2,54764,0,54764,2,58862,5000,53862
12556,370000,296000,0,0,0,0,0,0,0,222640,9413,213227,0,184330,7900,176430,0,169078,6000,163078,0,167940,6000,161940
12557,300000,240000,0,0,0,0,0,0,0,2060,1000,1060,0,0,0,0,0,78794,78794,0,-1,80385,2900,77485
12558,50000,40000,0,0,0,0,0,0,0,5631,1100,4531,0,5933,1100,4833,0,6433,600,5833,0,6828,500,6328
12559,260000,208000,0,0,0,0,0,0,0,11930,1300,10630,0,12954,1229,11725,0,14246,1521,12725,0,15733,1728,14005
12560,50000,40000,0,1,0,0,0,1,0,50215,1517,48698,0,29386,1000,28386,0,29527,1500,28027,0,30125,2005,28120
12561,290000,232000,0,0,0,0,0,0,2,194158,10013,184145,0,197590,9526,188064,0,187134,6549,180585,0,180887,6373,174514
12562,200000,160000,0,0,0,0,0,1,-1,581,581,0,-1,581,581,0,-1,581,581,0,-1,581,581,0
12563,80000,64000,0,0,0,0,0,1,0,9998,1233,8765,0,8950,261,8689,0,9415,549,8866,0,5700,400,5300
12564,80000,64000,0,0,0,0,0,1,2,9853,1200,8653,2,9546,0,9546,2,9890,503,9387,0,10479,900,9579
12565,60000,48000,0,0,0,0,0,1,0,48839,1600,47239,0,18971,3000,15971,0,19323,1000,18323,0,19395,737,18658
12566,20000,16000,0,0,0,1,1,1,0,15751,1268,14483,0,17068,1585,15483,0,17891,1408,16483,0,17463,0,17463
12567,170000,136000,0,0,0,0,0,0,0,50896,2000,48896,0,52554,2500,50054,0,53084,2000,51084,0,54197,1968,52229
12568,50000,40000,0,0,0,0,0,0,-2,0,0,0,-2,0,0,0,-2,0,0,0,-2,0,0,0
12569,130000,104000,0,0,0,0,0,0,0,89091,3424,85667,0,91212,4193,87019,0,29441,1042,28399,0,29683,1100,28583
12570,30000,24000,0,0,1,1,1,1,3,25522,1600,23922,2,26008,1200,24808,2,25294,0,25294,2,26928,2200,24728
12571,20000,16000,0,0,0,0,1,1,-1,0,0,0,-1,200,200,0,-2,17976,17976,0,-1,17980,4,17976
12572,10000,8000,0,0,1,0,1,0,2,9407,2310,7097,2,8126,0,8126,2,8838,1000,7838,0,9039,500,8539
12573,120000,96000,0,0,0,0,0,0,0,69903,3120,66783,0,71446,3300,68146,0,79589,10000,69589,0,81354,3200,78154
12574,150000,120000,0,0,0,0,0,0,-2,0,0,0,-2,3871,3871,0,-2,6200,6200,0,-2,336,336,0
12575,100000,80000,0,0,0,0,0,1,0,15697,2022,13675,0,11353,1000,10353,0,9306,1000,8306,0,9693,500,9193
12576,300000,240000,0,0,0,0,0,1,-2,0,0,0,-2,0,0,0,-2,0,0,0,-2,0,0,0
12577,120000,96000,0,0,0,0,0,0,0,75624,30000,45624,0,42754,5200,37554,0,15927,15000,927,0,2405,2405,0
12578,70000,56000,0,0,1,1,1,0,2,59878,62343,-2465,-1,58318,0,58318,2,61865,4500,57365,2,63695,3000,60695
12579,20000,16000,0,0,0,0,0,1,0,14462,1239,13223,0,14750,527,14223,0,15215,702,14513,0,16209,1400,14809
12580,250000,200000,0,0,0,0,0,0,3,3281,10,3271,2,934,0,934,0,467,0,467,0,12871,12871,0
12581,70000,56000,0,0,0,0,0,0,0,0,0,0,0,0,0,0,-2,0,0,0,-2,0,0,0
12582,100000,80000,0,0,0,0,0,1,0,75609,4000,71609,0,77265,4000,73265,0,78973,4000,74973,0,81665,5000,76665
12583,110000,88000,0,0,0,0,0,1,0,57239,3000,54239,0,104353,49000,55353,0,48308,1569,46739,0,49693,2000,47693
12584,150000,120000,0,0,0,0,0,0,0,46191,2500,43691,0,45564,2000,43564,0,45840,2000,43840,0,47077,2000,45077
12585,20000,16000,0,1,0,0,0,0,0,19000,1000,18000,0,0,0,0,0,80,40,40,-1,540,1000,-460
12586,160000,128000,0,0,0,0,0,0,-1,1443,1443,0,-1,1443,1443,0,-1,1443,1443,0,-1,1443,1443,0
12587,120000,96000,0,1,1,1,1,0,0,104347,6800,97547,0,108258,7300,100958,2,104972,0,104972,2,104638,4600,100038
12588,50000,40000,0,0,0,0,0,0,0,19129,1700,17429,0,18538,1500,17038,0,17494,700,16794,0,17833,1000,16833
12589,150000,120000,0,0,0,0,0,1,-1,0,0,0,-2,31106,31106,0,-1,0,0,0,-1,1505,1505,0
12590,360000,288000,0,0,0,0,0,0,-1,6894,6918,-24,-1,7143,7148,-5,-1,1787,1792,-5,-1,19526,19541,-15
12591,130000,104000,0,0,0,0,0,0,0,30795,4338,26457,0,38637,8399,30238,0,39259,1260,37999,0,72981,34721,38260
12592,200000,160000,0,0,0,0,0,0,-2,14129,14178,-49,-2,41359,41359,0,-2,9140,9140,0,-2,0,0,0
12593,80000,64000,0,0,0,0,0,0,-1,566,566,0,-1,61664,61664,0,-1,58281,0,58281,0,58281,0,58281
12594,250000,200000,0,0,1,1,1,0,0,205944,7481,198463,0,210513,8000,202513,0,214696,7682,207014,0,219218,7979,211239
12595,210000,168000,0,0,0,0,0,0,-1,7924,7924,0,-1,13416,13421,-5,-1,2228,2240,-12,-1,4490,4490,0
12596,80000,64000,0,0,0,0,0,1,2,832,832,0,-1,416,0,416,0,832,832,0,-1,416,0,416
12597,170000,136000,0,0,0,0,0,0,-1,1690,1690,0,-1,0,0,0,-1,0,0,0,-2,0,0,0
12598,70000,56000,0,0,0,0,0,1,2,18310,1500,16810,2,18611,900,17711,2,18966,800,18166,2,19403,900,18503
12599,300000,240000,0,0,0,0,0,1,-1,316,316,0,-1,316,316,0,-1,316,316,0,-1,316,316,0
12600,170000,136000,0,0,0,0,0,0,0,123476,6000,117476,0,124934,5000,119934,0,127918,5000,122918,0,130782,5000,125782
12601,210000,168000,0,0,0,0,0,0,0,0,0,0,-2,0,0,0,-2,0,0,0,-2,0,0,0
12602,20000,16000,0,0,0,0,0,0,-1,8176,8186,-10,-1,7909,7913,-4,-1,2948,3049,-101,-1,1220,1624,-404
12603,220000,176000,0,0,0,0,0,0,0,8708,3040,5668,0,4078,3520,558,0,5365,5371,-6,-1,4055,20,4035
12604,230000,184000,0,0,0,0,0,0,3,3579,8,3571,2,31053,30334,719,2,30334,0,30334,2,38203,8507,29696
12605,50000,40000,0,0,0,0,0,0,0,15622,1483,14139,0,14277,611,13666,0,12930,458,12472,0,11657,403,11254
12606,260000,208000,0,0,0,0,0,0,-1,2800,2800,0,-1,2800,2800,0,-1,2979,2979,0,-1,8247,8247,0
12607,460000,368000,0,0,0,0,0,0,0,12570,2500,10070,0,19403,9456,9947,0,10063,10063,0,-1,8628,0,8628
12608,360000,288000,0,0,0,0,0,1,0,265549,11208,254341,0,244053,6554,237499,0,239088,7248,231840,0,193401,7122,186279
12609,190000,152000,0,0,0,0,0,0,0,23130,1200,21930,0,28126,26703,1423,0,26104,2104,24000,0,18840,7000,11840
12610,500000,400000,0,0,0,0,0,0,-1,223085,223792,-707,-1,278999,85184,193815,0,207007,4803,202204,0,66516,1189,65327
12611,180000,144000,0,0,0,0,0,0,0,25590,6000,19590,0,5817,1000,4817,0,13623,13623,0,-1,-2202,388,-2590
12612,210000,168000,0,0,0,0,0,0,0,0,0,0,-2,0,0,0,-2,198,198,0,-1,0,0,0
12613,310000,248000,0,0,0,0,0,0,0,21218,4000,17218,0,40531,20003,20528,0,41630,3027,38603,0,51983,20006,31977
12614,50000,40000,0,0,0,0,0,0,-1,2545,0,2545,2,1170,1170,0,-1,2480,2480,0,-1,8047,8047,0
12615,150000,120000,0,0,0,0,0,0,0,2700,0,2700,2,1500,0,1500,0,18439,18439,0,-1,1381,1381,0
12616,50000,40000,0,1,0,0,0,0,0,42674,1882,40792,0,4593,2119,2474,0,18007,45800,-27793,-1,18230,662,17568
12617,500000,400000,0,0,0,0,0,0,-2,4822,4822,0,-2,48741,48741,0,-2,92978,92978,0,-2,0,0,0
12618,130000,104000,0,0,0,0,0,0,-1,1738,1738,0,-1,1738,1738,0,-1,1738,1738,0,-1,1738,1738,0
12619,130000,104000,0,0,0,0,0,0,-1,888,0,888,2,0,0,0,2,5087,5087,0,-1,3103,3103,0
12620,110000,88000,0,0,0,0,0,0,0,86544,3112,83432,0,77131,2467,74664,0,60895,2182,58713,0,60936,2190,58746
12621,100000,80000,0,0,0,0,0,0,0,49992,1600,48392,0,35518,2000,33518,0,36426,1500,34926,0,37836,2000,35836
12622,210000,168000,0,0,0,0,0,0,-2,0,0,0,-2,25478,25478,0,-1,9485,9485,0,-1,0,0,0
12623,50000,40000,0,0,0,0,0,0,-1,390,390,0,-1,2728,2728,0,-1,0,0,0,-1,780,780,0
12624,290000,232000,0,0,0,0,0,0,0,65357,3000,62357,0,66893,3000,63893,0,69740,4000,65740,0,56411,2500,53911
12625,280000,224000,0,0,0,0,0,0,-2,4873,4897,-24,-2,4071,4176,-105,-2,-30,0,-30,-2,-30,0,-30
12626,90000,72000,0,0,0,0,0,0,0,52452,2068,50384,0,35001,3315,31686,0,29675,1029,28646,0,28667,1334,27333
12627,70000,56000,0,0,0,0,0,0,0,42274,1750,40524,0,43596,2023,41573,0,44173,1600,42573,0,45309,1850,43459
12628,80000,64000,0,0,0,0,0,0,0,20977,1306,19671,0,20695,1019,19676,0,18587,685,17902,0,20767,2500,18267
12629,490000,392000,0,0,0,0,0,0,-1,755,762,-7,-1,7000,7000,0,-1,0,0,0,-1,4341,4341,0
12630,140000,112000,0,0,0,0,0,0,-1,3788,3815,-27,-1,0,0,0,-1,9386,9386,0,-1,722,722,0
12631,50000,40000,0,0,0,0,0,0,0,29691,1508,28183,0,29104,1502,27602,0,28968,1100,27868,0,29440,1032,28408
12632,250000,200000,0,0,0,0,0,0,-2,212,2000,-1788,-1,49924,51002,-1078,-1,-918,2,-920,-1,-1567,0,-1567
12633,50000,40000,0,0,0,0,0,1,2,18177,0,18177,2,19147,1289,17858,0,17827,800,17027,0,18389,1000,17389
12634,360000,288000,0,0,0,0,0,0,0,299059,12112,286947,0,281436,11500,269936,0,274358,9600,264758,0,270877,10005,260872
12635,90000,72000,0,0,0,0,0,0,0,0,0,0,0,0,0,0,-2,0,0,0,-2,0,0,0
12636,480000,384000,0,0,0,0,0,0,0,393648,25370,368278,0,330221,15203,315018,0,296004,12013,283991,0,279768,12013,267755
12637,210000,168000,0,0,0,0,0,0,0,6876,7067,-191,-1,2692,2696,-4,-1,5560,5560,0,-1,2866,2866,0
12638,160000,128000,0,0,0,0,0,0,-2,0,0,0,-2,0,0,0,-2,0,0,0,-2,388,388,0
12639,30000,24000,0,0,0,0,0,0,0,9019,1159,7860,0,7970,1000,6970,0,1479,1479,0,-1,1635,1635,0
12640,50000,40000,0,0,0,0,0,0,2,24538,3701,20837,2,22402,554,21848,2,9528,10026,-498,-1,8447,421,8026
12641,250000,200000,0,0,0,0,0,0,-1,62791,65791,-3000,-1,48598,2000,46598,0,50078,2100,47978,0,36050,2000,34050
12642,20000,16000,0,1,1,1,1,1,2,17276,0,17276,2,17514,800,16714,0,18462,1361,17101,0,18036,0,18036
12643,250000,200000,0,0,0,0,0,0,0,-60,0,-60,0,600,660,-60,-1,600,0,600,0,0,0,0
12644,90000,72000,0,0,0,0,0,1,2,61110,2200,58910,0,14223,1000,13223,0,9784,477,9307,0,5155,103,5052
12645,240000,192000,1,1,1,1,1,0,0,395612,15087,380525,0,386295,12000,374295,0,356206,15000,341206,0,352257,12000,340257
12646,130000,104000,0,0,0,0,0,0,-1,191,382,-191,-1,2898,2898,0,-1,4728,1900,2828,0,5149,500,4649
12647,730000,584000,0,0,0,0,0,0,0,49082,14023,35059,0,26873,9035,17838,0,514114,528897,-14783,-1,499100,22005,477095
12648,210000,168000,0,1,0,0,0,0,0,214775,10000,204775,0,111893,5000,106893,0,107697,4000,103697,0,105578,4000,101578
12649,200000,160000,0,0,0,0,0,0,0,49492,1706,47786,0,51802,4185,47617,0,38896,15,38881,2,36436,1537,34899
12650,30000,24000,0,0,0,0,0,0,2,20563,0,20563,3,18676,1000,17676,2,18281,0,18281,2,17261,2000,15261
12651,300000,240000,0,0,0,0,0,0,0,38450,38500,-50,-1,29925,29700,225,0,33769,33769,0,-1,21020,21020,0
12652,70000,56000,0,1,0,0,0,1,0,59165,2044,57121,0,29314,1773,27541,0,28844,1181,27663,0,29443,1215,28228
12653,110000,88000,0,0,0,0,0,0,0,78484,3500,74984,0,74652,3000,71652,0,75251,3000,72251,0,75643,2870,72773
12654,30000,24000,0,0,0,0,0,1,2,16557,1275,15282,0,16857,575,16282,0,18121,1539,16582,0,18375,700,17675
12655,240000,192000,0,0,0,0,0,0,-2,-28,0,-28,-2,-28,0,-28,-2,1522,1550,-28,-1,6820,6900,-80
12656,30000,24000,0,0,0,0,0,1,-1,318,318,0,-1,258,258,0,-1,0,0,0,-1,318,318,0
12657,360000,288000,0,0,0,0,0,1,-2,0,0,0,-2,0,0,0,-2,0,0,0,-2,0,0,0
12658,50000,40000,0,0,0,0,0,0,2,12030,0,12030,2,12650,1500,11150,0,13405,1500,11905,0,13793,1000,12793
12659,10000,8000,0,0,0,0,0,1,3,3564,0,3564,2,4500,1000,3500,0,5039,5039,0,-1,5275,375,4900
12660,100000,80000,0,0,0,0,0,0,0,62715,5030,57685,0,61465,10000,51465,0,55501,5000,50501,0,57892,10000,47892
12661,200000,160000,0,0,0,0,0,1,0,3618,3618,0,-1,0,0,0,-1,1496,1496,0,-1,0,0,0
12662,50000,40000,0,0,0,0,0,0,0,29136,1239,27897,0,19048,612,18436,0,17946,607,17339,0,17340,2593,14747
12663,30000,24000,0,0,0,0,0,1,2,13654,0,13654,2,13979,553,13426,0,15525,1825,13700,0,0,0,0
12664,220000,176000,0,0,0,0,0,1,-2,170,170,0,-2,5758,5789,-31,-2,792,792,0,-2,2538,2538,0
12665,100000,80000,0,1,1,1,1,1,3,98768,0,98768,3,96287,0,96287,2,102069,7629,94440,2,81931,0,81931
12666,240000,192000,0,0,0,0,0,1,2,41513,41000,513,0,10657,10657,0,-1,7893,0,7893,0,5347,5041,306
12667,30000,24000,0,1,1,0,0,0,0,29530,2169,27361,0,28433,1260,27173,0,21365,819,20546,0,0,0,0
12668,340000,272000,0,0,0,0,0,0,-1,86114,50000,36114,0,82049,30000,52049,0,57667,5000,52667,0,80767,80767,0
12669,100000,80000,0,0,0,0,0,0,0,16723,3013,13710,0,15868,4031,11837,0,8275,3012,5263,0,5954,2006,3948
12670,280000,224000,0,0,0,0,0,0,0,106380,4000,102380,0,112596,8000,104596,0,114235,5000,109235,0,117232,5000,112232
12671,100000,80000,0,0,0,0,0,0,0,70936,2600,68336,0,68104,5600,62504,0,68055,2600,65455,0,68084,2600,65484
12672,50000,40000,0,0,0,0,0,1,0,32067,3400,28667,0,31252,0,31252,2,32633,1900,30733,2,33965,2000,31965
12673,140000,112000,0,0,0,0,0,0,0,5233,1500,3733,0,6206,1100,5106,0,7140,1000,6140,0,8161,1100,7061
12674,270000,216000,0,0,0,0,0,0,0,0,0,0,0,0,0,0,-2,0,0,0,-2,0,0,0
12675,290000,232000,0,0,0,0,0,1,2,63624,3000,60624,0,64427,2406,62021,0,62853,2431,60422,0,63923,2433,61490
12676,370000,296000,0,0,0,0,0,0,0,59801,20000,39801,0,53925,8000,45925,0,30534,0,30534,2,23618,1000,22618
12677,80000,64000,0,0,0,0,0,0,0,20361,2000,18361,0,18722,1009,17713,0,12514,0,12514,0,8905,2000,6905
12678,250000,200000,0,0,0,0,0,0,-1,0,0,0,-2,0,0,0,-2,2546,2546,0,-1,0,0,0
12679,240000,192000,0,0,0,0,0,0,-1,390,390,0,-1,390,390,0,-1,232,232,0,-1,540,698,-158
12680,180000,144000,0,0,0,0,0,0,-1,19692,19713,-21,-1,13115,13117,-2,-1,24623,24630,-7,-1,485,485,0
12681,240000,192000,0,0,0,0,0,0,-2,37307,37307,0,-2,1086,1086,0,-2,1494,1494,0,-2,7724,7724,0
12682,110000,88000,0,0,0,0,0,0,0,54570,2563,52007,0,55368,2300,53068,0,56623,2300,54323,0,57196,1704,55492
12683,50000,40000,0,0,0,0,0,0,0,11342,1000,10342,0,8305,0,8305,0,7288,0,7288,0,0,0,0
12684,200000,160000,0,0,0,0,0,0,0,1408,1108,300,0,1800,669,1131,0,819,0,819,2,886,886,0
12685,50000,40000,0,0,0,0,0,0,0,0,0,0,0,0,0,0,-2,0,0,0,-2,0,0,0
12686,50000,40000,0,0,0,0,0,0,2,9600,1000,8600,2,10537,1500,9037,0,11008,1000,10008,0,11472,1000,10472
12687,360000,288000,0,0,0,0,0,0,-2,0,0,0,-2,23707,23707,0,-1,25233,2000,23233,0,23504,3391,20113
12688,90000,72000,0,0,0,0,0,1,0,70398,56388,14010,0,56266,112,56154,2,47804,1779,46025,0,44230,1786,42444
12689,210000,168000,0,0,0,0,0,0,-2,-18,0,-18,-2,-18,0,-18,-2,-18,0,-18,-2,-18,0,-18
12690,10000,8000,0,0,1,1,1,1,2,9055,1200,7855,0,9908,1000,8908,0,9611,0,9611,2,10059,1000,9059
12691,20000,16000,0,0,0,0,0,1,2,1650,0,1650,4,1650,0,1650,4,1650,0,1650,4,1650,0,1650
12692,100000,80000,0,1,1,0,0,0,0,96808,7728,89080,0,84528,0,84528,2,67873,5000,62873,2,65503,2600,62903
12693,70000,56000,1,1,0,0,0,0,0,76717,2888,73829,0,70281,26850,43431,0,30343,1047,29296,0,29782,1088,28694
12694,300000,240000,0,0,0,0,0,0,0,10282,2000,8282,0,11797,2000,9797,0,15571,4000,11571,0,17303,2000,15303
12695,50000,40000,0,0,0,0,0,0,0,38240,1292,36948,0,18443,804,17639,0,20065,5717,14348,0,20296,823,19473
12696,220000,176000,0,0,0,0,0,0,0,109884,5500,104384,0,106114,3775,102339,0,108202,4100,104102,0,110938,5000,105938
12697,120000,96000,0,0,0,0,0,0,-1,1551,0,1551,3,1410,9,1401,2,479,0,479,0,3158,3158,0
12698,30000,24000,0,0,0,0,0,1,0,14099,3042,11057,0,13580,0,13580,2,13657,600,13057,0,16356,2942,13414
12699,10000,8000,0,0,0,0,0,1,2,3510,3510,0,-1,3306,0,3306,2,3551,300,3251,0,5577,2260,3317
12700,80000,64000,0,0,0,0,0,0,0,64277,2500,61777,0,45455,1556,43899,0,42231,1600,40631,0,42804,1600,41204
12701,30000,24000,0,0,0,0,0,0,-1,1946,1946,0,-1,2503,1000,1503,0,0,0,0,0,780,780,0
12702,300000,240000,0,0,0,0,0,0,-1,790,790,0,-1,3569,3569,0,-1,657,657,0,-1,0,0,0
12703,50000,40000,0,0,0,0,0,0,0,22733,3334,19399,0,15100,27,15073,2,7080,300,6780,0,8049,1092,6957
12704,290000,232000,0,0,0,0,0,1,-2,0,0,0,-2,0,0,0,-2,0,0,0,-2,0,0,0
12705,400000,320000,0,0,0,0,0,0,-1,110958,110958,0,-1,164959,110000,54959,0,130737,20000,110737,0,128312,58312,70000
12706,50000,40000,0,0,0,0,0,1,-1,1271,1271,0,-1,940,949,-9,-1,110,110,0,-1,0,0,0
12707,30000,24000,0,0,0,0,0,0,0,380,400,-20,-2,590,601,-11,-1,7704,7504,200,0,20204,15005,5199
12708,160000,128000,0,0,0,0,0,0,-2,403,403,0,-2,1650,1650,0,-2,336,336,0,-2,790,790,0
12709,30000,24000,0,0,0,0,1,0,2,20905,1342,19563,0,21509,946,20563,0,25183,4200,20983,0,24242,0,24242
12710,140000,112000,0,0,0,0,0,0,0,68336,3110,65226,0,64648,5000,59648,0,58319,0,58319,2,55251,2100,53151
12711,50000,40000,0,1,0,0,0,0,0,50214,2456,47758,0,19321,0,19321,2,19867,1000,18867,0,20384,1000,19384
12712,20000,16000,0,0,0,0,0,1,2,7622,0,7622,2,8294,800,7494,2,8016,0,8016,2,9382,1500,7882
12713,90000,72000,0,0,0,0,0,0,3,36654,15,36639,2,32747,1831,30916,0,33091,1175,31916,0,33291,1338,31953
12714,360000,288000,0,0,0,0,0,1,-2,0,0,0,-2,0,0,0,-2,0,0,0,-2,0,0,0
12715,140000,112000,0,1,0,0,0,1,0,141532,5303,136229,0,75815,2806,73009,0,65099,1825,63274,0,66445,1880,64565
12716,370000,296000,0,0,0,0,0,0,-1,166229,166235,-6,-1,168601,3372,165229,0,171018,4018,167000,0,600,600,0
12717,330000,264000,0,0,0,0,0,1,0,175259,6000,169259,0,153562,5600,147962,0,157072,6000,151072,0,158516,6000,152516
12718,220000,176000,0,0,0,0,0,0,0,2664,1500,1164,0,891,891,0,-1,1927,1927,0,-1,4250,4250,0
12719,20000,16000,0,0,0,0,0,0,2,8402,1600,6802,2,9111,1000,8111,2,9802,1000,8802,0,10508,866,9642
12720,160000,128000,0,0,0,0,0,0,-1,762,762,0,-1,762,762,0,-1,762,762,0,-1,762,762,0
12721,280000,224000,0,0,0,0,0,0,0,7701,3007,4694,0,8951,3019,5932,0,6916,2004,4912,0,8790,3044,5746
12722,160000,128000,0,0,0,0,0,0,0,80240,3700,76540,0,39835,1700,38135,0,41150,2000,39150,0,0,0,0
12723,390000,312000,0,0,0,0,0,0,0,88335,3200,85135,0,89396,3200,86196,0,90769,3500,87269,0,91825,3300,88525
12724,430000,344000,0,0,0,0,0,0,-1,0,0,0,-2,0,0,0,-2,0,0,0,-2,2299,2299,0
12725,50000,40000,0,0,0,0,0,0,-1,22049,22049,0,-1,8110,8117,-7,-1,3164,3164,0,-1,10148,10148,0
12726,110000,88000,0,0,0,0,0,0,0,40084,1670,38414,0,41101,1977,39124,0,41834,2000,39834,0,42874,2000,40874
12727,350000,280000,0,0,0,0,0,0,2,259137,9754,249383,0,264798,10000,254798,0,269673,9396,260277,0,275672,10083,265589
12728,90000,72000,0,0,0,0,0,0,0,41181,2404,38777,0,41701,1500,40201,2,44000,3000,41000,2,45651,2500,43151
12729,320000,256000,0,0,0,0,0,0,0,101953,5050,96903,0,102284,3590,98694,0,104090,3700,100390,0,105859,3750,102109
12730,200000,160000,0,0,0,0,0,0,0,144245,7200,137045,0,135946,5300,130646,0,135736,5400,130336,0,134500,5240,129260
12731,360000,288000,0,0,0,0,0,0,-2,8564,8606,-42,-2,1495,1502,-7,-2,5977,6006,-29,-2,1211,4217,-3006
12732,50000,40000,0,0,0,0,0,1,0,23914,2600,21314,0,23231,0,23231,2,24851,2000,22851,2,24301,0,24301
12733,30000,24000,0,0,0,0,0,1,0,12513,1209,11304,0,13804,1500,12304,0,13442,0,13442,2,14066,1000,13066
12734,50000,40000,0,0,0,0,0,0,-2,0,0,0,-2,0,0,0,-2,0,0,0,-2,0,0,0
12735,260000,208000,0,0,0,0,0,0,-1,500,500,0,-2,2870,2870,0,-2,1141,1141,0,-2,679,679,0
12736,80000,64000,0,1,1,1,1,0,2,78499,2900,75599,0,79943,3102,76841,0,77354,3000,74354,0,78655,3010,75645
12737,180000,144000,0,0,0,0,0,0,-2,2027,2027,0,-2,1764,1774,-10,-2,11383,11383,0,-2,330,330,0
12738,90000,72000,0,0,0,0,0,0,0,66730,3000,63730,0,44850,2000,42850,0,29257,638,28619,0,24755,2000,22755
12739,210000,168000,0,0,0,0,0,0,0,27751,1372,26379,0,30418,5000,25418,0,23180,1304,21876,0,68842,60000,8842
12740,20000,16000,0,0,0,0,0,0,0,8840,1400,7440,0,-1560,0,-1560,0,-1560,0,-1560,-2,-1560,0,-1560
12741,500000,400000,0,0,0,0,0,0,0,9487,1000,8487,0,12641,6000,6641,0,14778,4000,10778,0,10665,3000,7665
12742,180000,144000,0,0,0,0,0,0,2,15632,1495,14137,0,15787,650,15137,0,16117,671,15446,0,17162,1401,15761
12743,20000,16000,0,1,1,1,1,1,0,19362,0,19362,2,19402,850,18552,0,19607,920,18687,0,19821,750,19071
12744,300000,240000,0,0,0,0,0,0,-1,316,316,0,-1,316,316,0,-1,316,316,0,-1,466,466,0
12745,420000,336000,0,0,0,0,0,0,0,11796,1600,10196,0,3089,1000,2089,0,4624,4641,-17,-1,210,210,0
12746,200000,160000,0,0,0,0,0,1,0,149765,5000,144765,2,131741,4500,127241,0,134488,4600,129888,0,137240,4700,132540
12747,160000,128000,0,0,0,0,0,0,0,125319,5900,119419,0,125283,5900,119383,0,124170,4300,119870,0,125140,4600,120540
12748,80000,64000,0,0,0,0,0,0,-1,-507,0,-507,-1,3129,4969,-1840,-1,1956,4990,-3034,-1,4246,2500,1746
12749,50000,40000,0,0,0,0,0,1,-1,526,526,0,-1,1913,1913,0,-1,1226,0,1226,2,1752,1052,700
12750,30000,24000,0,0,0,0,0,0,2,21658,0,21658,2,22794,1800,20994,2,22289,0,22289,2,22916,1000,21916
12751,200000,160000,0,0,0,0,0,0,0,77034,0,77034,2,64886,1500,63386,0,71957,10000,61957,0,66658,2000,64658
12752,280000,224000,0,0,0,0,0,0,-2,0,0,0,-2,539,539,0,-1,94,0,94,-1,3582,3582,0
12753,130000,104000,0,0,0,0,0,0,0,44975,1682,43293,0,45723,1430,44293,0,46515,1318,45197,0,47450,1331,46119
12754,240000,192000,0,0,0,0,0,0,0,109082,6500,102582,0,119221,13500,105721,2,118144,2300,115844,3,118029,2002,116027
12755,500000,400000,0,0,0,0,0,1,-1,5650,5678,-28,-1,4472,4495,-23,-1,67798,67969,-171,-1,65653,65814,-161
12756,20000,16000,0,0,0,0,0,0,0,15677,5000,10677,0,15133,0,15133,2,15582,1000,14582,0,16677,1500,15177
12757,280000,224000,0,0,0,0,0,1,2,111510,6000,105510,2,108253,0,108253,2,109065,4100,104965,0,111447,4300,107147
12758,240000,192000,0,0,0,0,0,0,-1,747,747,0,-1,0,0,0,-1,0,0,0,-2,0,0,0
12759,210000,168000,0,0,0,0,0,1,0,-4244,2572,-6816,0,205759,213509,-7750,-1,151849,6022,145827,0,150221,5817,144404
12760,50000,40000,0,0,0,0,0,0,0,23585,1700,21885,0,23894,1000,22894,0,24549,1039,23510,0,24990,1000,23990
12761,50000,40000,0,0,0,0,0,0,0,32106,1612,30494,0,32994,1500,31494,0,18220,652,17568,0,18755,828,17927
12762,120000,96000,0,0,0,0,0,0,0,8920,1500,7420,0,7439,7000,439,0,26832,21300,5532,0,26287,0,26287
12763,90000,72000,0,0,0,0,0,1,-2,0,0,0,-2,0,0,0,-2,0,0,0,-2,0,0,0
12764,300000,240000,0,0,0,0,0,0,-1,40996,43655,-2659,-1,41513,1752,39761,0,38303,937,37366,0,36352,916,35436
12765,170000,136000,0,0,0,0,0,0,-1,8101,5000,3101,0,6208,3749,2459,0,10460,6711,3749,0,11143,4432,6711
12766,50000,40000,0,0,0,0,0,0,0,33922,6,33916,2,30097,1000,29097,0,29013,1000,28013,0,28167,1200,26967
12767,60000,48000,1,1,0,0,0,1,0,67087,3490,63597,0,27121,1794,25327,0,26316,1311,25005,0,26476,953,25523
12768,230000,184000,0,0,0,0,0,0,-2,0,0,0,-2,0,0,0,-2,0,0,0,-2,0,0,0
12769,200000,160000,0,1,1,1,0,0,0,194283,7500,186783,0,191693,7000,184693,0,188261,5000,183261,0,155159,7000,148159
12770,280000,224000,0,0,0,0,0,0,-2,136,136,0,-2,0,0,0,-2,0,0,0,-2,350,350,0
12771,340000,272000,0,0,0,0,0,0,-1,390,390,0,-1,1489,1489,0,-1,2140,2140,0,-1,1190,1190,0
12772,140000,112000,0,0,0,0,0,0,0,34002,3000,31002,0,23567,3000,20567,0,24377,1000,23377,0,4327,1000,3327
12773,20000,16000,0,0,0,0,0,0,-1,10130,1145,8985,0,6165,950,5215,0,6165,0,6165,0,6315,150,6165
12774,20000,16000,0,0,0,0,0,1,-1,1320,1003,317,-1,930,0,930,2,780,240,540,2,240,0,240
12775,70000,56000,0,0,0,0,0,0,-1,390,0,390,2,390,390,0,-1,780,780,0,-1,0,0,0
12776,130000,104000,0,1,0,0,0,0,0,128380,5101,123279,0,97713,3600,94113,0,96245,3501,92744,0,95779,3800,91979
12777,200000,160000,0,0,0,0,0,0,-1,0,0,0,-1,0,0,0,-2,0,0,0,-2,980,980,0
12778,50000,40000,0,0,0,0,0,0,-1,6640,6640,0,-1,5410,5410,0,-1,9570,9570,0,-1,1500,1500,0
12779,180000,144000,0,0,0,0,0,1,4,82852,0,82852,4,81162,0,81162,3,79958,0,79958,2,178148,100000,78148
12780,50000,40000,0,0,0,0,0,1,-1,1214,0,1214,3,1494,457,1037,2,457,0,457,2,5523,5523,0
12781,180000,144000,0,0,0,0,0,0,-2,1251,1257,-6,-1,0,0,0,-1,0,0,0,-2,679,679,0
12782,180000,144000,0,0,0,0,0,0,-1,3173,3173,0,-1,13202,13212,-10,-1,6594,6594,0,-1,2549,2549,0
12783,50000,40000,0,0,0,0,0,1,0,19205,0,19205,3,18600,0,18600,2,19697,1700,17997,2,20243,1000,19243
12784,160000,128000,0,0,0,0,0,0,0,11486,5676,5810,0,12176,8874,3302,0,8044,161,7883,0,0,0,0
12785,560000,448000,0,0,0,0,0,0,0,151425,60052,91373,0,143343,10268,133075,0,127225,27225,100000,0,130479,15000,115479
12786,280000,224000,0,0,0,0,0,1,-2,-324,322,-646,-2,-324,0,-324,-2,-324,0,-324,-2,88036,88360,-324
12787,360000,288000,0,0,0,0,0,0,-2,6450,6482,-32,-2,13166,13242,-76,-2,23964,24011,-47,-2,5470,5497,-27
12788,50000,40000,0,1,0,0,0,0,0,47890,3012,44878,0,8412,1000,7412,0,9412,1000,8412,0,0,0,0
12789,270000,216000,0,0,0,0,0,0,-2,25417,25500,-83,-2,3839,4000,-161,-2,1794,2000,-206,-2,2459,2459,0
12790,150000,120000,0,0,0,0,0,1,2,-18,0,-18,-2,-18,0,-18,-2,-18,0,-18,-2,-18,0,-18
12791,20000,16000,0,1,1,1,1,1,0,19195,1397,17798,0,38040,836,37204,0,20009,1653,18356,0,20138,565,19573
12792,250000,200000,0,0,0,0,0,0,-1,2360,2377,-17,-1,6976,7006,-30,-1,3701,11,3690,0,2872,2981,-109
12793,80000,64000,0,0,0,0,0,0,0,39291,5000,34291,0,43476,5002,38474,0,46115,4003,42112,0,42129,3000,39129
12794,420000,336000,0,0,0,0,0,0,0,89586,4128,85458,0,83713,3147,80566,0,55375,2018,53357,0,54291,3130,51161
12795,140000,112000,0,0,0,0,0,0,-1,17227,17227,0,-1,12918,0,12918,0,10898,365,10533,0,823,840,-17
12796,460000,368000,0,0,0,0,0,0,-1,13776,13779,-3,-1,8226,8226,0,-1,12497,12497,0,-1,4503,4503,0
12797,20000,16000,0,1,0,0,0,1,0,19160,3000,16160,0,14506,5000,9506,0,12839,5000,7839,0,8495,3000,5495
12798,500000,400000,0,0,0,0,0,0,0,245012,29000,216012,0,243417,30000,213417,0,233968,30000,203968,0,209220,6110,203110
12799,300000,240000,0,0,0,0,0,1,-1,236220,8613,227607,0,233586,8000,225586,0,234661,11000,223661,0,233304,8093,225211
12800,480000,384000,0,0,0,0,0,0,0,13258,3066,10192,0,51723,51800,-77,-1,40511,5030,35481,0,37226,3039,34187
12801,500000,400000,0,0,0,0,0,0,-1,360,361,-1,-1,964,978,-14,-1,957,958,-1,-1,176,176,0
12802,50000,40000,0,1,0,0,0,1,0,48551,2124,46427,0,34656,2047,32609,0,18077,5618,12459,0,18815,1000,17815
12803,500000,400000,0,0,0,0,0,0,0,102315,4500,97815,0,90435,4000,86435,0,91924,4052,87872,0,81378,3007,78371
12804,110000,88000,0,0,0,0,0,0,0,52277,0,52277,2,52055,2000,50055,0,52437,3000,49437,0,55560,5000,50560
12805,140000,112000,0,0,0,0,0,1,0,89623,1038,88585,2,82030,3900,78130,0,84792,5000,79792,0,84794,4000,80794
12806,140000,112000,0,0,0,0,0,0,0,104462,4200,100262,0,43810,1810,42000,0,44434,1765,42669,0,45251,2000,43251
12807,50000,40000,0,0,0,0,0,0,0,25245,1722,23523,0,25955,1432,24523,0,26470,947,25523,0,27025,981,26044
12808,50000,40000,0,0,0,0,0,0,0,39589,1973,37616,0,19533,1307,18226,0,20535,1699,18836,0,19690,0,19690
12809,60000,48000,0,0,0,0,0,0,0,47778,2032,45746,0,37858,2005,35853,0,36467,1507,34960,0,34419,1501,32918
12810,500000,400000,0,0,0,0,0,0,0,157,157,0,-1,2025,2029,-4,-1,-1,0,-1,-1,-1,0,-1
12811,80000,64000,0,0,0,0,0,0,0,26813,1459,25354,0,27383,1500,25883,0,27475,1000,26475,0,27823,1003,26820
12812,470000,376000,0,0,0,0,0,1,0,177566,8000,169566,0,182074,9000,173074,0,183417,7000,176417,0,185608,8000,177608
12813,120000,96000,0,0,0,0,0,1,0,11876,1219,10657,0,12853,1196,11657,0,13109,452,12657,0,13015,460,12555
12814,300000,240000,0,0,0,0,0,1,-2,0,0,0,-2,1000,1000,0,-1,890,390,500,0,390,390,0
12815,360000,288000,0,0,0,0,0,0,-2,0,0,0,-2,0,0,0,-2,0,0,0,-2,0,0,0
12816,180000,144000,0,0,0,0,0,0,0,77640,2804,74836,0,78369,2802,75567,0,80010,2901,77109,0,83683,5000,78683
12817,170000,136000,0,0,0,0,0,0,0,36948,2000,34948,0,38031,2000,36031,0,38698,1600,37098,0,39524,1600,37924
12818,220000,176000,0,0,0,0,0,1,-1,0,0,0,-2,110699,110699,0,-1,0,0,0,-1,0,0,0
12819,50000,40000,0,0,0,0,0,0,0,18689,1700,16989,0,19284,1600,17684,0,19517,1200,18317,0,19193,1000,18193
12820,210000,168000,0,0,0,0,0,0,-2,410,412,-2,-2,0,0,0,-2,0,0,0,-2,0,0,0
12821,200000,160000,0,0,0,0,0,0,-2,-6144,0,-6144,-2,-7905,0,-7905,-2,-10213,0,-10213,-2,-11060,0,-11060
12822,170000,136000,0,0,0,0,0,0,2,119161,6000,113161,0,120662,5000,115662,0,127815,9000,118815,0,125098,0,125098
12823,240000,192000,0,0,0,0,0,0,-2,0,0,0,-2,0,0,0,-2,0,0,0,-2,0,0,0
12824,280000,224000,0,0,0,0,0,0,-2,-26,0,-26,-2,-26,0,-26,-2,5294,5320,-26,-2,-4,0,-4
12825,360000,288000,0,0,0,0,0,0,0,258122,9221,248901,0,255309,9225,246084,0,233946,8112,225834,0,235916,8369,227547
12826,10000,8000,0,0,1,1,1,1,0,9001,1400,7601,0,9768,1200,8568,0,9233,300,8933,0,9154,800,8354
12827,100000,80000,0,0,0,0,0,0,-1,8905,8944,-39,-1,0,200,-200,-1,4290,4290,0,-1,0,0,0
12828,30000,24000,0,0,0,1,1,0,0,24583,1705,22878,0,24915,1037,23878,0,25280,915,24365,0,25791,929,24862
12829,230000,184000,0,0,0,0,0,0,-2,2577,2590,-13,-2,8001,8039,-38,-2,2970,2984,-14,-2,-1,0,-1
12830,80000,64000,0,0,0,0,0,0,0,68835,5169,63666,0,41462,21,41441,2,36589,3000,33589,0,39985,4000,35985
12831,30000,24000,0,1,1,1,1,1,2,29058,1803,27255,0,29320,1733,27587,0,29787,1200,28587,0,27599,1200,26399
12832,130000,104000,0,0,0,0,0,0,-1,230,230,0,-1,630,830,-200,-1,430,430,0,-1,14802,14802,0
12833,270000,216000,0,0,0,0,0,1,0,19543,1469,18074,0,17160,514,16646,0,14818,581,14237,0,12702,612,12090
12834,240000,192000,0,0,0,0,0,0,-1,0,5717,-5717,-1,5717,0,5717,-1,10134,10134,0,-1,1045,1045,0
12835,50000,40000,0,0,0,0,0,0,-1,5408,5413,-5,-1,2734,2734,0,-1,7976,7976,0,-1,0,0,0
12836,50000,40000,0,1,0,0,0,0,0,47557,3006,44551,0,20914,1500,19414,0,19646,701,18945,0,20332,1000,19332
12837,270000,216000,0,0,0,0,0,0,-1,3366,3366,0,-1,0,0,0,-1,2192,2192,0,-1,0,0,0
12838,230000,184000,0,0,0,0,0,1,2,71201,0,71201,2,72029,4000,68029,0,71923,2607,69316,0,72020,2732,69288
12839,80000,64000,0,0,0,0,0,0,0,51770,2000,49770,0,49506,2015,47491,0,45722,1700,44022,0,46660,1700,44960
12840,30000,24000,0,0,1,1,1,0,2,24817,1715,23102,0,25602,1500,24102,0,26535,1500,25035,0,26947,1000,25947
12841,80000,64000,0,0,0,0,0,0,0,40350,15350,25000,0,38812,1491,37321,0,33459,3459,30000,0,31650,1650,30000
12842,20000,16000,0,1,1,1,1,1,0,18862,1610,17252,0,18931,679,18252,0,19624,1000,18624,0,20049,900,19149
12843,150000,120000,0,0,0,0,0,0,-2,0,0,0,-2,0,0,0,-2,0,0,0,-2,0,0,0
12844,20000,16000,0,0,0,0,0,0,0,5560,1000,4560,2,6310,1000,5310,2,7204,1000,6204,2,6943,0,6943
12845,50000,40000,0,0,0,0,0,0,-2,1697,1699,-2,-2,0,0,0,-2,0,0,0,-2,5000,5000,0
12846,180000,144000,0,0,0,0,0,0,-2,24974,25043,-69,-2,25256,25256,0,-2,29627,29627,0,-2,17765,17765,0
12847,340000,272000,0,0,0,0,0,0,0,8108,3000,5108,0,19291,21000,-1709,-1,35882,20000,15882,0,18924,18924,0
12848,30000,24000,0,1,0,0,0,1,0,26791,1232,25559,0,14500,1040,13460,0,0,0,0,0,0,0,0
12849,80000,64000,0,0,0,0,0,0,0,54936,5000,49936,0,55735,2300,53435,2,56699,2000,54699,2,55632,0,55632
12850,260000,208000,0,0,0,0,0,0,-1,399,399,0,-1,798,798,0,-1,399,0,399,0,399,399,0
12851,50000,40000,0,0,0,0,0,0,0,10238,1200,9038,0,10700,1000,9700,0,10762,1000,9762,0,11587,1000,10587
12852,110000,88000,0,0,0,0,0,0,0,51264,2500,48764,0,51584,1800,49784,0,49601,1800,47801,0,50485,2000,48485
12853,160000,128000,0,0,0,0,0,0,-1,1976,1976,0,-1,810,810,0,-1,2165,2165,0,-1,1997,0,1997
12854,270000,216000,0,0,0,0,0,0,-1,2521,2521,0,-1,5145,5184,-39,-1,8422,8422,0,-1,6374,6374,0
12855,160000,128000,0,0,0,0,0,0,-1,805,886,-81,-1,666,679,-13,-1,740,740,0,-1,539,539,0
12856,90000,72000,0,0,0,0,0,0,0,43421,1851,41570,0,45878,3500,42378,0,46054,1519,44535,0,47252,2000,45252
12857,90000,72000,0,0,0,0,0,0,2,0,0,0,2,0,0,0,-2,0,0,0,-2,0,0,0
12858,70000,56000,0,1,0,0,0,0,0,66460,3000,63460,0,46988,2000,44988,0,43530,2500,41030,0,44804,2000,42804
12859,220000,176000,0,0,0,0,0,0,0,119575,3900,115675,0,51317,1000,50317,0,51926,1000,50926,0,34608,2000,32608
12860,150000,120000,0,0,0,0,0,0,-1,30244,30620,-376,-1,2434,2434,0,-1,29139,29139,0,-1,26987,1210,25777
12861,110000,88000,0,1,1,0,0,0,2,107630,4334,103296,0,106354,4250,102104,0,79154,2946,76208,0,69988,2506,67482
12862,20000,16000,0,1,0,0,1,1,4,16345,0,16345,3,15785,0,15785,2,17018,1500,15518,0,18736,2000,16736
12863,50000,40000,0,0,0,0,0,1,2,7561,1125,6436,0,7712,276,7436,0,7936,348,7588,0,47743,40000,7743
12864,220000,176000,0,0,0,0,0,0,0,133534,6121,127413,0,27484,1551,25933,0,23728,875,22853,0,21039,1800,19239
12865,100000,80000,0,0,0,0,0,1,2,2449,1020,1429,0,-571,0,-571,0,40342,41113,-771,-1,41113,1000,40113
12866,50000,40000,0,0,0,0,0,0,0,12025,3000,9025,0,16025,4000,12025,0,0,0,0,0,0,0,0
12867,20000,16000,0,0,1,1,1,0,0,18394,9000,9394,0,16806,0,16806,2,36070,2000,34070,0,19257,2000,17257
12868,300000,240000,0,1,1,0,0,0,0,291480,12507,278973,0,298378,15056,283322,0,131103,5027,126076,0,128742,5007,123735
12869,390000,312000,0,1,0,0,0,0,0,337892,15057,322835,0,298729,10100,288629,0,243169,10000,233169,0,133977,10000,123977
12870,50000,40000,0,0,0,0,0,0,-1,1276,1276,0,-1,827,827,0,-1,105,105,0,-1,270,270,0
12871,140000,112000,0,0,0,0,0,0,0,82784,3000,79784,0,81458,4000,77458,0,86227,7000,79227,0,84646,0,84646
12872,120000,96000,0,0,0,0,0,0,-2,4050,4051,-1,-1,4050,0,4050,0,0,0,0,0,0,7,-7
12873,20000,16000,0,1,1,1,1,1,0,17676,1500,16176,0,18300,900,17400,0,20278,3600,16678,0,20192,393,19799
12874,120000,96000,0,0,0,0,0,0,-1,5079,5079,0,-1,2528,0,2528,2,4007,4007,0,-1,7457,7457,0
12875,100000,80000,0,0,1,1,1,1,2,84133,5000,79133,2,84873,3000,81873,2,82613,0,82613,2,87461,6200,81261
12876,170000,136000,0,0,0,0,0,0,0,136604,6800,129804,0,136607,4700,131907,0,133199,4700,128499,0,135242,5500,129742
12877,50000,40000,0,0,0,0,0,0,0,16227,1600,14627,0,17746,2100,15646,0,7496,1930,5566,2,7877,500,7377
12878,200000,160000,0,0,0,0,0,0,0,35420,10000,25420,0,26609,2000,24609,0,25392,5000,20392,0,23367,5000,18367
12879,200000,160000,0,0,0,0,0,0,-1,3498,0,3498,2,10494,10494,0,-1,6996,0,6996,0,3498,0,3498
12880,350000,280000,0,0,0,0,0,1,0,272799,11127,261672,0,117867,4327,113540,0,117518,4261,113257,0,119718,4150,115568
12881,100000,80000,0,0,0,0,0,1,0,58789,2640,56149,0,53091,2000,51091,0,55229,3000,52229,0,57144,3000,54144
12882,280000,224000,0,0,0,0,0,0,0,77944,6000,71944,0,81926,6000,75926,0,79277,7000,72277,0,78723,5000,73723
12883,50000,40000,0,0,0,0,0,0,0,14273,1237,13036,0,14555,519,14036,0,14860,538,14322,0,15155,541,14614
12884,130000,104000,0,0,0,0,0,0,-1,390,0,390,2,540,540,0,-1,11040,11040,0,-1,953,953,0
12885,360000,288000,0,0,0,0,0,0,-2,2344,2344,0,-2,9536,9536,0,-2,9043,9043,0,-2,0,0,0
12886,300000,240000,0,0,0,0,0,0,0,65059,6039,59020,0,147613,100000,47613,0,236687,100000,136687,0,237105,8600,228505
12887,50000,40000,0,1,1,0,0,0,0,50908,2005,48903,0,49756,1432,48324,0,27702,1008,26694,0,27429,3007,24422
12888,110000,88000,0,1,1,0,0,0,0,110937,5000,105937,0,108869,3814,105055,0,43207,2000,41207,0,42954,1600,41354
12889,430000,344000,0,0,0,0,0,0,0,45441,1587,43854,0,39174,1161,38013,0,28261,1943,26318,0,25411,995,24416
12890,210000,168000,0,0,0,0,0,0,0,89419,3892,85527,0,88758,3184,85574,0,85239,3128,82111,0,81723,2944,78779
12891,20000,16000,1,1,1,1,1,1,3,25871,0,25871,2,21970,0,21970,0,18669,0,18669,0,19669,1000,18669
12892,50000,40000,0,0,0,0,0,0,0,28971,0,28971,0,30437,2500,27937,0,14106,1024,13082,-1,794,397,397
12893,20000,16000,0,0,1,0,1,0,0,16926,3500,13426,0,17333,1000,16333,2,16820,1000,15820,0,17175,1000,16175
12894,280000,224000,0,1,0,0,0,0,0,262562,10565,251997,0,164059,20253,143806,0,131807,20518,111289,0,180524,155067,25457
12895,380000,304000,0,1,1,1,1,0,0,372261,17000,355261,0,375423,13070,362353,0,359527,15000,344527,0,361201,13000,348201
12896,290000,232000,0,0,0,0,0,0,0,198684,6000,192684,0,87700,1573,86127,0,88621,1629,86992,0,53243,3129,50114
12897,180000,144000,0,0,0,0,0,0,-2,0,0,0,-2,0,0,0,-2,680,680,0,-1,34704,34704,0
12898,120000,96000,0,0,0,0,0,0,0,29166,2003,27163,0,7403,2772,4631,0,3095,3095,0,-1,9641,9641,0
12899,180000,144000,0,0,0,0,0,0,0,120264,6000,114264,0,124203,6000,118203,0,125702,5000,120702,0,128734,5000,123734
12900,60000,48000,0,0,0,0,0,0,2,39252,1700,37552,0,38051,1700,36351,0,37988,2000,35988,0,38725,1500,37225
12901,50000,40000,0,0,0,0,0,1,3,8017,1000,7017,2,8687,810,7877,0,9048,500,8548,0,9306,408,8898
12902,80000,64000,0,1,0,0,0,0,0,69856,3000,66856,0,48816,1800,47016,0,48476,1800,46676,0,48448,2000,46448
12903,160000,128000,0,1,1,1,1,0,0,139323,0,139323,2,140719,5100,135619,0,143638,10251,133387,0,144482,5205,139277
12904,150000,120000,1,1,1,1,1,1,4,159283,0,159283,3,148309,0,148309,2,143972,5000,138972,2,139650,5000,134650
12905,80000,64000,0,1,1,0,0,1,2,81477,6800,74677,2,79035,0,79035,2,28503,1000,27503,0,29711,2000,27711
12906,140000,112000,0,1,0,0,0,0,0,117263,5006,112257,0,77496,5000,72496,0,79815,5000,74815,0,77911,3000,74911
12907,140000,112000,0,0,0,0,0,0,0,104817,4000,100817,2,102161,4500,97661,0,85512,3500,82012,0,83028,4000,79028
12908,100000,80000,0,0,0,0,0,1,2,46112,0,46112,2,48925,3900,45025,2,49794,1800,47994,2,50823,2000,48823
12909,30000,24000,0,0,1,1,1,0,0,24554,1409,23145,0,25213,1068,24145,0,27638,3000,24638,0,27042,0,27042
12910,200000,160000,0,0,0,0,0,0,0,0,1000,-1000,-2,0,0,0,-2,0,0,0,-2,-3500,0,-3500
12911,30000,24000,0,0,0,0,0,1,0,5235,1517,3718,0,3122,2000,1122,0,11446,11446,0,-1,1914,1914,0
12912,130000,104000,0,0,0,0,0,0,0,46741,10000,36741,0,42881,1000,41881,0,367,367,0,-1,46265,61170,-14905
12913,50000,40000,1,1,1,0,0,0,0,53676,2880,50796,0,51786,1950,49836,0,34919,1050,33869,0,33571,1010,32561
12914,20000,16000,0,0,0,1,1,0,2,243,1000,-757,-1,19853,20000,-147,-1,20157,1000,19157,0,20182,720,19462
12915,30000,24000,0,0,0,0,0,1,2,13255,2000,11255,2,14380,1670,12710,2,14081,551,13530,2,10796,0,10796
12916,100000,80000,0,0,0,0,0,0,0,6618,1162,5456,0,3895,3000,895,0,4037,159,3878,0,12959,11845,1114
12917,500000,400000,0,0,0,0,0,0,0,73583,10104,63479,0,79481,10000,69481,0,115741,40000,75741,0,168319,10000,158319
12918,20000,16000,0,0,0,0,1,1,0,15425,1600,13825,0,16460,1600,14860,0,17380,1500,15880,0,17650,700,16950
12919,230000,184000,0,0,0,0,0,0,-1,651,651,0,-1,0,0,0,-1,651,651,0,-1,1496,1496,0
12920,80000,64000,0,0,0,0,0,0,-2,0,0,0,-2,0,0,0,-2,0,0,0,-2,7010,6204,806
12921,50000,40000,0,1,0,0,0,0,2,49158,0,49158,2,29375,1008,28367,0,28050,1004,27046,0,27721,1032,26689
12922,110000,88000,0,1,0,0,0,0,2,94521,10,94511,2,88833,3917,84916,0,82585,2730,79855,0,75992,2770,73222
12923,80000,64000,0,0,0,0,0,0,0,38464,2000,36464,0,38922,1397,37525,0,40791,2500,38291,0,43108,3000,40108
12924,50000,40000,0,0,0,0,0,0,0,17187,10000,7187,0,6377,10000,-3623,-1,6370,6000,370,0,1910,0,1910
12925,20000,16000,0,0,0,0,0,0,2,1491,1491,0,-1,390,2500,-2110,-1,390,390,0,-1,390,390,0
12926,30000,24000,0,0,0,0,0,0,0,10279,1423,8856,0,10610,754,9856,0,10339,0,10339,2,8710,1000,7710
12927,150000,120000,0,0,0,0,0,0,0,105290,64890,40400,0,149530,122080,27450,0,146455,106625,39830,0,141711,141711,0
12928,30000,24000,0,1,1,0,0,1,2,28034,8,28026,2,26251,2007,24244,0,24133,1005,23128,0,22527,782,21745
12929,500000,400000,0,0,0,0,0,0,-1,32046,32077,-31,-1,32530,32579,-49,-1,18896,18914,-18,-1,17049,17069,-20
12930,240000,192000,0,1,0,0,1,0,0,219487,6900,212587,0,151295,6000,145295,0,228276,80000,148276,0,233079,8600,224479
12931,50000,40000,0,1,0,0,0,0,-1,49805,1200,48605,0,27605,600,27005,0,29447,29057,390,0,30045,1076,28969
12932,500000,400000,0,0,0,0,0,0,-1,1490,1490,0,-1,1822,1822,0,-1,1740,1740,0,-1,0,0,0
12933,20000,16000,0,1,1,1,1,1,0,19839,2000,17839,0,20236,688,19548,0,19807,1000,18807,0,19843,1500,18343
12934,180000,144000,0,0,0,0,0,0,-1,2220,2200,20,0,11303,11303,0,-1,9359,187,9172,0,9041,181,8860
12935,110000,88000,0,1,1,0,0,0,0,105848,5700,100148,0,103018,3100,99918,0,42298,2000,40298,0,43464,2000,41464
12936,50000,40000,0,0,0,0,0,0,0,17163,1300,15863,0,17878,1000,16878,0,18931,1500,17431,0,19617,1000,18617
12937,120000,96000,0,0,0,0,0,0,-2,0,0,0,-2,0,0,0,-2,305,305,0,-2,20502,21742,-1240
12938,80000,64000,0,1,1,0,0,1,2,83628,4001,79627,2,152452,12,152440,2,0,0,0,2,0,0,0
12939,240000,192000,0,0,0,0,0,0,-2,-10608,13000,-23608,-2,2657,13265,-10608,-1,4245,3392,853,0,3392,1000,2392
12940,350000,280000,0,0,0,0,0,0,0,1355,1359,-4,-1,7069,14615,-7546,-1,0,0,0,-1,180,180,0
12941,240000,192000,0,1,1,1,0,0,0,245387,12000,233387,0,248945,10000,238945,0,224776,20019,204757,0,11567,3000,8567
12942,150000,120000,0,0,0,0,0,1,-1,632,0,632,2,316,0,316,0,316,316,0,-1,1414,1414,0
12943,10000,8000,1,1,1,1,1,0,0,19570,1135,18435,0,19967,532,19435,0,9908,449,9459,0,9646,693,8953
12944,500000,400000,0,0,0,0,0,0,-2,30760,30760,0,-2,143791,143791,0,-2,-200,0,-200,-2,-200,0,-200
12945,230000,184000,0,0,0,0,0,1,0,87294,4231,83063,0,85336,4061,81275,0,81640,2846,78794,0,82462,2800,79662
12946,50000,40000,0,0,0,0,0,0,0,10529,1847,8682,0,8337,1000,7337,0,2475,0,2475,0,0,0,0
12947,140000,112000,0,0,0,0,0,0,-1,0,0,0,-2,0,0,0,-2,0,0,0,-2,579,579,0
12948,200000,160000,0,1,1,1,1,1,0,184262,7074,177188,0,178674,7870,170804,0,181318,7028,174290,0,179477,6768,172709
12949,140000,112000,0,0,0,0,0,0,2,58679,2100,56579,2,59379,2100,57279,2,60636,2200,58436,2,61656,2000,59656
12950,210000,168000,0,0,0,0,0,0,0,14939,1307,13632,0,15748,1116,14632,0,16069,437,15632,0,13780,399,13381
12951,200000,160000,0,0,0,0,0,0,0,133245,5000,128245,0,131906,4871,127035,0,135533,5905,129628,0,137809,5491,132318
12952,130000,104000,0,0,0,0,0,0,0,40523,10000,30523,0,54838,15000,39838,0,78769,25000,53769,0,82478,5000,77478
12953,310000,248000,0,0,0,0,0,0,0,30944,20000,10944,0,31594,2000,29594,0,30454,2000,28454,0,29246,2000,27246
12954,500000,400000,0,0,0,0,0,0,-1,20089,18,20071,2,28077,28077,0,-1,132588,132588,0,-1,115442,28500,86942
12955,230000,184000,0,0,0,0,0,0,-2,416,461,-45,-2,416,416,0,-2,566,566,0,-2,416,416,0
12956,30000,24000,0,0,0,0,0,0,0,14413,1537,12876,0,14476,600,13876,0,14792,550,14242,0,15145,600,14545
12957,250000,200000,0,0,0,0,0,0,-1,2325,202,2123,2,177,0,177,2,8068,8068,0,-1,5587,620,4967
12958,50000,40000,0,0,0,0,0,0,-1,550,1000,-450,-1,390,230,160,0,0,0,0,0,780,780,0
12959,50000,40000,0,1,1,0,0,0,2,49053,2200,46853,0,50106,2180,47926,0,17756,1000,16756,0,18072,1000,17072
12960,250000,200000,0,1,1,1,1,0,0,224949,8160,216789,0,229577,8364,221213,0,234221,8493,225728,0,238960,8625,230335
12961,20000,16000,0,0,0,0,0,0,-1,5064,6004,-940,-1,14745,14776,-31,-1,6805,10000,-3195,-1,6805,0,6805
12962,50000,40000,0,1,0,0,0,0,0,44090,3025,41065,0,36501,2029,34472,0,28493,2015,26478,0,24663,1001,23662
12963,210000,168000,0,0,0,0,0,0,-1,0,0,0,-1,1761,1761,0,-1,675,675,0,-1,752,752,0
12964,180000,144000,0,0,0,0,0,0,-1,89271,91272,-2001,-1,1946,162,1784,0,11859,11859,0,-1,506,506,0
12965,100000,80000,0,0,0,0,0,0,-2,416,416,0,-2,416,416,0,-2,416,416,0,-2,412,412,0
12966,370000,296000,0,0,0,0,0,0,0,19031,1320,17711,0,17345,1100,16245,0,18245,1000,17245,0,23200,10000,13200
12967,60000,48000,0,0,0,0,0,0,0,30312,2000,28312,0,22999,1000,21999,0,23484,1005,22479,0,24438,1500,22938
12968,50000,40000,0,0,0,0,0,1,0,7044,1098,5946,0,6787,231,6556,0,6534,234,6300,0,6277,238,6039
12969,20000,16000,0,0,0,0,0,0,0,390,390,0,-1,390,390,0,-1,780,780,0,-1,780,0,780
12970,380000,304000,0,0,0,0,0,0,-2,2517,2517,0,-2,710,716,-6,-1,0,0,0,-1,0,0,0
12971,150000,120000,0,0,0,0,0,0,-1,6152,6427,-275,-1,7306,7306,0,-1,18726,18738,-12,-1,13839,0,13839
12972,10000,8000,0,0,0,1,1,0,3,7800,0,7800,2,8672,1000,7672,2,8388,0,8388,2,9248,1000,8248
12973,80000,64000,0,0,0,0,0,0,-1,-185,0,-185,-1,-185,0,-185,-2,-185,0,-185,-2,665,1000,-335
12974,30000,24000,0,0,0,0,0,0,2,1000,1000,0,-1,543,3,540,2,18127,20077,-1950,-1,23563,10000,13563
12975,340000,272000,0,1,1,1,1,0,0,324322,12000,312322,0,316472,12000,304472,0,317349,12000,305349,0,314212,12000,302212
12976,50000,40000,0,1,1,1,0,1,0,50981,4414,46567,0,45793,1500,44293,0,46555,1042,45513,0,38816,2000,36816
12977,220000,176000,0,0,0,0,0,1,2,2500,0,2500,2,2500,0,2500,2,2500,0,2500,2,2500,0,2500
12978,80000,64000,0,0,0,0,0,1,0,10038,1047,8991,0,10040,248,9792,0,10400,408,9992,0,10490,294,10196
12979,20000,16000,0,0,0,0,0,0,-1,6573,6779,-206,-1,7422,7547,-125,-1,4381,4589,-208,-1,11718,12000,-282
12980,30000,24000,0,0,0,0,0,1,2,13850,1227,12623,0,14125,502,13623,0,14423,522,13901,0,14516,521,13995
12981,170000,136000,0,0,0,0,0,0,-1,1970,1970,0,-1,1132,1132,0,-1,1132,1132,0,-1,1397,1397,0
12982,20000,16000,0,0,0,0,0,1,2,7789,1500,6289,2,8505,1000,7505,2,9212,1000,8212,2,8922,0,8922
12983,130000,104000,0,0,0,0,0,1,2,10220,1000,9220,2,10353,600,9753,0,10636,600,10036,0,10711,400,10311
12984,50000,40000,0,0,0,0,0,1,0,33850,3500,30350,0,34495,1500,32995,2,35129,1500,33629,2,35918,1500,34418
12985,150000,120000,0,0,0,0,0,0,-2,0,0,0,-2,0,0,0,-2,0,0,0,-2,0,0,0
12986,310000,248000,0,0,0,0,0,1,-1,1261,1261,0,-1,1651,1651,0,-1,390,0,390,0,390,390,0
12987,30000,24000,0,1,1,1,1,0,2,28167,0,28167,2,28568,1168,27400,0,29019,1060,27959,0,30430,1900,28530
12988,210000,168000,0,0,0,0,0,0,0,78276,4000,74276,0,81246,4323,76923,0,78971,3501,75470,0,80359,3000,77359
12989,350000,280000,0,1,1,0,0,1,2,345088,14579,330509,0,341811,13557,328254,0,265953,12000,253953,0,93300,5000,88300
12990,500000,400000,0,0,0,0,0,0,0,261185,10000,251185,0,215575,6476,209099,0,174736,5489,169247,0,118438,5000,113438
12991,230000,184000,0,0,0,0,0,0,-1,3432,3461,-29,-1,495,495,0,-1,495,495,0,-1,495,495,0
12992,360000,288000,0,0,0,0,0,0,0,110795,4100,106695,0,101668,4208,97460,0,78730,3000,75730,0,66682,2300,64382
12993,130000,104000,0,0,0,0,0,0,-1,390,390,0,-1,1068,1068,0,-1,3169,3169,0,-1,390,390,0
12994,120000,96000,0,0,0,0,0,1,-1,0,0,0,-2,0,0,0,-2,0,0,0,-2,0,0,0
12995,60000,48000,0,0,0,0,0,0,-1,2816,0,2816,2,3579,1000,2579,0,3400,0,3400,0,4417,1017,3400
12996,200000,160000,0,0,0,0,0,0,-2,2571,2571,0,-2,2571,2571,0,-2,2571,2571,0,-2,2571,2571,0
12997,300000,240000,0,0,0,0,0,0,0,72886,2645,70241,0,74371,2696,71675,0,75854,2716,73138,0,77440,2809,74631
12998,360000,288000,0,0,0,0,0,0,-1,70460,70579,-119,-1,67357,10022,57335,0,71713,20000,51713,0,27399,27399,0
12999,230000,184000,0,0,0,0,0,0,-2,1876,1876,0,-2,2848,2848,0,-2,1876,1876,0,-2,4634,4634,0
13000,300000,240000,0,0,0,0,0,1,2,5000,0,5000,2,5000,0,5000,2,5000,0,5000,2,5000,0,5000
13001,50000,40000,0,1,1,1,1,1,2,47617,2000,45617,2,48542,2000,46542,2,49630,2000,47630,2,50047,1700,48347
13002,200000,160000,0,0,0,0,0,0,0,7796,1284,6512,0,8512,1000,7512,0,10205,2000,8205,0,11032,1000,10032
13003,50000,40000,0,1,1,0,0,0,0,49049,1804,47245,0,41876,1494,40382,0,29158,1031,28127,0,29493,1062,28431
13004,80000,64000,0,0,0,0,0,0,-1,333,333,0,-1,333,333,0,-1,0,0,0,-1,75,75,0
13005,140000,112000,0,1,1,0,0,0,0,132406,6213,126193,0,120046,5423,114623,0,92820,3400,89420,0,90525,4000,86525
13006,100000,80000,0,0,0,0,0,1,2,46927,2000,44927,2,47759,1900,45859,2,46865,0,46865,2,47930,2000,45930
13007,60000,48000,0,0,0,0,0,0,0,20264,1700,18564,0,20614,1403,19211,0,20877,1000,19877,0,21535,1000,20535
13008,20000,16000,0,0,0,0,0,0,-2,0,0,0,-2,0,0,0,-2,0,0,0,-2,0,0,0
13009,30000,24000,0,1,1,1,1,0,4,26645,0,26645,3,25919,0,25919,2,27535,2038,25497,2,28197,1268,26929
13010,210000,168000,0,0,0,0,0,0,-1,2168,2168,0,-1,762,762,0,-1,660,660,0,-1,3140,3140,0
13011,410000,328000,0,1,1,1,1,0,0,419988,16000,403988,0,359736,13100,346636,0,358471,12700,345771,0,360557,13000,347557
13012,80000,64000,0,0,0,0,0,0,3,1770,0,1770,2,3104,1400,1704,2,2946,0,2946,2,2844,57,2787
13013,360000,288000,0,0,0,0,0,0,-1,389,390,-1,-1,389,390,-1,-1,389,390,-1,-1,389,390,-1
13014,190000,152000,0,0,0,0,0,0,-1,0,0,0,-1,0,0,0,-2,0,0,0,-2,0,0,0
13015,330000,264000,0,0,0,0,0,0,0,84470,3026,81444,0,80923,3000,77923,0,82580,3000,79580,0,84330,3078,81252
13016,80000,64000,1,1,1,0,0,0,0,103223,4000,99223,0,97871,2600,95271,0,38640,3000,35640,0,14734,19707,-4973
13017,130000,104000,0,0,0,0,0,0,0,60390,1208,59182,0,390,390,0,-1,390,390,0,-1,390,390,0
13018,180000,144000,0,0,0,0,0,0,-2,0,0,0,-2,0,0,0,-2,0,0,0,-2,0,0,0
13019,120000,96000,0,1,1,1,1,1,2,113559,6000,107559,0,118784,9000,109784,0,118967,3425,115542,2,108887,45,108842
13020,260000,208000,0,0,0,1,1,1,0,204730,60000,144730,0,246985,100008,146977,0,240543,10000,230543,0,227725,11700,216025
13021,310000,248000,0,0,0,0,0,0,0,29427,1600,27827,0,29548,1607,27941,0,29839,898,28941,0,30532,1000,29532
13022,30000,24000,0,0,0,0,0,0,0,17723,1553,16170,0,17431,1002,16429,0,17882,2002,15880,0,17694,1000,16694
13023,230000,184000,0,0,0,0,0,1,-1,600,600,0,-1,600,0,600,4,300,0,300,3,150,0,150
13024,170000,136000,0,0,0,0,0,0,0,144225,50269,93956,0,111983,3567,108416,0,0,0,0,0,0,0,0
13025,50000,40000,0,1,0,0,0,0,0,49243,1325,47918,0,8760,490,8270,0,8796,300,8496,0,9176,500,8676
13026,80000,64000,0,0,0,0,0,0,0,7241,2005,5236,0,3261,3261,0,-1,6264,3003,3261,0,891,891,0
13027,20000,16000,0,1,1,1,1,0,2,16433,0,16433,2,17443,1289,16154,0,19254,2100,17154,0,18804,0,18804
13028,230000,184000,0,0,0,0,0,0,0,24408,5000,19408,0,8747,3060,5687,0,-1231,91,-1322,0,4771,6002,-1231
13029,20000,16000,1,1,1,1,1,1,3,23154,0,23154,6,22520,0,22520,5,21596,0,21596,4,20962,0,20962
13030,30000,24000,0,0,0,0,0,0,-1,9937,9942,-5,-1,8027,10,8017,0,14709,10022,4687,0,7483,384,7099
13031,80000,64000,0,0,0,0,0,0,0,20475,3990,16485,0,20325,850,19475,0,20276,800,19476,0,20662,1100,19562
13032,50000,40000,0,0,0,0,0,1,0,30000,3000,27000,0,0,0,0,0,0,0,0,-2,0,0,0
13033,50000,40000,0,0,0,0,0,0,0,0,0,0,-2,0,0,0,-2,0,0,0,-2,0,0,0
13034,310000,248000,0,0,0,0,0,1,-2,0,0,0,-2,0,0,0,-2,0,0,0,-2,0,0,0
13035,170000,136000,0,0,0,0,0,0,0,88390,50000,38390,0,63470,24517,38953,0,55890,14243,41647,0,51650,7852,43798
13036,180000,144000,0,0,0,0,0,0,-1,396,396,0,-1,396,396,0,-1,396,396,0,-1,396,396,0
13037,150000,120000,0,0,0,0,0,0,0,0,0,0,-2,0,0,0,-2,0,0,0,-2,0,0,0
13038,50000,40000,0,0,0,0,0,0,0,17445,1031,16414,0,15575,4050,11525,0,8075,4000,4075,0,-589,0,-589
13039,200000,160000,0,0,0,0,0,0,0,107765,4000,103765,0,109970,4000,105970,0,113436,5242,108194,0,115402,5000,110402
13040,350000,280000,0,0,0,0,0,0,-2,-25,0,-25,-2,-25,0,-25,-2,-25,25,-50,-2,-25,0,-25
13041,290000,232000,0,0,0,0,0,1,0,8711,1500,7211,0,9409,1000,8409,2,10153,900,9253,2,9846,0,9846
13042,230000,184000,0,0,0,0,0,0,-2,11979,12039,-60,-2,6667,6700,-33,-2,11972,11988,-16,-1,8654,22,8632
13043,40000,32000,0,0,0,0,1,1,0,38904,8040,30864,0,4235,4235,0,-1,87230,87230,0,-1,72647,3000,69647
13044,150000,120000,0,0,0,0,0,0,-1,3271,3271,0,-1,16741,16741,0,-1,8230,0,8230,0,6517,3885,2632
13045,50000,40000,0,0,0,0,0,0,-1,3225,3225,0,-1,656,656,0,-1,176,176,0,-1,0,0,0
13046,670000,536000,0,0,0,0,0,0,0,61900,10063,51837,0,58225,10060,48165,0,61329,10028,51301,0,49369,10042,39327
13047,500000,400000,0,0,0,0,0,0,0,165203,4699,160504,0,136067,623,135444,0,16120,1590,14530,0,93532,93469,63
13048,200000,160000,0,0,1,1,1,0,0,188990,55015,133975,0,188742,5327,183415,0,187267,5505,181762,0,190249,5525,184724
13049,50000,40000,0,0,0,0,0,0,4,20433,0,20433,3,19799,0,19799,2,19262,900,18362,0,19124,700,18424
13050,190000,152000,0,0,0,0,0,1,2,121093,0,121093,2,123126,5500,117626,0,131120,10000,121120,0,134135,5200,128935
13051,200000,160000,0,0,0,0,0,0,-1,1085,1100,-15,-1,769,0,769,2,453,0,453,0,137,0,137
13052,80000,64000,0,0,0,0,0,0,2,0,0,0,-2,0,0,0,-2,0,0,0,-2,0,0,0
13053,150000,120000,0,0,0,0,0,0,-2,367,367,0,-2,3287,3691,-404,-1,0,0,0,-1,0,0,0
13054,50000,40000,0,0,0,0,0,0,0,26635,2000,24635,0,20367,2066,18301,0,15640,611,15029,0,12269,500,11769
13055,500000,400000,0,0,0,0,0,0,2,413844,14000,399844,2,305875,14000,291875,0,46420,1500,44920,0,14540,14000,540
13056,50000,40000,0,0,0,0,0,1,-1,950,0,950,2,1560,1000,560,0,1170,0,1170,0,780,0,780
13057,30000,24000,0,0,0,0,0,0,4,14881,0,14881,3,14124,0,14124,2,14172,48,14124,0,1270,0,1270
13058,30000,24000,0,0,0,0,0,0,0,15459,1400,14059,0,15366,307,15059,0,15680,314,15366,0,15000,300,14700
13059,50000,40000,0,1,1,1,1,0,2,49276,3700,45576,2,48286,0,48286,2,47915,2000,45915,0,48386,6000,42386
13060,200000,160000,0,0,0,0,0,0,-2,115323,115916,-593,-2,21547,21722,-175,-2,4056,4076,-20,-2,3180,3196,-16
13061,80000,64000,0,0,0,0,0,0,0,44455,1724,42731,0,47825,4094,43731,0,48220,2300,45920,2,48884,1600,47284
13062,30000,24000,0,1,1,1,1,0,2,26718,0,26718,2,28168,2200,25968,2,27579,0,27579,2,28321,1200,27121
13063,200000,160000,0,1,1,1,1,1,0,168401,0,168401,3,164199,0,164199,2,174420,13000,161420,2,178485,7000,171485
13064,200000,160000,0,0,0,0,0,0,0,16013,6500,9513,0,28720,15000,13720,0,23607,3607,20000,0,24135,684,23451
13065,30000,24000,0,0,0,0,0,0,0,200,200,0,-1,323,323,0,-1,29525,29525,0,-1,0,0,0
13066,80000,64000,0,0,0,0,0,0,0,46879,2100,44779,0,47799,2000,45799,0,48876,2000,46876,0,49909,2000,47909
13067,50000,40000,0,1,1,1,1,0,0,48638,1800,46838,0,49207,1735,47472,0,49599,1938,47661,0,50594,1960,48634
13068,170000,136000,0,0,0,0,0,0,-1,390,390,0,-1,780,780,0,-1,780,0,780,0,0,0,0
13069,10000,8000,0,0,0,0,0,1,2,2400,0,2400,2,2400,0,2400,7,2400,0,2400,7,2400,0,2400
13070,50000,40000,0,0,0,0,0,1,0,41342,2000,39342,0,41424,2000,39424,0,41182,1600,39582,0,41187,2000,39187
13071,80000,64000,0,0,0,0,0,0,0,45961,1463,44498,0,29537,1039,28498,0,29758,1068,28690,0,30153,1267,28886
13072,10000,8000,0,0,0,0,0,1,0,0,0,0,0,0,0,0,-2,0,0,0,-2,0,0,0
13073,500000,400000,0,0,0,0,0,0,-1,58436,58436,0,-1,9536,9536,0,-1,8302,58302,-50000,-1,64460,64460,0
13074,50000,40000,0,1,0,0,0,0,0,47756,3862,43894,0,28275,2000,26275,0,28082,1100,26982,0,28846,1500,27346
13075,220000,176000,0,0,0,0,0,0,0,66834,2427,64407,0,68221,2500,65721,0,69576,2490,67086,0,71035,2580,68455
13076,150000,120000,0,0,0,0,0,0,0,95916,10629,85287,0,82867,3500,79367,0,58995,1833,57162,0,59799,1886,57913
13077,100000,80000,0,0,0,0,0,0,0,69971,3041,66930,0,60824,2500,58324,0,60969,2600,58369,0,59650,2171,57479
13078,230000,184000,0,0,0,0,0,1,-1,2754,2764,-10,-1,74,74,0,-1,3381,3381,0,-1,2308,2308,0
13079,60000,48000,0,0,0,0,0,0,0,48257,4000,44257,0,46353,4000,42353,0,45481,0,45481,2,48373,3800,44573
13080,120000,96000,0,1,0,0,0,0,0,115046,4552,110494,0,80987,3100,77887,0,85921,6416,79505,0,84384,0,84384
13081,100000,80000,0,1,0,0,0,0,0,97414,2785,94629,0,69166,2291,66875,0,53270,1965,51305,0,-1465,1465,-2930
13082,10000,8000,0,0,1,0,0,0,0,8050,1000,7050,0,10400,150,10250,0,0,0,0,0,0,0,0
13083,50000,40000,0,0,0,0,0,1,2,150,0,150,2,150,0,150,2,150,0,150,2,930,930,0
13084,50000,40000,0,0,0,0,0,1,2,23012,2000,21012,2,23338,1000,22338,2,23658,1000,22658,2,23139,0,23139
13085,30000,24000,0,0,0,0,0,0,-1,390,390,0,-1,390,390,0,-1,390,390,0,-1,0,0,0
13086,20000,16000,0,1,1,1,1,0,0,20070,1700,18370,0,20621,1600,19021,0,20347,700,19647,0,20389,710,19679
13087,440000,352000,0,0,0,0,0,0,0,79894,10000,69894,0,73984,10000,63984,0,137370,80000,57370,0,132889,7000,125889
13088,130000,104000,0,1,1,0,0,0,0,127706,6600,121106,0,121939,6000,115939,0,81506,3100,78406,0,83234,3200,80034
13089,230000,184000,1,1,1,1,0,0,0,298031,12500,285531,0,272103,11000,261103,0,205797,7000,198797,0,179247,36700,142547
13090,100000,80000,0,0,0,0,0,0,-1,390,390,0,-1,390,390,0,-1,390,390,0,-1,380,380,0
13091,50000,40000,0,0,0,0,0,1,2,21197,2000,19197,0,7666,1000,6666,0,4768,1000,3768,0,5685,1000,4685
13092,70000,56000,0,0,0,0,0,0,0,10637,1200,9437,0,11965,1507,10458,0,12178,1000,11178,0,13962,2000,11962
13093,80000,64000,0,0,0,0,0,1,0,19010,1214,17796,0,21808,600,21208,0,15995,656,15339,0,12290,282,12008
13094,80000,64000,0,0,0,0,0,0,0,60159,3009,57150,0,54151,2200,51951,0,45108,2000,43108,0,44490,2000,42490
13095,240000,192000,0,0,0,0,0,0,0,45054,2116,42938,0,39245,1200,38045,0,75742,75742,0,-1,39389,0,39389
13096,30000,24000,0,1,0,1,1,0,0,29860,1009,28851,0,30350,30000,350,0,59936,604,59332,0,29962,1500,28462
13097,150000,120000,0,0,0,0,0,0,0,49096,5000,44096,0,49848,3000,46848,0,52007,3000,49007,0,54161,3000,51161
13098,170000,136000,0,0,0,0,0,0,-1,10719,10725,-6,-1,12654,12654,0,-1,25784,25784,0,-1,19950,19950,0
13099,230000,184000,0,0,0,0,0,0,0,39295,5000,34295,0,38459,5000,33459,0,40242,3000,37242,0,42495,5000,37495
13100,10000,8000,0,0,0,0,0,0,0,8793,3000,5793,0,9106,3014,6092,0,7792,3000,4792,0,7500,3000,4500
13101,130000,104000,0,0,0,0,0,1,-2,0,0,0,-2,0,0,0,-2,0,0,0,-2,0,0,0
13102,80000,64000,0,1,1,1,1,1,2,71794,3278,68516,0,73125,3211,69914,0,82798,11457,71341,0,81336,0,81336
13103,230000,184000,0,0,0,0,0,0,-1,0,0,0,-1,0,0,0,-2,0,0,0,-2,376,376,0
13104,360000,288000,0,0,0,0,0,0,0,67507,50000,17507,0,68884,2502,66382,0,70406,2669,67737,0,71769,2650,69119
13105,110000,88000,0,1,1,0,0,0,0,111563,4200,107363,0,106625,4406,102219,0,48631,1800,46831,0,49724,1900,47824
13106,210000,168000,0,0,0,0,0,0,-2,0,0,0,-2,0,0,0,-2,0,0,0,-2,0,0,0
13107,300000,240000,0,0,0,0,0,0,0,80721,2783,77938,0,79939,3575,76364,0,58586,1605,56981,0,14570,1520,13050
13108,160000,128000,0,0,0,0,0,1,0,86091,4000,82091,2,83839,0,83839,2,85552,4000,81552,0,88028,4000,84028
13109,50000,40000,0,0,0,0,0,0,2,3135,3141,-6,-1,937,2,935,0,-3,0,-3,0,894,897,-3
13110,140000,112000,0,0,0,0,0,0,-2,1823,1823,0,-2,1769,1769,0,-1,84042,85096,-1054,-1,89381,9000,80381
13111,70000,56000,0,1,1,0,0,0,0,71318,3700,67618,0,59665,2600,57065,0,29510,1200,28310,0,26738,1200,25538
13112,360000,288000,0,0,0,0,0,1,-1,0,0,0,-1,0,0,0,-2,0,0,0,-2,0,0,0
13113,30000,24000,0,1,1,1,1,1,0,28538,718,27820,0,28208,1500,26708,0,29326,1500,27826,0,29508,3000,26508
13114,20000,16000,0,0,1,1,0,0,0,19395,4000,15395,0,20271,2000,18271,0,20445,2000,18445,0,17532,2900,14632
13115,20000,16000,0,0,0,1,1,0,0,15430,1600,13830,0,16367,1500,14867,0,16794,700,16094,0,17323,800,16523
13116,50000,40000,0,0,0,0,0,0,0,23927,2280,21647,0,20162,2157,18005,0,19342,0,19342,2,18347,660,17687
13117,30000,24000,0,0,0,1,1,0,0,24260,1403,22857,0,24743,886,23857,0,25261,917,24344,0,25763,922,24841
13118,160000,128000,0,0,0,0,0,0,-1,5464,5500,-36,-1,2079,2000,79,0,1908,2000,-92,-1,1394,1350,44
13119,200000,160000,0,0,0,0,0,0,0,25355,10198,15157,0,21666,15083,6583,0,15404,15450,-46,-1,11559,11593,-34
13120,450000,360000,0,0,0,0,0,0,-2,-2400,0,-2400,-2,3990,6390,-2400,-1,30050,30050,0,-1,9993,9993,0
13121,190000,152000,0,0,0,0,0,0,0,41016,3500,37516,0,40702,2500,38202,0,40676,4000,36676,0,27560,3000,24560
13122,400000,320000,0,0,0,0,0,0,2,8162,8513,-351,2,-1010,457,-1467,-2,3332,4903,-1571,-1,331,313,18
13123,580000,464000,0,0,0,0,0,0,-1,6527,6558,-31,-1,1818,1825,-7,-1,2227,2236,-9,-1,2666,2678,-12
13124,30000,24000,0,0,0,0,0,1,2,20313,1626,18687,2,19696,0,19696,2,20670,1600,19070,2,20200,0,20200
13125,30000,24000,0,0,0,0,0,0,0,1900,1900,0,-1,150,0,150,2,2558,2558,0,-1,2829,2829,0
13126,200000,160000,0,0,0,0,0,0,0,1292,1000,292,0,1778,1400,378,0,2064,1200,864,0,1000,0,1000
13127,150000,120000,0,0,0,0,0,0,-2,0,0,0,-2,0,0,0,-2,0,0,0,-2,0,0,0
13128,30000,24000,0,0,0,0,0,1,-1,731,0,731,2,7300,7300,0,-1,6071,6071,0,-1,7849,8000,-151
13129,170000,136000,0,0,0,0,0,0,-2,0,0,0,-2,0,0,0,-2,0,0,0,-2,0,0,0
13130,20000,16000,0,0,0,0,0,0,0,187,187,0,-1,-18,0,-18,-1,-18,0,-18,-2,-18,0,-18
13131,180000,144000,0,0,0,0,0,1,0,99278,2690,96588,0,95766,2067,93699,0,97753,2142,95611,0,95927,2217,93710
13132,260000,208000,0,0,0,0,0,1,-1,604,604,0,-1,664,664,0,-1,734,734,0,-1,1076,1076,0
13133,90000,72000,0,0,0,0,0,0,-1,498,498,0,-1,498,498,0,-1,3482,3482,0,-1,2793,0,2793
13134,50000,40000,0,0,0,0,0,0,0,40110,1685,38425,0,41070,2777,38293,0,40731,1423,39308,0,40440,1462,38978
13135,210000,168000,0,0,0,0,0,0,0,87469,3469,84000,0,90380,4380,86000,0,91355,3355,88000,0,92565,3565,89000
13136,290000,232000,0,0,0,0,0,0,-1,904,904,0,-1,904,0,904,0,0,0,0,0,0,0,0
13137,170000,136000,0,0,0,0,0,0,0,67856,3000,64856,0,38803,2308,36495,0,40259,3000,37259,0,41541,3000,38541
13138,130000,104000,0,0,0,0,0,1,2,4833,1000,3833,2,4236,0,4236,2,5178,1000,4178,2,4182,0,4182
13139,200000,160000,0,0,0,0,0,0,0,9571,1526,8045,0,0,0,0,0,0,0,0,-2,0,0,0
13140,230000,184000,0,0,0,0,0,0,0,110177,4533,105644,0,60137,2337,57800,0,62035,3035,59000,0,64034,3034,61000
13141,30000,24000,0,0,0,0,0,1,3,22768,600,22168,2,18600,800,17800,0,0,0,0,0,0,0,0
13142,50000,40000,0,0,0,0,0,0,0,38003,2025,35978,0,11625,562,11063,0,18442,339,18103,0,9743,1200,8543
13143,120000,96000,0,0,0,0,0,0,-1,0,0,0,-2,0,0,0,-2,0,0,0,-2,0,0,0
13144,500000,400000,0,0,0,0,0,0,0,123316,5198,118118,0,142773,46047,96726,0,107136,10039,97097,0,95915,30027,65888
13145,20000,16000,0,0,0,0,0,0,0,15657,2959,12698,0,14418,580,13838,2,13561,0,13561,2,13291,435,12856
13146,140000,112000,0,1,0,0,0,0,-1,138062,5554,132508,0,86738,3619,83119,0,43417,3002,40415,0,37398,1940,35458
13147,350000,280000,0,0,0,0,0,0,-2,9218,9274,-56,-2,9834,4711,5123,-2,1458,1472,-14,-2,5225,5251,-26
13148,90000,72000,0,0,0,0,0,0,0,60177,2390,57787,0,54440,1840,52600,0,45788,1690,44098,0,41874,1954,39920
13149,20000,16000,0,1,1,1,0,0,2,20199,2860,17339,2,19492,0,19492,2,19888,549,19339,0,14087,441,13646
13150,350000,280000,0,0,0,0,0,0,0,177483,10000,167483,0,182381,8000,174381,0,194678,15036,179642,0,215024,30050,184974
13151,50000,40000,0,1,1,0,0,0,0,48442,2007,46435,0,42550,1915,40635,0,16324,589,15735,0,17556,1500,16056
13152,160000,128000,0,1,0,0,0,0,0,146063,5187,140876,0,128318,5014,123304,0,96654,3000,93654,0,98694,3251,95443
13153,150000,120000,0,0,0,0,0,0,0,25977,1354,24623,0,30776,5153,25623,0,920,924,-4,-1,0,0,0
13154,50000,40000,0,1,1,1,1,0,0,50783,2100,48683,0,49776,2000,47776,0,50937,2000,48937,0,49956,2000,47956
13155,210000,168000,0,0,0,0,0,0,-1,11423,2500,8923,0,9329,1200,8129,0,12329,3000,9329,0,10039,1077,8962
13156,50000,40000,0,1,1,1,1,0,0,50074,2000,48074,0,60158,14455,45703,0,75277,16560,58717,3,90464,17000,73464
13157,150000,120000,0,0,0,0,0,0,0,18075,2000,16075,0,19902,2000,17902,0,5331,1000,4331,0,9281,3950,5331
13158,100000,80000,1,1,0,0,0,1,4,101256,0,101256,3,48876,0,48876,2,28468,1603,26865,0,3875,3875,0
13159,310000,248000,0,0,0,0,0,0,0,71851,2594,69257,0,71120,2483,68637,0,70463,2458,68005,0,69876,2516,67360
13160,240000,192000,0,0,0,0,0,0,-1,127494,125335,2159,0,102825,3358,99467,0,99867,2784,97083,0,99410,2833,96577
13161,380000,304000,0,1,1,1,1,0,2,331518,16001,315517,2,337703,13150,324553,2,343612,13000,330612,2,351089,13150,337939
13162,140000,112000,0,1,1,1,1,1,2,127701,0,127701,2,135551,10000,125551,2,135859,2600,133259,2,134687,2300,132387
13163,430000,344000,0,0,0,0,0,1,0,219739,8123,211616,0,210142,7522,202620,0,179350,7003,172347,0,130328,4700,125628
13164,60000,48000,0,0,0,0,0,0,2,17512,2000,15512,0,18413,1500,16913,0,19951,2000,17951,0,21454,2000,19454
13165,80000,64000,0,0,0,0,0,0,0,11000,3000,8000,0,16000,5000,11000,0,0,0,0,0,54070,54070,0
13166,300000,240000,0,0,0,0,0,0,-1,200,0,200,2,22935,22935,0,-1,16858,0,16858,0,0,0,0
13167,20000,16000,0,0,0,1,1,0,0,16069,1600,14469,0,16776,1278,15498,0,17118,620,16498,0,19835,3000,16835
13168,240000,192000,0,0,0,0,0,1,-1,0,0,0,-1,14944,14944,0,-1,968,968,0,-1,10408,10408,0
13169,150000,120000,0,0,0,0,0,0,-1,174,174,0,-1,640,640,0,-1,2414,2414,0,-1,500,500,0
13170,10000,8000,0,0,0,0,0,1,-1,0,0,0,-2,0,0,0,-2,0,0,0,-2,0,0,0
13171,150000,120000,0,0,0,0,0,0,-1,7500,7500,0,-1,11478,11478,0,-1,7080,7080,0,-1,1651,1651,0
13172,30000,24000,0,1,1,0,0,1,0,29886,1800,28086,0,28392,0,28392,2,22612,1000,21612,0,22750,1000,21750
13173,20000,16000,0,0,0,1,0,0,0,15491,1392,14099,0,16299,1200,15099,0,16428,329,16099,0,0,0,0
13174,160000,128000,0,0,0,0,0,0,0,107420,3899,103521,0,111123,5489,105634,0,111795,4005,107790,0,114136,4145,109991
13175,30000,24000,0,0,0,0,0,0,0,10159,1033,9126,0,9859,381,9478,0,8360,384,7976,0,4101,404,3697
13176,300000,240000,0,0,0,0,0,0,-2,200,200,0,-1,0,0,0,-1,16418,16418,0,-1,88632,88632,0
13177,420000,336000,0,0,0,0,0,0,0,21103,5006,16097,0,22217,5000,17217,0,23440,5000,18440,0,61084,61084,0
13178,50000,40000,0,0,0,0,0,0,0,29305,1759,27546,0,27595,1439,26156,0,27745,979,26766,0,28086,1164,26922
13179,10000,8000,0,0,0,0,0,0,-2,0,0,0,-2,0,0,0,-2,0,0,0,-2,0,0,0
13180,30000,24000,0,1,1,0,0,0,0,28575,1700,26875,0,28925,1010,27915,0,24159,1141,23018,0,0,0,0
13181,20000,16000,0,0,0,0,0,0,0,13357,1300,12057,0,14427,1300,13127,0,14894,700,14194,0,15112,600,14512
13182,290000,232000,0,1,1,0,0,0,0,286785,11231,275554,0,285345,10269,275076,0,239389,8500,230889,0,231420,10000,221420
13183,160000,128000,0,0,0,0,0,0,0,170449,50000,120449,0,96739,20000,76739,0,126139,30000,96139,0,154884,30000,124884
13184,10000,8000,0,0,1,1,1,0,0,9028,1384,7644,0,9644,1000,8644,0,9790,196,9594,0,9990,200,9790
13185,240000,192000,0,0,0,0,0,0,0,111030,5400,105630,0,114584,8000,106584,0,115681,4179,111502,2,112528,0,112528
13186,20000,16000,0,0,0,0,0,0,-1,440,440,0,-1,440,440,0,-1,440,440,0,-1,440,440,0
13187,500000,400000,0,0,0,0,0,0,0,95390,15390,80000,0,102203,12239,89964,0,47388,6000,41388,0,73230,30000,43230
13188,330000,264000,0,1,1,1,1,0,0,303257,13000,290257,0,302905,11000,291905,0,304151,11100,293051,0,299959,11000,288959
13189,220000,176000,0,0,0,0,0,0,0,74430,4000,70430,0,64485,4492,59993,0,24609,1000,23609,0,23419,1000,22419
13190,100000,80000,0,0,0,0,0,0,-1,490,490,0,-1,6974,6974,0,-1,8018,8018,0,-1,8441,8441,0
13191,200000,160000,0,0,0,0,0,0,0,17042,1000,16042,0,10075,212,9863,0,5107,102,5005,0,7789,7786,3
13192,10000,8000,0,0,0,0,0,0,2,4366,1100,3266,2,4148,0,4148,2,4579,500,4079,2,4360,0,4360
13193,60000,48000,0,0,0,0,0,1,2,26647,3000,23647,3,27912,2000,25912,4,26889,0,26889,4,29140,3000,26140
13194,80000,64000,0,0,0,0,0,1,2,13853,1200,12653,0,14823,1200,13623,0,14443,0,14443,2,15802,1600,14202
13195,50000,40000,0,0,0,0,0,1,2,24482,3200,21282,2,24693,910,23783,2,25283,1000,24283,0,27367,2500,24867
13196,220000,176000,0,0,0,0,0,0,0,127116,6540,120576,0,121336,5000,116336,0,121736,5000,116736,0,119164,5000,114164
13197,80000,64000,0,1,0,0,0,0,0,72263,2200,70063,0,50312,1730,48582,0,49878,1800,48078,0,50101,2500,47601
13198,90000,72000,0,0,0,0,0,0,-1,-21,0,-21,-1,2130,2151,-21,-1,3486,3486,0,-1,1495,1495,0
13199,110000,88000,0,0,0,0,0,0,0,39981,1700,38281,0,41312,2000,39312,0,42028,1700,40328,0,42899,1700,41199
13200,50000,40000,0,1,1,1,1,0,0,45284,2000,43284,0,46186,1655,44531,0,47440,2000,45440,0,48453,1800,46653
13201,50000,40000,0,0,0,0,0,0,0,18546,1338,17208,0,19476,1268,18208,0,18694,636,18058,0,19427,1000,18427
13202,30000,24000,0,0,0,0,0,0,-2,0,0,0,-2,0,0,0,-2,0,0,0,-2,0,0,0
13203,210000,168000,0,0,0,0,0,0,0,18288,1650,16638,0,19301,1620,17681,0,19383,700,18683,0,19940,870,19070
13204,10000,8000,0,0,1,1,1,0,2,8561,1149,7412,0,9571,1159,8412,0,9761,349,9412,0,10106,502,9604
13205,70000,56000,0,1,1,1,1,0,0,69475,3300,66175,0,69582,3100,66482,0,69589,2800,66789,0,68728,2600,66128
13206,280000,224000,0,0,0,0,0,0,-1,2726,2726,0,-1,10898,10916,-18,-1,1050,1056,-6,-1,812,812,0
13207,280000,224000,0,0,0,0,0,0,0,87786,3066,84720,0,86510,3171,83339,0,83560,3501,80059,0,84808,3030,81778
13208,210000,168000,0,0,0,0,0,0,0,26823,1791,25032,0,32032,6000,26032,0,37457,6000,31457,0,43814,7000,36814
13209,170000,136000,0,0,0,0,0,0,0,9522,2000,7522,0,10254,2000,8254,0,5520,0,5520,0,6212,2000,4212
13210,230000,184000,0,0,0,0,0,0,-1,6020,6161,-141,-1,18468,18468,0,-1,9665,9665,0,-1,28100,28100,0
13211,140000,112000,0,0,0,0,0,0,0,11755,1262,10493,0,7453,1000,6453,0,38415,38415,0,-1,31685,4000,27685
13212,160000,128000,0,0,0,0,0,1,2,17490,2000,15490,0,20724,3539,17185,0,23952,3566,20386,0,23859,446,23413
13213,70000,56000,0,1,1,0,0,0,0,68912,3300,65612,0,70652,3700,66952,0,50686,2100,48586,0,47093,2000,45093
13214,80000,64000,0,0,0,0,0,0,-1,6100,6100,0,-1,6420,6434,-14,-1,606,606,0,-1,7228,7228,0
13215,340000,272000,0,0,0,0,0,0,-1,8300,8321,-21,-1,2190,2190,0,-2,24599,24599,0,-2,7416,7416,0
13216,180000,144000,0,0,0,0,0,0,-1,715,715,0,-1,4079,6942,-2863,-1,0,0,0,-1,213,213,0
13217,230000,184000,0,0,0,0,0,0,-1,13165,13165,0,-1,0,0,0,-1,10500,10500,0,-1,6992,6992,0
13218,500000,400000,0,0,0,0,0,0,-1,298,298,0,-1,306,306,0,-1,150,150,0,-1,316,316,0
13219,470000,376000,0,0,0,0,0,0,-1,15171,15202,-31,-1,27319,27329,-10,-1,31029,30203,826,0,19211,33,19178
13220,340000,272000,0,0,0,0,0,0,0,40747,2000,38747,0,41930,2000,39930,0,43397,2000,41397,0,44710,2000,42710
13221,70000,56000,0,0,0,0,0,1,2,29628,0,29628,2,32350,3218,29132,2,33218,1532,31686,2,32532,0,32532
13222,60000,48000,0,1,1,0,0,0,0,61748,1800,59948,2,58583,0,58583,2,28301,600,27701,0,29301,1000,28301
13223,300000,240000,0,0,0,0,0,0,-1,17865,17865,0,-1,9215,9243,-28,-1,154926,154975,-49,-1,126482,0,126482
13224,200000,160000,0,0,0,0,0,1,0,132144,4530,127614,0,119136,4500,114636,0,122211,5000,117211,0,125021,5000,120021
13225,60000,48000,0,0,0,0,0,0,-1,6244,6244,0,-1,13615,13615,0,-1,25475,25478,-3,-1,26237,5000,21237
13226,480000,384000,0,1,0,0,0,0,0,424843,14706,410137,0,325772,15377,310395,0,320760,10481,310279,0,325841,11003,314838
13227,140000,112000,0,0,0,0,0,1,0,16606,10063,6543,0,9609,0,9609,2,5429,2000,3429,0,9763,5000,4763
13228,160000,128000,0,0,0,0,0,0,-2,-2,0,-2,-2,499,501,-2,-2,284,285,-1,-2,1248,1254,-6
13229,200000,160000,0,0,0,0,0,0,-2,0,0,0,-2,399,399,0,-2,1396,1396,0,-2,0,0,0
13230,230000,184000,0,0,0,0,0,0,0,37214,1954,35260,0,37680,1420,36260,0,33708,3708,30000,0,565,565,0
13231,60000,48000,0,0,0,0,0,1,2,-2750,0,-2750,2,360,5500,-5140,-1,-30,0,-30,-1,-420,0,-420
13232,220000,176000,0,0,0,0,0,0,-1,8000,8000,0,-1,0,0,0,-1,8000,8000,0,-1,0,0,0
13233,650000,520000,0,0,0,0,0,0,-2,5158,5180,-22,-2,7139,7201,-62,-2,1034,1035,-1,-2,2127,2139,-12
13234,90000,72000,0,0,0,0,0,1,0,4490,1000,3490,0,0,0,0,0,0,0,0,-2,0,0,0
13235,380000,304000,0,0,0,0,0,0,0,10626,1626,9000,0,312,312,0,0,986,1007,-21,-1,284729,284069,660
13236,30000,24000,0,0,0,0,0,0,-2,1310,1310,0,-1,816,816,0,-1,0,0,0,-1,0,0,0
13237,420000,336000,0,0,0,0,0,1,0,24751,1332,23419,0,24984,963,24021,0,24983,877,24106,0,23751,1000,22751
13238,200000,160000,0,1,1,1,1,1,2,197509,15900,181609,2,193046,200,192846,3,194368,6100,188268,2,182903,7000,175903
13239,100000,80000,0,0,0,0,0,0,0,3609,2000,1609,0,3381,2054,1327,0,3666,2000,1666,0,2233,0,2233
13240,50000,40000,0,1,0,0,0,0,0,49715,2519,47196,0,21332,712,20620,0,20096,706,19390,0,18883,740,18143
13241,210000,168000,0,0,0,0,0,1,-1,229,229,0,-1,799,799,0,-1,0,0,0,-1,0,0,0
13242,160000,128000,0,0,0,0,0,0,-1,0,0,0,-2,0,0,0,-2,0,0,0,-2,0,0,0
13243,20000,16000,0,0,0,0,0,0,0,11776,2000,9776,0,11776,0,11776,0,10886,0,10886,0,-1000,0,-1000
13244,310000,248000,0,0,0,0,0,0,0,90960,6000,84960,0,89993,3000,86993,0,92229,3000,89229,0,94473,3000,91473
13245,40000,32000,0,0,0,0,0,0,0,32644,3071,29573,0,29645,1384,28261,0,22930,1047,21883,0,0,0,0
13246,30000,24000,0,0,0,0,0,1,2,14766,0,14766,2,14763,539,14224,0,16662,2148,14514,0,16247,0,16247
13247,150000,120000,0,0,0,0,0,0,-2,4952,4952,0,-2,1040,1040,0,-2,3617,3617,0,-2,540,540,0
13248,50000,40000,0,0,0,0,0,1,0,7114,1700,5414,0,28042,30042,-2000,-1,28479,1200,27279,0,29066,1200,27866
13249,220000,176000,0,0,0,0,0,0,-2,19303,20063,-760,-2,19867,20057,-190,-2,12826,12863,-37,-2,19847,20061,-214
13250,70000,56000,0,0,0,0,0,0,0,29079,1739,27340,0,28562,1002,27560,0,29155,1033,28122,0,29448,1142,28306
13251,50000,40000,0,0,1,0,0,1,0,48735,11890,36845,0,45036,1367,43669,0,19246,668,18578,0,18872,675,18197
13252,70000,56000,0,0,0,0,0,1,2,42445,2007,40438,0,45020,3582,41438,0,44006,0,44006,2,46905,3601,43304
13253,80000,64000,0,0,0,0,0,0,-2,0,0,0,-2,0,0,0,-2,0,0,0,-2,0,0,0
13254,30000,24000,0,1,1,1,0,1,0,29500,2061,27439,0,29639,1200,28439,0,27546,551,26995,0,6718,0,6718
13255,100000,80000,0,0,0,0,0,0,-1,390,390,0,-1,1170,1170,0,-1,780,0,780,0,780,0,780
13256,350000,280000,0,0,0,0,0,0,-2,1518,1529,-11,-2,4625,4713,-88,-2,363,363,0,-2,858,858,0
13257,290000,232000,0,0,0,0,0,0,0,240584,9300,231284,0,212024,8000,204024,0,216379,7612,208767,0,209440,8015,201425
13258,500000,400000,0,0,0,0,0,0,-1,535,537,-2,-1,-13,0,-13,-1,20807,20911,-104,-1,20897,21001,-104
13259,240000,192000,0,0,0,0,0,0,-1,2880,0,2880,2,13267,13267,0,-1,10036,2000,8036,0,24731,15000,9731
13260,430000,344000,0,0,0,0,0,0,0,20739,15023,5716,0,12925,12925,0,-1,17566,17566,0,-1,14067,11000,3067
13261,110000,88000,0,0,0,0,0,0,0,89757,4087,85670,0,136859,64142,72717,0,60276,2038,58238,0,48652,1763,46889
13262,230000,184000,0,0,0,0,0,0,-2,0,0,0,-2,0,0,0,-2,0,0,0,-2,0,0,0
13263,110000,88000,0,0,0,0,0,1,-1,0,0,0,-1,0,0,0,-2,0,0,0,-2,0,0,0
13264,380000,304000,0,0,0,0,0,0,-2,0,0,0,-2,2039,2039,0,-1,0,0,0,-1,4481,4481,0
13265,180000,144000,0,0,0,0,0,0,-1,316,316,0,-1,692,692,0,-1,316,316,0,-1,859,859,0
13266,50000,40000,0,0,0,0,0,0,0,22339,10000,12339,0,22669,1000,21669,0,24121,1820,22301,0,23540,0,23540
13267,80000,64000,0,0,0,0,0,0,0,27360,1800,25560,0,27480,1100,26380,0,29642,3000,26642,0,28779,0,28779
13268,170000,136000,0,0,0,0,0,0,0,63000,4000,59000,0,0,0,0,0,0,0,0,-2,3300,3300,0
13269,100000,80000,0,0,0,0,0,0,0,70721,3000,67721,0,69603,3000,66603,0,65499,3000,62499,0,62296,3000,59296
13270,50000,40000,0,1,1,0,0,1,0,49161,2588,46573,0,50173,2600,47573,0,18279,1000,17279,0,18266,653,17613
13271,320000,256000,0,0,0,0,0,0,0,169920,25006,144914,0,174315,10025,164290,0,173032,6506,166526,0,176016,7006,169010
13272,340000,272000,0,0,0,0,0,0,-1,17707,17709,-2,-1,31778,31780,-2,-1,46063,47056,-993,-1,43101,43117,-16
13273,200000,160000,0,0,0,0,0,0,0,129962,8000,121962,0,124282,20000,104282,0,118956,15653,103303,0,121449,3793,117656
13274,100000,80000,0,0,0,0,0,1,2,31953,1850,30103,0,34308,3200,31108,0,34951,1500,33451,2,34261,0,34261
13275,50000,40000,0,0,0,0,0,0,0,25626,1480,24146,0,26444,1298,25146,0,19422,677,18745,0,19438,700,18738
13276,300000,240000,0,0,0,0,0,0,-2,0,0,0,-2,0,0,0,-2,0,0,0,-2,0,0,0
13277,30000,24000,0,1,1,1,1,1,2,30147,2000,28147,0,29366,1500,27866,0,29555,1010,28545,0,29793,1055,28738
13278,110000,88000,0,0,0,0,0,0,0,48140,2000,46140,0,49339,2000,47339,0,50542,2000,48542,0,52689,3000,49689
13279,10000,8000,0,0,0,0,0,0,0,7109,2000,5109,0,9082,3000,6082,0,7165,234,6931,0,6951,284,6667
13280,100000,80000,0,1,0,0,0,0,0,91096,3000,88096,0,76371,2700,73671,0,77162,2800,74362,0,78084,3000,75084
13281,390000,312000,0,0,0,0,0,0,-1,7599,7677,-78,-1,2947,2947,0,-1,86790,87476,-686,-1,3628,3639,-11
13282,210000,168000,0,0,0,0,0,0,0,78297,4000,74297,0,36137,2000,34137,0,33264,2000,31264,0,29493,2000,27493
13283,200000,160000,0,0,0,0,0,0,0,44150,3500,40650,0,43874,1500,42374,0,41378,500,40878,0,832,1000,-168
13284,30000,24000,0,0,0,0,0,0,0,13580,0,13580,2,13657,600,13057,0,16356,2942,13414,0,16540,600,15940
13285,20000,16000,0,1,1,1,1,0,0,18600,0,18600,2,19000,1000,18000,0,19000,0,19000,0,20000,1000,19000
13286,160000,128000,0,0,0,0,0,0,-2,0,0,0,-2,0,0,0,-2,0,0,0,-2,0,0,0
13287,50000,40000,0,0,0,0,0,0,2,36373,1908,34465,0,37165,1700,35465,0,39539,3000,36539,0,40454,1700,38754
13288,120000,96000,0,0,0,0,0,0,0,23562,3377,20185,0,22890,0,22890,2,23189,976,22213,0,23521,855,22666
13289,500000,400000,0,0,0,0,0,0,0,107198,4550,102648,0,98450,3533,94917,0,93828,3525,90303,0,92237,5034,87203
13290,20000,16000,0,1,1,1,1,1,0,19423,2000,17423,0,20140,1500,18640,0,19991,1000,18991,0,20079,600,19479
13291,230000,184000,0,0,0,0,0,0,0,10669,1380,9289,0,13498,8000,5498,0,12482,1000,11482,0,9949,4000,5949
13292,260000,208000,0,0,0,0,1,1,0,208601,7000,201601,0,213025,7508,205517,0,214931,7500,207431,0,219001,7595,211406
13293,270000,216000,0,0,0,0,0,1,-1,69048,27595,41453,0,68206,10343,57863,0,17510,18083,-573,-1,26175,26279,-104
13294,20000,16000,0,0,0,0,0,1,0,5270,2500,2770,0,5040,0,5040,2,5304,500,4804,0,5777,558,5219
13295,200000,160000,0,0,0,0,0,0,-2,900,900,0,-1,900,900,0,-1,900,900,0,-1,900,900,0
13296,80000,64000,0,1,1,0,0,0,2,80288,3456,76832,0,82150,3750,78400,0,319,319,0,-1,85,85,0
13297,30000,24000,0,1,1,1,1,0,0,26723,1800,24923,0,27104,1118,25986,0,28616,2100,26516,0,29102,1100,28002
13298,100000,80000,0,1,0,0,0,0,0,93751,10000,83751,0,13700,2000,11700,0,15474,2000,13474,0,17211,2000,15211
13299,20000,16000,0,0,0,0,0,0,0,9662,4029,5633,0,9708,5514,4194,0,4779,3000,1779,0,6968,3000,3968
13300,200000,160000,0,0,0,0,0,0,-1,5000,5000,0,-1,4000,4000,0,-1,22800,22800,0,-1,5716,5716,0
13301,80000,64000,0,0,0,0,0,1,-1,0,0,0,-1,0,0,0,-2,0,0,0,-2,496,496,0
13302,190000,152000,0,0,0,0,0,0,-1,2184,0,2184,2,2184,0,2184,0,2184,0,2184,0,0,0,0
13303,90000,72000,0,1,0,0,0,0,0,88122,4322,83800,0,62706,2706,60000,0,53612,3575,50037,0,40963,0,40963
13304,130000,104000,0,0,0,0,0,0,0,96775,4403,92372,0,98071,3814,94257,0,97743,3562,94181,0,100124,4021,96103
13305,160000,128000,0,0,0,0,0,1,-1,186,0,186,2,0,0,0,2,0,0,0,-2,0,0,0
13306,100000,80000,0,0,0,0,0,0,0,46266,1973,44293,0,45405,1708,43697,0,44723,1728,42995,0,42934,1621,41313
13307,60000,48000,0,0,1,0,0,0,0,72334,72334,0,-1,73396,4000,69396,0,12271,2000,10271,0,24278,14000,10278
13308,290000,232000,0,0,0,0,0,0,-1,396,396,0,-1,792,792,0,-1,396,0,396,0,423,423,0
13309,110000,88000,0,0,0,0,0,0,0,2487,2487,0,-1,2500,2700,-200,-1,2500,2500,0,-1,0,0,0
13310,500000,400000,0,0,0,0,0,0,0,26834,26834,0,-1,33120,33452,-332,-1,21771,21881,-110,-1,52277,52539,-262
13311,500000,400000,0,0,0,0,0,0,-1,-4617,99,-4716,-1,16879,22480,-5601,-1,5195,0,5195,0,290,580,-290
13312,360000,288000,0,0,0,0,0,1,-2,0,0,0,-2,0,0,0,-2,0,0,0,-2,0,0,0
13313,50000,40000,0,0,0,1,1,1,0,40352,1700,38652,0,41183,1500,39683,0,42221,1700,40521,0,42935,1568,41367
13314,500000,400000,0,0,1,1,1,1,0,412082,16500,395582,0,417759,15000,402759,0,428608,19000,409608,0,421871,18032,403839
13315,70000,56000,0,0,0,0,0,0,0,33439,1683,31756,0,24926,3160,21766,0,10681,3000,7681,0,7431,3000,4431
13316,400000,320000,0,0,0,0,0,0,-1,0,0,0,-2,0,0,0,-2,0,0,0,-2,0,0,0
13317,10000,8000,0,0,0,0,0,0,2,0,0,0,2,0,0,0,-2,0,0,0,-2,0,0,0
13318,20000,16000,0,0,0,0,0,0,-1,275,275,0,-1,329,329,0,-2,544,544,0,-1,190,190,0
13319,20000,16000,0,1,1,0,0,0,0,19504,2000,17504,0,19974,1011,18963,0,11548,300,11248,0,10784,216,10568
13320,420000,336000,0,1,1,1,0,1,0,366938,14996,351942,0,361024,13209,347815,0,354813,12890,341923,0,344221,11081,333140
13321,270000,216000,0,0,0,0,0,0,-1,-54,0,-54,-1,-54,0,-54,-2,19315,19369,-54,-1,8388,996,7392
13322,220000,176000,0,0,0,0,0,0,-1,316,316,0,-1,956,956,0,-1,1087,1087,0,-1,316,316,0
13323,270000,216000,0,1,1,1,1,1,4,227597,0,227597,3,230751,8400,222351,2,235931,9000,226931,2,240595,8700,231895
13324,130000,104000,0,1,1,1,1,1,0,129576,4700,124876,0,129829,5000,124829,0,125382,4600,120782,0,124942,5200,119742
13325,50000,40000,0,0,0,0,0,1,0,12635,1500,11135,0,15403,3000,12403,0,16657,1500,15157,0,16240,0,16240
13326,200000,160000,0,0,0,0,0,0,-2,7165,7165,0,-2,6946,6966,-20,-2,9776,9776,0,-2,2007,2007,0
13327,150000,120000,0,0,0,0,0,0,-2,1999,1999,0,-2,1999,1999,0,-2,1500,1500,0,-2,1500,1500,0
13328,80000,64000,0,0,0,1,1,0,0,4457,1000,3457,0,75743,75743,0,-1,76343,2667,73676,0,76567,3395,73172
13329,170000,136000,0,0,0,0,0,0,-2,0,0,0,-2,0,0,0,-2,0,0,0,-2,0,0,0
13330,50000,40000,0,1,0,0,0,0,0,49291,2019,47272,0,28314,1200,27114,0,28959,1100,27859,0,29547,1069,28478
13331,150000,120000,0,0,0,0,0,0,0,106129,3794,102335,0,106531,3783,102748,0,107062,3892,103170,0,109938,4662,105276
13332,140000,112000,0,0,0,0,0,0,-1,1646,1646,0,-1,4650,4500,150,0,5764,3000,2764,0,7116,3000,4116
13333,50000,40000,0,1,0,0,0,0,2,42779,0,42779,2,38180,1600,36580,0,40685,3300,37385,0,37662,0,37662
13334,80000,64000,0,0,0,0,0,0,0,62163,4000,58163,2,62756,2200,60556,2,61149,0,61149,2,62464,2300,60164
13335,30000,24000,0,0,0,0,0,1,0,12421,1214,11207,0,13507,1300,12207,0,13782,500,13282,0,14159,600,13559
13336,500000,400000,0,0,0,0,0,0,-2,0,0,0,-2,0,0,0,-2,1300,1300,0,-2,0,0,0
13337,90000,72000,0,0,0,0,0,0,2,28067,6000,22067,2,27320,0,27320,2,31199,4500,26699,2,30548,0,30548
13338,60000,48000,0,0,0,0,0,1,-1,264,264,0,-1,264,264,0,-1,264,264,0,-1,264,264,0
13339,140000,112000,0,1,1,1,0,1,0,133767,6377,127390,0,120287,5604,114683,0,117183,4160,113023,0,119575,8239,111336
13340,500000,400000,0,0,0,0,0,0,0,375070,50000,325070,0,354839,20000,334839,0,369532,19586,349946,0,367399,14122,353277
13341,30000,24000,0,1,1,1,1,1,0,25949,1500,24449,0,28478,3000,25478,0,27754,0,27754,2,28186,1001,27185
13342,120000,96000,0,0,0,0,0,0,0,83592,5000,78592,0,22321,2000,20321,0,32150,20000,12150,0,36644,10000,26644
13343,280000,224000,0,0,0,0,0,1,-1,10802,10802,0,-1,23323,13000,10323,0,17041,10041,7000,0,282,282,0
13344,320000,256000,0,1,0,0,0,0,0,290057,12756,277301,0,25922,1295,24627,0,22982,10312,12670,0,20553,8394,12159
13345,50000,40000,0,0,0,0,0,0,2,14908,1475,13433,0,15033,600,14433,0,15705,1000,14705,0,11616,500,11116
13346,60000,48000,0,0,0,0,0,0,0,18347,37325,-18978,-1,15707,20800,-5093,-1,18976,3500,15476,0,6355,1232,5123
13347,50000,40000,0,0,0,0,0,0,2,35690,2000,33690,2,34817,0,34817,2,36252,2000,34252,0,37645,2000,35645
13348,370000,296000,0,1,0,0,0,0,0,338660,10000,328660,0,221808,114000,107808,0,222304,10000,212304,2,217704,0,217704
13349,250000,200000,0,0,0,0,0,0,-2,0,0,0,-2,124832,124832,0,-1,7984,7984,0,-1,1500,1500,0
13350,50000,40000,0,0,0,0,0,0,0,30026,1700,28326,0,29857,2000,27857,0,30619,1261,29358,0,30376,1419,28957
13351,20000,16000,0,0,0,0,0,0,0,8690,1152,7538,0,9699,1161,8538,0,10138,600,9538,0,10400,600,9800
13352,80000,64000,0,1,1,1,1,0,0,76710,2629,74081,2,74792,0,74792,2,79636,6000,73636,2,77757,0,77757
13353,500000,400000,0,0,0,0,0,0,-2,500,810,-310,-1,617,617,0,-1,617,0,617,-2,617,0,617
13354,180000,144000,0,0,0,0,0,0,-1,26876,26876,0,-1,53390,53390,0,-1,35292,35292,0,-1,61910,61910,0
13355,340000,272000,0,0,0,0,0,0,0,57160,2500,54660,0,58794,2500,56294,0,61231,3300,57931,0,62516,2200,60316
13356,500000,400000,0,0,0,0,0,0,0,180782,9387,171395,0,194893,20000,174893,0,93416,3525,89891,0,94255,3338,90917
13357,520000,416000,0,0,0,0,0,0,0,178531,7001,171530,0,170915,5989,164926,0,162864,5701,157163,0,155297,6001,149296
13358,30000,24000,0,0,0,0,0,0,2,20374,3000,17374,2,20738,1000,19738,2,22253,2170,20083,2,24748,3000,21748
13359,130000,104000,0,0,0,0,0,0,-2,0,0,0,-2,0,0,0,-2,0,0,0,-2,0,0,0
13360,220000,176000,0,0,0,0,0,0,0,149864,10000,139864,0,155828,10000,145828,0,178160,25000,153160,0,175140,0,175140
13361,360000,288000,0,0,0,0,0,0,-1,6131,6195,-64,-1,7662,7664,-2,-1,19423,19423,0,-1,28351,28351,0
13362,50000,40000,0,0,0,0,0,0,0,8857,1147,7710,0,9658,1222,8436,0,9359,0,9359,2,9554,350,9204
13363,10000,8000,0,1,1,1,0,1,0,9437,1000,8437,0,9630,193,9437,0,8399,168,8231,0,1697,1734,-37
13364,130000,104000,0,0,0,0,0,0,0,0,0,0,0,0,0,0,-2,0,0,0,-2,0,0,0
13365,400000,320000,0,0,0,0,0,0,0,128630,2551,126079,0,69040,2735,66305,0,64657,2628,62029,0,54363,1574,52789
13366,80000,64000,0,1,1,1,1,1,0,79650,4000,75650,0,81338,4003,77335,0,81438,13000,68438,0,80959,3515,77444
13367,210000,168000,0,0,0,0,0,0,0,124788,5185,119603,0,126946,4900,122046,0,93925,4526,89399,0,-285,21787,-22072
13368,340000,272000,0,0,0,0,0,1,-2,-15,0,-15,-2,-15,0,-15,-2,-15,0,-15,-2,-15,0,-15
13369,100000,80000,0,0,0,0,0,0,-1,4153,4153,0,-1,2972,1000,1972,0,1990,1990,0,-1,1861,1861,0
13370,50000,40000,0,0,0,0,0,0,2,18122,0,18122,2,18530,1000,17530,0,19089,1001,18088,0,18856,634,18222
13371,380000,304000,0,0,0,0,0,0,0,13277,1300,11977,0,14291,1242,13049,0,15949,1900,14049,0,15556,0,15556
13372,240000,192000,0,0,0,0,0,0,-2,0,0,0,-2,0,0,0,-2,0,0,0,-2,41300,41300,0
13373,360000,288000,0,0,0,0,0,0,-1,200,0,200,2,0,0,0,2,12140,12140,0,-1,42424,42424,0
13374,160000,128000,0,0,0,0,0,0,-1,2003,2235,-232,-1,2580,2605,-25,-1,0,0,0,-1,380,380,0
13375,190000,152000,0,0,0,0,0,0,0,127014,6112,120902,0,120826,4202,116624,0,112211,4200,108011,0,110396,4200,106196
13376,130000,104000,0,0,0,0,0,0,0,66372,3372,63000,0,64854,2354,62500,0,66432,2432,64000,0,46919,2919,44000
13377,140000,112000,0,0,0,0,0,0,0,109646,6000,103646,2,106420,0,106420,2,111130,8000,103130,2,113204,4000,109204
13378,360000,288000,0,0,0,0,0,1,2,283943,7000,276943,3,266246,0,266246,2,258197,8500,249697,0,114052,5145,108907
13379,240000,192000,0,0,0,0,0,0,-2,0,0,0,-2,2194,2194,0,-2,439,441,-2,-2,1085,1085,0
13380,50000,40000,0,0,0,0,0,0,-2,51400,51400,0,-1,11330,11330,0,-1,12144,1000,11144,0,12938,1000,11938
13381,280000,224000,0,1,1,1,0,0,2,286773,13500,273273,0,275447,14500,260947,0,245409,10000,235409,0,211351,9000,202351
13382,240000,192000,0,0,0,0,0,0,-2,-18,0,-18,-2,-18,0,-18,-2,-18,0,-18,-2,-18,0,-18
13383,80000,64000,0,0,0,0,0,1,2,4229,4242,-13,-1,4161,1032,3129,0,4042,1000,3042,0,6807,2812,3995
13384,500000,400000,0,0,0,0,0,0,-1,19501,19501,0,-1,20000,1000,19000,0,0,0,0,0,0,0,0
13385,50000,40000,0,0,0,0,0,0,-2,9555,9588,-33,-2,4807,4821,-14,-2,14429,14472,-43,-2,9872,10002,-130
13386,90000,72000,0,0,0,0,0,0,0,12255,1499,10756,0,12192,436,11756,0,12448,452,11996,0,12895,654,12241
13387,80000,64000,0,1,0,0,0,0,0,82150,4000,78150,0,0,0,0,0,0,0,0,-2,0,0,0
13388,30000,24000,0,0,1,1,1,0,-1,27557,27557,0,-1,28433,2000,26433,0,29477,1500,27977,0,28910,1100,27810
13389,120000,96000,0,0,0,0,0,0,0,0,0,0,0,0,0,0,-2,0,0,0,-2,0,0,0
13390,330000,264000,0,0,0,0,0,0,0,48123,3000,45123,0,50195,3000,47195,0,51942,3000,48942,0,55963,5000,50963
13391,20000,16000,0,0,0,0,0,0,0,0,0,0,-2,0,0,0,-2,2105,2105,0,-1,2105,0,2105
13392,200000,160000,0,0,0,0,0,0,-1,3835,3835,0,-1,12559,12559,0,-1,6764,6764,0,-1,7700,7700,0
13393,70000,56000,0,1,0,0,0,0,0,70867,6550,64317,0,54425,0,54425,2,55555,2033,53522,0,48530,1915,46615
13394,10000,8000,0,0,0,0,0,0,0,6509,1279,5230,0,7313,1083,6230,0,6469,500,5969,0,6988,1000,5988
13395,170000,136000,0,0,0,0,0,0,0,14394,1158,13236,0,15249,1100,14149,0,15999,1000,14999,0,16753,1025,15728
13396,50000,40000,0,0,0,0,0,1,2,3997,0,3997,2,1047,1000,47,0,0,0,0,0,0,0,0
13397,270000,216000,0,1,1,1,1,0,0,262623,11100,251523,0,268735,12000,256735,0,273709,11000,262709,0,273139,10200,262939
13398,120000,96000,0,0,0,0,0,0,2,5333,5333,0,-1,5333,5333,0,-1,5333,5333,0,-1,21348,21348,0
13399,230000,184000,0,0,0,0,0,0,-1,23777,23820,-43,-1,78287,78287,0,-1,8986,35890,-26904,-1,11666,11000,666
13400,80000,64000,0,1,0,0,0,0,2,82150,3800,78350,0,0,0,0,0,0,0,0,-2,0,0,0
13401,300000,240000,0,0,0,0,0,0,-1,97979,5006,92973,0,94349,4500,89849,0,88213,3000,85213,0,78746,3000,75746
13402,100000,80000,0,0,0,0,0,0,-1,390,390,0,-1,390,390,0,-1,390,390,0,-1,390,390,0
13403,300000,240000,0,0,0,0,0,0,0,64747,1491,63256,0,65150,1303,63847,0,-450,0,-450,0,700,2000,-1300
13404,310000,248000,0,0,0,0,0,0,-2,-3484,0,-3484,-2,-3484,0,-3484,-2,-3484,0,-3484,-2,13833,17317,-3484
13405,350000,280000,0,0,0,0,0,0,-1,4150,4160,-10,-1,3750,3750,0,-1,1362,2272,-910,-1,8210,8210,0
13406,10000,8000,0,0,0,0,0,0,0,0,0,0,0,2640,2640,0,-1,695,695,0,-1,738,738,0
13407,220000,176000,0,0,0,0,0,0,-2,2635,2653,-18,-2,2460,2472,-12,-2,859,859,0,-2,2784,2784,0
13408,710000,568000,0,0,0,0,0,0,-1,940,944,-4,-1,6299,7586,-1287,-1,4720,4739,-19,-1,3738,3754,-16
13409,200000,160000,0,0,0,0,0,0,-1,0,0,0,-2,0,0,0,-2,218,218,0,-1,270,270,0
13410,260000,208000,0,0,0,0,0,0,0,5082,2025,3057,0,7732,7770,-38,-1,1379,1385,-6,-1,-8,0,-8
13411,60000,48000,0,0,0,0,0,0,0,12420,5000,7420,0,14731,4000,10731,0,21508,4000,17508,0,7695,3500,4195
13412,160000,128000,0,0,0,0,0,1,-1,270,270,0,-1,52,0,52,-1,0,0,0,-1,394,394,0
13413,50000,40000,0,0,0,0,0,0,0,1270,1270,0,-1,880,0,880,0,390,0,390,0,390,390,0
13414,360000,288000,0,0,0,0,0,0,0,37917,5043,32874,0,36502,8160,28342,0,31715,10069,21646,0,4857,2023,2834
13415,150000,120000,0,0,0,0,0,0,0,49410,10000,39410,0,58549,10000,48549,0,67560,10000,57560,0,86315,20000,66315
13416,20000,16000,0,1,0,0,0,0,0,18481,1258,17223,0,15495,1260,14235,0,15938,700,15238,0,16680,1000,15680
13417,80000,64000,0,0,0,0,0,0,2,0,0,0,2,0,0,0,-2,0,0,0,-2,0,0,0
13418,200000,160000,0,0,0,0,0,1,-1,188,0,188,2,376,376,0,-1,188,0,188,0,6884,6884,0
13419,20000,16000,0,0,1,1,1,0,0,17922,2000,15922,0,18895,2000,16895,0,19325,1500,17825,0,19859,1000,18859
13420,20000,16000,0,0,1,0,0,0,0,17723,4150,13573,0,18733,1500,17233,0,12249,577,11672,0,19910,8000,11910
13421,140000,112000,0,0,0,0,0,0,0,110827,4130,106697,0,113078,4600,108478,0,98901,3600,95301,0,100466,3600,96866
13422,20000,16000,0,0,0,0,0,1,0,1261,1261,0,-1,2126,2126,0,-1,1573,0,1573,2,1170,0,1170
13423,380000,304000,0,0,0,0,0,0,-2,359,359,0,-2,359,359,0,-2,359,359,0,-2,509,509,0
13424,50000,40000,0,0,0,0,0,0,0,30362,1546,28816,0,30764,1453,29311,0,30065,1039,29026,0,30179,1066,29113
13425,50000,40000,0,0,0,0,0,0,2,33101,1700,31401,2,28192,0,28192,2,22676,517,22159,0,14647,503,14144
13426,710000,568000,0,0,0,0,0,0,0,391305,12000,379305,0,195642,8000,187642,0,189101,7000,182101,0,182062,7000,175062
13427,30000,24000,0,0,0,0,0,1,0,20453,1531,18922,0,16076,1544,14532,0,15844,702,15142,0,15785,724,15061
13428,150000,120000,0,0,0,0,0,0,0,120458,5000,115458,0,98302,3903,94399,0,69424,2500,66924,0,70906,2600,68306
13429,380000,304000,0,0,0,0,0,0,0,236292,9000,227292,0,237176,10021,227155,0,236379,10000,226379,0,239221,10000,229221
13430,170000,136000,0,0,0,0,0,1,0,119050,4300,114750,0,120225,4400,115825,0,122345,4518,117827,0,124302,4500,119802
13431,150000,120000,0,0,0,0,0,1,-2,0,0,0,-2,0,0,0,-2,1883,1883,0,-1,1883,0,1883
13432,30000,24000,0,1,1,1,0,0,0,28261,2000,26261,0,29337,2000,27337,0,26189,500,25689,0,21715,1000,20715
13433,180000,144000,0,0,0,0,1,0,0,108232,8633,99599,0,108628,3600,105028,2,94416,0,94416,2,178120,3700,174420
13434,160000,128000,0,0,0,0,0,0,-1,632,632,0,-1,316,316,0,-1,0,0,0,-1,316,316,0
13435,50000,40000,0,0,0,0,0,0,0,13948,0,13948,2,12165,500,11665,0,10242,360,9882,0,8428,500,7928
13436,350000,280000,0,0,0,0,0,0,0,142794,25000,117794,0,101923,5000,96923,0,103119,5000,98119,0,84834,4000,80834
13437,320000,256000,0,0,0,0,0,1,-1,11131,12446,-1315,-1,13824,17746,-3922,-1,17992,6000,11992,0,15250,5749,9501
13438,170000,136000,0,0,0,0,0,0,-1,0,0,0,-1,0,0,0,-2,1861,1861,0,-1,-167,0,-167
13439,70000,56000,0,0,0,0,0,0,0,23756,1635,22121,0,18897,1463,17434,0,10873,525,10348,0,10707,535,10172
13440,20000,16000,0,0,0,0,0,0,0,2549,2549,0,-1,2696,2696,0,-1,1188,1188,0,-1,2677,2677,0
13441,260000,208000,0,0,0,0,0,0,-1,7288,7288,0,-1,1055,1055,0,-1,710,710,0,-1,755,755,0
13442,10000,8000,0,1,1,1,1,1,0,9844,0,9844,2,9554,400,9154,0,9515,499,9016,0,9700,500,9200
13443,180000,144000,0,1,1,1,1,0,0,162477,6000,156477,0,166861,7000,159861,0,171083,7000,164083,0,169365,7000,162365
13444,30000,24000,0,1,1,1,1,0,0,28944,2000,26944,0,29850,1741,28109,0,29523,1164,28359,0,28925,1027,27898
13445,110000,88000,0,1,1,0,0,0,0,105922,5000,100922,0,108820,5000,103820,0,66883,2100,64783,0,68083,2000,66083
13446,20000,16000,0,0,0,0,0,0,-2,0,0,0,-2,0,0,0,-2,0,0,0,-2,0,0,0
13447,70000,56000,0,0,0,0,0,0,0,57774,5043,52731,0,47326,5000,42326,0,50910,5000,45910,0,55059,5000,50059
13448,160000,128000,0,0,0,0,0,1,-2,1990,2009,-19,-2,0,0,0,-2,0,0,0,-2,0,0,0
13449,80000,64000,0,1,1,1,1,0,0,78015,3000,75015,0,79571,3500,76071,0,80121,3000,77121,0,77304,3000,74304
13450,150000,120000,0,1,0,0,0,0,0,148990,7007,141983,0,70303,3000,67303,0,64749,3000,61749,0,66206,2500,63706
13451,310000,248000,0,0,0,0,0,0,0,18599,3000,15599,0,21277,3000,18277,0,25896,5000,20896,0,25354,0,25354
13452,320000,256000,0,0,1,1,1,0,0,303265,300000,3265,0,310715,14000,296715,0,318340,15000,303340,0,268942,12000,256942
13453,170000,136000,0,0,0,0,0,0,-1,1638,1638,0,-1,3276,3276,0,-1,1638,0,1638,0,1638,1638,0
13454,80000,64000,0,0,0,0,0,0,-2,0,0,0,-2,0,0,0,-2,0,0,0,-2,0,0,0
13455,500000,400000,0,1,1,1,1,1,0,430774,17200,413574,0,437950,15853,422097,0,447203,17000,430203,0,456453,17000,439453
13456,30000,24000,0,0,0,0,0,1,2,12997,1500,11497,2,12491,0,12491,2,13374,1090,12284,2,13017,0,13017
13457,170000,136000,0,0,0,0,0,0,-1,9351,9361,-10,-1,22222,22222,0,-1,20437,20437,0,-1,8744,8744,0
13458,50000,40000,0,0,0,0,0,0,0,33826,1757,32069,0,30387,1047,29340,0,28850,1042,27808,0,29022,1036,27986
13459,80000,64000,0,0,0,0,0,1,-1,596,597,-1,-1,-4,0,-4,-1,1426,1430,-4,-1,1300,1309,-9
13460,180000,144000,0,0,0,0,0,0,-1,411,411,0,-1,955,960,-5,-1,416,416,0,-1,2408,2408,0
13461,180000,144000,0,0,0,0,0,1,-2,0,0,0,-2,0,0,0,-2,0,0,0,-2,0,0,0
13462,500000,400000,0,0,0,0,0,0,-1,1924,1933,-9,-1,976,980,-4,-1,986,990,-4,-1,1200,1206,-6
13463,170000,136000,0,0,0,0,0,0,0,48989,4000,44989,0,47900,0,47900,2,51088,4000,47088,0,54256,4000,50256
13464,390000,312000,0,0,0,0,0,0,-1,682,682,0,-1,10943,11130,-187,-1,9942,9942,0,-1,11168,6600,4568
13465,30000,24000,0,0,0,0,0,1,2,10221,0,10221,2,16808,6808,10000,2,17738,1502,16236,2,17174,0,17174
13466,330000,264000,0,0,0,0,0,0,-1,176,177,-1,-1,0,0,0,-1,0,0,0,-2,0,0,0
13467,80000,64000,0,1,1,1,1,0,2,75408,2600,72808,2,76618,3000,73618,2,77459,3000,74459,2,75327,1580,73747
13468,50000,40000,0,1,0,0,0,0,0,49844,1590,48254,0,20239,701,19538,0,20241,803,19438,0,19921,1000,18921
13469,300000,240000,0,0,0,0,0,0,0,3342,3342,0,-1,1287,0,1287,0,0,0,0,0,3899,3899,0
13470,240000,192000,0,0,0,0,0,0,-1,5232,5232,0,-1,6464,6464,0,-1,3820,3820,0,-1,11870,10000,1870
13471,60000,48000,0,0,0,0,0,0,-2,539,539,0,-1,37970,37970,0,-1,39354,2000,37354,0,40048,1500,38548
13472,190000,152000,0,1,1,1,0,0,-1,189018,7779,181239,0,175871,6092,169779,0,157218,5018,152200,0,151618,6168,145450
13473,80000,64000,0,0,0,0,0,0,0,46882,5000,41882,0,49170,4000,45170,0,48269,0,48269,2,49121,2002,47119
13474,390000,312000,0,0,0,0,0,0,-2,321,321,0,-2,4411,4412,-1,-2,1069,1069,0,-2,448,448,0
13475,50000,40000,0,0,0,0,0,1,2,6090,1136,4954,0,6626,1062,5564,0,6513,339,6174,0,6097,187,5910
13476,150000,120000,0,0,0,0,0,0,-2,1481,1481,0,-2,21640,21643,-3,-2,2636,2636,0,-2,4346,4346,0
13477,50000,40000,0,0,0,0,0,0,0,30660,2000,28660,0,31320,1500,29820,0,36227,5400,30827,0,35569,0,35569
13478,350000,280000,0,0,0,0,0,0,-1,0,0,0,-1,0,0,0,-2,0,0,0,-2,0,0,0
13479,520000,416000,0,0,0,0,0,0,0,6850,5010,1840,0,13178,13009,169,0,17059,10035,7024,0,17528,10007,7521
13480,90000,72000,0,1,0,0,0,1,0,79623,2917,76706,0,70039,2500,67539,0,70962,2451,68511,0,71013,2600,68413
13481,280000,224000,0,0,0,0,0,1,0,31900,1500,30400,0,21342,1400,19942,0,11500,2000,9500,0,2000,2000,0
13482,230000,184000,0,1,0,0,1,0,0,230302,9000,221302,0,186635,8000,178635,0,189896,8000,181896,0,193351,7500,185851
13483,160000,128000,0,0,0,0,0,0,-2,0,0,0,-2,0,0,0,-2,0,0,0,-2,0,0,0
13484,250000,200000,0,0,0,0,0,0,0,75436,2893,72543,0,58695,2201,56494,0,41211,1215,39996,0,34987,10040,24947
13485,170000,136000,0,0,0,0,0,0,-1,465,1000,-535,-1,1422,1422,0,-1,582,291,291,0,291,0,291
13486,80000,64000,0,0,0,0,0,0,-1,42108,2400,39708,0,30610,1900,28710,0,32396,2600,29796,0,31743,0,31743
13487,70000,56000,0,0,0,0,0,0,0,28346,4000,24346,0,12170,12,12158,0,-1686,0,-1686,0,-3594,0,-3594
13488,470000,376000,0,0,0,0,0,0,0,167876,7000,160876,0,170610,5716,164894,0,173643,5982,167661,0,178083,7000,171083
13489,350000,280000,0,0,0,0,0,0,-2,0,0,0,-2,0,0,0,-2,0,0,0,-2,0,0,0
13490,50000,40000,0,1,1,0,0,0,0,49268,2000,47268,0,50437,2100,48337,0,37302,1400,35902,0,38302,1600,36702
13491,170000,136000,0,0,0,0,0,0,0,0,0,0,0,0,0,0,-2,0,0,0,-2,0,0,0
13492,200000,160000,0,0,0,0,0,0,0,19496,1241,18255,0,16104,5000,11104,0,28666,16831,11835,0,18215,1000,17215
13493,80000,64000,0,0,0,0,0,0,0,29299,2085,27214,0,12406,248,12158,0,1308,26,1282,0,-52,52,-104
13494,450000,360000,0,0,0,0,0,0,0,5747,5747,0,-1,3339,3339,0,-1,9458,18916,-9458,-1,7231,7231,0
13495,70000,56000,0,0,0,0,0,1,2,46621,2000,44621,2,45573,0,45573,2,48678,4000,44678,2,47744,0,47744
13496,50000,40000,0,1,0,0,0,1,2,49551,0,49551,2,22673,2300,20373,0,17147,1000,16147,0,17505,635,16870
13497,500000,400000,0,0,0,0,0,0,1,4639,7439,-2800,-1,2800,0,2800,0,854,854,0,-1,10854,10000,854
13498,410000,328000,0,0,0,0,0,0,-1,13379,13379,0,-1,5165,5180,-15,-1,5034,5851,-817,-1,3089,3089,0
13499,240000,192000,0,0,0,0,0,0,0,94520,3558,90962,0,14422,1000,13422,0,12552,600,11952,0,20550,10550,10000
13500,260000,208000,0,0,0,0,0,0,-1,-850,0,-850,-1,300,1000,-700,-1,-832,0,-832,-1,-832,0,-832
13501,250000,200000,0,0,0,0,0,0,-1,98808,89000,9808,0,78366,10668,67698,0,10668,0,10668,0,390,0,390
13502,200000,160000,0,0,0,0,0,0,-1,3855,3855,0,-1,3411,3411,0,-1,6788,6788,0,-1,9921,9921,0
13503,160000,128000,0,0,0,0,0,0,-1,1665,1680,-15,-1,330,330,0,-1,165,0,165,0,794,794,0
13504,40000,32000,0,0,0,0,0,0,0,21687,2000,19687,0,22327,1000,21327,0,22816,1000,21816,0,23436,1000,22436
13505,290000,232000,0,1,0,0,0,1,2,297386,12139,285247,0,243558,80000,163558,0,241765,10000,231765,0,236413,8443,227970
13506,260000,208000,0,1,0,0,0,0,0,225258,10007,215251,0,189500,10017,179483,0,182771,10003,172768,0,188876,10007,178869
13507,20000,16000,0,0,0,0,0,1,2,2400,0,2400,2,2400,0,2400,7,2400,0,2400,7,2400,0,2400
13508,120000,96000,0,0,0,0,0,0,0,86353,3022,83331,0,84327,3100,81227,0,82469,3000,79469,0,82491,3100,79391
13509,60000,48000,0,1,1,1,1,0,0,56444,2500,53944,0,53183,2000,51183,0,55288,3000,52288,0,55782,2700,53082
13510,330000,264000,0,0,0,0,0,0,0,25036,5200,19836,0,21804,6000,15804,0,19228,4300,14928,0,18799,5000,13799
13511,50000,40000,0,0,0,0,0,0,-1,3416,3421,-5,-1,2040,2044,-4,-1,30430,30430,0,-1,257,257,0
13512,60000,48000,0,0,0,0,0,1,2,28577,0,28577,2,30805,2709,28096,2,31601,1600,30001,2,32349,1400,30949
13513,290000,232000,0,0,0,0,0,0,0,95169,4000,91169,0,93718,4250,89468,0,89712,5000,84712,0,82809,3241,79568
13514,100000,80000,0,0,0,0,0,1,0,10303,5000,5303,0,11007,1000,10007,0,11254,5200,6054,0,5934,1052,4882
13515,20000,16000,0,1,1,1,0,0,0,19298,1130,18168,0,19378,600,18778,0,19717,861,18856,0,15630,313,15317
13516,50000,40000,0,1,1,0,0,0,0,49705,2400,47305,0,51400,3000,48400,0,16087,16087,0,-1,16827,1000,15827
13517,70000,56000,0,0,0,0,0,0,0,31420,6000,25420,0,30940,1125,29815,2,24765,1300,23465,0,25942,3000,22942
13518,290000,232000,0,0,0,0,0,0,0,142264,5800,136464,0,101952,3792,98160,0,103174,4010,99164,0,105464,4276,101188
13519,30000,24000,1,1,1,1,1,1,2,37026,2145,34881,0,34579,1400,33179,0,32477,1000,31477,0,32477,0,32477
13520,30000,24000,0,1,1,1,1,0,0,26447,1800,24647,0,26946,1300,25646,0,28957,2400,26557,0,29408,1000,28408
13521,170000,136000,0,0,0,0,0,0,0,121958,4428,117530,0,123629,4326,119303,0,123605,4154,119451,0,123794,4345,119449
13522,100000,80000,0,0,0,0,0,0,-1,0,0,0,-1,316,316,0,-1,632,632,0,-1,0,0,0
13523,20000,16000,1,1,1,1,1,0,7,20206,0,20206,6,19617,0,19617,5,18737,0,18737,4,18148,0,18148
13524,170000,136000,0,1,1,0,0,1,0,152429,7400,145029,0,154704,5600,149104,0,96724,4500,92224,0,73916,3000,70916
13525,50000,40000,0,0,0,0,0,0,2,26992,1400,25592,0,27693,1100,26593,0,29237,2100,27137,0,28607,0,28607
13526,60000,48000,0,0,0,0,0,0,0,16773,5084,11689,0,11568,6000,5568,0,9727,4000,5727,0,3832,3832,0
13527,390000,312000,0,1,1,1,1,1,2,375899,16000,359899,0,374302,15000,359302,0,395430,29000,366430,0,384825,0,384825
13528,210000,168000,0,0,0,0,0,1,2,390,780,-390,-1,390,390,0,-1,780,780,0,-1,390,0,390
13529,140000,112000,0,0,0,0,0,0,-1,4158,4158,0,-1,2021,0,2021,2,-372,0,-372,2,628,2000,-1372
13530,120000,96000,0,0,0,0,0,1,0,32286,1600,30686,0,32692,1200,31492,0,32261,1200,31061,0,32644,1200,31444
13531,50000,40000,0,0,0,0,0,0,-2,0,0,0,-2,0,0,0,-2,0,0,0,-2,0,0,0
13532,320000,256000,1,1,1,1,0,1,0,391741,11000,380741,0,400196,11000,389196,0,408503,10800,397703,0,156881,5992,150889
13533,160000,128000,0,0,0,0,0,0,-1,390,390,0,-1,390,390,0,-1,390,390,0,-1,390,390,0
13534,130000,104000,0,0,0,0,0,0,0,7060,1000,6060,0,4480,3990,490,0,3000,3000,0,-1,0,0,0
13535,50000,40000,0,0,0,0,0,0,-1,4725,1600,3125,0,8933,8933,0,-1,11784,11784,0,-1,9927,199,9728
13536,100000,80000,0,0,0,0,0,0,-1,6690,443,6247,2,1196,1196,0,-1,416,2080,-1664,-1,620,620,0
13537,30000,24000,0,1,1,1,1,0,0,24602,1,24601,2,27964,3801,24163,2,27232,0,27232,2,29800,3001,26799
13538,80000,64000,0,0,0,0,0,0,0,52446,2037,50409,0,49999,2000,47999,0,41411,1499,39912,0,42328,2000,40328
13539,360000,288000,0,0,0,0,0,0,-2,9000,9000,0,-1,3002,3002,0,-1,3063,61,3002,0,3063,0,3063
13540,10000,8000,0,1,1,1,0,1,0,9900,1300,8600,0,9941,1041,8900,0,9250,1000,8250,0,9403,2000,7403
13541,230000,184000,0,0,0,0,0,0,-2,13499,13499,0,-2,9078,9117,-39,-2,11009,11009,0,-2,6172,6172,0
13542,150000,120000,0,0,0,0,0,1,2,53710,2503,51207,0,48797,2000,46797,0,49928,1804,48124,0,51106,2000,49106
13543,110000,88000,0,0,0,0,0,0,0,16002,3,15999,2,15262,521,14741,0,15626,1000,14626,0,14465,520,13945
13544,280000,224000,0,0,0,0,0,0,0,81244,3000,78244,0,81193,3007,78186,0,82470,5000,77470,0,49630,2000,47630
13545,400000,320000,0,0,0,0,0,0,0,6402,6430,-28,-1,20772,20118,654,0,12406,5037,7369,0,10945,5054,5891
13546,300000,240000,0,0,0,0,0,0,-1,5090,5134,-44,-1,309,322,-13,-1,2700,5013,-2313,-1,7593,7611,-18
13547,20000,16000,0,0,0,0,0,0,0,5326,1096,4230,0,6574,1344,5230,0,7417,1187,6230,0,2246,285,1961
13548,140000,112000,0,0,0,0,0,1,0,107496,3500,103996,0,69218,2700,66518,0,70702,2600,68102,0,72267,2742,69525
13549,50000,40000,0,0,0,0,0,0,0,10355,1202,9153,0,9853,1000,8853,0,2917,2917,0,-1,1473,29,1444
13550,360000,288000,0,0,0,0,0,0,-2,3168,3168,0,-2,1469,1469,0,-2,1833,1833,0,-2,1449,1449,0
13551,60000,48000,0,0,0,0,0,0,0,17298,1300,15998,0,17889,1277,16612,0,17847,625,17222,0,17827,644,17183
13552,150000,120000,0,0,0,0,0,0,-2,0,0,0,-2,0,0,0,-2,0,0,0,-2,0,0,0
13553,90000,72000,0,1,1,0,0,0,0,91595,4000,87595,0,88197,3002,85195,0,59822,1974,57848,0,55345,2000,53345
13554,500000,400000,0,0,0,0,0,0,-1,5239,5239,0,-1,5239,0,5239,0,1559,0,1559,0,2680,2680,0
13555,180000,144000,0,0,0,0,0,0,-2,0,0,0,-2,0,0,0,-2,0,0,0,-2,0,0,0
13556,50000,40000,0,1,0,0,0,1,0,47206,1302,45904,0,19189,678,18511,0,19008,695,18313,0,19687,1000,18687
13557,150000,120000,0,0,0,0,0,1,2,39394,3105,36289,2,37686,2,37684,2,38810,2020,36790,2,31548,36,31512
13558,260000,208000,0,0,0,0,0,0,0,115106,5000,110106,0,118811,5000,113811,0,121514,4000,117514,0,124815,4815,120000
13559,50000,40000,0,1,1,1,1,0,0,47095,2200,44895,0,49485,3500,45985,0,49083,2000,47083,2,45187,0,45187
13560,20000,16000,0,0,0,0,0,0,0,5341,1100,4241,0,5751,500,5251,0,6500,1000,5500,0,7386,1000,6386
13561,90000,72000,0,0,0,0,0,1,0,1988,2000,-12,-1,55970,61000,-5030,-1,59612,5000,54612,0,40281,1800,38481
13562,120000,96000,0,0,0,0,0,0,0,65838,2319,63519,0,61527,2151,59376,0,59620,2200,57420,0,60767,2300,58467
13563,470000,376000,0,0,0,0,0,0,0,13149,3000,10149,0,15824,3000,12824,0,19424,4000,15424,0,27522,8098,19424
13564,90000,72000,0,0,0,0,0,0,0,29601,1396,28205,0,20650,1050,19600,0,0,0,0,0,0,0,0
13565,30000,24000,0,0,0,0,0,0,0,18456,28,18428,2,4190,5000,-810,-1,13702,13702,0,-1,13247,0,13247
13566,210000,168000,0,0,0,0,0,1,-1,1737,1737,0,-1,2433,2433,0,-1,3115,3115,0,-1,3899,3899,0
13567,50000,40000,1,1,1,0,0,0,0,69594,2236,67358,0,46181,2807,43374,0,16770,629,16141,0,19890,3810,16080
13568,80000,64000,0,1,1,0,0,0,0,80107,2600,77507,2,78323,371,77952,2,45985,1904,44081,0,45434,1801,43633
13569,360000,288000,0,0,0,0,0,0,-1,165,165,0,-1,165,165,0,-1,165,165,0,-1,165,165,0
13570,50000,40000,0,0,0,0,0,1,2,22838,0,22838,3,20411,57,20354,2,16016,2000,14016,2,15242,0,15242
13571,260000,208000,0,0,0,0,0,0,2,96689,5000,91689,0,101023,6000,95023,0,93738,5000,88738,0,96218,4000,92218
13572,20000,16000,0,0,0,0,0,0,4,14474,0,14474,3,13944,0,13944,2,15073,1363,13710,2,14692,0,14692
13573,200000,160000,0,0,0,0,0,0,-1,150,150,0,-1,3570,3570,0,-1,2853,2853,0,-1,0,0,0
13574,80000,64000,0,0,0,0,0,0,0,15173,1874,13299,0,10493,0,10493,2,10313,3313,7000,2,6687,0,6687
13575,310000,248000,0,0,0,0,0,0,-2,4488,4488,0,-1,4696,264,4432,0,84522,80000,4522,0,86206,2950,83256
13576,180000,144000,0,1,1,0,0,0,0,171772,8206,163566,0,172344,6500,165844,0,134321,5000,129321,0,131191,5000,126191
13577,280000,224000,0,0,0,0,0,0,0,214180,15038,199142,0,226277,23084,203193,0,216716,11001,205715,0,232367,20000,212367
13578,90000,72000,0,1,1,1,1,1,0,88183,5400,82783,2,91204,5804,85400,2,89687,0,89687,2,91060,6700,84360
13579,100000,80000,0,0,0,0,0,0,0,14562,14562,0,-1,6930,6969,-39,-1,5958,5958,0,-1,1448,1448,0
13580,20000,16000,0,0,0,0,0,0,-1,4840,0,4840,2,780,780,0,-1,390,0,390,0,0,0,0
13581,130000,104000,0,0,0,0,0,1,2,73442,0,73442,2,75115,3500,71615,0,79230,5500,73730,0,81278,3500,77778
13582,80000,64000,1,1,1,1,1,1,2,83656,3000,80656,2,84457,3000,81457,2,83897,3100,80797,2,80159,0,80159
13583,70000,56000,0,0,0,0,0,0,0,14016,1300,12716,0,14782,1000,13782,0,15249,701,14548,0,15595,1000,14595
13584,200000,160000,0,0,0,0,0,0,-1,770,0,770,2,5259,5269,-10,-1,1329,1329,0,-1,3609,2280,1329
13585,50000,40000,0,0,0,0,0,0,-1,0,0,0,-2,0,0,0,-2,0,0,0,-2,0,0,0
13586,160000,128000,0,0,0,0,0,1,-1,0,0,0,-1,650,650,0,-1,325,0,325,0,325,325,0
13587,60000,48000,0,0,0,0,0,0,0,34358,1800,32558,0,34986,1500,33486,0,35770,1500,34270,0,36622,1600,35022
13588,360000,288000,0,0,0,0,0,0,0,30878,36063,-5185,-1,66017,67000,-983,-1,83049,36545,46504,0,16775,0,16775
13589,360000,288000,0,0,0,0,0,0,0,121284,90054,31230,0,93951,9011,84940,0,58200,3007,55193,0,52585,2592,49993
13590,90000,72000,0,0,0,0,0,0,0,20559,0,20559,2,17228,1000,16228,0,6531,1000,5531,0,8411,2000,6411
13591,140000,112000,0,0,0,0,0,0,0,89226,4000,85226,0,91680,4003,87677,0,93220,4003,89217,0,94456,4006,90450
13592,280000,224000,0,0,0,0,0,0,0,78544,3504,75040,0,63106,3204,59902,0,63465,2304,61161,0,64031,2504,61527
13593,200000,160000,0,0,0,0,0,0,-1,1198,1198,0,-1,6081,6081,0,-1,4203,4203,0,-1,3044,3044,0
13594,110000,88000,0,0,0,0,0,0,2,86274,3200,83074,2,84001,0,84001,2,85897,3400,82497,0,88759,4500,84259
13595,200000,160000,0,0,0,0,0,0,0,47318,3224,44094,0,21594,0,21594,2,19067,8000,11067,0,13814,8000,5814
13596,200000,160000,0,0,0,0,0,0,-2,0,0,0,-2,1500,1500,0,-1,0,0,0,-1,0,0,0
13597,230000,184000,0,1,0,0,0,0,0,227311,8750,218561,0,184500,7470,177030,0,128190,4540,123650,0,130883,4710,126173
13598,50000,40000,0,1,0,0,0,0,0,43952,1500,42452,0,29136,1239,27897,0,19048,612,18436,0,17946,607,17339
13599,30000,24000,0,1,1,1,1,0,0,27821,2000,25821,0,28075,2000,26075,0,29682,2014,27668,0,28001,2000,26001
13600,30000,24000,0,1,1,1,1,0,0,27699,1500,26199,0,28257,1018,27239,0,30695,2900,27795,0,30059,0,30059
13601,60000,48000,0,0,0,0,0,0,0,35628,2000,33628,0,31738,1022,30716,0,28217,1009,27208,0,29817,5000,24817
13602,230000,184000,0,0,0,0,0,0,-2,1258,1264,-6,-2,2565,2577,-12,-2,-5,0,-5,-2,1100,1105,-5
13603,60000,48000,0,0,0,0,0,0,0,29732,1600,28132,0,29411,1394,28017,0,28859,1000,27859,0,28309,1000,27309
13604,50000,40000,0,0,0,0,0,0,0,14675,1236,13439,0,14967,528,14439,0,15282,548,14734,0,15585,550,15035
13605,80000,64000,0,0,0,0,0,0,0,15729,5000,10729,0,3000,3000,0,-1,1500,0,1500,0,1500,1500,0
13606,20000,16000,0,1,1,1,0,0,2,17651,1400,16251,0,17603,352,17251,0,17962,1139,16823,0,0,0,0
13607,30000,24000,0,0,0,0,0,0,0,19590,1290,18300,0,18447,4150,14297,0,15525,15525,0,-1,0,0,0
13608,160000,128000,0,0,0,0,0,0,0,56625,2100,54525,0,57757,2500,55257,0,59424,3000,56424,0,60631,2200,58431
13609,20000,16000,0,1,0,0,0,0,0,18775,1162,17613,0,13854,524,13330,0,10718,606,10112,0,0,0,0
13610,280000,224000,0,0,0,0,0,0,0,36381,1600,34781,0,36594,1300,35294,0,37010,1500,35510,0,36334,2000,34334
13611,740000,592000,0,0,0,0,0,1,-1,1477,1487,-10,-1,15713,15754,-41,-1,8988,9012,-24,-1,25449,25596,-147
13612,360000,288000,0,0,0,0,0,0,0,-6877,0,-6877,-2,-5377,2000,-7377,-2,-2377,3000,-5377,-2,-377,2000,-2377
13613,50000,40000,0,1,1,0,0,0,0,49894,1991,47903,0,49453,1670,47783,0,29824,1036,28788,0,29319,1050,28269
13614,200000,160000,0,0,0,0,0,1,-1,1582,1677,-95,-1,3607,3607,0,-1,894,894,0,-1,301,301,0
13615,20000,16000,0,1,1,1,1,0,0,19476,1315,18161,0,19865,704,19161,0,20480,928,19552,0,20063,912,19151
13616,340000,272000,0,0,0,0,0,0,0,113312,0,113312,2,114379,4387,109992,0,113627,4634,108993,0,112193,4519,107674
13617,150000,120000,0,0,0,0,0,0,0,100369,4500,95869,0,101035,4000,97035,0,101982,4000,97982,0,103970,5000,98970
13618,160000,128000,0,0,0,0,0,0,0,110390,6200,104190,0,122358,15000,107358,0,120714,0,120714,2,124145,5000,119145
13619,260000,208000,0,0,0,0,0,0,-2,0,0,0,-2,0,0,0,-2,8867,8867,0,-2,763,763,0
13620,20000,16000,0,0,0,0,0,0,-1,0,0,0,-1,0,0,0,-2,0,0,0,-2,0,0,0
13621,180000,144000,0,0,0,0,0,0,-1,390,390,0,-1,0,0,0,-1,390,390,0,-1,930,930,0
13622,350000,280000,0,0,0,0,0,0,0,16991,3000,13991,0,18541,2000,16541,0,20075,2001,18074,0,20491,580,19911
13623,50000,40000,0,0,0,0,0,1,2,3186,3000,186,0,6527,3341,3186,0,3328,0,3328,2,33166,30000,3166
13624,160000,128000,0,0,0,0,0,0,0,56561,3015,53546,0,52338,2128,50210,0,31133,2000,29133,0,27590,1000,26590
13625,360000,288000,0,0,0,0,0,0,0,5866,1166,4700,0,1297,1297,0,-1,0,0,0,-1,0,0,0
13626,250000,200000,0,0,0,0,0,0,0,16998,16998,0,-2,17504,17504,0,-2,0,0,0,-2,0,0,0
13627,160000,128000,0,0,0,0,0,0,0,42769,2700,40069,0,44448,2700,41748,0,46269,2700,43569,0,48036,2700,45336
13628,70000,56000,0,1,1,0,0,0,0,65169,1680,63489,0,64370,3000,61370,0,15082,142,14940,0,0,142,-142
13629,20000,16000,0,0,0,0,0,0,-2,0,0,0,-2,0,0,0,-2,222,222,0,-1,6345,6345,0
13630,30000,24000,0,1,1,0,0,0,0,27849,0,27849,2,27451,1400,26051,0,24358,487,23871,0,21192,424,20768
13631,280000,224000,0,0,0,0,0,0,-1,53603,53871,-268,-1,976,981,-5,-1,20825,20929,-104,-1,1159,1164,-5
13632,120000,96000,0,0,0,0,0,0,-1,4531,4531,0,-1,1211,0,1211,0,4015,4015,0,-1,2042,0,2042
13633,190000,152000,0,0,0,0,0,0,-1,3022,4000,-978,-1,1397,0,1397,2,1554,1600,-46,-1,1561,1600,-39
13634,320000,256000,0,0,0,0,0,1,-2,0,0,0,-2,0,0,0,-2,0,0,0,-2,0,0,0
13635,220000,176000,0,0,0,0,0,1,0,91266,12000,79266,0,88051,3100,84951,2,81803,0,81803,2,79286,2900,76386
13636,240000,192000,0,0,0,0,0,0,-2,5000,5000,0,-2,0,0,0,-2,254,254,0,-2,9366,9366,0
13637,130000,104000,0,0,0,0,0,1,0,29927,3500,26427,0,24555,498,24057,2,24873,3000,21873,0,26583,3300,23283
13638,100000,80000,1,1,1,1,1,1,5,100328,0,100328,4,97883,0,97883,3,96238,0,96238,2,96160,3469,92691
13639,90000,72000,0,0,0,0,0,0,0,5613,3000,2613,0,5613,0,5613,0,10113,4500,5613,0,10113,0,10113
13640,300000,240000,0,0,0,0,0,0,-1,1005,1005,0,-1,1372,1372,0,-1,1610,1610,0,-1,1355,1355,0
13641,500000,400000,0,0,0,0,0,0,-1,-37,0,-37,-1,-37,0,-37,-2,-37,0,-37,-2,213,250,-37
13642,30000,24000,0,0,0,0,0,0,-1,390,400,-10,-1,3797,3797,0,-1,0,0,0,-1,0,0,0
13643,50000,40000,0,0,0,0,0,0,0,33043,4000,29043,0,25556,3000,22556,0,24389,2500,21889,0,25436,4000,21436
13644,100000,80000,0,0,0,0,0,0,0,75296,3010,72286,0,73774,3000,70774,0,75603,6000,69603,0,77807,3500,74307
13645,150000,120000,0,0,0,0,0,1,2,6334,0,6334,2,9058,2823,6235,2,8823,0,8823,2,7458,3530,3928
13646,200000,160000,0,0,0,0,0,0,0,22409,1770,20639,0,11671,2003,9668,0,5493,900,4593,0,3288,1800,1488
13647,130000,104000,0,0,0,0,0,0,-2,306,306,0,-1,3670,3670,0,-1,1473,1473,0,-1,5555,5555,0
13648,500000,400000,0,0,0,0,0,0,-1,2988,2988,0,-1,11645,11645,0,-1,13237,13237,0,-1,303512,303512,0
13649,210000,168000,0,0,0,0,0,0,-1,307,307,0,-1,614,307,307,-1,307,614,-307,-1,307,307,0
13650,280000,224000,0,0,0,0,0,0,0,20209,1649,18560,0,20395,1304,19091,0,18969,703,18266,0,18381,701,17680
13651,100000,80000,0,0,0,0,0,1,2,6637,6637,0,-1,6300,0,6300,2,12300,6000,6300,0,0,0,0
13652,180000,144000,0,0,0,0,0,0,0,145440,5002,140438,0,140057,4470,135587,0,132260,4620,127640,0,110427,4346,106081
13653,400000,320000,0,0,0,0,0,0,0,7056,1100,5956,0,7310,310,7000,0,9943,3000,6943,0,12849,3000,9849
13654,140000,112000,0,0,0,0,0,1,-1,0,0,0,-2,6560,6560,0,-1,3617,3617,0,-1,0,0,0
13655,30000,24000,0,1,1,1,0,1,0,30097,1420,28677,0,25887,0,25887,0,25707,92,25615,0,0,0,0
13656,180000,144000,0,0,0,0,0,0,0,100951,3682,97269,0,104625,5253,99372,0,106498,5000,101498,0,115632,11000,104632
13657,50000,40000,0,1,1,1,1,1,0,47317,1787,45530,0,48259,1729,46530,0,50245,2765,47480,0,50265,1000,49265
13658,50000,40000,0,1,0,0,0,0,0,48776,1000,47776,0,19251,19251,0,-1,19650,622,19028,0,14974,558,14416
13659,500000,400000,0,0,0,1,1,1,0,167682,5872,161810,0,501496,508229,-6733,-1,508213,18089,490124,0,496801,14070,482731
13660,30000,24000,0,0,0,0,0,0,0,664,664,0,-1,1814,1500,314,0,0,0,0,0,0,0,0
13661,20000,16000,0,1,1,1,1,1,2,20465,2690,17775,2,20381,900,19481,2,18446,0,18446,2,18598,1000,17598
13662,270000,216000,0,0,0,0,0,1,-1,12985,13056,-71,-1,0,0,0,-1,0,0,0,-2,0,0,0
13663,310000,248000,0,0,0,0,0,0,0,78497,5000,73497,0,72529,72529,0,-1,76345,5000,71345,0,79072,4000,75072
13664,110000,88000,0,0,0,0,0,0,0,9000,1500,7500,0,63853,63853,0,-1,59308,1500,57808,2,60576,2062,58514
13665,20000,16000,0,1,0,0,1,0,0,19669,1640,18029,0,16479,1506,14973,0,16694,721,15973,0,17334,1000,16334
13666,50000,40000,0,0,0,0,0,0,0,23306,1400,21906,0,16282,1300,14982,0,9451,400,9051,0,9408,400,9008
13667,50000,40000,0,0,0,0,0,0,-1,390,0,390,2,390,390,0,-1,390,390,0,-1,1320,1320,0
13668,150000,120000,0,1,1,1,1,0,0,146410,7000,139410,0,142858,4000,138858,0,146007,8071,137936,0,130721,4000,126721
13669,340000,272000,0,0,0,0,0,0,-1,41533,41634,-101,-1,15711,15711,0,-1,1338,1338,0,-1,6800,6800,0
13670,190000,152000,0,0,0,0,0,0,0,144636,5987,138649,0,148173,5948,142225,0,151853,6000,145853,0,155031,5481,149550
13671,60000,48000,0,0,0,0,0,1,2,45603,3628,41975,2,44569,0,44569,2,47452,3600,43852,2,46536,0,46536
13672,130000,104000,0,0,0,0,0,0,0,29710,2000,27710,0,34310,5000,29310,0,21900,438,21462,0,780,780,0
13673,120000,96000,0,0,0,0,0,0,0,39505,1672,37833,0,45373,10000,35373,0,46641,2000,44641,0,47569,1704,45865
13674,160000,128000,0,0,0,0,0,0,-2,0,0,0,-2,980,980,0,-2,0,0,0,-2,0,0,0
13675,30000,24000,0,0,0,0,0,1,2,17697,0,17697,2,18416,1317,17099,0,20099,2000,18099,0,21631,2000,19631
13676,20000,16000,1,1,1,1,1,0,0,47594,2400,45194,0,49281,2000,47281,0,18714,900,17814,0,19162,800,18362
13677,220000,176000,0,1,1,0,0,1,0,219611,10098,209513,0,204740,5828,198912,0,97722,3000,94722,0,89971,3000,86971
13678,360000,288000,0,1,1,1,0,0,0,358716,14000,344716,0,353426,12080,341346,0,299403,10000,289403,0,260620,9500,251120
13679,230000,184000,0,0,0,0,0,0,0,2936,1000,1936,0,476,476,0,-1,476,476,0,-1,476,476,0
13680,230000,184000,0,0,0,0,0,1,2,0,0,0,2,878,878,0,-1,0,0,0,-1,0,0,0
13681,170000,136000,0,0,0,0,0,0,0,81688,3000,78688,0,100841,20000,80841,0,23528,5000,18528,0,32579,10000,22579
13682,230000,184000,0,0,0,0,0,0,0,65452,4000,61452,0,61129,3000,58129,0,55199,3000,52199,0,55380,2000,53380
13683,170000,136000,0,0,0,0,0,0,-2,0,0,0,-2,0,0,0,-2,0,0,0,-2,0,0,0
13684,20000,16000,0,0,0,0,0,1,0,8370,1145,7225,0,9380,1154,8226,0,10078,852,9226,0,10072,150,9922
13685,10000,8000,0,1,1,1,1,0,-1,9379,1200,8179,0,9566,342,9224,0,9766,354,9412,0,10042,438,9604
13686,20000,16000,0,1,1,1,1,0,4,18405,0,18405,3,17680,0,17680,2,18000,1500,16500,2,19000,1000,18000
13687,360000,288000,0,0,0,0,0,0,0,235716,12000,223716,0,171573,10000,161573,0,95455,10000,85455,0,91687,0,91687
13688,50000,40000,0,0,0,0,0,0,2,22608,3321,19287,2,21951,0,21951,2,22287,1000,21287,0,22778,1000,21778
13689,430000,344000,0,0,0,0,0,1,2,300873,11000,289873,2,294527,0,294527,2,308523,19000,289523,2,318274,15000,303274
13690,160000,128000,0,0,0,0,0,0,-2,0,0,0,-2,0,0,0,-2,0,0,0,-2,0,0,0
13691,260000,208000,0,1,0,0,0,0,0,222102,11900,210202,0,108724,207,108517,2,68500,2003,66497,0,69174,2003,67171
13692,20000,16000,0,0,0,0,0,0,-1,9457,9847,-390,-1,10311,1000,9311,0,10374,1000,9374,0,10692,500,10192
13693,200000,160000,0,0,0,0,0,0,0,14704,7240,7464,0,8000,2000,6000,0,10285,2285,8000,0,16285,6000,10285
13694,80000,64000,0,0,0,0,0,0,0,10816,1131,9685,0,9746,322,9424,0,9798,490,9308,0,10401,1402,8999
13695,20000,16000,0,1,1,1,1,1,2,19502,1000,18502,3,20881,2000,18881,2,20266,0,20266,3,20511,700,19811
13696,50000,40000,0,0,0,0,0,1,-1,5880,5880,0,-1,0,0,0,-1,0,0,0,-2,0,0,0
13697,160000,128000,0,1,1,0,0,0,0,135452,5142,130310,0,136804,4450,132354,0,116042,4178,111864,0,118202,5000,113202
13698,260000,208000,0,0,0,0,0,0,-1,15362,15362,0,-1,21068,10000,11068,0,27669,7000,20669,0,32202,5000,27202
13699,30000,24000,0,1,0,0,0,0,0,28782,1500,27282,0,24082,1000,23082,0,17060,1000,16060,0,0,0,0
13700,50000,40000,0,1,0,0,0,1,2,48647,2045,46602,2,36411,1314,35097,2,32087,1268,30819,2,22909,0,22909
13701,10000,8000,0,0,0,1,1,1,4,7992,0,7992,3,8610,900,7710,2,8325,0,8325,2,8441,400,8041
13702,210000,168000,0,0,0,0,0,0,0,-27,0,-27,-2,-27,0,-27,-2,3073,3100,-27,-1,2878,0,2878
13703,80000,64000,1,1,1,0,0,0,2,82194,3,82191,3,78715,5,78710,2,26681,1075,25606,0,0,0,0
13704,70000,56000,0,0,0,0,0,0,0,16373,3000,13373,0,16945,1260,15685,0,21462,6138,15324,0,11128,1128,10000
13705,200000,160000,0,0,0,0,0,0,-1,416,416,0,-1,416,416,0,-1,416,416,0,-1,0,0,0
13706,50000,40000,0,0,0,0,0,1,0,34536,1000,33536,0,0,0,0,0,0,0,0,-2,0,0,0
13707,120000,96000,0,0,0,0,0,0,0,67525,3040,64485,0,67091,2400,64691,0,67419,2500,64919,0,67711,2450,65261
13708,400000,320000,0,0,0,0,0,0,-2,4039,4039,0,-2,10692,10692,0,-1,18692,8000,10692,0,19565,9000,10565
13709,180000,144000,0,0,0,0,0,0,-2,0,0,0,-2,0,0,0,-2,0,0,0,-2,0,0,0
13710,170000,136000,0,0,0,0,0,0,-1,1243,1246,-3,-1,0,0,0,-1,0,0,0,-2,0,0,0
13711,20000,16000,0,0,0,0,0,1,-1,396,396,0,-1,396,396,0,-1,8972,8972,0,-1,3984,3984,0
13712,200000,160000,0,0,0,0,0,0,-1,4581,4581,0,-1,610,612,-2,-1,0,0,0,-1,0,0,0
13713,50000,40000,0,0,0,0,0,0,2,19124,1597,17527,0,18117,649,17468,0,18496,671,17825,0,18880,691,18189
13714,130000,104000,0,0,0,0,0,0,2,103351,12700,90651,2,100724,0,100724,2,97675,4000,93675,0,102080,11461,90619
13715,260000,208000,0,0,0,0,0,0,-1,2800,9,2791,2,3804,2998,806,0,5009,5034,-25,-1,3035,3050,-15
13716,150000,120000,0,0,0,0,0,0,-2,0,0,0,-2,0,0,0,-2,0,0,0,-2,0,0,0
13717,160000,128000,0,0,0,0,0,1,-1,326,652,-326,-1,79652,79652,0,-1,326,0,326,0,49326,49326,0
13718,110000,88000,0,0,0,0,0,0,0,34533,3000,31533,0,36819,3000,33819,0,32467,3000,29467,0,35806,4000,31806
13719,160000,128000,0,0,0,0,0,0,2,5859,2000,3859,0,10299,5008,5291,0,11825,3007,8818,0,13121,2000,11121
13720,170000,136000,0,0,0,0,0,0,-2,28144,28144,0,-2,1883,1883,0,-2,27938,27938,0,-2,14832,14832,0
13721,150000,120000,0,0,0,0,0,0,0,19674,20155,-481,-1,57858,63992,-6134,-1,53588,3004,50584,0,56892,6002,50890
13722,150000,120000,0,0,0,0,0,0,-1,291,291,0,-1,432,432,0,-1,441,300,141,0,882,882,0
13723,500000,400000,0,0,0,0,0,0,0,30327,16107,14220,0,16314,3325,12989,0,1151,1151,0,-1,3074,3074,0
13724,50000,40000,0,0,0,0,0,0,0,9899,2000,7899,0,11017,2000,9017,0,13460,3000,10460,0,15529,4000,11529
13725,420000,336000,0,0,0,0,0,0,-2,15000,15000,0,-2,15000,15000,0,-2,15000,15000,0,-2,15000,15000,0
13726,20000,16000,0,1,1,1,1,1,0,17884,1602,16282,0,18590,1308,17282,0,18959,677,18282,0,19347,692,18655
13727,20000,16000,0,0,0,0,0,0,0,0,0,0,0,0,0,0,-2,0,0,0,-2,0,0,0
13728,450000,360000,0,0,0,0,0,0,-1,14276,14500,-224,-1,1346,1346,0,-1,1448,1448,0,-1,4005,4005,0
13729,190000,152000,0,0,0,0,0,0,0,86897,5000,81897,0,90399,5600,84799,0,85698,3000,82698,0,88400,4000,84400
13730,160000,128000,0,0,0,0,0,1,-1,316,316,0,-1,316,316,0,-1,316,316,0,-1,316,316,0
13731,20000,16000,0,1,1,1,1,0,0,18312,1577,16735,0,18474,2000,16474,0,18074,808,17266,0,19618,2000,17618
13732,260000,208000,0,0,0,0,0,0,-2,0,0,0,-2,0,0,0,-2,0,0,0,-2,0,0,0
13733,250000,200000,0,0,0,0,0,0,-2,-320,320,-640,-2,-320,0,-320,-2,1680,2000,-320,-2,4058,4058,0
13734,20000,16000,0,1,1,0,0,1,2,18325,1000,17325,2,18391,600,17791,2,14235,0,14235,2,18955,5000,13955
13735,70000,56000,0,0,0,0,0,0,0,0,0,0,-2,0,0,0,-2,0,0,0,-2,1453,1453,0
13736,120000,96000,0,0,0,0,0,0,0,91961,3500,88461,0,94433,4000,90433,0,97787,5000,92787,0,87413,3500,83913
13737,50000,40000,0,0,0,0,0,0,-1,0,0,0,-2,0,0,0,-2,0,0,0,-2,0,0,0
13738,180000,144000,0,1,1,0,0,0,0,156803,7133,149670,0,159342,7369,151973,0,10400,600,9800,0,20650,20650,0
13739,80000,64000,0,0,0,0,0,0,-1,1107,1000,107,0,1338,1338,0,-1,0,0,0,-1,0,0,0
13740,240000,192000,0,0,0,0,0,0,2,17601,17601,0,-1,1410,2115,-705,-1,705,0,705,0,705,705,0
13741,30000,24000,0,0,0,0,0,0,-1,-581,0,-581,-2,-2054,0,-2054,-2,1473,5000,-3527,-1,14510,14510,0
13742,200000,160000,0,0,0,0,0,0,-2,3760,3771,-11,-2,4273,4285,-12,-1,3015,3023,-8,-1,5076,5088,-12
13743,20000,16000,0,0,0,0,0,0,0,5596,1500,4096,0,7337,2000,5337,0,8063,1000,7063,0,8769,1000,7769
13744,70000,56000,0,1,1,1,1,1,2,65516,3000,62516,2,65945,2100,63845,2,66267,2000,64267,2,68549,3500,65049
13745,20000,16000,0,0,0,1,1,0,2,0,0,0,2,20358,20358,0,-1,18044,0,18044,2,20325,2577,17748
13746,20000,16000,0,0,0,0,0,0,0,15868,5086,10782,0,16188,5000,11188,0,14891,3202,11689,0,3044,5000,-1956
13747,100000,80000,0,0,0,0,0,0,0,45591,1505,44086,0,39764,1300,38464,0,33091,1210,31881,0,34265,3000,31265
13748,80000,64000,0,0,0,0,0,0,0,14608,1567,13041,0,17441,3400,14041,0,16866,0,16866,2,17443,1000,16443
13749,90000,72000,0,0,0,0,0,0,-1,10967,10967,0,-1,14644,10000,4644,0,12467,249,12218,0,4155,0,4155
13750,130000,104000,0,1,1,1,1,1,2,131073,6230,124843,0,132399,5000,127399,0,140254,10200,130054,0,139209,4400,134809
13751,60000,48000,0,0,0,0,0,0,0,42627,2000,40627,0,43914,2000,41914,0,45053,2000,43053,0,46303,2000,44303
13752,20000,16000,1,1,0,0,0,0,2,20296,3,20293,3,10245,0,10245,2,6635,700,5935,0,6877,500,6377
13753,20000,16000,0,1,1,1,1,1,0,19543,1374,18169,0,20002,1215,18787,0,19314,596,18718,0,19320,609,18711
13754,140000,112000,0,0,0,0,0,0,-1,3400,4000,-600,-1,3218,3218,0,-1,16478,17000,-522,-1,4078,4500,-422
13755,200000,160000,0,0,0,0,0,0,-2,736,736,0,-2,736,736,0,-2,736,736,0,-2,316,316,0
13756,290000,232000,0,0,0,0,0,0,-1,10986,11584,-598,-1,8184,8184,0,-1,14936,14936,0,-1,19573,19573,0
13757,70000,56000,0,1,1,1,1,0,0,60263,2200,58063,0,65348,6100,59248,0,63699,0,63699,2,67667,5000,62667
13758,200000,160000,0,0,0,0,0,0,-2,4695,4695,0,-2,2008,2008,0,-2,164,164,0,-2,3383,3383,0
13759,100000,80000,0,1,1,1,1,0,0,96642,5000,91642,0,99362,4400,94962,0,100571,3669,96902,0,102680,3800,98880
13760,200000,160000,0,0,0,0,0,0,0,492,492,0,0,2038,2038,0,-1,316,0,316,-1,1226,1226,0
13761,230000,184000,0,0,0,0,0,0,-2,1462,1462,0,-2,622,622,0,-2,1083,1083,0,-2,622,622,0
13762,100000,80000,0,1,0,0,0,0,0,87244,3811,83433,0,23181,3002,20179,0,7721,4000,3721,0,3219,3219,0
13763,80000,64000,0,1,0,0,0,0,2,76916,5090,71826,0,51070,2001,49069,0,52727,3000,49727,0,54847,3000,51847
13764,140000,112000,0,0,0,0,0,0,0,78458,3520,74938,0,76387,2500,73887,0,76344,2689,73655,0,67302,2494,64808
13765,400000,320000,0,0,0,0,0,0,0,22584,2159,20425,0,22655,1000,21655,0,23417,3000,20417,0,16845,1008,15837
13766,50000,40000,0,0,0,0,0,1,0,0,0,0,-2,0,0,0,-2,0,0,0,-2,0,0,0
13767,110000,88000,0,1,0,0,0,0,2,103749,5100,98649,0,78961,3411,75550,0,76180,3003,73177,0,76353,3000,73353
13768,100000,80000,0,1,1,1,1,0,0,94893,4230,90663,0,101301,10000,91301,0,101451,3582,97869,0,99319,5000,94319
13769,230000,184000,0,0,0,0,0,0,-2,0,0,0,-2,144,144,0,-2,225,225,0,-2,0,0,0
13770,410000,328000,0,1,1,1,1,0,0,415917,18026,397891,0,389659,14095,375564,0,342329,12037,330292,0,344974,15026,329948
13771,320000,256000,0,0,0,0,0,0,-1,49210,3011,46199,0,50052,4000,46052,0,53325,4019,49306,0,53765,5000,48765
13772,50000,40000,0,0,0,0,0,1,2,31438,1500,29938,2,31924,1300,30624,2,32566,1300,31266,2,33081,1200,31881
13773,80000,64000,0,0,0,0,0,0,0,0,0,0,0,0,0,0,-2,0,0,0,-2,0,0,0
13774,30000,24000,0,1,1,1,1,0,0,27899,1700,26199,0,29614,2500,27114,0,30127,1000,29127,0,29646,2000,27646
13775,350000,280000,0,0,0,0,0,0,-2,714,716,-2,-2,263,263,0,-2,900,900,0,-2,1271,1271,0
13776,60000,48000,0,0,0,0,0,0,2,5366,0,5366,2,6772,1500,5272,2,6515,0,6515,2,7906,1500,6406
13777,200000,160000,0,0,0,0,0,0,3,782,0,782,2,1166,700,466,2,700,0,700,2,1414,1200,214
13778,50000,40000,0,0,0,0,0,1,2,19345,0,19345,2,19152,1000,18152,0,18953,1000,17953,0,19388,900,18488
13779,360000,288000,0,0,0,0,0,1,-2,-9,0,-9,-2,1840,1849,-9,-2,0,0,0,-2,0,0,0
13780,360000,288000,0,0,0,0,0,0,-2,-8,0,-8,-2,-8,0,-8,-2,1677,1685,-8,-1,2600,2613,-13
13781,20000,16000,0,0,0,0,0,1,0,14252,2800,11452,0,13678,0,13678,2,15041,1500,13541,2,14751,0,14751
13782,120000,96000,0,0,0,0,0,0,-2,0,0,0,-2,0,0,0,-2,0,0,0,-2,150,150,0
13783,500000,400000,0,0,0,0,0,0,-1,1320,1320,0,-1,1320,1320,0,-1,1320,1320,0,-1,1320,1320,0
13784,500000,400000,0,0,0,0,0,0,0,218508,15020,203488,0,230776,20007,210769,0,245546,20007,225539,0,255905,15912,239993
13785,120000,96000,0,1,1,1,1,0,0,113736,5000,108736,0,116000,4152,111848,0,119131,5000,114131,0,122135,5000,117135
13786,340000,272000,0,0,0,0,0,0,-1,9085,9126,-41,-1,9461,9481,-20,-1,12654,12657,-3,-1,7296,7306,-10
13787,270000,216000,0,0,0,0,0,1,-1,3097,0,3097,2,48546,48546,0,-1,47250,2000,45250,0,46649,3000,43649
13788,60000,48000,0,1,0,0,0,1,0,59797,1353,58444,0,30372,27826,2546,0,45283,1300,43983,0,24588,1903,22685
13789,50000,40000,0,0,0,0,0,0,0,26823,2003,24820,0,26799,1420,25379,0,26536,937,25599,0,27093,972,26121
13790,140000,112000,0,0,0,0,0,0,0,57549,3000,54549,0,60971,5000,55971,0,61374,2000,59374,2,63243,3000,60243
13791,50000,40000,0,0,0,0,0,0,0,0,0,0,0,0,0,0,-2,6553,6553,0,-1,19653,13100,6553
13792,150000,120000,0,0,0,0,0,1,2,18617,1000,17617,2,18020,0,18020,2,18726,1000,17726,0,19414,1000,18414
13793,130000,104000,0,1,0,0,0,0,0,126021,5010,121011,0,70186,2505,67681,0,71762,2700,69062,0,73192,2623,70569
13794,80000,64000,0,0,0,0,0,0,0,19744,2011,17733,0,14556,3105,11451,0,0,0,0,0,1460,1460,0
13795,20000,16000,1,1,1,0,0,1,0,20200,0,20200,2,20000,0,20000,0,0,0,0,0,0,0,0
13796,150000,120000,0,0,0,0,0,0,-1,2483,2490,-7,-1,4556,4573,-17,-1,1606,1610,-4,-1,2047,2053,-6
13797,150000,120000,0,0,0,0,0,1,-1,390,390,0,-1,4825,4825,0,-1,5202,5202,0,-1,780,780,0
13798,50000,40000,0,0,0,0,0,1,0,25725,10000,15725,0,25017,0,25017,2,34385,10000,24385,2,33248,0,33248
13799,100000,80000,0,0,0,0,0,0,-2,0,0,0,-2,0,0,0,-2,0,0,0,-2,0,0,0
13800,210000,168000,0,0,0,0,0,0,0,30713,2000,28713,0,27644,1200,26444,0,26236,1200,25036,0,26312,1000,25312
13801,340000,272000,0,0,0,0,0,1,-1,35028,35028,0,-1,35028,0,35028,0,8500,0,8500,0,1612,1612,0
13802,250000,200000,0,0,0,0,0,1,-2,4438,4455,-17,-2,3416,3417,-1,-2,-4,0,-4,-2,1404,1408,-4
13803,10000,8000,0,0,0,0,1,0,0,6118,1020,5098,0,245,250,-5,-1,10274,10300,-26,-1,9963,0,9963
13804,260000,208000,0,0,0,0,0,0,-1,3863,3863,0,-1,56173,56006,167,0,15700,5712,9988,0,5049,1000,4049
13805,200000,160000,0,0,0,0,0,0,-1,3802,3803,-1,-1,1271,1271,0,-1,1489,1489,0,-1,1260,1260,0
13806,110000,88000,0,0,0,0,0,0,0,53550,1499,52051,0,44084,1309,42775,0,42077,1487,40590,0,37770,2000,35770
13807,30000,24000,0,0,0,0,0,0,0,7090,7090,0,-1,2680,2680,0,-1,390,390,0,-1,0,0,0
13808,330000,264000,0,0,0,0,0,0,0,233122,8507,224615,0,246414,17215,229199,0,253338,11000,242338,2,249107,0,249107
13809,290000,232000,0,0,0,0,0,0,-2,4536,4538,-2,-2,6074,6074,0,-2,0,0,0,-2,817,817,0
13810,240000,192000,0,0,0,0,0,0,-1,419,419,0,-1,419,419,0,-1,419,419,0,-1,419,419,0
13811,80000,64000,0,1,1,0,0,0,0,74349,2800,71549,0,75443,2400,73043,0,57735,2100,55635,0,58139,2100,56039
13812,190000,152000,0,1,1,1,1,0,0,187521,8500,179021,0,190448,9270,181178,0,195492,14100,181392,0,190598,0,190598
13813,60000,48000,0,1,0,0,0,0,0,53235,2018,51217,0,38533,1900,36633,0,39639,2000,37639,0,39619,1500,38119
13814,80000,64000,0,0,0,0,0,1,2,41199,2000,39199,2,42264,2000,40264,2,43083,1600,41483,2,43471,1200,42271
13815,80000,64000,0,0,0,0,0,0,0,58099,5028,53071,0,52599,21595,31004,0,52519,5541,46978,0,46945,1507,45438
13816,80000,64000,0,0,0,0,0,0,0,48198,2000,46198,0,49182,2000,47182,0,49939,1770,48169,0,50626,2002,48624
13817,50000,40000,0,1,0,0,1,0,0,49243,5450,43793,0,5112,0,5112,2,48455,45554,2901,0,48456,2100,46356
13818,70000,56000,0,0,0,0,0,0,2,26305,2600,23705,2,27570,2000,25570,2,28021,1200,26821,2,27436,0,27436
13819,120000,96000,1,1,0,0,0,0,0,160932,3117,157815,0,54967,1551,53416,0,42017,2000,40017,0,30455,1273,29182
13820,100000,80000,0,0,0,0,0,1,2,27045,1500,25545,0,28598,2000,26598,0,30131,2000,28131,0,32356,2700,29656
13821,390000,312000,0,0,0,0,0,0,2,153795,3000,150795,2,140387,5000,135387,0,128112,4548,123564,0,115514,4100,111414
13822,300000,240000,0,0,0,0,0,0,-1,2660,2684,-24,-1,2319,2319,0,-1,1905,1905,0,-1,257,257,0
13823,50000,40000,0,1,0,0,0,0,0,50376,2310,48066,0,9408,336,9072,0,9605,348,9257,0,9806,360,9446
13824,200000,160000,0,1,0,0,0,0,0,183344,9000,174344,0,153880,8000,145880,0,155359,6000,149359,0,158776,6000,152776
13825,30000,24000,0,0,0,0,0,0,0,7098,1114,5984,0,10148,4000,6148,0,22070,13000,9070,0,23182,2000,21182
13826,170000,136000,0,0,0,0,0,1,-2,2760,26058,-23298,-2,3474,3474,0,-2,7680,7680,0,-2,7860,7860,0
13827,270000,216000,0,0,0,0,0,0,0,54715,3019,51696,0,51796,5000,46796,0,53256,5000,48256,0,59733,10000,49733
13828,60000,48000,0,0,0,0,0,1,-1,1876,1876,0,-1,1876,1876,0,-1,1876,1876,0,-1,1876,1876,0
13829,120000,96000,0,1,1,1,1,0,0,118886,6100,112786,0,117170,4600,112570,0,117403,5000,112403,0,117388,4800,112588
13830,90000,72000,0,1,0,0,0,0,0,77489,5021,72468,0,46544,3000,43544,0,48266,3000,45266,0,49926,3000,46926
13831,280000,224000,0,0,0,0,0,0,-1,9252,9298,-46,-1,21254,21360,-106,-1,1608,1614,-6,-1,407,2,405
13832,80000,64000,0,1,1,1,1,1,0,68875,4330,64545,0,70646,3500,67146,2,72870,3500,69370,2,75018,3500,71518
13833,130000,104000,0,1,1,1,1,0,0,133781,6900,126881,0,133834,7000,126834,0,132336,7000,125336,0,132614,6000,126614
13834,240000,192000,0,1,1,1,1,0,0,242079,12350,229729,0,243114,15969,227145,0,213930,7968,205962,0,219009,8700,210309
13835,120000,96000,0,0,0,0,0,1,2,316,316,0,-1,632,632,0,-1,316,0,316,0,316,316,0
13836,200000,160000,0,0,0,0,0,0,0,159907,10000,149907,0,168200,10000,158200,0,148987,4183,144804,0,152224,4465,147759
13837,150000,120000,0,0,0,0,0,1,-1,4175,4175,0,-1,1707,1707,0,-1,4492,4492,0,-1,6149,6149,0
13838,10000,8000,0,0,0,0,0,1,-1,780,0,780,2,390,0,390,0,390,390,0,-1,780,780,0
13839,240000,192000,0,0,0,0,0,0,0,61412,2237,59175,0,62771,5000,57771,0,65038,5000,60038,0,67266,5000,62266
13840,160000,128000,0,0,0,0,0,0,2,78047,3000,75047,2,79362,3200,76162,2,81089,3152,77937,2,82796,3200,79596
13841,240000,192000,0,0,0,0,0,1,-2,-150,0,-150,-2,-150,0,-150,-2,-150,0,-150,-2,-150,0,-150
13842,490000,392000,0,0,0,0,0,0,-1,-571,571,-1142,-1,-1796,1225,-3021,-2,137158,140597,-3439,-1,139345,6000,133345
13843,200000,160000,0,0,0,0,0,0,0,66029,3000,63029,0,66836,2500,64336,0,68390,2632,65758,0,69800,2700,67100
13844,200000,160000,0,0,0,0,0,0,2,6314,6314,0,-1,6034,0,6034,2,6034,0,6034,0,2493,0,2493
13845,120000,96000,0,1,1,0,0,1,2,112279,10800,101479,2,108089,0,108089,2,88594,3500,85094,0,87630,3400,84230
13846,200000,160000,0,1,0,1,1,0,2,202466,8555,193911,0,168015,10000,158015,0,169799,6500,163299,0,171981,7103,164878
13847,190000,152000,0,0,0,0,0,0,2,119570,5000,114570,2,116284,0,116284,2,123528,9000,114528,2,125478,4000,121478
13848,70000,56000,0,1,1,0,0,0,2,69422,2000,67422,2,65107,55,65052,2,28736,1170,27566,0,29221,1100,28121
13849,50000,40000,0,0,0,0,0,0,2,20088,3300,16788,2,19483,0,19483,2,19742,1560,18182,2,19275,0,19275
13850,280000,224000,0,0,0,0,0,0,0,185067,7500,177567,0,177878,9000,168878,0,140710,6500,134210,0,81033,5000,76033
13851,20000,16000,0,0,0,0,0,0,0,10571,1000,9571,2,10995,600,10395,0,11169,500,10669,0,11979,1000,10979
13852,300000,240000,0,0,0,0,0,1,-2,0,0,0,-2,0,0,0,-2,0,0,0,-2,0,0,0
13853,350000,280000,0,0,0,0,0,0,0,42499,5000,37499,0,46590,5000,41590,0,52606,7000,45606,0,59537,8000,51537
13854,170000,136000,0,0,0,0,0,0,0,130585,7005,123580,0,127013,7000,120013,0,126635,6000,120635,0,127093,6000,121093
13855,70000,56000,0,0,0,0,0,0,0,21125,7000,14125,0,6197,1100,5097,0,4560,1000,3560,0,0,0,0
13856,260000,208000,0,0,0,0,0,0,-1,0,0,0,-2,0,0,0,-2,0,0,0,-2,0,0,0
13857,360000,288000,0,0,0,0,0,0,0,17295,86,17209,2,8331,8372,-41,-1,2643,2656,-13,-1,6008,6038,-30
13858,160000,128000,0,0,0,0,0,0,2,56316,2000,54316,0,59331,3500,55831,0,60227,2000,58227,0,61778,2200,59578
13859,50000,40000,0,0,0,0,0,0,0,10476,1500,8976,0,11197,1200,9997,0,11609,600,11009,0,11922,500,11422
13860,60000,48000,0,0,0,0,0,0,0,27275,5816,21459,0,22095,1000,21095,0,14293,5000,9293,0,12217,12217,0
13861,30000,24000,0,1,1,1,0,0,0,29846,2000,27846,0,28631,1064,27567,0,27359,1000,26359,0,21750,1223,20527
13862,70000,56000,0,0,0,0,0,0,0,28401,3005,25396,0,22587,3000,19587,0,24361,3000,21361,0,25424,1500,23924
13863,220000,176000,0,0,0,0,0,0,0,31277,1377,29900,0,23258,8011,15247,0,4546,165,4381,0,6470,2000,4470
13864,80000,64000,0,0,0,0,0,0,-1,-3990,0,-3990,-1,22193,27194,-5001,-1,21546,1381,20165,0,1922,1922,0
13865,30000,24000,0,0,1,1,1,0,0,25437,2000,23437,0,28391,3700,24691,0,27801,0,27801,2,28684,1500,27184
13866,150000,120000,1,1,0,0,0,0,0,241615,25099,216516,0,139741,80000,59741,0,144692,120000,24692,0,124197,95000,29197
13867,50000,40000,0,0,0,0,0,0,-1,0,0,0,-1,0,0,0,-2,0,0,0,-2,0,0,0
13868,80000,64000,0,0,0,0,0,0,2,9387,9387,0,-1,125,125,0,-1,-68,0,-68,-1,-261,0,-261
13869,200000,160000,0,0,0,0,0,0,-2,390,390,0,-2,390,390,0,-2,386,386,0,-2,1376,1380,-4
13870,50000,40000,0,0,0,0,0,0,0,20669,1150,19519,0,4510,1000,3510,0,2893,300,2593,0,2000,400,1600
13871,60000,48000,0,0,0,0,0,0,0,51237,5011,46226,0,29999,1005,28994,0,28972,1000,27972,0,29444,14000,15444
13872,10000,8000,0,0,0,1,1,0,0,7329,1125,6204,0,8343,2139,6204,0,8508,304,8204,0,8686,315,8371
13873,20000,16000,0,0,0,0,0,0,-1,677,677,0,-1,-1,0,-1,-1,213,214,-1,-1,856,856,0
13874,150000,120000,0,1,1,0,0,0,0,149386,7200,142186,0,149031,4800,144231,0,78284,2730,75554,0,76500,2750,73750
13875,30000,24000,0,0,0,0,0,0,-1,1393,1393,0,-1,1543,1543,0,-1,1596,1596,0,-1,2970,2970,0
13876,360000,288000,0,0,0,0,0,0,2,11627,12085,-458,-1,35765,41879,-6114,-1,9681,10053,-372,-1,3002,4016,-1014
13877,140000,112000,0,1,0,0,0,0,2,136223,210,136013,2,113942,7903,106039,2,109652,0,109652,2,109118,4183,104935
13878,380000,304000,0,0,0,0,0,0,-2,6267,6930,-663,-2,19774,19873,-99,-2,12297,12361,-64,-2,2700,2713,-13
13879,230000,184000,0,0,0,0,0,0,0,22219,4000,18219,0,23512,3047,20465,0,12894,3000,9894,0,15183,3000,12183
13880,80000,64000,0,0,0,0,0,0,-1,2500,2500,0,-1,3045,3045,0,-1,1451,1456,-5,-1,6541,6541,0
13881,280000,224000,0,1,1,0,0,0,0,269140,12011,257129,0,272665,10807,261858,0,159017,4306,154711,0,88321,4023,84298
13882,400000,320000,0,0,0,0,0,0,-1,71671,72031,-360,-1,-329,0,-329,-1,65691,66020,-329,-1,23657,23776,-119
13883,60000,48000,0,0,0,0,0,1,0,21227,1500,19727,0,22564,2000,20564,0,24191,2000,22191,0,25778,2000,23778
13884,30000,24000,0,0,0,0,0,1,0,3398,6253,-2855,-1,2855,0,2855,2,2115,2115,0,-1,521,0,521
13885,210000,168000,0,0,0,0,0,0,-2,5292,5292,0,-2,8866,8872,-6,-1,16809,16876,-67,-1,5794,5794,0
13886,130000,104000,0,0,0,0,0,0,0,83245,3000,80245,0,76631,2410,74221,0,75607,7639,67968,0,73006,12962,60044
13887,50000,40000,0,0,0,0,0,0,1,0,0,0,-2,0,0,0,-2,0,0,0,-2,0,0,0
13888,100000,80000,0,1,1,1,0,0,0,90357,4044,86313,0,89209,3420,85789,0,84983,3300,81683,0,81484,3886,77598
13889,40000,32000,0,0,0,0,0,1,-1,30107,20000,10107,0,31567,3000,28567,0,32583,3000,29583,0,31309,31749,-440
13890,150000,120000,0,0,0,0,0,0,-2,3363,18285,-14922,-2,1774,1774,0,-2,0,0,0,-2,0,0,0
13891,280000,224000,0,0,0,0,0,0,0,193638,10000,183638,0,161264,8000,153264,0,148863,5500,143363,0,155006,8500,146506
13892,340000,272000,0,0,0,0,0,0,0,89689,4000,85689,0,81996,3504,78492,0,83439,4349,79090,0,71239,3000,68239
13893,20000,16000,0,0,0,0,0,0,2,11304,1500,9804,0,12311,1500,10811,0,12410,600,11810,0,13358,1300,12058
13894,360000,288000,0,0,0,0,0,1,-2,0,0,0,-2,0,0,0,-2,0,0,0,-2,0,0,0
13895,80000,64000,0,0,0,0,0,1,0,16391,4122,12269,0,3729,139,3590,0,4663,1000,3663,0,5429,1000,4429
13896,410000,328000,0,0,0,0,0,0,-1,25014,26880,-1866,-1,26184,15083,11101,0,21515,12049,9466,0,15656,4077,11579
13897,210000,168000,0,0,0,0,0,0,0,40288,5000,35288,0,42605,3000,39605,0,43870,2000,41870,0,13750,1000,12750
13898,100000,80000,0,1,0,0,0,1,0,91943,4000,87943,0,71201,2500,68701,0,69804,2700,67104,0,71088,2600,68488
13899,50000,40000,0,0,0,0,0,1,0,6680,1000,5680,0,0,0,0,0,0,0,0,-2,0,0,0
13900,340000,272000,0,0,0,0,0,0,-1,-22,0,-22,-1,7569,7591,-22,-1,797,799,-2,-1,1211,1214,-3
13901,200000,160000,0,0,0,0,0,0,-1,1800,1800,0,-1,1795,2000,-205,-1,58932,60000,-1068,-1,29331,29331,0
13902,140000,112000,0,1,1,1,1,1,0,135956,6500,129456,0,137143,6265,130878,0,137195,5000,132195,0,136300,5006,131294
13903,280000,224000,0,0,0,0,0,1,2,4689,4689,0,-1,2289,2300,-11,-1,1700,1725,-25,-1,803,803,0
13904,500000,400000,0,0,0,0,0,0,0,7403,5000,2403,0,12225,5000,7225,0,16702,5000,11702,0,21253,5000,16253
13905,180000,144000,0,0,0,0,0,1,-2,-200,0,-200,-2,-200,0,-200,-2,-200,0,-200,-2,-200,0,-200
13906,500000,400000,0,0,0,0,0,0,0,19080,3010,16070,0,13860,2000,11860,0,15904,2044,13860,0,134584,131438,3146
13907,30000,24000,0,0,0,0,0,0,-1,1392,1392,0,-1,696,696,0,-1,0,0,0,-1,696,696,0
13908,20000,16000,0,0,0,0,0,1,0,12450,2900,9550,0,13949,2000,11949,2,13437,0,13437,3,13082,0,13082
13909,290000,232000,0,0,0,0,0,0,0,191188,9041,182147,0,145089,7027,138062,0,137942,10088,127854,0,116689,8027,108662
13910,50000,40000,0,0,0,0,0,0,0,36287,4000,32287,0,30691,1200,29491,2,29901,0,29901,2,49293,20000,29293
13911,200000,160000,0,0,0,0,0,0,0,99528,7004,92524,0,100341,5000,95341,0,102585,5003,97582,0,108567,7345,101222
13912,310000,248000,0,1,1,1,1,1,0,261550,11300,250250,0,285233,29841,255392,0,280905,69,280836,2,272240,9980,262260
13913,280000,224000,0,0,0,0,0,0,0,81718,2965,78753,0,83347,2987,80360,0,85623,3623,82000,0,87252,3148,84104
13914,50000,40000,0,0,0,1,1,1,2,40071,1000,39071,2,40906,1800,39106,2,42100,2000,40100,2,41269,0,41269
13915,110000,88000,0,0,0,0,0,0,0,55357,2200,53157,0,56281,2200,54081,0,56483,2149,54334,0,56685,2170,54515
13916,280000,224000,0,0,0,0,0,0,0,32868,2100,30768,0,34292,2500,31792,0,173487,185957,-12470,-1,177195,6500,170695
13917,50000,40000,0,1,0,0,0,1,0,51136,2261,48875,0,20171,1296,18875,0,19286,672,18614,0,19292,688,18604
13918,80000,64000,0,0,0,0,0,0,0,20790,1650,19140,0,0,0,0,0,0,0,0,-2,0,0,0
13919,140000,112000,0,0,0,0,0,0,0,63093,3000,60093,0,58650,5000,53650,0,54946,3000,51946,0,53773,3000,50773
13920,250000,200000,0,0,0,0,0,0,-2,8660,8703,-43,-2,7495,7532,-37,-2,1120,1125,-5,-2,62,62,0
13921,20000,16000,0,1,0,0,1,0,0,18635,1268,17367,0,-1542,0,-1542,0,19909,21451,-1542,-1,19417,0,19417
13922,50000,40000,0,1,1,0,0,0,0,44302,4228,40074,0,42942,1603,41339,0,20103,900,19203,0,20163,700,19463
13923,380000,304000,0,1,0,0,0,0,0,363343,14000,349343,0,290371,12500,277871,0,289600,12000,277600,0,288256,11000,277256
13924,20000,16000,0,0,0,0,0,0,2,8469,0,8469,2,9481,1157,8324,0,10324,1000,9324,0,10017,0,10017
13925,140000,112000,0,1,0,0,0,0,-1,135573,8000,127573,0,98172,5075,93097,0,93677,4000,89677,0,95276,4000,91276
13926,160000,128000,0,0,0,0,0,0,-1,27380,27380,0,-1,10028,10050,-22,-1,2824,3000,-176,-1,9940,9940,0
13927,100000,80000,0,1,1,1,1,1,3,89011,0,89011,7,96593,10000,86593,6,105083,10000,95083,7,103522,0,103522
13928,300000,240000,0,0,0,0,0,0,-2,1702,1702,0,-2,0,0,0,-2,0,0,0,-2,0,0,0
13929,30000,24000,0,0,0,0,0,0,0,17379,1279,16100,0,23100,10000,13100,0,0,0,0,0,0,0,0
13930,400000,320000,0,0,0,0,0,0,-2,5498,5503,-5,-1,3259,3262,-3,-1,5949,5966,-17,-1,1111,1111,0
13931,50000,40000,0,0,0,0,0,1,2,29000,1482,27518,0,29731,1213,28518,0,30400,1300,29100,0,33427,3703,29724
13932,340000,272000,0,0,0,0,0,0,0,62918,16000,46918,0,53322,13322,40000,0,50180,10005,40175,0,57000,9081,47919
13933,100000,80000,0,1,0,0,0,0,0,97195,5900,91295,0,69299,0,69299,2,68030,2500,65530,0,63601,2500,61101
13934,360000,288000,0,0,0,0,0,0,0,-29,37,-66,0,-1671,1642,-3313,-2,87329,89000,-1671,-2,89608,3000,86608
13935,180000,144000,0,0,0,0,0,0,-1,326,326,0,-1,326,326,0,-1,76465,76465,0,-1,79695,5000,74695
13936,50000,40000,0,0,0,0,0,0,-1,6152,6152,0,-1,4419,0,4419,2,4419,0,4419,0,1473,0,1473
13937,240000,192000,0,1,0,0,0,0,0,205084,10006,195078,0,194800,7000,187800,0,183962,7000,176962,0,188496,8000,180496
13938,430000,344000,0,0,0,0,0,1,2,296219,13000,283219,2,300873,11000,289873,2,294527,0,294527,2,308523,19000,289523
13939,110000,88000,0,0,0,0,0,0,0,37038,1800,35238,0,38336,2000,36336,0,12907,600,12307,0,13541,1000,12541
13940,50000,40000,0,0,0,0,0,0,0,23122,2000,21122,0,24654,2000,22654,0,26365,2000,24365,0,25844,2000,23844
13941,70000,56000,0,1,1,0,0,1,0,69038,3001,66037,0,69927,2608,67319,0,50579,1777,48802,0,49483,1792,47691
13942,20000,16000,0,0,0,0,0,0,-2,1238,1000,238,-2,5300,5300,0,-2,0,0,0,-2,16100,16100,0
13943,300000,240000,0,0,0,0,0,0,0,16703,3012,13691,0,16000,2048,13952,0,10154,10154,0,-1,10154,0,10154
13944,270000,216000,0,0,0,0,0,1,2,13539,0,13539,2,15005,2000,13005,0,16438,2000,14438,0,17021,1000,16021
13945,30000,24000,0,1,1,1,1,1,2,27648,1300,26348,2,29297,2400,26897,2,28544,0,28544,3,29125,1200,27925
13946,50000,40000,0,0,0,0,0,0,0,4123,1200,2923,0,680,0,680,0,978,978,0,-1,978,0,978
13947,50000,40000,0,0,0,0,0,0,-1,4204,4204,0,-1,390,390,0,-1,390,390,0,-1,540,540,0
13948,300000,240000,0,1,1,1,1,1,0,305697,12000,293697,0,269017,10000,259017,0,275230,10500,264730,0,260419,10000,250419
13949,390000,312000,0,0,0,0,0,0,-1,18401,18426,-25,-1,13200,34,13166,0,6385,31,6354,0,7088,7088,0
13950,340000,272000,0,0,0,0,0,0,-1,14007,24330,-10323,-1,11922,11943,-21,-1,84739,84739,0,-1,11132,11132,0
13951,400000,320000,0,0,0,0,0,1,0,13010,1000,12010,0,12620,0,12620,0,17945,13945,4000,0,20030,7116,12914
13952,150000,120000,0,0,0,0,0,0,-2,0,0,0,-2,0,0,0,-2,0,0,0,-2,0,0,0
13953,130000,104000,0,0,0,0,0,0,0,11666,1500,10166,0,11806,616,11190,0,11081,500,10581,0,11396,500,10896
13954,270000,216000,0,0,0,0,0,0,-1,9791,9791,0,-1,10532,10532,0,-1,6559,6559,0,-1,500,500,0
13955,140000,112000,0,0,0,0,0,0,-2,0,0,0,-2,0,0,0,-2,0,0,0,-2,0,0,0
13956,140000,112000,0,0,0,0,0,0,-2,0,0,0,-2,4647,4647,0,-1,250,5423,-5173,-1,4654,4404,250
13957,100000,80000,0,0,0,0,0,0,0,32331,1451,30880,0,29035,4,29031,0,19576,41,19535,0,33825,34938,-1113
13958,130000,104000,0,0,0,0,0,0,-1,15253,15253,0,-1,7338,7338,0,-1,3666,3669,-3,-1,7856,7856,0
13959,240000,192000,0,0,0,0,0,0,0,81563,3000,78563,0,83224,3016,80208,0,84878,3033,81845,0,86665,3150,83515
13960,300000,240000,0,0,0,0,0,1,0,25145,5000,20145,0,37666,37676,-10,-1,19453,8808,10645,0,10492,2000,8492
13961,300000,240000,0,0,0,0,0,0,-1,4790,4790,0,-1,3145,3145,0,-1,4274,4274,0,-1,0,0,0
13962,120000,96000,0,1,0,0,0,1,0,111003,5000,106003,0,84840,3000,81840,0,86954,3500,83454,0,83448,3000,80448
13963,30000,24000,0,0,0,0,0,0,-1,2936,2936,0,-1,588,0,588,0,0,0,0,0,0,0,0
13964,60000,48000,0,0,0,0,0,0,0,29626,1794,27832,0,29804,1772,28032,0,28045,1200,26845,0,28629,1186,27443
13965,180000,144000,0,0,0,0,0,0,0,136239,7000,129239,0,138116,6500,131616,0,135246,5000,130246,0,130436,5000,125436
13966,50000,40000,0,0,0,0,0,0,0,12684,1521,11163,0,12050,1148,10902,0,11005,364,10641,0,9952,355,9597
13967,160000,128000,0,0,0,0,0,1,2,1560,1560,0,-1,1170,0,1170,0,780,0,780,0,390,0,390
13968,200000,160000,0,0,0,0,0,0,-1,390,390,0,-1,780,780,0,-1,390,0,390,0,390,390,0
13969,10000,8000,0,0,1,1,1,1,0,8415,1440,6975,0,9075,800,8275,0,8785,0,8785,2,8959,320,8639
13970,320000,256000,0,0,0,0,0,0,-1,72623,73706,-1083,-1,61459,1692,59767,0,44390,1023,43367,0,29773,761,29012
13971,90000,72000,0,0,0,0,0,0,0,27618,9000,18618,0,26382,0,26382,0,27546,2000,25546,0,17660,0,17660
13972,120000,96000,0,0,0,0,0,1,2,68592,0,68592,2,72525,5700,66825,2,73741,3000,70741,2,72440,0,72440
13973,60000,48000,0,1,1,0,0,0,0,57284,3200,54084,0,58562,3300,55262,0,29121,1000,28121,0,27003,1100,25903
13974,210000,168000,0,0,0,0,0,0,-1,430,430,0,-1,430,430,0,-1,430,430,0,-1,430,430,0
13975,50000,40000,0,0,0,0,0,0,2,38423,3000,35423,2,37212,0,37212,2,39319,3007,36312,2,36082,7,36075
13976,130000,104000,0,0,0,0,0,0,-2,0,0,0,-2,0,0,0,-2,0,0,0,-2,0,0,0
13977,40000,32000,0,0,0,0,0,0,0,25378,5000,20378,0,28058,5000,23058,0,31145,5000,26145,0,38030,7500,30530
13978,80000,64000,0,1,0,0,0,0,0,80250,1000,79250,2,61467,600,60867,0,10662,400,10262,0,11486,1000,10486
13979,100000,80000,0,0,0,0,0,0,2,26352,0,26352,2,33871,8000,25871,2,33192,0,33192,2,35637,3000,32637
13980,360000,288000,0,0,0,0,0,1,3,2504,0,2504,2,1878,0,1878,0,1252,0,1252,0,626,0,626
13981,30000,24000,0,1,1,0,1,0,0,29224,2000,27224,0,26692,1527,25165,0,18466,1600,16866,0,29824,1000,28824
13982,30000,24000,0,0,0,0,0,1,2,7347,2000,5347,0,8024,800,7224,0,7751,0,7751,2,9607,2000,7607
13983,320000,256000,0,0,0,0,0,0,-1,200,400,-200,-1,0,0,0,-1,10000,10000,0,-1,210000,200000,10000
13984,310000,248000,0,0,0,0,0,0,0,119953,6000,113953,0,119583,5005,114578,0,120837,5000,115837,0,99114,4000,95114
13985,80000,64000,0,1,1,0,0,0,0,79821,3600,76221,0,79308,10002,69306,0,52172,1754,50418,0,50266,1765,48501
13986,60000,48000,0,0,0,0,0,1,0,12853,2090,10763,0,12352,0,12352,2,12703,700,12003,0,13338,1000,12338
13987,100000,80000,0,0,0,0,1,0,0,78265,4000,74265,0,82808,8000,74808,0,83869,4000,79869,0,85191,3500,81691
13988,60000,48000,0,0,0,0,0,0,-1,8373,8373,0,-1,7565,7565,0,-1,7565,7565,0,-1,7565,7565,0
13989,50000,40000,0,0,0,0,1,0,-1,780,780,0,-1,390,390,0,-1,42958,42958,0,-1,44849,3500,41349
13990,30000,24000,0,0,0,0,0,0,0,390,390,0,-1,390,390,0,-1,780,780,0,-1,780,0,780
13991,430000,344000,0,0,0,0,0,0,-1,23547,23547,0,-1,5064,5064,0,-1,13258,13258,0,-1,2249,2249,0
13992,170000,136000,0,0,0,0,0,0,-1,0,0,0,-2,467,467,0,-1,203,203,0,-1,0,0,0
13993,210000,168000,0,0,0,0,0,0,-1,588,588,0,-1,1488,1488,0,-1,609,609,0,-1,768,768,0
13994,340000,272000,0,0,0,0,0,1,0,330510,312723,17787,0,272220,9748,262472,0,269629,9800,259829,0,266723,9569,257154
13995,210000,168000,0,0,0,0,0,1,-2,0,0,0,-2,0,0,0,-2,0,0,0,-2,0,0,0
13996,520000,416000,0,0,0,0,0,0,-2,19046,19058,-12,-2,7359,7387,-28,-2,16336,16475,-139,-2,20040,20040,0
13997,20000,16000,0,0,0,0,0,0,0,6687,1262,5425,0,5165,1101,4064,0,5060,2180,2880,0,2180,0,2180
13998,80000,64000,0,0,0,0,0,0,-1,466,466,0,-1,628,628,0,-1,2395,2395,0,-1,930,0,930
13999,220000,176000,0,0,0,0,0,0,0,10542,1147,9395,0,10903,508,10395,0,10981,374,10607,0,9931,384,9547
14000,140000,112000,0,1,0,0,0,0,0,135820,5820,130000,0,84829,3829,81000,0,86753,3753,83000,0,88808,3808,85000
14001,190000,152000,0,1,0,0,0,1,0,182680,8382,174298,0,154753,10221,144532,0,90540,10000,80540,0,92248,3000,89248
14002,430000,344000,0,1,1,0,0,0,0,434836,18016,416820,0,378571,16005,362566,0,228568,9005,219563,0,232668,9013,223655
14003,330000,264000,0,0,0,0,0,0,-2,0,0,0,-2,0,0,0,-2,29221,29221,0,-2,3194,3194,0
14004,270000,216000,0,0,0,0,0,0,0,121106,4275,116831,0,118269,4054,114215,0,120737,4191,116546,0,123227,4302,118925
14005,200000,160000,0,0,0,0,0,0,0,64594,3000,61594,0,65070,1367,63703,0,20478,475,20003,0,13737,344,13393
14006,150000,120000,0,0,0,0,0,0,-1,0,0,0,-1,0,0,0,-2,0,0,0,-2,1500,1500,0
14007,260000,208000,0,0,0,0,0,0,0,130398,5000,125398,0,134075,5035,129040,0,130448,5000,125448,0,134477,5097,129380
14008,410000,328000,0,0,0,0,0,0,-2,7259,8036,-777,-2,8430,8542,-112,-2,5130,5155,-25,-2,5064,5089,-25
14009,50000,40000,0,0,0,0,0,1,0,12186,1206,10980,0,13280,1300,11980,0,14055,1000,13055,0,14428,600,13828
14010,20000,16000,0,1,0,0,0,0,0,20650,2000,18650,0,0,0,0,0,0,0,0,-2,0,0,0
14011,50000,40000,0,0,0,0,0,0,0,0,500,-500,0,0,0,0,-2,0,0,0,-2,0,0,0
14012,310000,248000,0,0,0,0,0,0,-2,3500,6000,-2500,-2,159028,159028,0,-1,162372,5899,156473,0,165588,5921,159667
14013,240000,192000,0,0,0,0,0,0,0,12211,2550,9661,0,13828,2167,11661,0,11337,1000,10337,0,11577,389,11188
14014,20000,16000,0,1,1,1,1,0,2,19057,2260,16797,2,18453,0,18453,2,19755,1600,18155,2,19288,0,19288
14015,230000,184000,0,0,0,0,0,1,-1,0,0,0,-2,0,0,0,-2,0,0,0,-2,0,0,0
14016,80000,64000,0,0,0,0,0,1,2,31250,0,31250,2,34109,3711,30398,2,34802,1550,33252,2,34108,0,34108
14017,60000,48000,0,0,0,0,0,1,2,27725,3300,24425,2,26981,0,26981,2,28921,2400,26521,2,29506,1200,28306
14018,360000,288000,0,0,0,0,0,0,-1,390,390,0,-1,390,390,0,-1,390,390,0,-1,390,390,0
14019,200000,160000,0,0,0,0,0,0,-2,500,500,0,-1,0,0,0,-1,0,0,0,-2,0,0,0
14020,120000,96000,0,0,0,0,0,0,0,58417,3000,55417,0,49050,2000,47050,0,49722,2000,47722,0,48898,2000,46898
14021,110000,88000,0,1,0,0,0,0,0,100475,4244,96231,0,48409,1837,46572,0,47693,1713,45980,0,49018,2100,46918
14022,50000,40000,0,0,0,0,0,0,0,41532,2124,39408,0,18646,646,18000,0,19183,828,18355,0,19214,1097,18117
14023,180000,144000,0,0,0,0,0,0,0,25631,1416,24215,0,23609,2150,21459,0,24529,1500,23029,0,25095,1000,24095
14024,360000,288000,0,0,0,0,0,0,-1,0,0,0,-1,617,617,0,-1,617,0,617,0,0,0,0
14025,500000,400000,0,0,0,0,0,0,-2,179618,5066,174552,-2,152069,5145,146924,-2,110763,5145,105618,-2,69267,5117,64150
14026,230000,184000,0,0,0,0,0,1,-1,0,0,0,-1,0,0,0,-2,4135,4135,0,-1,814,0,814
14027,160000,128000,0,0,0,0,0,1,0,77346,3400,73946,0,78921,3458,75463,0,83303,6300,77003,0,81852,0,81852
14028,50000,40000,0,0,0,0,0,0,0,18478,1147,17331,0,10279,348,9931,0,10646,512,10134,0,10776,435,10341
14029,10000,8000,0,0,0,0,0,1,-1,0,0,0,-1,0,0,0,-2,0,0,0,-2,0,0,0
14030,130000,104000,0,0,0,0,0,1,-2,0,0,0,-2,0,0,0,-2,1170,1170,0,-1,0,0,0
14031,120000,96000,0,0,0,0,0,0,0,50473,5024,45449,0,45087,5000,40087,0,35424,5000,30424,0,31760,4000,27760
14032,200000,160000,0,1,0,0,0,0,0,189524,7108,182416,0,167163,7680,159483,0,146975,6200,140775,0,122324,5000,117324
14033,90000,72000,0,0,0,0,0,0,-1,2422,2422,0,-1,1051,0,1051,0,1051,1051,0,-1,83573,83573,0
14034,100000,80000,0,1,1,1,1,0,0,94192,3503,90689,0,95535,4000,91535,0,97945,4003,93942,0,93412,3500,89912
14035,120000,96000,0,1,1,0,0,1,-1,120047,4065,115982,0,100637,4000,96637,0,79613,3000,76613,0,79286,3000,76286
14036,30000,24000,0,0,0,0,0,0,0,17240,3000,14240,0,19934,3000,16934,0,22441,3000,19441,0,24899,3000,21899
14037,110000,88000,0,0,0,0,0,0,-1,66102,3114,62988,0,54275,4016,50259,0,51791,2000,49791,0,52928,2000,50928
14038,200000,160000,0,0,0,0,0,0,-2,2786,2844,-58,-1,0,0,0,-1,116,116,0,-2,0,0,0
14039,20000,16000,0,1,1,1,1,1,2,17796,1325,16471,0,18729,1258,17471,0,19049,1373,17676,0,17300,0,17300
14040,80000,64000,0,0,0,0,0,0,0,49311,0,49311,2,52584,4100,48484,2,53589,2000,51589,2,54748,2200,52548
14041,130000,104000,0,0,0,0,0,0,0,22389,1598,20791,0,22535,744,21791,0,24236,2000,22236,0,20246,744,19502
14042,250000,200000,0,0,0,0,0,0,0,157088,8300,148788,0,136787,5200,131587,0,139385,5500,133885,0,122947,5000,117947
14043,350000,280000,0,0,0,0,0,0,-1,722,722,0,-1,867,867,0,-1,1150,1150,0,-1,5263,5263,0
14044,120000,96000,0,0,0,0,0,0,-2,7817,7832,-15,-2,416,416,0,-2,270,270,0,-2,0,0,0
14045,110000,88000,0,0,0,0,0,1,2,89555,3800,85755,2,87410,3000,84410,2,85576,3100,82476,2,84021,3000,81021
14046,360000,288000,0,0,0,0,0,0,-2,-11,0,-11,-2,-11,0,-11,-2,-11,0,-11,-2,2339,2350,-11
14047,50000,40000,0,0,0,0,0,0,-2,390,390,0,-2,390,390,0,-2,390,390,0,-2,0,0,0
14048,50000,40000,0,0,0,0,0,0,0,20094,1641,18453,0,19559,1600,17959,0,16795,600,16195,0,17233,1000,16233
14049,100000,80000,0,0,0,0,0,0,-1,1782,1794,-12,-1,1338,1338,0,-1,768,768,0,-1,2643,2643,0
14050,100000,80000,0,0,0,0,0,0,2,8101,1500,6601,0,8235,565,7670,0,34087,36252,-2165,-1,34749,1500,33249
14051,20000,16000,0,0,0,0,0,0,-1,-620,0,-620,-2,-1400,0,-1400,-2,0,1400,-1400,-2,0,0,0
14052,80000,64000,0,0,0,0,0,0,0,57761,2100,55661,0,58707,2100,56607,0,56220,2100,54120,0,60463,5500,54963
14053,250000,200000,0,0,0,0,0,0,-2,24502,25000,-498,-2,25016,15167,9849,-2,33754,80000,-46246,-2,4418,5000,-582
14054,240000,192000,0,0,0,0,0,0,0,26654,2000,24654,0,28065,2000,26065,0,29503,2000,27503,0,32042,3000,29042
14055,20000,16000,0,0,0,0,0,0,2,14331,902,13429,2,12495,500,11995,2,12787,500,12287,0,13583,1000,12583
14056,90000,72000,0,1,0,0,0,0,0,89964,4022,85942,0,29802,686,29116,0,29174,753,28421,0,26111,740,25371
14057,20000,16000,0,0,0,0,0,0,0,600,600,0,0,1040,1040,0,-1,0,800,-800,-1,0,0,0
14058,160000,128000,0,0,0,0,0,0,-2,0,0,0,-2,0,0,0,-2,0,0,0,-2,0,0,0
14059,500000,400000,0,0,0,0,0,0,0,77726,3000,74726,0,79494,4000,75494,0,83150,5000,78150,0,85805,4000,81805
14060,230000,184000,0,0,0,0,0,0,-1,660,660,0,-1,660,660,0,-1,660,660,0,-1,660,660,0
14061,430000,344000,0,0,0,0,0,0,0,0,0,0,0,18518,18518,0,-1,16574,5,16569,0,12215,244,11971
14062,50000,40000,0,0,0,0,0,0,0,4600,1000,3600,0,2300,2300,0,-1,0,0,0,-1,0,0,0
14063,130000,104000,0,0,0,0,0,1,0,0,0,0,0,0,0,0,-2,0,0,0,-2,0,0,0
14064,50000,40000,0,0,0,0,0,0,0,28628,1519,27109,0,19502,1035,18467,0,1971,296,1675,0,7538,20300,-12762
14065,180000,144000,0,0,0,0,0,1,-1,0,0,0,-1,0,0,0,-2,0,0,0,-2,0,0,0
14066,400000,320000,0,0,0,0,0,0,-1,471,471,0,-1,-203,203,-406,-1,2371,2574,-203,-2,1949,1949,0
14067,340000,272000,0,0,0,0,0,0,0,259489,150000,109489,0,328507,90168,238339,0,283758,25001,258757,0,273018,10000,263018
14068,230000,184000,0,0,0,0,0,1,0,176457,5603,170854,0,125552,4187,121365,0,127993,4327,123666,0,112107,5237,106870
14069,200000,160000,0,0,0,0,0,0,0,7737,9189,-1452,-1,8586,8586,0,-1,4291,4291,0,-1,52605,52605,0
14070,90000,72000,0,1,1,1,1,0,2,79872,2200,77672,3,80662,2700,77962,3,80740,2000,78740,3,83275,4000,79275
14071,40000,32000,0,0,0,0,0,1,0,8961,1196,7765,0,3090,1000,2090,0,390,1950,-1560,-1,795,795,0
14072,320000,256000,0,0,0,0,0,0,0,18262,0,18262,2,18157,1000,17157,0,19043,2000,17043,0,17759,0,17759
14073,30000,24000,0,0,0,0,1,0,0,16084,2000,14084,0,4432,2000,2432,0,24621,26100,-1479,-1,25073,1000,24073
14074,120000,96000,0,0,0,0,0,0,-2,0,0,0,-2,0,0,0,-2,197,197,0,-1,0,0,0
14075,160000,128000,0,0,0,0,0,0,0,38512,2000,36512,0,19129,1604,17525,0,15525,2000,13525,0,11146,11146,0
14076,60000,48000,0,1,0,0,0,0,-1,56317,1126,55191,0,0,0,0,0,0,0,0,-2,567,567,0
14077,120000,96000,0,0,0,0,0,1,2,12591,0,12591,2,17366,5000,12366,0,22064,5000,17064,0,21432,0,21432
14078,50000,40000,0,0,0,0,0,1,0,0,0,0,-2,0,0,0,-2,0,0,0,-2,0,0,0
14079,90000,72000,0,0,0,0,0,1,0,46812,3970,42842,0,44976,2500,42476,0,46406,2500,43906,0,47625,2500,45125
14080,20000,16000,0,0,0,0,0,0,2,15040,2040,13000,2,14174,0,14174,2,14472,526,13946,0,14763,532,14231
14081,50000,40000,0,0,0,0,0,0,0,25381,1669,23712,0,9652,330,9322,0,9464,1342,8122,0,9248,330,8918
14082,450000,360000,0,0,0,0,0,0,-2,0,0,0,-2,0,0,0,-2,0,0,0,-2,0,0,0
14083,260000,208000,0,0,0,0,0,0,0,31619,1403,30216,0,22020,1642,20378,0,22040,1053,20987,0,23061,2000,21061
14084,210000,168000,0,0,0,0,0,0,0,18796,3000,15796,0,117846,100004,17842,0,118877,4000,114877,0,121476,3687,117789
14085,30000,24000,0,0,0,0,0,0,0,18782,0,18782,2,19006,742,18264,0,19637,1000,18637,0,21251,2000,19251
14086,160000,128000,0,0,0,0,0,0,0,37847,2500,35347,0,37837,1300,36537,0,37637,0,37637,0,0,0,0
14087,100000,80000,0,0,0,0,0,0,-2,-342,0,-342,-2,-342,0,-342,-2,1158,1500,-342,-1,2485,1500,985
14088,340000,272000,0,0,0,0,0,0,0,259651,25118,234533,0,243094,20085,223009,0,223907,10041,213866,0,216912,8184,208728
14089,80000,64000,0,0,0,0,0,1,2,36198,2000,34198,0,37094,1500,35594,0,38489,2000,36489,0,40341,2500,37841
14090,30000,24000,0,0,0,0,0,0,2,1170,1100,70,0,780,0,780,0,390,0,390,0,150,150,0
14091,250000,200000,0,0,0,0,0,0,-1,1222,1222,0,-1,7337,7409,-72,-1,0,0,0,-1,2752,2752,0
14092,100000,80000,0,1,1,1,1,1,0,99504,0,99504,2,94453,3400,91053,0,99711,6800,92911,0,97944,0,97944
14093,20000,16000,0,1,0,0,0,0,0,19534,10,19524,2,16467,577,15890,0,15746,430,15316,0,13246,1017,12229
14094,180000,144000,0,0,0,0,0,0,0,136942,30023,106919,0,114632,10024,104608,0,117808,10000,107808,0,120302,4458,115844
14095,30000,24000,0,1,1,1,1,1,0,29179,2000,27179,0,30146,1500,28646,0,26371,933,25438,0,27567,2000,25567
14096,500000,400000,0,0,0,0,0,0,0,54927,4927,50000,0,57972,3972,54000,0,60224,3224,57000,0,71198,11980,59218
14097,120000,96000,0,0,0,0,0,1,0,69676,3234,66442,0,44879,1448,43431,0,43532,1400,42132,0,44467,1400,43067
14098,50000,40000,0,0,0,0,0,0,0,0,0,0,0,0,0,0,-2,0,0,0,-2,0,0,0
14099,90000,72000,0,0,0,0,0,0,0,53817,2600,51217,0,54818,2500,52318,0,55985,2200,53785,0,57398,2500,54898
14100,80000,64000,0,0,0,0,0,0,2,1646,1700,-54,-1,3266,2000,1266,0,380,380,0,-1,1951,1951,0
14101,160000,128000,0,0,0,0,0,0,-1,5175,5175,0,-1,2475,2475,0,-1,3975,3975,0,-1,8175,8175,0
14102,250000,200000,1,1,1,1,1,0,0,263493,9637,253856,0,268861,9765,259096,0,274444,10021,264423,0,290235,20300,269935
14103,280000,224000,0,0,0,0,0,0,0,223180,11000,212180,0,237301,20000,217301,0,201226,10000,191226,0,207802,10000,197802
14104,50000,40000,0,1,1,0,0,1,2,46153,2010,44143,0,45284,1807,43477,0,23653,812,22841,0,20733,743,19990
14105,80000,64000,0,0,0,0,0,0,-2,317,317,0,-1,317,0,317,2,1521,1204,317,2,1204,0,1204
14106,20000,16000,0,0,0,0,0,1,2,10730,900,9830,2,12241,2000,10241,2,11748,0,11748,2,12456,900,11556
14107,10000,8000,0,0,0,0,0,0,0,8827,1300,7527,0,5622,1250,4372,0,5877,500,5377,0,7036,1255,5781
14108,210000,168000,0,0,0,0,0,0,0,50283,3069,47214,0,159231,110017,49214,0,155342,5496,149846,0,156769,6307,150462
14109,100000,80000,0,0,0,0,0,0,0,22573,2000,20573,0,23596,1400,22196,0,24068,863,23205,0,24679,1000,23679
14110,220000,176000,0,0,0,0,0,1,2,2500,0,2500,2,2500,0,2500,2,2500,0,2500,2,2500,0,2500
14111,160000,128000,0,1,1,1,0,0,0,158160,6700,151460,0,156314,5000,151314,0,145663,5049,140614,0,113486,3825,109661
14112,10000,8000,0,1,1,1,1,0,2,9608,0,9608,2,9639,1200,8439,0,9985,500,9485,0,11084,1400,9684
14113,110000,88000,0,0,0,0,0,0,0,18145,1500,16645,0,17729,1200,16529,0,17239,467,16772,0,10231,400,9831
14114,70000,56000,0,0,0,0,0,1,0,41549,2000,39549,0,31966,1500,30466,0,31071,1200,29871,0,30476,1500,28976
14115,40000,32000,0,1,1,1,0,0,0,40370,1400,38970,0,39970,0,39970,0,39970,0,39970,0,0,0,0
14116,60000,48000,0,0,0,0,0,0,0,38313,2300,36013,0,28660,1700,26960,0,31398,10000,21398,0,9966,1200,8766
14117,160000,128000,0,1,1,1,1,0,2,157804,6000,151804,0,157478,7217,150261,0,156098,6000,150098,0,156659,6000,150659
14118,410000,328000,0,0,0,0,0,0,-1,10513,10513,0,-1,9137,9137,0,-1,7781,7781,0,-1,28870,28870,0
14119,70000,56000,0,1,1,0,0,0,0,67243,2777,64466,0,67533,1751,65782,0,28653,969,27684,0,29253,1004,28249
14120,20000,16000,0,0,0,0,0,0,-1,2430,2430,0,-1,850,850,0,-1,2430,2430,0,-1,2530,2530,0
14121,160000,128000,0,0,0,0,0,0,0,99864,4000,95864,0,101900,3699,98201,0,103924,3719,100205,0,106101,3851,102250
14122,50000,40000,0,0,0,0,0,0,-2,-1,0,-1,-2,-1,0,-1,-2,-1,0,-1,-2,349,350,-1
14123,20000,16000,0,0,0,0,0,1,-2,0,0,0,-2,0,0,0,-2,0,0,0,-2,0,0,0
14124,610000,488000,0,0,0,0,0,0,0,413942,8000,405942,2,420120,16385,403735,0,427886,16000,411886,0,437131,16000,421131
14125,110000,88000,0,0,0,0,0,1,2,81753,30,81723,2,84368,7000,77368,2,80262,2600,77662,2,80529,3500,77029
14126,50000,40000,0,1,1,0,0,0,0,50795,2193,48602,0,50150,2040,48110,0,9658,330,9328,0,10011,492,9519
14127,20000,16000,0,0,1,0,1,0,0,16660,3200,13460,0,16100,0,16100,2,17521,2000,15521,0,19237,2000,17237
14128,240000,192000,0,0,0,0,0,0,-1,12104,12104,0,-1,2788,2788,0,-1,4084,4084,0,-1,3288,3288,0
14129,20000,16000,0,0,0,1,1,0,0,16392,2000,14392,0,17789,2000,15789,0,18238,1000,17238,0,17638,800,16838
14130,300000,240000,0,0,0,0,0,0,-1,0,0,0,-1,462,462,0,-1,0,0,0,-1,3069,3069,0
14131,60000,48000,0,0,0,0,0,0,0,28574,1516,27058,0,29059,1391,27668,0,29244,966,28278,0,29462,997,28465
14132,150000,120000,0,0,0,0,0,0,-1,3664,3735,-71,-1,1461,1461,0,-1,2348,2348,0,-1,3626,3626,0
14133,150000,120000,0,0,0,0,0,0,0,50683,2014,48669,0,46602,1599,45003,0,40599,2014,38585,0,37192,2018,35174
14134,50000,40000,0,0,0,0,0,0,2,19590,1200,18390,0,18861,477,18384,0,4581,121,4460,0,2158,22,2136
14135,170000,136000,0,0,0,0,0,0,0,81703,3000,78703,0,66496,4710,61786,0,36000,1500,34500,0,25167,1000,24167
14136,200000,160000,0,0,0,0,0,0,-1,5455,5481,-26,-1,26975,27110,-135,-1,8734,29889,-21155,-1,10756,10809,-53
14137,360000,288000,0,0,0,0,0,0,-1,9251,9297,-46,-1,18860,18954,-94,-1,-40,0,-40,-1,-40,0,-40
14138,20000,16000,0,0,0,0,0,0,-1,-1500,0,-1500,-2,780,2280,-1500,-1,0,0,0,-1,0,0,0
14139,200000,160000,0,0,0,0,0,1,-1,660,660,0,-1,2315,2315,0,-1,1290,1290,0,-1,5745,5745,0
14140,70000,56000,0,1,1,1,1,1,2,71020,3008,68012,2,67338,0,67338,2,70769,5100,65669,2,68957,2600,66357
14141,60000,48000,0,1,1,0,0,0,0,59869,3869,56000,0,59942,2742,57200,0,28934,1200,27734,0,27461,1461,26000
14142,100000,80000,0,0,0,0,0,0,-1,0,0,0,-2,0,0,0,-2,0,0,0,-2,0,0,0
14143,90000,72000,0,1,0,0,0,0,0,78594,4300,74294,0,39209,2700,36509,0,40057,1500,38557,0,40744,1400,39344
14144,210000,168000,0,0,0,0,0,0,-2,54832,54832,0,-2,2233,2351,-118,-2,0,0,0,-2,0,0,0
14145,30000,24000,0,0,0,0,0,1,-1,6991,6998,-7,-1,17176,17186,-10,-1,8053,8054,-1,-1,10363,10375,-12
14146,390000,312000,0,1,1,0,0,0,0,359292,13705,345587,0,348513,15454,333059,0,272077,144206,127871,0,225079,9000,216079
14147,20000,16000,0,0,0,0,0,0,-1,1758,1500,258,0,3720,3720,0,-1,3820,100,3720,0,0,0,0
14148,50000,40000,0,1,0,0,0,1,0,41707,1456,40251,0,29358,1200,28158,0,29860,1100,28760,0,30461,1076,29385
14149,240000,192000,1,1,1,0,0,1,0,256740,12000,244740,0,246364,5700,240664,0,127177,3200,123977,0,33622,1200,32422
14150,310000,248000,0,0,0,0,0,0,0,103601,4500,99101,0,102895,4348,98547,0,101017,3407,97610,0,95530,4000,91530
14151,30000,24000,0,1,0,0,0,0,0,26386,1450,24936,0,9370,1010,8360,0,7290,500,6790,0,0,0,0
14152,150000,120000,0,0,0,0,0,0,0,86961,5050,81911,0,79284,3026,76258,0,74531,5000,69531,0,78359,5012,73347
14153,200000,160000,0,0,0,0,0,1,-2,0,0,0,-2,0,0,0,-2,0,0,0,-2,0,0,0
14154,20000,16000,0,1,0,0,0,0,0,19347,1005,18342,0,8007,160,7847,0,4890,98,4792,0,0,0,0
14155,200000,160000,0,0,0,0,0,0,-1,10373,7,10366,2,2669,0,2669,2,1024,6177,-5153,-1,170722,180722,-10000
14156,50000,40000,0,0,0,0,0,0,2,32092,1833,30259,0,32581,1322,31259,0,33897,2000,31897,0,34691,1358,33333
14157,180000,144000,0,0,0,0,0,1,-2,0,0,0,-2,0,0,0,-2,0,0,0,-2,0,0,0
14158,20000,16000,0,0,0,0,0,0,-1,0,0,0,-2,0,0,0,-2,0,0,0,-2,0,0,0
14159,50000,40000,0,1,1,1,1,0,2,50498,3900,46598,2,47579,0,47579,2,47567,2000,45567,0,48155,1900,46255
14160,300000,240000,0,0,0,0,0,0,0,0,0,0,0,0,0,0,-2,0,0,0,-2,0,0,0
14161,20000,16000,0,0,0,0,0,1,-1,416,416,0,-1,416,416,0,-1,416,416,0,-1,982,982,0
14162,20000,16000,0,1,0,0,0,0,0,18929,1384,17545,0,14900,615,14285,0,10400,600,9800,0,0,0,0
14163,300000,240000,0,0,0,0,0,1,-1,148,148,0,-1,148,148,0,-1,148,148,0,-1,0,0,0
14164,90000,72000,0,0,0,0,0,1,0,15482,1500,13982,0,18219,3000,15219,0,22737,5000,17737,0,23387,1020,22367
14165,100000,80000,0,0,0,0,0,0,0,45522,3000,42522,0,46832,2500,44332,0,37683,2000,35683,0,28680,2000,26680
14166,280000,224000,0,0,0,0,0,0,2,10660,2053,8607,0,4191,4211,-20,-1,1671,2001,-330,-1,105726,105747,-21
14167,50000,40000,0,1,1,1,1,1,3,48268,0,48268,2,49075,2000,47075,0,49475,1000,48475,0,48575,1000,47575
14168,360000,288000,0,0,0,0,0,0,-1,41262,41285,-23,-1,8882,8882,0,-1,17348,17348,0,-1,29216,29216,0
14169,210000,168000,0,0,0,0,0,0,-2,0,0,0,-2,0,0,0,-2,0,0,0,-2,0,0,0
14170,150000,120000,0,0,0,0,0,0,-2,7351,7424,-73,-2,1279,1279,0,-2,0,0,0,-2,0,0,0
14171,150000,120000,0,0,0,0,0,0,-1,135090,66066,69024,0,80085,2031,78054,0,35940,35940,0,-1,38460,38460,0
14172,170000,136000,0,0,0,0,0,1,0,98196,3600,94596,0,100108,3500,96608,0,95629,3500,92129,0,89472,3300,86172
14173,370000,296000,0,0,0,0,0,0,-1,234379,8409,225970,0,239082,8500,230582,0,244124,8800,235324,0,243986,8800,235186
14174,340000,272000,0,0,0,0,0,0,0,128079,6706,121373,0,64598,3003,61595,0,12014,241,11773,0,710,712,-2
14175,50000,40000,0,0,0,0,0,0,-2,0,0,0,-2,0,0,0,-2,0,0,0,-2,0,0,0
14176,140000,112000,0,0,0,0,0,0,0,9032,9032,0,-1,0,0,0,-1,0,0,0,-2,0,0,0
14177,400000,320000,0,0,0,0,0,0,0,53291,3000,50291,0,57265,5000,52265,0,61035,5000,56035,0,64879,5000,59879
14178,10000,8000,0,1,1,1,1,1,0,9473,7,9466,2,8947,308,8639,0,9135,320,8815,0,8613,328,8285
14179,260000,208000,0,1,0,0,0,0,0,266858,10000,256858,0,194413,5731,188682,0,189687,5654,184033,0,162473,5275,157198
14180,120000,96000,0,0,0,0,0,0,0,73326,3505,69821,0,72594,3005,69589,0,72008,3008,69000,0,74622,7253,67369
14181,150000,120000,0,0,0,0,0,0,0,26219,1619,24600,0,17705,2550,15155,0,17920,800,17120,2,17494,0,17494
14182,50000,40000,0,1,1,1,1,1,0,49140,2525,46615,0,49423,3900,45523,0,48377,0,48377,2,48158,2000,46158
14183,160000,128000,0,0,0,0,0,0,0,-890,0,-890,-2,-890,0,-890,-2,-890,0,-890,-2,-890,0,-890
14184,230000,184000,0,0,0,0,0,0,0,24092,5000,19092,0,65840,65840,0,-1,56538,2000,54538,0,51522,2000,49522
14185,100000,80000,0,0,0,0,1,0,0,74709,3324,71385,0,76143,4220,71923,0,73327,2728,70599,0,147496,2800,144696
14186,100000,80000,0,0,0,0,0,0,-1,2279,2279,0,-1,1796,1730,66,0,466,466,0,-1,466,466,0
14187,130000,104000,0,0,0,0,0,0,-2,0,0,0,-2,0,0,0,-2,0,0,0,-2,0,0,0
14188,460000,368000,0,0,0,0,0,0,-1,224526,224850,-324,-1,227242,5000,222242,0,228126,4593,223533,0,143697,23584,120113
14189,20000,16000,0,0,0,1,1,0,0,16024,1267,14757,0,16345,588,15757,0,17579,1500,16079,0,18750,1500,17250
14190,360000,288000,0,0,0,0,0,0,-2,0,0,0,-2,0,0,0,-2,0,0,0,-2,239,239,0
14191,80000,64000,0,0,0,0,0,0,-1,4695,4695,0,-1,390,390,0,-1,1289,1289,0,-1,935,935,0
14192,30000,24000,0,0,0,0,0,0,-1,890,2390,-1500,-1,0,0,0,-1,750,750,0,-1,0,0,0
14193,100000,80000,0,0,0,0,0,1,0,49954,1830,48124,0,50974,1850,49124,0,52021,1894,50127,0,53186,2000,51186
14194,200000,160000,0,0,0,0,0,0,0,0,0,0,-2,0,0,0,-2,0,0,0,-2,0,0,0
14195,100000,80000,0,0,0,0,0,0,0,2377,2377,0,-1,0,40000,-40000,-1,0,0,0,-2,0,0,0
14196,260000,208000,0,0,0,0,0,0,0,150917,7500,143417,0,152447,6000,146447,0,123771,4300,119471,0,126472,4500,121972
14197,210000,168000,0,0,0,0,0,0,-1,291,291,0,-1,291,291,0,-1,291,291,0,-1,291,291,0
14198,220000,176000,0,0,0,0,0,0,0,97995,5419,92576,0,97577,3000,94577,2,98583,3501,95082,0,99708,3629,96079
14199,80000,64000,0,0,1,1,1,0,0,94675,83402,11273,0,90470,4000,86470,0,85449,3058,82391,0,80309,2903,77406
14200,100000,80000,0,0,0,0,0,0,-2,20000,20000,0,-2,0,0,0,-2,0,0,0,-2,0,0,0
14201,140000,112000,0,0,0,0,0,0,0,20729,5000,15729,0,15583,2000,13583,0,7218,0,7218,0,7365,147,7218
14202,60000,48000,0,1,1,0,0,0,0,59828,2800,57028,0,58217,2000,56217,0,18527,1110,17417,0,40334,40621,-287
14203,240000,192000,0,0,0,0,0,0,-2,0,0,0,-2,12700,12700,0,-1,12500,0,12500,0,26225,13725,12500
14204,70000,56000,0,0,0,0,0,0,2,27733,1500,26233,2,27982,1000,26982,2,27396,0,27396,2,28341,1400,26941
14205,170000,136000,0,0,0,0,0,1,2,113778,0,113778,2,117989,6100,111889,0,118803,4210,114593,0,121434,4500,116934
14206,40000,32000,0,0,0,0,0,1,2,16320,1500,14820,2,16456,700,15756,2,16492,600,15892,2,16086,0,16086
14207,100000,80000,0,1,0,0,0,1,2,99973,3000,96973,2,71008,103000,-31992,-1,66735,2500,64235,0,68621,3000,65621
14208,510000,408000,0,0,0,0,0,0,-2,0,0,0,-2,0,0,0,-2,0,0,0,-2,1769,1769,0
14209,50000,40000,0,0,0,0,0,0,0,13295,1000,12295,2,14126,1112,13014,0,12185,366,11819,0,8419,503,7916
14210,110000,88000,0,0,0,0,0,0,0,39584,10000,29584,0,43581,5000,38581,0,48458,6000,42458,0,17129,0,17129
14211,130000,104000,0,1,1,1,1,0,0,132026,5306,126720,0,122804,5000,117804,0,121663,5000,116663,0,122032,6000,116032
14212,400000,320000,0,0,0,0,0,0,-2,12527,12527,0,-1,12640,253,12387,0,14805,2305,12500,0,238,238,0
14213,10000,8000,0,0,0,1,1,0,2,8894,1281,7613,0,8136,1135,7001,0,8449,448,8001,0,8493,329,8164
14214,30000,24000,0,0,0,0,0,1,-1,223,223,0,-1,223,223,0,-1,223,223,0,-1,675,675,0
14215,180000,144000,0,0,0,0,0,0,-1,1300,1300,0,-1,0,0,0,-1,4689,4689,0,-1,4689,0,4689
14216,80000,64000,0,0,0,0,0,0,0,10656,2000,8656,0,11474,1000,10474,0,13117,2000,11117,0,15899,3000,12899
14217,280000,224000,0,0,0,0,0,0,-1,2928,2928,0,-1,9564,9564,0,-1,22017,22017,0,-1,5220,5220,0
14218,80000,64000,0,0,0,0,0,1,2,0,0,0,2,0,0,0,-2,0,0,0,-2,0,0,0
14219,230000,184000,0,0,0,0,0,0,0,43140,1538,41602,0,34039,1777,32262,0,26622,1160,25462,0,11891,1500,10391
14220,140000,112000,0,0,0,0,0,1,2,1420,2,1418,2,0,0,0,2,49,49,0,-1,49,0,49
14221,310000,248000,0,0,0,0,0,0,0,105687,5222,100465,0,102306,5197,97109,0,93929,4000,89929,0,87681,5000,82681
14222,200000,160000,0,0,0,0,0,0,-1,4506,4506,0,-1,10067,10137,-70,-1,9273,9521,-248,-1,2931,2931,0
14223,280000,224000,0,0,0,0,0,1,2,166749,5,166744,2,168739,5858,162881,0,166757,5741,161016,0,161777,5608,156169
14224,210000,168000,0,0,0,0,0,0,0,25200,3007,22193,0,19850,5000,14850,0,15530,1000,14530,0,13021,13021,0
14225,170000,136000,0,0,0,0,0,0,0,106657,5323,101334,0,108804,5402,103402,0,109584,4071,105513,0,111881,4215,107666
14226,20000,16000,0,1,1,1,0,1,0,17794,1444,16350,0,18550,1200,17350,0,18850,500,18350,0,0,0,0
14227,110000,88000,0,0,0,0,0,0,0,48995,2509,46486,0,46772,2031,44741,0,33220,1507,31713,0,31858,2032,29826
14228,50000,40000,0,0,0,0,0,1,2,38411,1600,36811,0,30659,1712,28947,0,30963,1016,29947,0,30505,2500,28005
14229,60000,48000,0,0,0,0,0,0,-1,9588,9700,-112,-1,18041,18064,-23,-1,14458,4016,10442,0,12710,5029,7681
14230,470000,376000,0,0,0,0,0,0,0,154424,6170,148254,0,147137,5100,142037,0,138240,4726,133514,0,125866,4555,121311
14231,180000,144000,0,0,0,0,0,0,0,96462,4300,92162,0,96846,3500,93346,0,95549,4000,91549,0,94131,4000,90131
14232,120000,96000,0,0,0,0,0,0,0,33481,3194,30287,0,28563,1200,27363,0,24065,6206,17859,0,2802,0,2802
14233,160000,128000,0,0,0,0,0,0,-1,10709,10709,0,-1,8677,1000,7677,0,4318,100,4218,0,2659,1000,1659
14234,190000,152000,0,0,0,0,0,0,0,153900,6900,147000,0,0,0,0,0,0,0,0,-2,0,0,0
14235,490000,392000,0,0,0,0,0,0,0,195022,5217,189805,0,196099,5000,191099,0,201289,5340,195949,0,86703,94762,-8059
14236,580000,464000,0,0,0,0,0,0,0,82057,2299,79758,0,27666,618,27048,0,20226,2636,17590,-1,276422,326889,-50467
14237,200000,160000,0,0,0,0,0,0,0,14918,2000,12918,0,16992,5000,11992,0,8967,2000,6967,0,8494,1000,7494
14238,120000,96000,0,1,0,0,0,0,0,101152,5000,96152,0,80503,3007,77496,0,75407,3000,72407,0,77157,3000,74157
14239,80000,64000,0,1,0,0,0,0,0,80770,4450,76320,0,53142,2249,50893,0,55064,1200,53864,0,28750,2400,26350
14240,20000,16000,0,1,1,1,1,0,0,19133,1300,17833,0,19397,678,18719,0,19702,706,18996,0,20506,2037,18469
14241,170000,136000,0,0,0,0,0,0,0,59800,3400,56400,0,20650,3000,17650,0,127601,127601,0,-1,121774,4600,117174
14242,220000,176000,0,0,0,0,0,1,-1,0,0,0,-2,0,0,0,-2,0,0,0,-2,0,0,0
14243,200000,160000,0,0,0,0,0,0,-1,605,608,-3,-1,3098,3114,-16,-1,805,1003,-198,-1,2154,2164,-10
14244,360000,288000,0,0,0,0,0,0,-1,33473,10000,23473,0,51900,20000,31900,0,30424,3003,27421,0,48646,20000,28646
14245,20000,16000,0,0,0,0,0,0,2,780,780,0,-1,390,0,390,0,12246,12246,0,-1,12409,911,11498
14246,90000,72000,0,1,1,0,0,0,0,84447,3014,81433,0,78238,3203,75035,0,68234,3000,65234,0,69684,3000,66684
14247,180000,144000,0,0,0,0,0,0,0,6570,2000,4570,0,7192,1018,6174,0,6437,6154,283,0,12499,12527,-28
14248,160000,128000,0,0,0,0,0,0,-2,2102,2118,-16,-2,5477,5477,0,-2,2258,2276,-18,-2,1849,1851,-2
14249,140000,112000,0,0,0,0,0,0,-1,7283,2000,5283,0,8577,2000,6577,0,9452,1000,8452,0,11153,2000,9153
14250,100000,80000,0,0,0,0,0,1,2,70638,3100,67538,2,71680,2800,68880,2,72705,2800,69905,2,74195,2800,71395
14251,250000,200000,0,0,0,0,0,0,0,191040,15000,176040,0,199400,10011,189389,0,206988,11214,195774,0,167607,5315,162292
14252,50000,40000,0,0,0,0,0,0,0,27240,2000,25240,0,31505,5000,26505,0,25979,2000,23979,0,25925,21000,4925
14253,280000,224000,0,0,0,0,0,1,-2,-200,0,-200,-2,-200,0,-200,-2,-200,0,-200,-2,-200,0,-200
14254,150000,120000,0,0,0,0,0,0,0,39322,2071,37251,0,40260,1591,38669,0,41458,2000,39458,0,42251,1632,40619
14255,80000,64000,0,1,0,0,0,0,0,81356,3500,77856,0,63039,3500,59539,0,64371,2500,61871,0,65650,2351,63299
14256,30000,24000,0,0,0,1,1,1,2,23217,3000,20217,0,28498,6000,22498,0,28060,1200,26860,4,29999,3000,26999
14257,180000,144000,0,0,0,0,0,1,-2,0,0,0,-2,0,0,0,-2,0,0,0,-2,0,0,0
14258,30000,24000,0,1,1,1,1,0,0,27709,1414,26295,0,27457,952,26505,0,26848,1002,25846,0,26407,832,25575
14259,220000,176000,0,0,0,0,0,0,0,46446,5008,41438,0,37604,7000,30604,0,15540,4000,11540,0,20330,5000,15330
14260,330000,264000,0,0,0,0,0,1,0,253863,0,253863,2,257535,9400,248135,0,262753,9542,253211,0,268145,9766,258379
14261,30000,24000,0,1,1,1,1,0,0,30485,3900,26585,0,30533,1700,28833,0,29148,1200,27948,0,29782,1180,28602
14262,300000,240000,0,0,0,0,0,0,-1,1438,1438,0,-1,5322,5328,-6,-1,6814,6814,0,-1,2956,114,2842
14263,450000,360000,0,0,0,0,0,0,-1,11670,11728,-58,-1,1530,1532,-2,-1,1232,1234,-2,-1,201,201,0
14264,500000,400000,0,0,0,0,0,0,0,10627,10663,-36,-1,680,680,0,-1,0,0,0,-1,0,0,0
14265,130000,104000,0,0,0,0,0,0,-1,0,0,0,-1,0,0,0,-2,0,0,0,-2,0,0,0
14266,50000,40000,0,0,0,0,0,0,-1,8845,331,8514,2,8867,317,8550,0,9074,350,8724,0,9254,331,8923
14267,200000,160000,0,0,0,0,0,1,2,19208,1303,17905,0,20023,1522,18501,0,19572,0,19572,2,19652,1099,18553
14268,20000,16000,0,1,0,0,1,0,0,17481,1323,16158,0,15572,1111,14461,0,15902,441,15461,0,35565,2158,33407
14269,30000,24000,0,1,1,0,0,0,0,29248,1694,27554,0,29254,1200,28054,0,19837,8697,11140,0,14793,2000,12793
14270,270000,216000,0,0,0,0,0,1,-2,0,0,0,-2,0,0,0,-2,0,0,0,-2,0,0,0
14271,50000,40000,0,1,0,0,0,0,0,48186,2044,46142,0,20127,3150,16977,0,18988,1000,17988,0,19942,3000,16942
14272,50000,40000,1,1,1,1,0,0,0,54587,2000,52587,2,49571,0,49571,2,50028,1809,48219,0,17159,35082,-17923
14273,50000,40000,0,0,0,0,0,0,0,16460,2000,14460,0,16888,1000,15888,0,17464,1000,16464,0,18171,1000,17171
14274,110000,88000,0,1,1,1,1,1,0,111227,3912,107315,0,110849,3888,106961,0,110575,3975,106600,0,110394,4162,106232
14275,50000,40000,0,0,0,0,0,1,0,28627,1600,27027,2,32708,4900,27808,2,31886,0,31886,2,33808,2600,31208
14276,10000,8000,0,0,1,1,0,0,0,10084,2500,7584,0,9699,6,9693,2,9699,0,9699,0,0,0,0
14277,50000,40000,0,1,0,0,0,0,0,49522,1605,47917,0,19843,397,19446,0,18440,369,18071,0,18272,365,17907
14278,620000,496000,0,0,0,0,0,0,-2,21049,21171,-122,-2,13846,13915,-69,-2,3565,3583,-18,-2,7076,7111,-35
14279,30000,24000,0,1,1,1,1,0,0,25885,1700,24185,0,26851,1900,24951,0,26808,557,26251,0,27599,1000,26599
14280,90000,72000,0,0,0,0,0,0,-2,0,0,0,-2,0,0,0,-2,0,0,0,-2,0,0,0
14281,360000,288000,0,0,0,0,0,0,-1,0,0,0,-2,2455,2455,0,-1,6447,6447,0,-1,0,0,0
14282,130000,104000,0,0,0,0,0,0,0,75900,2800,73100,0,74982,3000,71982,0,79701,6000,73701,0,81282,3000,78282
14283,500000,400000,0,0,0,0,0,0,0,35426,6664,28762,0,28479,1500,26979,0,15729,501,15228,0,7905,5000,2905
14284,30000,24000,0,0,0,0,0,1,2,10318,1200,9118,0,10522,375,10147,0,11354,1000,10354,0,11022,0,11022
14285,140000,112000,0,0,0,0,0,1,-1,1460,1460,0,-1,1460,0,1460,0,0,0,0,0,0,0,0
14286,300000,240000,0,0,0,0,0,0,-1,1269,1269,0,-1,11347,11347,0,-1,369,369,0,-1,860,860,0
14287,80000,64000,0,0,0,0,0,0,-2,0,0,0,-2,600,600,0,-1,600,0,600,4,300,0,300
14288,390000,312000,0,0,0,0,0,0,-1,2123,2133,-10,-1,2219,2230,-11,-1,1205,1209,-4,-1,3343,3365,-22
14289,200000,160000,0,0,0,0,0,0,-1,8587,8587,0,-1,7782,5314,2468,0,6987,5000,1987,0,7662,5000,2662
14290,30000,24000,0,0,0,0,0,1,3,2758,0,2758,2,20878,22000,-1122,-1,20582,4200,16382,0,19357,2000,17357
14291,50000,40000,0,1,1,1,1,0,2,45650,2000,43650,2,46320,1700,44620,2,45290,0,45290,2,48322,3760,44562
14292,10000,8000,0,0,0,0,0,1,-1,2264,1066,1198,0,3230,1032,2198,0,0,0,0,0,0,0,0
14293,30000,24000,0,1,1,1,1,1,0,28085,2073,26012,2,27344,0,27344,3,26768,0,26768,2,27454,1129,26325
14294,290000,232000,0,0,0,0,0,0,0,50453,3104,47349,0,193665,160045,33620,0,188075,4959,183116,0,162106,5201,156905
14295,240000,192000,1,1,1,1,1,0,0,471796,17389,454407,0,468202,80167,388035,0,442401,15167,427234,0,419209,16000,403209
14296,60000,48000,0,1,0,0,0,0,2,57244,7,57237,2,28853,1200,27653,0,29510,1200,28310,0,26547,1100,25447
14297,320000,256000,0,0,0,0,0,0,-2,816,824,-8,-2,30026,31144,-1118,-2,49154,25664,23490,-2,1299,2610,-1311
14298,50000,40000,0,0,0,0,0,0,0,23192,1000,22192,2,24073,1500,22573,0,21759,891,20868,0,21959,1000,20959
14299,150000,120000,0,0,0,0,0,1,2,86686,0,86686,2,78497,4800,73697,2,67612,1800,65812,2,55050,0,55050
14300,500000,400000,0,0,0,0,0,0,2,161768,7400,154368,0,164438,10000,154438,0,162050,6000,156050,0,163456,5907,157549
14301,80000,64000,0,0,0,0,0,0,-1,3550,3550,0,-1,7529,7529,0,-1,0,0,0,-1,3228,3228,0
14302,120000,96000,0,1,1,0,1,1,0,117777,4773,113004,0,119086,3776,115310,0,70013,3200,66813,0,102991,1882,101109
14303,180000,144000,0,0,0,0,0,0,-1,6028,6028,0,-1,3996,3996,0,-1,9062,9066,-4,-1,3997,3997,0
14304,140000,112000,0,1,1,1,1,1,0,140773,12602,128171,0,133147,0,133147,2,140350,12000,128350,2,136475,0,136475
14305,360000,288000,0,0,0,0,0,0,0,113438,5046,108392,0,112940,10000,102940,0,122122,10048,112074,0,121547,10043,111504
14306,10000,8000,0,0,0,0,0,1,0,390,390,0,-1,390,390,0,-1,390,390,0,-1,0,0,0
14307,350000,280000,0,0,0,0,0,0,-1,1630,1630,0,-1,7461,7461,0,-1,4124,4124,0,-1,1261,1261,0
14308,100000,80000,0,0,0,0,0,0,0,78351,5000,73351,0,79030,3006,76024,0,56016,2023,53993,0,36210,3000,33210
14309,50000,40000,0,0,0,0,0,0,-1,1068,11000,-9932,-1,1386,2000,-614,-1,2800,2000,800,-1,3696,6396,-2700
14310,210000,168000,0,0,0,0,0,0,-2,0,0,0,-2,0,0,0,-2,0,0,0,-2,0,0,0
14311,210000,168000,0,0,0,0,0,0,-1,396,396,0,-1,396,396,0,-1,1911,1911,0,-1,396,396,0
14312,200000,160000,0,0,0,0,0,0,-2,73284,73421,-137,-1,65428,1309,64119,0,65820,392,65428,0,2859,2859,0
14313,200000,160000,0,0,0,0,0,0,0,109068,4345,104723,0,112286,6000,106286,0,77062,3950,73112,0,0,0,0
14314,30000,24000,0,1,1,1,1,0,3,28312,1200,27112,2,28747,1200,27547,2,29439,1300,28139,2,29909,1100,28809
14315,80000,64000,0,1,1,0,0,0,0,70313,3000,67313,0,71636,3000,68636,0,52471,2000,50471,0,53316,2000,51316
14316,260000,208000,0,0,0,0,0,1,-2,3210,3210,0,-2,0,0,0,-2,0,0,0,-2,2712,2712,0
14317,50000,40000,0,0,0,0,0,1,0,25768,0,25768,2,26142,1100,25042,0,26771,1200,25571,0,27175,1000,26175
14318,200000,160000,0,0,0,0,0,0,-2,1585,1585,0,-2,1470,1470,0,-2,1273,1273,0,-2,1000,1000,0
14319,150000,120000,0,0,0,0,0,0,0,58228,10000,48228,0,38495,3993,34502,0,35807,15838,19969,0,24871,10000,14871
14320,20000,16000,0,0,0,0,0,1,2,8000,0,8000,2,0,0,0,2,186,186,0,-1,3314,3314,0
14321,30000,24000,0,0,0,0,0,1,2,17302,800,16502,2,17521,800,16721,2,17893,800,17093,2,18252,800,17452
14322,290000,232000,0,0,0,0,0,0,-2,1100,1100,0,-2,6000,6000,0,-2,3533,3533,0,-2,880,880,0
14323,90000,72000,0,0,0,0,0,0,-1,1473,1473,0,-1,1473,1473,0,-1,1473,1473,0,-1,1473,1473,0
14324,200000,160000,0,0,0,0,0,0,2,145374,6000,139374,2,147273,5860,141413,2,149244,6000,143244,2,151973,5000,146973
14325,500000,400000,0,0,0,0,0,0,0,5090,1000,4090,0,2043,0,2043,0,8479,8479,0,-1,236,236,0
14326,50000,40000,0,0,0,0,0,0,4,23840,0,23840,3,22790,0,22790,2,23001,1500,21501,0,24557,2100,22457
14327,80000,64000,0,0,0,0,0,1,2,4119,1200,2919,2,2705,0,2705,2,2855,1411,1444,2,1411,0,1411
14328,460000,368000,0,0,0,0,0,0,0,102350,15000,87350,0,134878,35000,99878,0,162715,30000,132715,0,203451,43451,160000
14329,70000,56000,0,0,0,0,0,0,0,47852,8808,39044,0,48538,2200,46338,0,49034,2000,47034,0,49689,2000,47689
14330,150000,120000,0,0,0,0,0,0,0,45569,3000,42569,0,46533,2000,44533,0,47653,2000,45653,0,49729,3000,46729
14331,300000,240000,0,0,0,0,0,0,0,134080,6164,127916,0,126996,6069,120927,0,127820,4425,123395,0,130325,4412,125913
14332,110000,88000,0,0,0,0,0,0,0,59977,2800,57177,0,59411,2710,56701,0,55112,5227,49885,0,45025,0,45025
14333,210000,168000,0,0,0,0,0,0,0,23251,2000,21251,0,24358,1500,22858,0,25805,2000,23805,0,27168,1800,25368
14334,180000,144000,0,0,0,0,0,0,0,5549,5549,0,-1,22349,17000,5349,0,2974,3322,-348,-1,0,0,0
14335,150000,120000,0,0,0,0,0,0,-2,0,0,0,-2,0,0,0,-2,0,0,0,-2,0,0,0
14336,190000,152000,0,0,0,0,0,0,-2,-3000,0,-3000,-2,-3000,0,-3000,-2,-3000,0,-3000,-2,-3000,0,-3000
14337,430000,344000,0,0,0,0,0,0,-2,6698,6698,0,-2,2104,2104,0,-2,888,888,0,-2,888,888,0
14338,80000,64000,0,1,1,1,1,0,0,81229,4300,76929,0,82456,3340,79116,0,82854,3500,79354,0,80868,2999,77869
14339,50000,40000,0,0,0,0,0,1,2,34394,300,34094,2,36509,3000,33509,2,37105,1500,35605,2,37866,1500,36366
14340,160000,128000,0,0,0,0,0,0,0,97629,3676,93953,0,100398,3637,96761,0,102606,3000,99606,0,104864,3040,101824
14341,30000,24000,0,1,1,0,0,0,0,27369,2200,25169,0,25111,790,24321,0,22235,922,21313,0,19000,663,18337
14342,120000,96000,0,0,0,0,0,0,-2,-33,0,-33,-2,-33,0,-33,-2,-33,0,-33,-2,-33,0,-33
14343,180000,144000,0,0,0,0,0,0,0,130598,5004,125594,0,98336,3416,94920,0,86862,3074,83788,0,88618,3500,85118
14344,50000,40000,0,0,0,0,0,0,0,41535,5000,36535,0,36973,3000,33973,0,39581,4000,35581,0,41817,5000,36817
14345,40000,32000,0,0,0,0,0,0,2,28347,0,28347,2,30561,3000,27561,2,29770,0,29770,2,31666,2382,29284
14346,200000,160000,0,0,0,0,0,0,0,73816,3000,70816,0,79033,6500,72533,0,79539,3013,76526,0,80584,5000,75584
14347,100000,80000,0,0,0,0,0,0,-2,0,0,0,-2,0,0,0,-2,0,0,0,-2,0,0,0
14348,30000,24000,0,0,0,0,0,1,2,20460,1000,19460,2,19836,0,19836,2,20266,900,19366,0,21568,1800,19768
14349,200000,160000,0,0,0,0,0,0,0,23532,2023,21509,0,23632,5060,18572,0,12852,1549,11303,0,5799,3029,2770
14350,120000,96000,0,0,0,0,0,0,0,51786,3000,48786,0,43180,3000,40180,0,41469,4000,37469,0,42004,4000,38004
14351,50000,40000,0,0,0,0,0,1,0,22538,0,22538,2,22864,1000,21864,0,23495,1000,22495,0,24100,1000,23100
14352,90000,72000,0,0,0,0,0,0,0,7635,1115,6520,0,8020,500,7520,0,8403,500,7903,0,9504,1252,8252
14353,240000,192000,0,1,1,0,0,1,0,234557,9010,225547,0,200643,7400,193243,0,194410,8000,186410,0,198857,8000,190857
14354,50000,40000,0,1,1,0,0,1,0,50036,2142,47894,0,60770,2254,58516,0,10598,680,9918,0,10122,491,9631
14355,30000,24000,0,1,0,0,0,1,2,29088,4,29084,2,26788,2916,23872,2,17014,106,16908,2,3000,3000,0
14356,220000,176000,0,0,0,0,0,0,0,57675,25000,32675,0,75892,25000,50892,0,49548,10000,39548,0,35530,10000,25530
14357,200000,160000,0,0,0,0,0,1,-1,0,0,0,-1,0,0,0,-2,1000,1000,0,-1,1000,1000,0
14358,80000,64000,0,0,0,0,0,0,0,59040,2540,56500,0,49555,1566,47989,0,38185,1485,36700,0,32582,1258,31324
14359,16000,12800,1,1,1,1,1,0,0,26965,3000,23965,0,29521,3000,26521,0,32032,3000,29032,0,31385,0,31385
14360,230000,184000,0,0,0,0,0,0,-1,8743,8786,-43,-1,31886,32467,-581,-1,14893,14893,0,-1,8343,0,8343
14361,220000,176000,0,0,0,0,0,1,2,34913,2100,32813,0,36334,2000,34334,0,38729,3000,35729,0,39062,1100,37962
14362,60000,48000,0,1,0,0,0,1,0,59001,1628,57373,0,27971,1002,26969,0,28619,1100,27519,0,29213,1100,28113
14363,10000,8000,0,0,0,1,1,0,0,8345,1207,7138,0,8688,1000,7688,0,8865,177,8688,0,9046,181,8865
14364,20000,16000,0,0,0,0,0,1,0,5797,1254,4543,0,6654,1111,5543,0,6786,243,6543,0,7077,400,6677
14365,30000,24000,0,1,1,1,1,1,2,28590,2800,25790,2,27831,0,27831,2,28433,1050,27383,0,30257,2300,27957
14366,50000,40000,0,1,0,0,0,1,0,47446,3030,44416,0,39516,4000,35516,0,17643,2000,15643,0,32230,2800,29430
14367,20000,16000,0,0,0,0,0,1,0,14092,1254,12838,0,10474,1000,9474,0,11198,724,10474,0,12198,1000,11198
14368,330000,264000,0,0,0,0,0,0,0,3381,5000,-1619,-1,40635,42054,-1419,-1,40490,3000,37490,0,38431,2000,36431
14369,50000,40000,0,0,0,0,0,0,0,35230,2500,32730,0,32888,3000,29888,0,19624,2000,17624,0,20112,2000,18112
14370,240000,192000,0,1,0,0,0,0,0,226909,9859,217050,0,135626,4147,131479,0,138520,3691,134829,0,141280,3700,137580
14371,350000,280000,0,0,0,0,0,0,-1,5800,5800,0,-1,369718,371718,-2000,-1,2000,2180,-180,-1,5910,5910,0
14372,240000,192000,0,0,0,0,0,0,-1,-5,0,-5,-2,561,566,-5,-1,0,0,0,-1,0,0,0
14373,50000,40000,0,1,1,1,1,0,0,42699,1400,41299,0,43617,1300,42317,0,44509,1271,43238,0,45420,1300,44120
14374,150000,120000,0,0,0,0,0,0,0,75324,4000,71324,0,78773,5000,73773,0,95375,40000,55375,0,57663,3000,54663
14375,350000,280000,0,0,0,0,0,0,-1,1606,1612,-6,-1,1015,1017,-2,-1,24555,24560,-5,-1,185,1000,-815
14376,50000,40000,0,0,0,0,0,0,-1,946,0,946,3,576,0,576,2,18611,18611,0,-1,17721,0,17721
14377,160000,128000,0,0,0,0,0,0,-1,5969,5969,0,-1,18941,18941,0,-1,16578,0,16578,2,12652,12652,0
14378,140000,112000,0,1,1,1,1,0,2,120435,5000,115435,0,139795,21500,118295,0,142950,5500,137450,2,140505,0,140505
14379,240000,192000,0,1,1,1,1,1,2,223137,22000,201137,2,226470,8500,217970,2,229706,8500,221206,2,234889,9000,225889
14380,230000,184000,0,0,0,0,0,0,0,38228,5000,33228,0,36542,3000,33542,0,35989,3459,32530,0,34347,4000,30347
14381,30000,24000,0,0,0,0,1,0,0,24084,1602,22482,0,23631,1563,22068,0,29863,8500,21363,0,29369,1100,28269
14382,130000,104000,0,0,0,0,0,1,-1,15578,10000,5578,0,19887,5000,14887,0,11659,2000,9659,0,11735,2000,9735
14383,30000,24000,0,1,1,1,1,0,0,27407,2000,25407,0,29002,2500,26502,0,26806,1500,25306,0,25948,1000,24948
14384,240000,192000,0,0,0,0,0,0,0,128856,5800,123056,0,131620,4900,126720,0,134413,4900,129513,0,137188,5000,132188
14385,60000,48000,0,0,0,0,0,1,2,145,0,145,2,145,0,145,2,145,0,145,2,1195,1200,-5
14386,240000,192000,0,0,0,0,0,1,2,2236,2236,0,-1,3166,3166,0,-1,1925,0,1925,0,3326,3326,0
14387,230000,184000,0,0,0,0,0,0,-1,-74,0,-74,-1,926,1500,-574,-1,426,0,426,0,926,1000,-74
14388,280000,224000,0,0,0,0,0,0,0,125214,5024,120190,0,126426,5020,121406,0,126333,5093,121240,0,109953,3219,106734
14389,230000,184000,0,0,0,0,0,0,0,111244,6000,105244,0,116300,6000,110300,0,121346,6000,115346,0,130318,10000,120318
14390,50000,40000,0,0,0,0,0,0,0,32115,2000,30115,0,31824,1000,30824,0,32498,1064,31434,0,21757,1059,20698
14391,70000,56000,0,0,0,0,0,0,0,9864,2063,7801,0,5201,2000,3201,0,6950,2000,4950,0,7256,421,6835
14392,500000,400000,0,0,0,0,0,0,-1,7009,7114,-105,-1,12515,12587,-72,-2,8037,8071,-34,-1,7944,7978,-34
14393,200000,160000,0,0,0,0,0,1,-1,389,391,-2,2,389,390,-1,-1,389,390,-1,-1,775,776,-1
14394,30000,24000,0,1,1,0,0,0,0,30112,1626,28486,0,26763,1267,25496,0,22303,766,21537,0,24397,10000,14397
14395,60000,48000,0,0,0,0,0,0,0,42345,2000,40345,0,42849,1870,40979,0,17490,1000,16490,0,15633,586,15047
14396,110000,88000,0,0,0,0,0,0,0,76460,4000,72460,0,60136,2951,57185,0,41872,1600,40272,0,38158,1540,36618
14397,50000,40000,0,1,0,0,0,0,0,50313,1700,48613,0,10264,348,9916,0,10082,354,9728,0,9899,362,9537
14398,30000,24000,0,0,0,0,0,1,2,13991,1528,12463,0,14114,651,13463,0,14406,668,13738,0,14692,674,14018
14399,130000,104000,0,1,1,1,1,0,0,128231,6500,121731,0,127677,6201,121476,0,125675,5000,120675,0,127318,5500,121818
14400,180000,144000,0,0,0,0,0,1,0,118587,6005,112582,0,118482,5702,112780,0,119952,7509,112443,0,110003,14,109989
14401,350000,280000,0,0,0,0,0,1,-1,7147,7147,0,-2,9950,9950,0,-2,22117,22117,0,-2,4874,4874,0
14402,180000,144000,0,0,0,0,0,0,-2,5047,5047,0,-2,200,200,0,-2,745,745,0,-2,0,0,0
14403,20000,16000,0,1,1,1,1,1,2,19279,3000,16279,2,20663,2000,18663,2,20043,0,20043,3,19584,0,19584
14404,130000,104000,0,1,1,0,0,0,2,135624,6200,129424,2,129959,0,129959,2,93360,3500,89860,0,90040,3238,86802
14405,230000,184000,0,0,0,0,0,0,0,103506,5000,98506,0,100554,4500,96054,0,103929,5000,98929,0,107780,6500,101280
14406,150000,120000,0,0,0,0,0,0,-1,101,281,-180,-1,480,600,-120,-1,0,0,0,-1,0,0,0
14407,500000,400000,0,0,0,0,0,0,2,501,501,0,-1,300,300,0,-1,600,600,0,-1,450,300,150
14408,50000,40000,0,0,0,0,0,1,0,24565,1291,23274,0,21098,695,20403,0,18965,668,18297,0,18063,654,17409
14409,100000,80000,0,1,1,1,1,0,0,97974,4600,93374,0,97486,4500,92986,0,95479,3500,91979,0,92817,3500,89317
14410,370000,296000,0,0,0,0,0,0,0,49097,2000,47097,0,48216,1668,46548,0,47675,2000,45675,0,48074,3000,45074
14411,30000,24000,0,0,0,0,0,0,-2,5235,5235,0,-2,5000,5000,0,-2,2100,2100,0,-2,1970,1970,0
14412,260000,208000,0,0,0,0,0,0,0,71430,4000,67430,0,73837,4007,69830,0,73271,13990,59281,0,74266,2056,72210
14413,500000,400000,0,0,0,0,0,0,-1,13138,14587,-1449,-1,6653,28,6625,0,7081,7114,-33,-1,4651,4672,-21
14414,160000,128000,0,0,0,0,0,0,-1,2141,2141,0,-1,2144,2144,0,-1,5816,5816,0,-1,2144,2144,0
14415,230000,184000,0,0,0,0,0,1,-2,430,430,0,-2,430,430,0,-2,430,430,0,-2,430,430,0
14416,250000,200000,0,0,0,0,0,0,-2,0,0,0,-2,0,0,0,-2,0,0,0,-2,0,0,0
14417,200000,160000,0,0,0,0,0,0,0,80620,3900,76720,0,82300,3900,78400,0,0,0,0,0,0,0,0
14418,140000,112000,0,1,1,1,1,1,0,136996,11421,125575,0,140813,7580,133233,2,142170,5000,137170,2,144587,4913,139674
14419,120000,96000,0,0,0,0,0,1,2,2682,1000,1682,0,3272,1000,2272,0,3455,1000,2455,0,3261,0,3261
14420,20000,16000,0,0,0,0,0,0,-1,780,780,0,-1,780,780,0,-1,780,780,0,-1,390,390,0
14421,20000,16000,0,0,1,1,1,0,0,16852,1279,15573,0,17188,615,16573,0,17546,635,16911,0,17895,639,17256
14422,50000,40000,0,1,1,1,1,0,0,43414,2023,41391,0,44126,1735,42391,0,45004,1613,43391,0,46100,1823,44277
14423,290000,232000,0,0,0,0,0,0,-2,-68,0,-68,-2,675,743,-68,-2,-6,0,-6,-2,2168,2174,-6
14424,130000,104000,0,0,0,0,0,0,0,0,0,0,0,0,0,0,-2,0,0,0,-2,6163,6163,0
14425,210000,168000,0,0,0,0,0,0,0,2569,2576,-7,-1,36116,36120,-4,-1,36287,1093,35194,0,5695,2968,2727
14426,90000,72000,0,0,0,0,0,0,0,68883,1497,67386,0,265,265,0,-1,-613,0,-613,-1,-613,0,-613
14427,20000,16000,0,0,0,0,0,0,0,6860,1000,5860,0,7000,140,6860,0,10199,3199,7000,0,1500,1500,0
14428,240000,192000,0,0,0,0,0,0,0,85194,4200,80994,0,83021,3600,79421,0,78556,3000,75556,0,78495,3000,75495
14429,50000,40000,0,0,0,0,0,0,-2,0,0,0,-2,0,0,0,-2,0,0,0,-2,0,0,0
14430,360000,288000,0,0,0,0,0,0,0,23202,2000,21202,0,24979,2000,22979,0,26734,2000,24734,0,17956,2000,15956
14431,100000,80000,0,0,0,0,0,0,0,81572,3007,78565,0,71451,3200,68251,0,68530,3000,65530,0,66844,3500,63344
14432,20000,16000,0,1,1,1,1,0,0,17903,1300,16603,0,18321,700,17621,0,19680,1643,18037,0,18292,0,18292
14433,90000,72000,0,0,0,0,0,0,-2,11855,11855,0,-2,665,10655,-9990,-2,0,0,0,-2,665,665,0
14434,20000,16000,0,0,1,1,1,0,2,17994,6000,11994,2,17412,0,17412,2,18422,1600,16822,2,18768,800,17968
14435,540000,432000,0,0,0,0,0,0,-1,946,1000,-54,-1,946,946,0,-1,946,946,0,-1,946,946,0
14436,150000,120000,0,0,0,0,0,1,-1,1333,0,1333,2,0,0,0,2,0,0,0,-2,1930,1930,0
14437,80000,64000,0,0,0,0,0,0,-1,28798,28798,0,-1,29398,1000,28398,0,15037,1000,14037,0,0,0,0
14438,30000,24000,0,1,1,1,0,1,-1,28672,1600,27072,0,29622,1500,28122,0,30271,1000,29271,0,24536,1000,23536
14439,20000,16000,0,0,0,0,0,0,0,15074,3100,11974,0,14426,0,14426,2,14526,500,14026,0,15026,500,14526
14440,110000,88000,0,0,0,0,0,0,0,71698,3200,68498,0,72418,2700,69718,0,72293,2800,69493,0,73954,3000,70954
14441,30000,24000,0,0,0,0,0,0,-1,390,390,0,-1,0,0,0,-1,780,780,0,-1,0,0,0
14442,50000,40000,0,1,0,0,0,1,3,49205,24,49181,2,30394,1500,28894,0,30249,1000,29249,0,29957,1201,28756
14443,50000,40000,0,0,0,0,0,0,0,-200,0,-200,0,-200,0,-200,-2,-200,0,-200,-2,-200,0,-200
14444,470000,376000,0,0,0,0,0,0,0,153651,5484,148167,0,155381,5504,149877,0,155287,5655,149632,0,160843,9471,151372
14445,30000,24000,0,0,0,0,0,1,2,20758,1000,19758,2,21118,1000,20118,2,21632,1000,20632,2,22129,1000,21129
14446,500000,400000,0,0,0,0,0,0,0,248425,10146,238279,0,242854,10103,232751,0,226764,7108,219656,0,210947,7396,203551
14447,200000,160000,0,0,0,0,0,0,0,148817,6000,142817,0,154033,7600,146433,0,155435,5421,150014,0,151806,5400,146406
14448,240000,192000,0,0,0,0,0,0,0,75880,3004,72876,0,46407,4006,42401,0,12697,5000,7697,0,215281,215281,0
14449,300000,240000,0,0,0,0,0,0,-1,12963,13265,-302,-1,989,1087,-98,-1,12238,12238,0,-1,0,0,0
14450,80000,64000,0,0,0,0,0,0,0,22842,2000,20842,0,24147,2000,22147,0,29133,5394,23739,0,28532,0,28532
14451,200000,160000,0,0,0,0,0,0,-2,1097,1102,-5,-2,0,0,0,-2,0,0,0,-2,160,160,0
14452,150000,120000,0,1,0,1,1,0,0,138722,6100,132622,0,130494,30000,100494,0,147851,19227,128624,0,145535,0,145535
14453,50000,40000,0,0,0,0,0,1,0,3565,1240,2325,0,3820,3840,-20,-1,1275,1275,0,-1,1275,0,1275
14454,270000,216000,0,0,0,0,0,0,0,78574,2700,75874,0,70330,3180,67150,0,61355,2300,59055,0,52969,2800,50169
14455,300000,240000,0,0,0,0,0,0,-1,1380,1380,0,-1,390,0,390,2,1170,1170,0,-1,390,0,390
14456,270000,216000,0,0,0,0,0,0,-1,68660,10000,58660,0,77184,10000,67184,0,85591,10000,75591,0,101945,20000,81945
14457,80000,64000,1,1,1,0,0,0,0,84247,4000,80247,0,81619,2048,79571,0,30095,1300,28795,0,20639,1700,18939
14458,180000,144000,0,1,0,0,0,0,0,178659,7756,170903,0,138243,4788,133455,0,138023,5100,132923,0,137923,5500,132423
14459,60000,48000,0,0,0,0,0,0,0,41084,1983,39101,0,41741,1640,40101,0,42461,1542,40919,0,43457,1703,41754
14460,210000,168000,0,0,0,0,0,0,0,13173,3397,9776,0,13258,3000,10258,0,8155,2000,6155,0,2838,2300,538
14461,90000,72000,0,0,0,0,0,0,-2,-240,0,-240,-2,-240,0,-240,-2,-240,0,-240,-2,-240,0,-240
14462,230000,184000,0,0,0,0,0,0,-1,-150,0,-150,-1,517,667,-150,-1,53,0,53,2,603,700,-97
14463,260000,208000,0,0,0,0,0,0,0,38040,1571,36469,0,33882,1213,32669,0,34589,1253,33336,0,35397,1381,34016
14464,500000,400000,0,0,0,0,0,0,-1,58508,49019,9489,0,57855,134,57721,0,134,0,134,0,11421,11421,0
14465,50000,40000,0,0,0,0,0,0,0,29980,1200,28780,0,30000,1000,29000,0,0,0,0,0,0,0,0
14466,330000,264000,0,0,0,0,0,0,0,254855,9000,245855,0,258220,9174,249046,0,256058,9590,246468,0,256840,9500,247340
14467,30000,24000,1,1,1,1,1,0,2,49338,3000,46338,2,44430,1000,43430,2,40875,2000,38875,2,40272,5000,35272
14468,50000,40000,0,1,1,1,1,1,2,46225,2120,44105,0,46473,2810,43663,0,45099,1000,44099,2,45116,2083,43033
14469,160000,128000,0,0,0,0,0,0,-2,6371,6371,0,-1,0,0,0,-1,0,0,0,-2,0,0,0
14470,220000,176000,0,1,1,0,0,1,0,218878,8100,210778,0,193596,7000,186596,0,167149,5900,161249,0,157817,5600,152217
14471,180000,144000,0,0,0,0,0,0,0,21802,2808,18994,0,20100,2101,17999,0,16629,3,16626,0,15628,2000,13628
14472,90000,72000,0,1,1,1,1,0,0,79168,4000,75168,0,84904,8000,76904,0,87914,5348,82566,2,90043,3700,86343
14473,180000,144000,0,0,0,0,0,0,0,4268,3000,1268,0,5423,3000,2423,0,6423,1000,5423,0,7404,1814,5590
14474,100000,80000,0,0,0,0,0,0,0,62126,5000,57126,0,68082,7000,61082,0,73858,6900,66958,0,77226,4600,72626
14475,50000,40000,0,1,0,0,0,0,0,49943,2000,47943,0,18568,1000,17568,0,18740,1000,17740,0,19036,1000,18036
14476,130000,104000,0,1,1,1,1,0,0,117602,5800,111802,0,119119,5800,113319,0,120030,4300,115730,0,122510,4500,118010
14477,240000,192000,0,0,0,0,0,0,0,0,0,0,-2,0,0,0,-2,0,0,0,-2,0,0,0
14478,30000,24000,0,0,1,1,1,0,0,25239,1800,23439,0,26314,1800,24514,0,27074,1500,25574,0,28723,2250,26473
14479,30000,24000,0,0,0,0,0,0,0,0,780,-780,0,2320,2320,0,-1,0,0,0,-1,0,0,0
14480,200000,160000,0,0,0,0,0,0,0,94125,3455,90670,0,89550,5000,84550,0,98565,10000,88565,0,54370,2500,51870
14481,20000,16000,0,0,0,0,0,1,0,7053,1171,5882,0,5909,500,5409,0,3287,500,2787,0,3604,500,3104
14482,110000,88000,0,0,0,0,1,0,2,87486,0,87486,5,90126,5000,85126,4,94687,7000,87687,4,97585,5000,92585
14483,200000,160000,0,0,0,0,0,0,0,96731,3700,93031,0,67431,6478,60953,0,60690,2114,58576,0,60442,2337,58105
14484,80000,64000,0,1,1,0,0,0,-1,77986,3837,74149,0,78803,3141,75662,0,50140,2000,48140,0,47757,2000,45757
14485,150000,120000,0,0,0,0,0,0,0,12620,4620,8000,0,13027,3027,10000,0,17760,7050,10710,0,83146,75415,7731
14486,290000,232000,0,0,0,0,0,0,-2,972,972,0,-2,445,455,-10,-2,3589,3589,0,-2,6939,6939,0
14487,230000,184000,0,0,0,0,0,1,2,2154,2154,0,-1,1966,1966,0,-1,1966,1966,0,-1,1966,1966,0
14488,30000,24000,0,1,1,1,1,1,0,30480,1500,28980,0,31124,1100,30024,0,29333,1053,28280,0,30177,1320,28857
14489,230000,184000,0,0,0,0,0,0,-1,1678,1678,0,-1,0,0,0,-1,764,764,0,-1,0,0,0
14490,210000,168000,0,0,0,0,0,0,0,145675,7056,138619,0,149399,7656,141743,0,150796,5885,144911,0,88463,3345,85118
14491,210000,168000,0,0,0,0,0,0,-2,1865,1865,0,-2,-3,0,-3,-2,-3,0,-3,-2,3677,3680,-3
14492,500000,400000,0,0,0,0,0,0,-1,1429,1439,-10,-1,-601,0,-601,-1,120195,120796,-601,-1,976,981,-5
14493,120000,96000,0,0,0,0,0,1,2,744,444,300,2,1188,888,300,2,594,0,594,2,1038,888,150
14494,50000,40000,0,0,0,0,0,1,3,31558,0,31558,2,31664,1000,30664,0,15700,314,15386,0,0,0,0
14495,60000,48000,0,1,1,0,0,1,0,57416,2324,55092,0,55736,2049,53687,0,26958,2000,24958,0,28847,3000,25847
14496,380000,304000,0,0,0,0,0,0,0,33442,2800,30642,2,32361,0,32361,2,32518,1205,31313,0,32308,1226,31082
14497,60000,48000,0,0,0,0,0,0,-1,392,0,392,2,502,500,2,0,962,1000,-38,-1,422,0,422
14498,250000,200000,0,0,0,0,0,0,-1,8150,8150,0,-1,15410,15410,0,-1,1276,1276,0,-1,0,0,0
14499,90000,72000,0,0,0,0,0,0,0,59461,2200,57261,0,60974,2500,58474,0,62339,2500,59839,0,63648,2500,61148
14500,50000,40000,0,1,1,0,0,0,0,51082,3009,48073,0,46983,4012,42971,0,19839,3000,16839,0,16389,2000,14389
14501,80000,64000,0,1,0,0,0,0,0,67025,2873,64152,0,64850,2380,62470,0,63658,2401,61257,0,63005,2492,60513
14502,300000,240000,0,0,0,0,0,0,-1,4215,4247,-32,-1,2579,2595,-16,-1,970,970,0,-1,2656,2672,-16
14503,180000,144000,0,0,0,0,0,0,-1,1557,1562,-5,-1,2540,2540,0,-1,3058,3058,0,-1,16030,16030,0
14504,360000,288000,0,0,0,0,0,0,-1,0,0,0,-2,0,0,0,-2,0,0,0,-2,0,0,0
14505,130000,104000,0,0,0,0,0,0,-1,735,0,735,2,1575,1575,0,-1,316,316,0,-1,5039,5039,0
14506,130000,104000,0,0,0,0,0,0,2,390,0,390,2,0,0,0,2,780,780,0,-1,0,0,0
14507,200000,160000,0,1,1,1,1,1,2,188461,14000,174461,2,191363,7000,184363,2,188683,0,188683,2,196057,10000,186057
14508,80000,64000,0,0,0,0,0,0,0,58501,2600,55901,0,51042,3000,48042,0,19036,1691,17345,0,19414,695,18719
14509,100000,80000,0,0,0,0,0,1,2,31154,1200,29954,2,31625,1200,30425,2,31059,0,31059,2,33123,2500,30623
14510,110000,88000,0,0,0,0,0,1,0,77901,5000,72901,0,84592,8000,76592,0,82350,0,82350,2,87186,7000,80186
14511,180000,144000,0,0,0,0,1,1,2,146552,5600,140952,2,142714,0,142714,2,152219,12000,140219,2,149618,0,149618
14512,210000,168000,0,0,0,0,0,0,0,133963,15103,118860,0,115989,5000,110989,0,101628,4000,97628,0,104809,5000,99809
14513,450000,360000,0,0,0,0,0,0,-2,0,0,0,-2,0,0,0,-2,0,0,0,-2,0,0,0
14514,90000,72000,0,0,0,0,0,0,0,46496,5000,41496,0,40244,3000,37244,0,39903,10000,29903,0,8629,1000,7629
14515,100000,80000,0,0,0,0,0,0,2,66365,2893,63472,0,62913,2104,60809,0,9389,312,9077,0,6076,207,5869
14516,90000,72000,0,0,0,0,0,0,0,8961,1285,7676,0,11676,3000,8676,0,1189,1189,0,0,0,0,0
14517,20000,16000,0,0,0,0,0,1,0,14461,2100,12361,0,13221,0,13221,2,12591,458,12133,0,12631,1000,11631
14518,500000,400000,0,0,0,0,0,0,-1,1508,1100,408,0,1862,2103,-241,-1,3676,2500,1176,0,4961,2000,2961
14519,800000,640000,0,0,0,0,0,0,-2,3810,3832,-22,-2,6193,6219,-26,-1,1957,1961,-4,-1,3175,3183,-8
14520,70000,56000,0,1,0,0,0,1,2,68899,1378,67521,0,69131,70000,-869,-1,29289,1185,28104,0,29898,1220,28678
14521,290000,232000,0,0,0,0,0,1,0,96194,5000,91194,0,96089,2928,93161,0,92505,3097,89408,0,74760,2033,72727
14522,200000,160000,0,1,0,0,0,1,0,167877,6700,161177,0,128550,5000,123550,0,131511,5100,126411,0,127781,4700,123081
14523,630000,504000,0,0,0,0,0,0,0,470298,20000,450298,0,480587,20000,460587,0,385587,15000,370587,0,373910,15000,358910
14524,20000,16000,0,0,0,0,0,1,2,8340,0,8340,2,10044,1855,8189,2,9739,0,9739,2,10571,1000,9571
14525,300000,240000,0,0,0,0,0,0,2,198422,8000,190422,0,204116,9000,195116,0,214691,15500,199191,0,218101,7000,211101
14526,500000,400000,0,0,0,0,0,0,-2,0,0,0,-2,0,0,0,-2,0,0,0,-2,522,522,0
14527,60000,48000,0,1,0,0,0,0,0,58971,304,58667,2,29137,1100,28037,0,29900,1216,28684,0,30069,1300,28769
14528,20000,16000,0,1,1,1,1,0,0,18706,1400,17306,0,20086,1684,18402,0,19632,0,19632,2,20160,1000,19160
14529,200000,160000,0,0,0,0,0,0,-2,2342,2342,0,-2,810,810,0,-2,9743,10253,-510,-2,1000,1000,0
14530,230000,184000,0,0,0,0,0,0,0,56150,2100,54050,0,57074,2300,54774,0,50670,2000,48670,0,50652,2000,48652
14531,20000,16000,0,0,0,0,0,1,2,9823,1000,8823,0,10023,200,9823,0,0,0,0,0,0,0,0
14532,50000,40000,0,0,0,0,0,1,0,29660,1560,28100,0,30600,1500,29100,0,-300,0,-300,0,9037,9337,-300
14533,230000,184000,0,0,0,0,0,0,-2,282,282,0,-2,2427,2427,0,-2,282,282,0,-2,282,282,0
14534,220000,176000,0,0,0,0,0,1,-1,9743,9752,-9,-1,7480,0,7480,2,22880,22880,0,-1,880,0,880
14535,350000,280000,0,0,0,0,0,0,0,190173,8700,181473,0,192649,7000,185649,0,197269,7600,189669,0,201360,7800,193560
14536,20000,16000,1,1,1,0,0,1,4,20786,0,20786,3,19994,4,19990,2,10700,0,10700,0,0,0,0
14537,60000,48000,0,0,0,0,0,1,-1,696,696,0,-1,696,696,0,-1,696,696,0,-1,696,696,0
14538,80000,64000,0,0,0,0,0,0,0,28009,1489,26520,0,28977,1457,27520,0,28756,1016,27740,0,28962,1046,27916
14539,360000,288000,0,0,0,0,0,0,0,115304,5000,110304,0,114966,4000,110966,0,113208,5000,108208,0,113504,8000,105504
14540,60000,48000,0,0,0,0,0,0,0,30604,1300,29304,0,22204,1000,21204,0,19895,803,19092,0,19199,1107,18092
14541,30000,24000,0,1,1,1,1,0,2,28395,1812,26583,0,29409,1826,27583,0,25267,904,24363,0,25800,940,24860
14542,300000,240000,0,0,0,0,0,0,-2,0,0,0,-2,4319,4319,0,-2,0,0,0,-2,0,0,0
14543,30000,24000,0,0,0,0,1,0,0,22419,3008,19411,0,22075,5066,17009,0,29466,29572,-106,-1,28911,1911,27000
14544,30000,24000,0,0,0,0,0,0,-1,3631,0,3631,3,1950,0,1950,2,1170,0,1170,0,1170,0,1170
14545,400000,320000,0,0,0,0,0,0,0,67887,3072,64815,0,20356,72,20284,0,12780,62,12718,0,11625,11681,-56
14546,130000,104000,0,0,0,0,0,1,-2,30656,32100,-1444,-1,29426,0,29426,0,29100,0,29100,0,-1410,0,-1410
14547,10000,8000,0,0,0,0,0,0,2,10062,4312,5750,2,6267,0,6267,2,-610,0,-610,2,-220,780,-1000
14548,20000,16000,0,0,0,0,0,1,0,14429,1500,12929,0,15659,1500,14159,0,16959,1500,15459,0,-41,3000,-3041
14549,50000,40000,0,1,0,0,0,0,0,46396,2014,44382,0,19673,1000,18673,0,17083,1000,16083,0,17694,3000,14694
14550,200000,160000,0,1,1,0,0,1,2,202494,7500,194994,2,162228,0,162228,2,154294,6700,147594,2,147514,5000,142514
14551,10000,8000,0,0,0,0,0,0,-2,2038,2040,-2,-2,1938,1938,0,-2,0,0,0,-2,0,0,0
14552,60000,48000,0,0,0,0,0,0,0,37274,1491,35783,0,30203,2000,28203,0,30809,1092,29717,0,33323,3000,30323
14553,210000,168000,0,0,0,0,0,0,-1,740,0,740,2,2048,2048,0,-1,740,740,0,-1,740,740,0
14554,10000,8000,0,0,0,0,0,1,-1,622,0,622,2,149,1000,-851,-1,-1324,0,-1324,-1,-797,2000,-2797
14555,210000,168000,0,0,0,0,0,0,0,6020,1000,5020,0,6143,123,6020,0,6268,125,6143,0,399,0,399
14556,30000,24000,0,0,0,0,0,1,0,10062,1500,8562,0,11581,2000,9581,0,12580,1500,11080,0,13716,1500,12216
14557,140000,112000,0,0,0,0,0,0,0,73225,15000,58225,0,56999,0,56999,2,61050,5000,56050,0,67086,7086,60000
14558,20000,16000,0,0,1,1,0,1,0,20997,5000,15997,0,20200,0,20200,2,20000,0,20000,0,0,0,0
14559,50000,40000,0,1,1,0,0,0,0,48888,2009,46879,0,47037,1180,45857,0,12187,1000,11187,0,9962,1000,8962
14560,250000,200000,0,0,0,0,0,0,0,78886,3282,75604,0,79845,2698,77147,0,79323,2752,76571,0,77788,2843,74945
14561,130000,104000,0,0,0,0,0,0,-1,8552,8591,-39,-1,5459,5463,-4,-1,2850,2855,-5,-1,9611,9611,0
14562,390000,312000,0,0,0,0,0,0,2,5797,5806,-9,-1,7657,7667,-10,-1,4086,95,3991,0,5795,5804,-9
14563,240000,192000,0,0,0,0,0,0,2,7094,1200,5894,0,3227,0,3227,0,-18,0,-18,0,-18,0,-18
14564,170000,136000,0,1,1,1,1,0,0,165592,7464,158128,0,167482,6127,161355,0,171106,6550,164556,0,164042,6100,157942
14565,410000,328000,0,0,0,0,0,0,0,8726,2000,6726,0,9760,2200,7560,0,9570,312,9258,0,8935,500,8435
14566,150000,120000,0,0,0,0,0,0,0,60252,2500,57752,0,62245,3000,59245,0,64202,3000,61202,0,66167,3000,63167
14567,50000,40000,0,1,1,0,0,0,0,50204,4000,46204,0,44580,1010,43570,0,4712,5504,-792,-1,3914,5500,-1586
14568,230000,184000,0,0,0,0,0,1,-2,181,181,0,-1,2680,2680,0,-1,0,0,0,-1,0,0,0
14569,50000,40000,0,1,0,0,0,0,0,44709,1740,42969,0,28179,1400,26779,0,28877,1000,27877,0,29217,1000,28217
14570,160000,128000,0,0,0,0,0,0,-2,12431,12431,0,-2,12145,12145,0,-2,13391,13391,0,-2,7957,7957,0
14571,130000,104000,0,0,0,0,0,0,0,2277,2277,0,-1,1132,1132,0,-1,1289,1289,0,-1,0,0,0
14572,20000,16000,0,0,0,0,0,0,0,8169,1213,6956,0,8956,1000,7956,0,8956,0,8956,0,0,0,0
14573,50000,40000,0,0,0,0,0,0,0,17518,1588,15930,0,17710,780,16930,0,18079,803,17276,0,18302,673,17629
14574,230000,184000,0,0,0,0,0,0,-2,3267,3267,0,-2,800,800,0,-2,2458,2458,0,-2,1880,1880,0
14575,300000,240000,0,0,0,0,0,0,-1,3744,3744,0,-1,8059,8059,0,-1,3425,3425,0,-1,11860,11860,0
14576,50000,40000,0,0,0,0,0,0,0,20259,1305,18954,0,20274,700,19574,0,20311,718,19593,0,19957,724,19233
14577,150000,120000,0,0,0,0,0,0,-2,522,522,0,-2,0,0,0,-2,3978,3978,0,-1,25590,25590,0
14578,300000,240000,0,0,0,0,0,0,0,76777,47009,29768,0,34072,34044,28,0,11632,11677,-45,-2,15429,15483,-54
14579,360000,288000,0,0,0,0,0,0,-1,831,835,-4,-1,899,899,0,-1,1172,1172,0,-1,820,820,0
14580,150000,120000,0,0,0,0,0,1,-2,0,0,0,-2,11068,11068,0,-1,0,0,0,-1,189,189,0
14581,250000,200000,0,0,0,0,0,0,0,29385,3000,26385,0,27677,901,26776,0,86250,63000,23250,0,65710,2700,63010
14582,50000,40000,0,0,0,0,0,1,0,8896,2700,6196,0,7088,0,7088,2,7109,500,6609,0,6898,500,6398
14583,20000,16000,0,0,0,0,0,1,2,14255,2500,11755,2,13729,0,13729,2,14706,1200,13506,2,14320,0,14320
14584,500000,400000,0,0,0,0,0,0,0,129576,4787,124789,0,129863,4745,125118,0,120781,4256,116525,0,98163,3321,94842
14585,30000,24000,0,1,1,1,1,0,0,27474,1524,25950,0,28351,1401,26950,0,26389,917,25472,0,26992,1000,25992
14586,20000,16000,0,0,0,0,0,1,-1,1252,1252,0,-1,626,0,626,2,626,626,0,-1,776,776,0
14587,100000,80000,0,1,1,1,1,1,2,95884,0,95884,3,93528,0,93528,2,96397,6050,90347,2,96258,1600,94658
14588,100000,80000,0,0,0,0,0,1,2,46157,1700,44457,2,46900,1800,45100,2,47999,2000,45999,2,49057,2000,47057
14589,550000,440000,0,0,0,0,0,0,2,94,94,0,2,100,112,-12,-2,704,704,0,-1,7480,7491,-11
14590,100000,80000,0,0,0,0,0,1,2,72432,3462,68970,2,74322,3700,70622,2,74496,2000,72496,2,76058,2760,73298
14591,360000,288000,0,0,0,0,0,0,-2,7486,8063,-577,-2,24472,25217,-745,-2,5935,6487,-552,-2,4999,5000,-1
14592,120000,96000,0,0,0,0,0,0,-1,-72,0,-72,-2,-72,0,-72,-2,-72,0,-72,-2,-72,0,-72
14593,50000,40000,0,0,0,0,0,0,-2,12493,12493,0,-1,28365,16000,12365,0,6300,0,6300,0,999,999,0
14594,80000,64000,0,0,0,0,0,0,0,600,600,0,-1,53900,53900,0,-1,55000,1100,53900,0,65000,10000,55000
14595,390000,312000,0,0,0,0,0,0,0,216051,8035,208016,0,208373,7035,201338,0,199727,6056,193671,0,186332,8053,178279
14596,20000,16000,0,1,1,1,1,0,2,19276,2100,17176,2,19451,1000,18451,2,19641,1000,18641,0,20188,1000,19188
14597,110000,88000,0,1,1,1,1,0,0,108555,4200,104355,0,106692,5200,101492,0,103971,3800,100171,0,104140,3900,100240
14598,230000,184000,0,0,0,0,0,0,2,14718,5028,9690,0,13524,5003,8521,0,15529,3012,12517,0,12936,3,12933
14599,50000,40000,0,1,0,0,0,1,0,49966,1140,48826,0,7825,226,7599,0,3753,555,3198,0,34287,35190,-903
14600,50000,40000,1,1,1,1,1,1,0,59529,4400,55129,0,55405,0,55405,2,55904,4000,51904,2,52160,0,52160
14601,200000,160000,0,0,0,0,0,1,-1,7990,7990,0,-1,10392,6000,4392,0,7042,0,7042,0,5692,2000,3692
14602,500000,400000,0,0,0,0,0,1,-2,3500,3500,0,-1,3500,0,3500,2,0,0,0,2,0,0,0
14603,70000,56000,0,1,1,1,1,1,2,71622,2604,69018,2,68443,0,68443,2,72210,5001,67209,2,70267,9,70258
14604,20000,16000,0,1,1,1,0,0,0,20179,1409,18770,0,18800,0,18800,0,19500,1000,18500,0,0,0,0
14605,230000,184000,0,0,0,0,0,0,-1,15900,15900,0,-1,1678,1678,0,-1,0,0,0,-1,764,764,0
14606,20000,16000,0,1,1,0,0,1,0,18398,1446,16952,0,19052,1100,17952,0,15429,0,15429,2,9199,379,8820
14607,50000,40000,0,0,0,0,0,1,0,27496,1304,26192,0,20414,1500,18914,0,19978,0,19978,2,18547,868,17679
14608,600000,480000,0,0,0,0,0,0,0,82803,8340,74463,0,380337,380478,-141,-1,368527,12625,355902,0,390197,60000,330197
14609,270000,216000,0,0,0,0,0,0,-1,14770,14841,-71,-1,14367,1200,13167,0,14388,1288,13100,0,47441,41437,6004
14610,270000,216000,0,0,0,0,0,0,-2,1900,5011,-3111,-2,7518,8049,-531,-1,57765,53008,4757,0,59377,5004,54373
14611,210000,168000,0,0,0,0,0,1,-2,0,0,0,-2,0,0,0,-2,0,0,0,-2,0,0,0
14612,250000,200000,0,0,0,0,0,1,0,13683,5028,8655,0,22970,15127,7843,0,5409,8028,-2619,-1,4490,5021,-531
14613,190000,152000,0,0,0,0,0,0,0,127189,6000,121189,0,122034,4000,118034,0,124837,5000,119837,0,128442,5000,123442
14614,380000,304000,0,0,0,0,0,0,0,249018,9190,239828,0,252496,9000,243496,0,253331,8100,245231,0,238051,8100,229951
14615,50000,40000,0,1,0,0,0,1,0,49911,2300,47611,0,19817,715,19102,0,20492,1000,19492,0,20365,878,19487
14616,130000,104000,0,0,0,0,0,0,2,990,990,0,-1,990,990,0,-1,990,990,0,-1,1130,1130,0
14617,80000,64000,0,1,0,0,0,0,0,74383,7248,67135,0,48315,2980,45335,0,48831,2000,46831,0,48950,1903,47047
14618,50000,40000,0,1,0,0,0,0,0,50218,2083,48135,0,20141,697,19444,0,20072,711,19361,0,19493,717,18776
14619,280000,224000,0,0,0,0,0,0,-2,651,651,0,-2,3126,3126,0,-2,3707,3707,0,-2,11225,11225,0
14620,80000,64000,0,0,0,0,0,1,-2,-1458,3,-1461,-2,16950,18950,-2000,-1,16475,0,16475,2,19284,5889,13395
14621,300000,240000,0,0,0,0,0,0,0,71387,3175,68212,0,72340,2736,69604,0,73853,2829,71024,0,75316,2843,72473
14622,20000,16000,0,0,0,0,0,0,0,10526,1000,9526,2,11049,1000,10049,0,11865,1000,10865,0,12665,1000,11665
14623,100000,80000,0,0,0,0,0,1,0,47053,2400,44653,0,47747,1845,45902,0,48459,2400,46059,0,49560,2500,47060
14624,50000,40000,0,0,0,0,0,0,0,9757,1139,8618,0,8941,2000,6941,0,9893,1000,8893,0,6181,300,5881
14625,50000,40000,0,0,1,0,0,1,0,50694,13000,37694,0,49483,0,49483,2,17299,1000,16299,0,17959,1000,16959
14626,200000,160000,0,0,0,0,0,0,0,136685,30000,106685,0,137432,4148,133284,0,138059,15100,122959,0,126615,8029,118586
14627,90000,72000,0,1,1,1,1,1,2,90758,3273,87485,0,90537,3267,87270,0,90263,3212,87051,0,90268,3440,86828
14628,30000,24000,0,1,0,0,0,0,0,28829,1209,27620,0,15762,700,15062,0,0,0,0,0,0,0,0
14629,360000,288000,0,0,0,0,0,0,0,92915,4500,88415,0,52341,2000,50341,0,51739,2100,49639,0,55079,4400,50679
14630,210000,168000,0,0,0,0,0,0,-2,416,416,0,-2,416,416,0,-2,416,416,0,-2,416,416,0
14631,20000,16000,0,1,0,0,1,1,0,18270,1600,16670,0,16992,2400,14592,0,19025,3800,15225,0,35744,739,35005
14632,50000,40000,0,1,1,1,0,0,0,50192,3000,47192,0,50451,5000,45451,0,49086,3000,46086,0,34161,1000,33161
14633,240000,192000,0,0,0,0,0,0,0,7899,1124,6775,0,8072,2000,6072,0,728,728,0,0,24511,24709,-198
14634,300000,240000,0,0,0,0,0,0,0,56738,2640,54098,0,57282,2080,55202,0,58575,2246,56329,0,59653,2174,57479
14635,350000,280000,0,0,0,0,0,0,-1,15047,15052,-5,-1,3220,3805,-585,-1,20461,20467,-6,-1,3249,3253,-4
14636,50000,40000,0,0,0,0,0,1,0,41776,2062,39714,0,17083,2016,15067,0,9412,1022,8390,0,1038,1388,-350
14637,130000,104000,0,1,1,1,0,0,0,129713,0,129713,2,129883,5100,124783,0,122349,4820,117529,0,101415,3844,97571
14638,50000,40000,0,0,0,0,0,1,0,37166,1621,35545,0,39710,3165,36545,0,40519,1600,38919,2,41324,1620,39704
14639,60000,48000,0,1,0,0,0,1,2,59327,4058,55269,2,35305,34,35271,2,17655,3000,14655,0,77775,40793,36982
14640,120000,96000,0,0,0,0,0,0,0,122177,50053,72124,0,120667,29377,91290,0,47880,0,47880,2,49629,30000,19629
14641,120000,96000,0,0,0,0,0,0,-1,1360,1360,0,-1,9474,10000,-526,-1,10158,1000,9158,0,2551,2000,551
14642,170000,136000,0,0,0,0,0,0,-2,0,0,0,-2,0,0,0,-2,1903,1903,0,-2,0,0,0
14643,50000,40000,0,1,0,0,0,0,0,46567,2000,44567,0,27211,1000,26211,0,28274,1500,26774,0,29005,1500,27505
14644,250000,200000,0,0,0,0,0,0,-1,4037,4057,-20,-1,1184,1196,-12,-1,5107,5123,-16,-1,1893,6,1887
14645,290000,232000,0,1,0,1,0,0,0,290951,11212,279739,0,237255,8503,228752,0,241778,9047,232731,0,236917,9003,227914
14646,120000,96000,0,0,0,0,0,1,2,50104,3000,47104,2,43957,0,43957,2,43401,5000,38401,2,37371,0,37371
14647,240000,192000,0,0,0,0,0,0,-1,0,0,0,-2,0,0,0,-2,0,0,0,-2,0,0,0
14648,100000,80000,0,0,0,0,0,0,0,68095,10000,58095,0,64339,2635,61704,0,15522,15522,0,-1,51336,41136,10200
14649,320000,256000,0,1,1,1,1,1,0,302561,21041,281520,0,283356,1514,281842,2,275361,9122,266239,0,268871,9518,259353
14650,20000,16000,0,0,0,0,0,0,-1,0,0,0,-1,780,780,0,-1,0,0,0,-1,0,0,0
14651,140000,112000,0,0,0,0,0,0,0,107209,5211,101998,0,106353,4000,102353,0,100653,4000,96653,0,99546,4000,95546
14652,50000,40000,0,0,0,0,0,1,-1,390,390,0,-1,390,390,0,-1,390,390,0,-1,390,390,0
14653,50000,40000,0,1,1,0,0,0,0,48905,2311,46594,0,49794,2200,47594,0,8820,176,8644,0,9000,180,8820
14654,50000,40000,0,0,0,0,0,0,0,28192,1448,26744,0,28356,1002,27354,0,28554,1032,27522,0,28718,1024,27694
14655,200000,160000,0,0,0,0,0,0,0,212,220,-8,0,2387,2387,0,-2,0,0,0,-2,-2620,0,-2620
14656,320000,256000,0,0,0,0,0,0,0,99433,10000,89433,0,107659,10000,97659,0,110567,10000,100567,0,99935,5000,94935
14657,110000,88000,0,0,0,1,0,1,2,89655,3300,86355,2,90593,3300,87293,2,89025,0,89025,2,94509,7000,87509
14658,240000,192000,0,0,0,0,0,0,0,27620,27662,-42,-1,24873,24873,0,-1,24511,24511,0,-1,24000,24000,0
14659,60000,48000,0,0,0,0,0,0,-1,1586,30000,-28414,-1,5781,11776,-5995,-1,1188,0,1188,0,1061,1061,0
14660,100000,80000,0,0,0,0,0,0,0,59038,2954,56084,0,52735,2307,50428,0,46667,1756,44911,0,49009,3181,45828
14661,80000,64000,0,0,0,0,0,0,2,8721,8721,0,-1,3589,3589,0,-1,8209,8209,0,-1,10253,10253,0
14662,260000,208000,0,0,0,0,0,0,0,186778,6637,180141,0,184132,7784,176348,0,189947,10000,179947,0,89016,3500,85516
14663,260000,208000,0,0,0,0,0,0,0,22643,3000,19643,0,20864,2000,18864,0,25604,5634,19970,0,28748,3748,25000
14664,170000,136000,0,0,0,0,0,0,-1,2016,5991,-3975,-1,3957,3957,0,-1,4956,5444,-488,-1,482,482,0
14665,460000,368000,0,0,0,0,0,0,-1,52920,52937,-17,-1,50106,1006,49100,0,50147,1019,49128,0,1341,1347,-6
14666,110000,88000,0,1,1,0,0,0,0,94503,3838,90665,0,95571,3056,92515,0,91794,8000,83794,0,80365,3000,77365
14667,200000,160000,0,1,1,0,0,0,0,186093,20000,166093,0,188139,6000,182139,0,141208,5300,135908,0,144242,5500,138742
14668,140000,112000,0,0,0,0,0,1,0,435,436,-1,-1,556,621,-65,-1,92556,94500,-1944,-1,94567,3500,91067
14669,50000,40000,0,0,0,0,0,0,0,0,0,0,0,0,0,0,-2,0,0,0,-2,0,0,0
14670,20000,16000,0,1,1,1,1,0,0,18356,1621,16735,0,19028,1293,17735,0,38688,830,37858,0,19897,1548,18349
14671,60000,48000,0,0,0,0,0,0,-1,1647,1675,-28,-1,1355,1355,0,-1,1458,1458,0,-1,1631,1631,0
14672,150000,120000,0,0,0,0,0,0,2,8969,8969,0,-1,6027,6027,0,-1,5132,0,5132,0,1461,1461,0
14673,50000,40000,0,0,0,0,0,0,-2,4151,4151,0,-2,4186,4186,0,-2,3545,3545,0,-2,2659,2860,-201
14674,30000,24000,0,0,0,0,1,0,0,0,0,0,0,517,1517,-1000,-1,25420,25420,0,-1,24863,0,24863
14675,100000,80000,0,0,0,0,0,0,2,2394,2000,394,0,2839,3000,-161,-1,32934,31000,1934,0,31056,2000,29056
14676,50000,40000,0,0,0,0,0,0,0,7081,1000,6081,0,5738,91,5647,0,6461,11283,-4822,-1,4822,0,4822
14677,50000,40000,0,1,1,1,1,0,-1,50206,2500,47706,0,50831,2031,48800,0,42731,1274,41457,0,43224,1500,41724
14678,20000,16000,0,0,1,1,1,1,0,17137,2000,15137,0,18541,2000,16541,0,18909,677,18232,0,19464,860,18604
14679,150000,120000,0,0,0,0,0,0,-1,6994,7034,-40,-1,8102,8112,-10,-1,25715,25715,0,-1,11350,11350,0
14680,70000,56000,0,0,0,0,0,1,2,10557,1500,9057,0,11576,1200,10376,0,12383,1000,11383,0,13180,1000,12180
14681,50000,40000,0,0,0,0,0,1,0,12637,0,12637,2,13922,1500,12422,2,13556,0,13556,2,14528,1200,13328
14682,20000,16000,0,1,1,1,0,0,0,19339,1153,18186,0,19733,547,19186,0,19799,611,19188,0,10400,600,9800
14683,30000,24000,0,1,1,1,1,1,0,27480,1804,25676,0,26960,1800,25160,0,27215,1000,26215,0,27977,1200,26777
14684,240000,192000,0,0,0,0,0,0,-1,51380,1651,49729,0,25438,1705,23733,0,19376,564,18812,0,12889,2093,10796
14685,50000,40000,0,0,0,0,0,1,2,15889,1354,14535,0,16650,1115,15535,0,18535,2000,16535,0,18924,520,18404
14686,230000,184000,0,0,0,0,0,0,-2,264,264,0,-2,264,264,0,-2,264,264,0,-2,264,264,0
14687,280000,224000,0,0,0,0,0,0,-1,5118,5118,0,-1,380,380,0,-1,380,380,0,-1,380,380,0
14688,170000,136000,0,0,0,0,0,0,0,31776,3000,28776,0,34228,3000,31228,0,36645,3000,33645,0,38885,3000,35885
14689,380000,304000,0,0,0,0,0,1,-1,-4,0,-4,-1,-4,0,-4,-2,-4,0,-4,-2,-4,0,-4
14690,30000,24000,0,0,0,0,0,0,0,14485,1600,12885,0,15936,2000,13936,0,16370,1000,15370,0,17105,1000,16105
14691,460000,368000,0,0,0,0,0,0,0,111899,20000,91899,0,199682,90000,109682,0,177073,9000,168073,0,175979,10000,165979
14692,160000,128000,0,0,0,0,0,1,0,1481,1331,150,0,2623,2473,150,0,2457,0,2457,2,4912,2500,2412
14693,80000,64000,0,0,0,0,0,0,0,55760,2000,53760,0,15029,5000,10029,0,13809,3000,10809,0,13597,1000,12597
14694,500000,400000,0,0,0,0,0,0,-2,0,0,0,-2,0,0,0,-2,0,0,0,-2,0,0,0
14695,200000,160000,0,0,0,0,0,0,0,0,0,0,-2,0,0,0,-2,0,0,0,-2,0,0,0
14696,260000,208000,0,0,0,0,0,0,0,131933,5200,126733,0,134482,5000,129482,0,135772,5000,130772,0,138229,5000,133229
14697,120000,96000,0,1,0,0,0,0,-2,120584,4023,116561,-2,70990,3300,67690,-2,0,0,0,-2,0,0,0
14698,200000,160000,0,0,0,0,0,0,-1,1886,1902,-16,-1,4700,4723,-23,-1,0,0,0,-1,0,0,0
14699,200000,160000,0,0,0,0,0,0,-2,0,0,0,-2,1782,2422,-640,-2,669,669,0,-2,0,0,0
14700,50000,40000,0,0,0,0,0,1,2,28371,0,28371,3,31208,3600,27608,2,30149,0,30149,4,29375,0,29375
14701,160000,128000,0,0,0,0,0,0,-1,16846,16890,-44,-1,2150,2150,0,-1,1033,0,1033,0,8264,8264,0
14702,170000,136000,0,0,0,0,0,0,-2,0,0,0,-2,0,0,0,-2,185,185,0,-1,185,0,185
14703,30000,24000,0,0,0,0,0,0,-1,0,0,0,-1,0,0,0,-2,0,0,0,-2,0,0,0
14704,240000,192000,0,1,0,0,0,0,0,218142,9000,209142,0,195913,7000,188913,0,197823,7000,190823,0,189111,6625,182486
14705,120000,96000,0,0,0,0,0,0,0,30285,10000,20285,0,24879,6000,18879,0,29479,5000,24479,0,27553,7553,20000
14706,140000,112000,0,0,0,0,0,0,0,83514,2890,80624,0,72387,3118,69269,0,67261,3000,64261,0,68670,2493,66177
14707,20000,16000,0,1,0,0,0,0,0,19864,2013,17851,0,4723,4731,-8,-1,0,0,0,-1,0,0,0
14708,50000,40000,0,0,0,0,0,0,0,17818,2000,15818,0,17028,1000,16028,0,16387,1000,15387,0,15728,1000,14728
14709,280000,224000,0,0,0,0,0,0,0,156784,10000,146784,0,156230,6000,150230,0,159123,5200,153923,0,163152,6000,157152
14710,150000,120000,0,0,1,0,0,0,0,100683,3500,97183,0,147127,3000,144127,0,79942,5242,74700,0,71976,3009,68967
14711,120000,96000,0,0,0,0,0,1,2,83496,3900,79596,2,84333,3100,81233,2,85444,3400,82044,2,87323,3400,83923
14712,90000,72000,0,1,0,0,0,1,2,76823,3365,73458,0,47008,2051,44957,0,32358,1200,31158,0,33318,1500,31818
14713,50000,40000,0,1,1,1,1,1,0,46993,0,46993,2,47940,1694,46246,0,50903,3713,47190,0,49794,2000,47794
14714,290000,232000,0,0,0,0,0,0,-1,28874,29020,-146,-1,77790,78178,-388,-2,8142,8572,-430,-2,9547,9590,-43
14715,80000,64000,0,1,0,0,0,1,0,82150,4000,78150,0,0,0,0,0,0,0,0,-2,0,0,0
14716,500000,400000,0,0,0,0,0,0,0,218778,18778,200000,0,236377,36377,200000,0,225650,10650,215000,0,15233,15233,0
14717,50000,40000,0,0,0,0,0,0,0,36496,2000,34496,0,33512,6416,27096,0,29854,4406,25448,0,28144,1014,27130
14718,360000,288000,0,0,0,0,0,0,0,163120,8071,155049,0,140383,7029,133354,0,121771,3011,118760,0,102568,4000,98568
14719,100000,80000,0,0,0,0,0,1,2,63179,0,63179,2,67467,5346,62121,2,65784,0,65784,2,69309,4600,64709
14720,70000,56000,0,1,1,0,0,0,0,68683,3500,65183,0,68771,2104,66667,0,55168,2015,53153,0,49674,2001,47673
14721,290000,232000,0,0,0,0,0,0,0,13802,4000,9802,0,0,0,0,0,2242,2242,0,-1,1850,0,1850
14722,240000,192000,0,0,0,0,0,0,0,194043,194043,0,-1,194991,6530,188461,0,192800,7000,185800,0,178318,7000,171318
14723,100000,80000,0,0,0,0,0,0,0,44607,3000,41607,2,45576,2000,43576,2,46495,1800,44695,2,47182,1600,45582
14724,200000,160000,0,0,0,0,0,0,-1,386,396,-10,-1,0,4,-4,-1,475,475,0,-1,390,1170,-780
14725,300000,240000,0,0,0,0,0,0,-1,2431,2431,0,-1,2198,2198,0,-1,14487,14487,0,-1,725,725,0
14726,240000,192000,0,0,0,0,0,0,0,7816,7816,0,-1,7500,7500,0,-1,7500,7500,0,-1,14497,14497,0
14727,90000,72000,0,0,0,0,0,1,0,66627,2500,64127,0,70652,5140,65512,0,69397,0,69397,2,70842,2600,68242
14728,160000,128000,0,0,0,0,0,0,0,4770,1276,3494,0,5494,1000,4494,0,4586,92,4494,0,4686,100,4586
14729,180000,144000,0,0,0,0,0,1,0,93682,6428,87254,0,103273,13669,89604,0,104492,3816,100676,0,109818,8048,101770
14730,140000,112000,0,0,0,0,0,1,0,29354,300,29054,2,30609,2038,28571,2,29981,0,29981,2,30581,1100,29481
14731,160000,128000,0,0,0,0,0,0,-1,4856,4856,0,-1,4127,1000,3127,0,3995,3995,0,-1,842,842,0
14732,220000,176000,0,0,0,0,0,0,2,264,264,0,-1,292,292,0,-1,528,500,28,0,264,0,264
14733,80000,64000,0,0,0,0,0,0,0,64469,2500,61969,0,54020,2000,52020,0,55852,3000,52852,0,44286,2000,42286
14734,160000,128000,0,1,1,1,1,1,3,155201,7000,148201,3,157202,6000,151202,3,153311,0,153311,2,162973,12000,150973
14735,240000,192000,0,1,1,0,0,1,0,240041,8685,231356,0,231036,10252,220784,0,194520,7016,187504,0,195392,7033,188359
14736,150000,120000,0,0,0,0,0,0,-2,0,0,0,-2,0,0,0,-2,2000,2000,0,-1,2000,2000,0
14737,100000,80000,0,0,0,0,0,0,0,36338,0,36338,2,37698,2270,35428,2,38074,1300,36774,2,40295,3000,37295
14738,70000,56000,0,0,0,0,0,0,2,39369,2369,37000,0,43627,5178,38449,0,15251,0,15251,2,16285,1285,15000
14739,220000,176000,0,0,0,0,0,0,0,89687,5000,84687,0,90889,4200,86689,0,91892,4000,87892,0,93815,4000,89815
14740,500000,400000,0,0,0,0,0,0,0,74832,40000,34832,0,126778,85000,41778,0,82611,139,82472,0,71338,20000,51338
14741,80000,64000,0,0,0,0,0,0,2,50207,2000,48207,2,51081,2000,49081,2,52118,2001,50117,2,51129,0,51129
14742,30000,24000,0,0,0,0,0,0,2,20399,2403,17996,2,19945,0,19945,3,19645,0,19645,2,11229,2000,9229
14743,30000,24000,0,0,0,0,0,0,0,19341,1000,18341,0,12459,249,12210,0,12244,600,11644,0,11550,201,11349
14744,240000,192000,0,0,0,0,0,0,0,0,0,0,-2,0,0,0,-2,0,0,0,-2,0,0,0
14745,30000,24000,0,1,0,0,0,1,0,26602,1620,24982,0,21000,0,21000,0,0,0,0,0,0,0,0
14746,150000,120000,0,0,0,0,0,0,-2,2154,2160,-6,-2,2900,3046,-146,-2,2512,2519,-7,-2,3514,3625,-111
14747,130000,104000,0,1,1,0,0,0,0,131790,12206,119584,0,126031,6259,119772,0,99489,5105,94384,0,94722,3474,91248
14748,100000,80000,0,0,0,0,0,0,0,76305,3352,72953,0,77855,3413,74442,0,78961,3000,75961,0,80452,2919,77533
14749,30000,24000,0,1,1,1,1,0,0,28122,1447,26675,0,29139,3000,26139,0,28534,0,28534,2,30360,2300,28060
14750,140000,112000,0,0,0,0,0,0,2,91936,1800,90136,2,94623,5000,89623,2,94952,1900,93052,2,95234,4700,90534
14751,90000,72000,0,1,1,1,1,0,0,89059,5167,83892,0,88822,3300,85522,0,90978,3615,87363,0,89363,3217,86146
14752,520000,416000,0,0,0,0,0,0,0,102762,3800,98962,0,104865,3803,101062,0,106947,3822,103125,0,109507,4277,105230
14753,50000,40000,0,0,0,0,0,0,0,26901,1555,25346,0,26021,1148,24873,0,19438,1000,18438,0,12198,422,11776
14754,100000,80000,0,0,0,0,0,0,0,44446,1742,42704,0,45704,2000,43704,0,54916,10000,44916,0,56063,2025,54038
14755,120000,96000,0,0,0,0,0,0,-1,390,390,0,-1,390,390,0,-1,390,390,0,-1,390,390,0
14756,50000,40000,0,0,0,0,0,1,0,10099,1629,8470,0,8686,500,8186,0,8614,500,8114,0,6977,1000,5977
14757,50000,40000,0,0,0,0,0,0,2,25142,1000,24142,2,15498,1000,14498,0,16613,1366,15247,0,16197,0,16197
14758,180000,144000,0,0,0,0,0,1,0,29650,2000,27650,0,29981,1100,28881,0,30419,1200,29219,0,31127,1500,29627
14759,400000,320000,0,0,0,0,0,0,-1,67823,1939,65884,0,61918,1720,60198,0,61884,1712,60172,0,61911,1766,60145
14760,80000,64000,0,0,0,0,0,0,-1,817,1000,-183,-1,1907,1907,0,-1,1962,2000,-38,-1,1865,2000,-135
14761,500000,400000,0,0,0,0,0,0,-1,32413,32611,-198,-1,193427,200967,-7540,-1,21978,22074,-96,-1,38102,38272,-170
14762,210000,168000,0,1,1,1,1,0,0,200590,7400,193190,0,204494,7300,197194,0,208990,7700,201290,0,214031,8600,205431
14763,100000,80000,0,0,0,0,0,0,0,85787,88678,-2891,-1,78762,2169,76593,0,79529,2634,76895,0,80335,3132,77203
14764,140000,112000,0,1,1,1,1,0,0,142477,12500,129977,0,140617,4009,136608,2,139353,5000,134353,0,140953,6000,134953
14765,140000,112000,0,1,1,1,0,0,2,136222,10,136212,2,124871,6015,118856,0,118141,4000,114141,0,111716,4000,107716
14766,20000,16000,0,0,0,0,0,0,-1,184,0,184,2,5932,5924,8,0,7725,2000,5725,0,7679,2451,5228
14767,80000,64000,0,0,0,0,0,1,2,46998,2000,44998,2,47929,2000,45929,2,46860,0,46860,2,51931,6000,45931
14768,30000,24000,0,0,0,0,0,1,0,19129,2000,17129,2,18527,0,18527,2,18758,679,18079,0,19285,837,18448
14769,70000,56000,0,0,0,0,0,1,-1,5566,1113,4453,0,6139,1076,5063,0,5868,195,5673,0,6399,1000,5399
14770,380000,304000,0,1,0,0,0,0,0,349753,15287,334466,0,296465,8532,287933,0,193342,4334,189008,0,311009,317077,-6068
14771,230000,184000,0,0,0,0,0,0,0,54556,5000,49556,0,58624,5000,53624,0,59848,2197,57651,0,68828,10000,58828
14772,360000,288000,0,0,0,0,0,0,-1,1397,1397,0,-1,298,298,0,-1,7950,7950,0,-1,60097,60097,0
14773,320000,256000,0,0,0,0,0,0,0,254293,17000,237293,0,206521,7030,199491,0,202697,7000,195697,0,203332,10000,193332
14774,360000,288000,0,0,0,0,0,0,0,10633,3017,7616,0,7217,144,7073,0,7364,147,7217,0,-7,0,-7
14775,50000,40000,0,0,0,0,0,0,0,21068,2000,19068,0,18132,2000,16132,0,18405,1000,17405,0,16754,1000,15754
14776,130000,104000,0,0,0,0,0,0,2,700,700,0,-1,0,0,0,-1,0,0,0,-2,0,0,0
14777,470000,376000,0,0,0,0,0,0,0,26805,1502,25303,0,24808,3696,21112,0,21101,1008,20093,0,17906,1006,16900
14778,280000,224000,0,0,0,0,0,0,-1,6781,7104,-323,-1,5725,5857,-132,-1,3989,3989,0,-1,2599,2599,0
14779,80000,64000,0,0,0,0,0,0,2,14814,3412,11402,2,14163,0,14163,3,13770,0,13770,2,15323,1810,13513
14780,80000,64000,0,0,0,0,0,0,-1,16801,12532,4269,-1,12532,1,12531,2,12059,0,12059,0,1242,0,1242
14781,60000,48000,0,0,0,0,0,0,-1,849,849,0,-1,1120,1120,0,-1,327,327,0,-1,531,531,0
14782,170000,136000,0,0,0,0,0,1,-1,676,676,0,-1,326,326,0,-1,326,326,0,-1,326,326,0
14783,150000,120000,0,0,0,0,0,0,-2,-512,0,-512,-2,-512,0,-512,-2,-508,4,-512,-2,-913,0,-913
14784,410000,328000,0,0,0,0,0,0,-1,15106,15106,0,-1,15313,6000,9313,0,10959,0,10959,0,8341,8341,0
14785,210000,168000,0,0,0,0,0,0,-1,0,0,0,-2,0,0,0,-2,0,0,0,-2,0,0,0
14786,470000,376000,0,0,0,0,0,1,-1,350,350,0,-1,2277,2277,0,-2,41523,41523,0,-1,2175,2175,0
14787,460000,368000,0,0,0,0,0,1,-2,0,0,0,-2,0,0,0,-2,0,0,0,-2,0,0,0
14788,80000,64000,0,0,0,0,0,0,0,14631,1500,13131,0,8592,1500,7092,0,1425,1425,0,-1,88516,88516,0
14789,410000,328000,0,0,0,0,0,0,-2,23591,23785,-194,-2,224,225,-1,-2,193,194,-1,-2,6441,6473,-32
14790,100000,80000,0,0,0,0,0,0,0,63464,2009,61455,0,45910,3000,42910,0,46996,2000,44996,0,42935,2000,40935
14791,500000,400000,0,0,0,0,0,0,-1,-50,0,-50,-1,-50,0,-50,-2,10037,10087,-50,-1,79,79,0
14792,490000,392000,0,0,0,0,0,0,-1,739,742,-3,-1,-11,0,-11,-1,5132,5143,-11,-1,2724,13,2711
14793,170000,136000,0,0,0,0,0,0,0,91571,4071,87500,0,94045,4000,90045,0,97965,5600,92365,2,101176,5000,96176
14794,150000,120000,0,0,0,0,0,0,0,79424,3000,76424,2,76350,0,76350,2,79721,6000,73721,2,77028,0,77028
14795,50000,40000,0,1,1,1,1,1,5,48988,0,48988,4,47917,0,47917,3,47020,0,47020,2,48027,1943,46084
14796,150000,120000,0,0,0,0,0,0,0,50170,3000,47170,0,46725,3000,43725,0,100503,5000,95503,0,54798,10000,44798
14797,50000,40000,0,1,1,0,0,0,0,51113,4900,46213,0,48114,0,48114,2,19400,3000,16400,0,19240,2500,16740
14798,170000,136000,0,0,0,0,0,0,0,67062,3028,64034,0,68188,2847,65341,0,56454,2600,53854,0,58453,3400,55053
14799,260000,208000,0,0,0,0,0,0,-1,20258,20034,224,0,52574,52045,529,0,19463,7000,12463,0,20226,8073,12153
14800,300000,240000,0,0,0,0,0,0,-1,291,291,0,-1,291,291,0,-1,291,291,0,-1,291,291,0
14801,50000,40000,0,0,0,0,0,1,-1,0,0,0,-1,0,0,0,-2,0,0,0,-2,0,0,0
14802,280000,224000,0,0,0,0,0,0,-1,10190,10200,-10,-1,2355,2355,0,-1,3612,3612,0,-1,586,4248,-3662
14803,60000,48000,0,0,0,0,0,1,4,29210,0,29210,3,29729,1300,28429,2,30505,1400,29105,2,32232,2400,29832
14804,180000,144000,0,0,0,0,0,0,-2,9973,9973,0,-2,10069,10083,-14,-2,13190,13279,-89,-2,20127,20127,0
14805,300000,240000,0,0,0,0,0,0,-1,2500,0,2500,2,2500,0,2500,2,2500,0,2500,2,2500,0,2500
14806,180000,144000,0,0,0,0,0,0,0,160925,20000,140925,0,132312,10130,122182,0,80984,3000,77984,0,42562,4000,38562
14807,150000,120000,0,1,0,0,0,0,0,149313,6000,143313,0,129768,40000,89768,0,136084,42000,94084,0,30312,34880,-4568
14808,20000,16000,0,1,0,0,0,0,0,18980,1179,17801,0,7674,1000,6674,0,5708,114,5594,0,4899,98,4801
14809,20000,16000,0,0,0,0,0,0,0,0,0,0,0,0,0,0,-2,0,0,0,-2,0,0,0
14810,290000,232000,0,1,0,0,0,1,0,250549,4647,245902,0,31370,949,30421,0,-4020,4391,-8411,0,107239,146216,-38977
14811,360000,288000,0,0,0,0,0,0,-1,1008,1008,0,-1,1250,1250,0,-1,0,0,0,-1,860,860,0
14812,160000,128000,0,0,0,0,0,0,-1,0,0,0,-1,0,0,0,-2,0,0,0,-2,0,0,0
14813,110000,88000,0,0,0,0,0,0,0,86595,3056,83539,0,81077,2802,78275,0,77747,2813,74934,0,78913,4000,74913
14814,180000,144000,0,0,0,0,0,0,0,71902,3340,68562,0,10045,500,9545,0,10484,1000,9484,0,10816,1000,9816
14815,110000,88000,0,0,0,0,0,0,0,42051,1774,40277,0,30803,1526,29277,0,28377,1100,27277,0,29053,1200,27853
14816,390000,312000,0,0,0,0,0,0,-1,45281,2287,42994,0,31219,1500,29719,0,24962,4962,20000,0,17002,815,16187
14817,330000,264000,0,0,0,0,0,0,0,228275,10008,218267,0,227974,10000,217974,0,185431,20000,165431,0,107493,25000,82493
14818,500000,400000,0,0,0,0,0,0,-1,28362,28435,-73,-1,41489,41503,-14,-1,44158,31748,12410,0,37880,25449,12431
14819,120000,96000,0,0,0,0,0,0,0,75735,4020,71715,0,62511,3000,59511,0,62179,5700,56479,0,60981,0,60981
14820,200000,160000,0,0,0,0,0,0,0,112715,3891,108824,0,102542,3488,99054,0,92335,3250,89085,0,81667,2755,78912
14821,410000,328000,0,1,1,1,1,1,0,369776,15500,354276,0,368779,14000,354779,0,369358,13580,355778,0,368043,14000,354043
14822,380000,304000,0,0,0,0,0,0,0,63203,8009,55194,0,44889,7000,37889,0,44276,6000,38276,0,31799,10500,21299
14823,220000,176000,0,0,0,0,0,1,0,23115,2009,21106,0,20354,5004,15350,0,7438,1000,6438,0,4887,1000,3887
14824,390000,312000,0,0,0,0,0,0,0,0,0,0,0,0,0,0,-2,0,0,0,-2,0,0,0
14825,210000,168000,0,0,0,0,0,0,0,45502,20020,25482,0,41704,1672,40032,0,40509,1600,38909,0,41305,1600,39705
14826,230000,184000,0,0,0,0,0,0,0,168214,7684,160530,0,159106,5600,153506,0,162436,5755,156681,0,165878,6000,159878
14827,50000,40000,0,1,1,1,1,1,2,45470,2000,43470,2,46424,2000,44424,2,45377,0,45377,2,48441,3800,44641
14828,300000,240000,0,0,0,0,0,0,2,0,0,0,2,780,780,0,-1,70,150,-80,-1,430,710,-280
14829,230000,184000,0,0,0,0,0,1,-2,0,0,0,-2,0,0,0,-2,0,0,0,-2,0,0,0
14830,160000,128000,0,0,0,0,0,0,0,102324,4000,98324,0,104697,4000,100697,0,103202,4115,99087,0,94360,4000,90360
14831,160000,128000,0,0,0,0,0,0,2,-110,0,-110,2,187,687,-500,-1,197,400,-203,-1,307,500,-193
14832,360000,288000,0,0,0,0,0,0,-2,0,0,0,-2,0,0,0,-2,0,0,0,-2,0,0,0
14833,310000,248000,0,0,0,0,0,1,-1,1415,1415,0,-1,883,0,883,0,883,883,0,-1,1033,1033,0
14834,270000,216000,0,0,0,0,0,1,-1,792,792,0,-1,396,0,396,0,396,396,0,-1,396,396,0
14835,240000,192000,0,0,0,0,0,0,-1,5500,5500,0,-1,5500,5500,0,-1,5500,5500,0,-1,5463,5463,0
14836,360000,288000,0,0,0,0,0,0,0,293675,100000,193675,0,196475,0,196475,0,2475,0,2475,0,0,0,0
14837,80000,64000,0,0,0,0,0,0,2,7156,7156,0,-1,2099,2099,0,-1,915,0,915,0,915,915,0
14838,10000,8000,0,0,1,1,1,0,0,8374,1139,7235,0,8540,305,8235,0,8719,316,8403,0,8905,331,8574
14839,320000,256000,0,1,1,1,0,0,0,283356,1514,281842,2,275361,9122,266239,0,268871,9518,259353,0,256974,9209,247765
14840,180000,144000,0,0,0,0,0,0,-1,264,264,0,-1,264,264,0,-1,264,264,0,-1,264,264,0
14841,480000,384000,0,0,0,0,0,0,-1,12318,12331,-13,-1,6295,6295,0,-1,5284,5284,0,-1,6220,6220,0
14842,200000,160000,0,1,1,1,1,0,0,175956,8045,167911,0,171340,8000,163340,0,177236,8000,169236,0,181978,7000,174978
14843,210000,168000,0,0,0,0,0,0,-1,775,775,0,-1,0,0,0,-1,0,0,0,-2,635,635,0
14844,120000,96000,0,1,1,1,1,0,0,121907,6000,115907,0,123949,6300,117649,0,112430,4000,108430,0,114322,4300,110022
14845,20000,16000,0,1,1,1,0,0,0,20464,2900,17564,0,19756,0,19756,2,19978,773,19205,0,11680,626,11054
14846,150000,120000,0,0,0,0,0,0,-1,3337,3367,-30,-1,1012,1020,-8,-1,4944,5392,-448,-1,1016,1016,0
14847,180000,144000,0,0,0,0,0,0,-1,106,106,0,-1,59,59,0,-2,-47,47,-94,-2,347,570,-223
14848,10000,8000,0,0,0,0,0,1,0,9756,1800,7956,0,8560,1300,7260,0,780,800,-20,-1,0,0,0
14849,200000,160000,0,0,0,0,0,0,-2,2090,2090,0,-2,0,0,0,-2,0,0,0,-2,2820,2820,0
14850,20000,16000,0,0,0,0,0,0,-1,0,0,0,-1,832,832,0,-1,1486,1486,0,-1,0,0,0
14851,130000,104000,0,0,0,0,0,0,0,62650,2230,60420,0,63896,2243,61653,0,65411,2500,62911,0,64684,3000,61684
14852,500000,400000,0,0,0,0,0,1,-1,37844,37311,533,0,9441,9442,-1,-1,12700,5001,7699,0,19267,10001,9266
14853,60000,48000,0,0,0,0,0,0,0,43077,1850,41227,0,36197,1318,34879,0,34283,5822,28461,0,20395,794,19601
14854,500000,400000,0,0,0,0,0,0,0,291760,20026,271734,0,288024,20020,268004,0,274632,10017,264615,0,266669,15024,251645
14855,100000,80000,0,0,0,0,0,0,0,24666,1200,23466,0,10550,1000,9550,0,0,0,0,0,0,0,0
14856,100000,80000,0,0,0,0,0,0,-2,0,0,0,-2,0,0,0,-2,0,0,0,-2,0,0,0
14857,410000,328000,0,0,0,0,0,0,-2,388,388,0,-2,388,388,0,-2,110345,110345,0,-1,116128,8000,108128
14858,120000,96000,0,0,0,0,0,0,0,49933,1933,48000,0,51400,2400,49000,0,0,0,0,0,0,0,0
14859,20000,16000,0,0,0,0,0,0,0,14450,1000,13450,0,8796,8796,0,-1,5419,108,5311,0,2377,2377,0
14860,300000,240000,0,0,0,0,0,0,-1,12970,12985,-15,-1,14786,14816,-30,-1,12794,12808,-14,-1,14180,14201,-21
14861,90000,72000,0,0,0,0,0,0,0,28718,2000,26718,0,28847,2000,26847,0,28747,2000,26747,0,29177,2000,27177
14862,160000,128000,0,0,0,0,0,0,0,38870,1325,37545,0,28574,891,27683,0,27268,1000,26268,0,28021,1098,26923
14863,20000,16000,0,0,0,0,0,0,-1,390,390,0,-1,780,780,0,-1,780,0,780,0,10400,10400,0
14864,40000,32000,0,1,1,1,1,0,0,33634,1600,32034,0,34586,1500,33086,0,34762,1500,33262,0,35673,1500,34173
14865,150000,120000,0,0,0,0,0,0,0,24410,1403,23007,0,27007,3000,24007,0,28585,2000,26585,0,27827,1155,26672
14866,60000,48000,0,0,0,0,0,0,0,46074,1608,44466,0,39917,1391,38526,0,39382,1410,37972,0,39799,1580,38219
14867,150000,120000,0,0,0,0,0,0,-1,0,0,0,-2,159,159,0,-1,14903,14903,0,-1,410,509,-99
14868,420000,336000,1,1,1,1,1,0,0,483277,24000,459277,0,479800,11000,468800,0,489200,10000,479200,0,489200,0,489200
14869,290000,232000,0,0,0,0,0,0,0,5441,1200,4241,0,7371,2033,5338,0,38832,38832,0,-1,41955,3900,38055
14870,50000,40000,0,0,0,0,0,1,-1,3079,0,3079,2,7095,4095,3000,0,7237,245,6992,0,6446,234,6212
14871,110000,88000,0,0,0,0,0,0,0,66533,2123,64410,0,67677,1952,65725,0,39066,2000,37066,0,39884,1468,38416
14872,90000,72000,0,1,1,1,1,0,2,89896,3000,86896,2,86706,0,86706,2,87385,3000,84385,0,88351,5000,83351
14873,50000,40000,0,0,1,1,1,0,0,42996,5064,37932,0,43992,2000,41992,2,43155,0,43155,2,44436,2000,42436
14874,60000,48000,0,0,0,0,0,0,0,15557,1400,14157,0,15526,1000,14526,0,16273,1000,15273,0,17001,1000,16001
14875,260000,208000,0,0,0,0,0,0,0,190339,7200,183139,0,186688,6500,180188,0,177785,6000,171785,0,165789,6000,159789
14876,30000,24000,0,0,0,0,0,0,-1,736,0,736,2,736,736,0,-1,736,736,0,-1,1423,1423,0
14877,360000,288000,0,0,0,0,0,0,-1,0,0,0,-2,0,0,0,-2,0,0,0,-2,902,902,0
14878,50000,40000,0,0,0,0,0,0,0,26482,1247,25235,0,16770,1770,15000,0,15529,700,14829,0,16266,1000,15266
14879,60000,48000,0,0,0,0,0,0,0,41137,2000,39137,0,43644,3500,40144,0,44498,1700,42798,2,45417,1800,43617
14880,70000,56000,0,0,0,0,0,0,2,48214,1500,46714,0,27572,1300,26272,0,26810,1505,25305,0,20541,1000,19541
14881,200000,160000,0,0,0,0,0,0,0,45929,5929,40000,0,48661,3500,45161,0,49723,2000,47723,0,50896,2000,48896
14882,60000,48000,0,1,0,0,0,1,0,50243,1237,49006,0,15092,422,14670,0,12037,528,11509,0,10000,2000,8000
14883,50000,40000,0,0,0,0,0,0,-2,3508,3508,0,-2,339,339,0,-2,1655,1655,0,-2,679,679,0
14884,200000,160000,0,0,0,0,0,0,-1,0,0,0,-1,0,0,0,-2,0,0,0,-2,0,0,0
14885,20000,16000,0,1,1,1,1,1,0,18902,1308,17594,0,38250,683,37567,0,19709,1472,18237,0,19774,714,19060
14886,320000,256000,0,0,0,0,0,0,-2,0,0,0,-2,0,0,0,-2,0,0,0,-2,0,0,0
14887,120000,96000,0,0,0,0,0,1,0,78276,4326,73950,0,78971,3000,75971,0,80907,9000,71907,0,79219,0,79219
14888,200000,160000,0,0,0,0,0,0,-1,40258,40265,-7,-1,15103,15159,-56,-1,14079,14079,0,-1,20878,20878,0
14889,120000,96000,0,0,0,0,0,0,-1,325,325,0,-1,325,325,0,-1,325,325,0,-1,1866,1866,0
14890,240000,192000,0,1,1,0,0,0,0,226013,11000,215013,0,229014,9000,220014,0,178852,7000,171852,0,182547,7000,175547
14891,300000,240000,0,0,0,0,0,0,-1,2095,2095,0,-1,1215,1215,0,-1,340,340,0,-1,1424,1424,0
14892,80000,64000,0,0,0,0,0,1,2,50416,2100,48316,2,51293,2000,49293,2,50170,0,50170,2,53391,4200,49191
14893,120000,96000,0,0,0,0,0,0,-2,0,0,0,-2,0,0,0,-2,0,0,0,-2,0,0,0
14894,270000,216000,0,0,0,0,0,0,-2,0,0,0,-2,0,0,0,-2,0,0,0,-2,0,0,0
14895,60000,48000,0,0,0,0,0,0,0,7506,1508,5998,0,4790,4790,0,-1,6388,6388,0,-1,5816,6046,-230
14896,290000,232000,0,0,0,0,0,0,0,70642,5000,65642,0,71008,4706,66302,0,65455,0,65455,2,63421,2007,61414
14897,50000,40000,0,0,0,0,0,0,-1,2500,2525,-25,-1,0,0,0,-1,0,0,0,-2,0,0,0
14898,260000,208000,0,0,0,0,0,0,2,1350,1350,0,-1,4645,4645,0,-1,4625,4625,0,-1,12209,12209,0
14899,140000,112000,0,0,0,0,0,0,0,98007,4505,93502,0,82227,12906,69321,0,65000,0,65000,2,60848,2210,58638
14900,80000,64000,0,0,0,0,0,0,0,58346,1973,56373,0,56361,3000,53361,0,55933,5000,50933,0,56936,2100,54836
14901,450000,360000,0,0,0,0,0,0,-1,2469,2000,469,-1,1562,0,1562,2,20030,20030,0,-1,9248,1000,8248
14902,160000,128000,0,0,0,0,0,0,-2,0,0,0,-2,0,0,0,-2,1240,1240,0,-1,0,0,0
14903,100000,80000,0,0,0,0,0,0,-1,589,1005,-416,-1,1416,1416,0,-1,416,416,0,-1,416,416,0
14904,20000,16000,0,1,0,0,0,0,0,19693,0,19693,2,11932,239,11693,2,1280,3380,-2100,-1,0,0,0
14905,180000,144000,0,0,0,0,0,0,2,376,376,0,-1,0,0,0,-1,2202,2202,0,-1,150,0,150
14906,310000,248000,0,0,0,0,0,0,-2,256,257,-1,-2,2513,2537,-24,-2,795,798,-3,-2,250,251,-1
14907,20000,16000,0,1,1,1,1,0,4,18547,1300,17247,3,19118,1170,17948,3,18679,0,18679,2,19812,1600,18212
14908,10000,8000,0,1,1,1,1,1,0,10067,1210,8857,0,10105,1200,8905,0,9471,339,9132,0,9669,351,9318
14909,150000,120000,0,0,0,0,0,0,-2,0,0,0,-2,0,0,0,-2,0,0,0,-2,0,0,0
14910,210000,168000,0,0,0,0,0,0,0,54929,1900,53029,0,55696,1900,53796,0,54773,1925,52848,0,51616,1845,49771
14911,110000,88000,0,0,0,0,0,0,0,65379,5379,60000,0,65467,5467,60000,0,64596,4596,60000,0,62405,3405,59000
14912,120000,96000,0,0,0,0,0,0,0,-718,1300,-2018,-2,1282,2000,-718,-1,81988,81899,89,0,83665,3200,80465
14913,160000,128000,0,0,0,0,0,0,-1,-527,396,-923,-2,-923,396,-1319,-2,-1488,565,-2053,-2,-1884,792,-2676
14914,250000,200000,0,0,0,0,0,0,-2,138,138,0,-1,946,946,0,-1,377,377,0,-1,0,0,0
14915,110000,88000,0,0,0,0,0,1,0,74341,3000,71341,0,50184,1800,48384,0,51412,2041,49371,0,49448,2069,47379
14916,30000,24000,0,1,1,1,1,1,0,27456,1600,25856,2,27915,1200,26715,2,27185,0,27185,2,28806,2200,26606
14917,20000,16000,0,1,1,1,1,0,0,17207,0,17207,2,20409,3490,16919,2,20844,900,19944,2,20349,0,20349
14918,50000,40000,0,0,0,0,0,1,-2,0,0,0,-2,0,0,0,-2,0,0,0,-2,0,0,0
14919,500000,400000,0,0,0,0,0,0,0,119760,7041,112719,0,72506,4123,68383,0,60548,5039,55509,0,57212,5071,52141
14920,500000,400000,0,0,0,0,0,0,0,184782,20241,164541,0,152365,20154,132211,0,139757,20019,119738,0,153348,20151,133197
14921,100000,80000,0,0,0,0,0,0,0,82669,4025,78644,0,70018,2511,67507,0,57847,1523,56324,0,43618,1292,42326
14922,360000,288000,0,0,0,0,0,0,0,49781,10180,39601,0,12846,41,12805,0,4548,22,4526,0,9820,9865,-45
14923,470000,376000,0,0,0,0,0,0,-2,0,0,0,-2,0,0,0,-2,0,0,0,-2,0,0,0
14924,80000,64000,0,0,0,0,0,0,0,61991,10036,51955,0,30597,3000,27597,0,30794,2000,28794,0,30684,2000,28684
14925,150000,120000,0,0,0,0,0,0,-1,0,0,0,-2,6784,6784,0,-1,6923,159,6764,0,14116,167,13949
14926,120000,96000,0,0,0,0,0,1,-2,-1248,0,-1248,-2,832,2080,-1248,-1,416,0,416,0,1398,1398,0
14927,150000,120000,0,0,0,0,0,0,0,70203,3300,66903,0,71321,3200,68121,0,72235,3000,69235,0,73611,3000,70611
14928,110000,88000,0,0,0,0,0,0,0,51166,2119,49047,0,42718,1857,40861,0,42183,1418,40765,0,40909,1390,39519
14929,150000,120000,0,0,0,0,0,0,-1,813,813,0,-1,3028,3032,-4,-1,5264,5264,0,-1,208,208,0
14930,50000,40000,0,0,0,0,0,0,0,4013,1000,3013,0,2027,41,1986,0,15090,30525,-15435,-1,14078,477,13601
14931,360000,288000,0,0,0,0,0,0,-1,5306,5306,0,-1,3603,0,3603,2,604,604,0,-1,14850,14850,0
14932,50000,40000,0,1,1,1,1,0,2,46836,0,46836,4,45785,0,45785,3,47003,2100,44903,2,48085,2000,46085
14933,170000,136000,0,1,1,0,0,0,0,168824,7000,161824,0,164597,5000,159597,0,94094,4000,90094,0,92177,3500,88677
14934,20000,16000,0,0,0,0,0,0,0,14054,1400,12654,0,14900,1200,13700,0,15000,300,14700,0,0,0,0
14935,100000,80000,0,1,1,1,1,0,3,97410,4400,93010,2,98611,3700,94911,2,100787,4700,96087,2,102261,3300,98961
14936,190000,152000,0,0,0,0,0,0,0,5040,0,5040,2,6050,1103,4947,0,6447,500,5947,0,7339,1000,6339
14937,180000,144000,0,0,0,0,0,0,0,81166,5000,76166,0,72463,6800,65663,0,72189,5000,67189,0,70712,5000,65712
14938,200000,160000,0,0,0,0,0,0,0,56909,2472,54437,0,56841,1683,55158,0,51245,1755,49490,0,42268,1658,40610
14939,60000,48000,0,0,0,0,0,0,0,48491,2000,46491,0,28518,1000,27518,0,29157,959,28198,0,30073,1300,28773
14940,210000,168000,0,0,0,0,0,0,-2,20363,21337,-974,-1,770,770,0,-1,0,0,0,-1,6138,6138,0
14941,120000,96000,0,1,1,1,1,0,0,125089,9000,116089,0,122242,1609,120633,2,119996,5000,114996,0,122049,5000,117049
14942,220000,176000,0,0,0,0,0,0,0,99009,5000,94009,0,100462,4000,96462,0,102614,3824,98790,0,104806,4000,100806
14943,200000,160000,0,0,0,0,0,0,-2,1100,1100,0,-2,1500,1500,0,-2,1402,1402,0,-2,0,0,0
14944,360000,288000,0,0,0,0,0,0,2,0,0,0,2,0,0,0,-2,0,0,0,-2,0,0,0
14945,210000,168000,0,0,0,0,0,0,0,68742,3000,65742,0,65557,3000,62557,0,65287,3000,62287,0,64428,3000,61428
14946,180000,144000,0,0,0,0,0,0,0,59852,3000,56852,0,60761,2500,58261,0,62425,2800,59625,0,63982,3000,60982
14947,100000,80000,0,0,0,0,0,0,-2,0,0,0,-2,0,0,0,-2,2483,2483,0,-1,0,0,0
14948,120000,96000,0,0,0,0,0,1,-1,776,776,0,-1,776,776,0,-1,776,776,0,-1,776,776,0
14949,250000,200000,0,0,0,0,0,0,-1,40292,39600,692,-1,39600,7,39593,2,21304,1185,20119,2,1185,0,1185
14950,80000,64000,0,0,0,0,0,0,0,36601,2500,34101,0,40589,5000,35589,0,42675,3000,39675,0,44567,2500,42067
14951,120000,96000,0,0,0,0,0,0,-1,390,0,390,2,0,0,0,2,762,762,0,-1,-18,0,-18
14952,200000,160000,0,0,0,0,0,0,-1,3275,3275,0,-1,5430,5430,0,-1,6683,6871,-188,-1,7790,7790,0
14953,150000,120000,0,0,0,0,0,0,-1,63917,63917,0,-1,59865,2100,57765,0,59258,2100,57158,0,57924,2200,55724
14954,230000,184000,0,1,1,1,1,1,2,221001,10000,211001,2,220886,5000,215886,2,239299,23700,215599,2,237297,2000,235297
14955,110000,88000,0,1,0,0,0,0,2,95391,3515,91876,0,79409,3307,76102,0,78014,3014,75000,0,77709,3009,74700
14956,20000,16000,0,0,0,0,0,1,3,2160,21,2139,2,0,10800,-10800,2,0,0,0,-2,0,0,0
14957,30000,24000,0,0,0,1,0,0,2,23117,0,23117,2,24800,3000,21800,0,29410,5000,24410,0,23905,23905,0
14958,460000,368000,0,0,0,0,0,0,0,295807,14000,281807,0,291616,11500,280116,0,289529,10500,279029,0,289449,10500,278949
14959,200000,160000,0,0,0,0,0,0,-1,3673,3673,0,-1,0,0,0,-1,150,150,0,-1,609,609,0
14960,10000,8000,0,0,1,0,0,0,0,8371,1800,6571,0,8090,0,8090,2,8261,450,7811,0,8773,800,7973
14961,150000,120000,0,0,0,0,0,0,0,96314,8000,88314,0,87862,14,87848,2,79936,3000,76936,0,76971,4500,72471
14962,410000,328000,0,1,1,0,0,0,0,410877,17986,392891,0,419454,18545,400909,0,1356,1362,-6,-1,1362,6,1356
14963,120000,96000,0,0,0,0,0,1,0,75499,3400,72099,0,77739,3500,74239,0,78666,2815,75851,0,80399,3000,77399
14964,360000,288000,0,0,0,0,0,0,-2,387,388,-1,-2,776,779,-3,-2,810,814,-4,-2,0,0,0
14965,350000,280000,0,0,0,0,0,0,0,36582,16000,20582,0,40452,6000,34452,0,15203,314,14889,0,20596,10000,10596
14966,60000,48000,0,0,0,0,0,0,0,41746,2000,39746,0,25488,1000,24488,0,26199,1501,24698,0,28200,3000,25200
14967,130000,104000,0,0,0,0,0,0,0,0,0,0,0,0,0,0,-2,0,0,0,-2,0,0,0
14968,30000,24000,0,0,0,1,1,0,3,24087,300,23787,2,25890,2500,23390,2,25175,0,25175,2,26870,2100,24770
14969,430000,344000,0,0,0,0,0,0,-1,11164,11220,-56,-1,1531,1531,0,-1,9848,9902,-54,-1,10178,10202,-24
14970,90000,72000,0,0,0,0,0,0,-2,0,0,0,-2,0,0,0,-2,0,0,0,-2,0,0,0
14971,210000,168000,0,0,0,1,1,0,0,169614,8000,161614,0,172297,7000,165297,0,177427,8000,169427,0,182399,8000,174399
14972,20000,16000,0,0,1,1,1,1,0,19335,3900,15435,0,20029,1000,19029,0,20473,900,19573,0,19860,900,18960
14973,130000,104000,0,0,0,0,0,0,0,15546,2000,13546,0,108047,93000,15047,0,93708,4000,89708,0,97353,5027,92326
14974,350000,280000,0,0,0,0,0,0,0,26329,1441,24888,0,27343,1455,25888,0,27886,998,26888,0,28470,1033,27437
14975,100000,80000,0,0,0,0,0,0,-1,0,0,0,-1,1012,1012,0,-1,0,0,0,-1,0,0,0
14976,150000,120000,0,0,0,0,0,0,-1,32311,32311,0,-1,12791,12956,-165,-1,390,390,0,-1,1508,1508,0
14977,120000,96000,0,0,0,0,0,0,-1,1085,1085,0,-1,193,193,0,-1,1549,1549,0,-1,1549,0,1549
14978,80000,64000,0,0,0,0,0,0,0,59083,2455,56628,0,60051,2667,57384,0,41757,2002,39755,0,42641,2055,40586
14979,100000,80000,0,0,0,0,0,0,0,14320,1000,13320,0,180,180,0,-1,2500,2500,0,-1,12411,10000,2411
14980,30000,24000,1,1,0,1,1,0,0,91157,3000,88157,0,30420,31959,-1539,-1,30384,1052,29332,0,29774,1062,28712
14981,20000,16000,0,0,0,0,0,0,0,16223,1185,15038,0,15594,492,15102,0,15920,510,15410,0,15338,557,14781
14982,200000,160000,0,0,0,0,0,0,0,18834,18834,0,-1,0,60000,-60000,-1,0,0,0,-2,0,0,0
14983,320000,256000,0,0,0,0,0,0,-1,7210,7210,0,-1,6091,6091,0,-1,24641,24641,0,-1,30005,30000,5
14984,250000,200000,0,0,1,1,1,0,0,206282,7527,198755,0,210963,8000,202963,0,215711,8000,207711,0,218692,8000,210692
14985,240000,192000,0,0,0,0,0,0,0,182639,7000,175639,0,186275,6680,179595,0,190337,7070,183267,0,193961,6954,187007
14986,220000,176000,0,1,1,1,1,1,0,223193,8100,215093,0,215040,8000,207040,0,210884,7804,203080,0,210479,8254,202225
14987,390000,312000,0,0,0,0,0,1,-1,79,79,0,-1,79,0,79,-1,290,290,0,-1,106,106,0
14988,260000,208000,0,0,0,0,0,0,0,70259,2338,67921,0,58341,1911,56430,0,58730,5014,53716,0,52789,5004,47785
14989,200000,160000,0,0,0,0,0,0,-1,2249,2261,-12,-1,3367,3377,-10,-1,-33,0,-33,-1,11202,11235,-33
14990,30000,24000,0,0,0,0,0,1,3,18986,1500,17486,2,18390,0,18390,3,17954,0,17954,2,18654,1000,17654
14991,30000,24000,0,1,1,1,1,0,0,25892,1800,24092,0,27366,2200,25166,0,26798,0,26798,2,28321,2500,25821
14992,290000,232000,0,0,0,0,0,0,0,6957,0,6957,2,4954,1000,3954,0,7221,5000,2221,0,6988,2500,4488
14993,80000,64000,0,0,0,0,0,0,2,58358,2800,55558,0,58992,2200,56792,0,62696,4700,57996,0,64148,2600,61548
14994,270000,216000,0,0,0,0,0,0,0,170225,6081,164144,0,156719,5072,151647,0,151716,5009,146707,0,153519,5254,148265
14995,210000,168000,0,0,0,0,0,0,-2,4811,4811,0,-2,2994,2994,0,-2,14321,14327,-6,-2,5193,5193,0
14996,480000,384000,0,0,0,0,0,0,0,7000,1000,6000,0,7331,7331,0,-1,7000,7000,0,-1,7000,7000,0
14997,130000,104000,0,0,0,0,0,1,0,26942,941,26001,2,26210,0,26210,2,27982,2197,25785,2,27383,0,27383
14998,50000,40000,0,0,0,0,0,0,0,29128,2000,27128,0,29707,2500,27207,0,28825,1033,27792,0,29022,1053,27969
14999,300000,240000,0,0,0,0,0,0,-1,3529,4506,-977,-1,-5364,0,-5364,-1,-8943,0,-8943,-2,4057,14000,-9943
15000,200000,160000,0,0,0,0,0,0,0,13457,1000,12457,0,-387,0,-387,0,-387,0,-387,-2,-387,0,-387
15001,250000,200000,0,0,0,0,0,0,-1,8963,8963,0,-1,0,0,0,-1,14660,14660,0,-1,62832,62832,0
15002,230000,184000,0,0,1,1,1,1,0,198941,18150,180791,0,201358,7200,194158,2,204067,7500,196567,2,200720,0,200720
15003,500000,400000,0,0,1,1,0,0,0,444462,300018,144444,0,418237,15000,403237,0,424244,17000,407244,0,383145,15000,368145
15004,20000,16000,0,1,0,0,0,0,0,19744,1231,18513,0,14999,524,14475,0,15121,741,14380,0,19283,5000,14283
15005,140000,112000,0,1,1,1,1,0,0,131910,6200,125710,0,136810,10000,126810,0,133090,0,133090,2,134415,5000,129415
15006,50000,40000,0,0,0,0,0,1,-1,2136,2136,0,-1,1560,0,1560,2,1170,0,1170,0,780,0,780
15007,80000,64000,0,1,0,0,0,0,0,77416,3060,74356,0,53338,3000,50338,0,53749,2000,51749,0,51026,2000,49026
15008,500000,400000,0,0,0,0,0,0,0,185142,5000,180142,2,115640,0,115640,2,78082,5000,73082,0,80588,10000,70588
15009,360000,288000,0,0,0,0,0,0,-1,3394,3394,0,-1,6451,12902,-6451,-1,26370,27000,-630,-1,9956,0,9956
15010,160000,128000,0,0,0,0,0,0,-2,390,390,0,-2,390,390,0,-2,390,390,0,-2,584,584,0
15011,300000,240000,0,0,0,0,0,0,0,2977,3000,-23,-1,4796,2500,2296,0,2367,2367,0,-1,7367,5000,2367
15012,50000,40000,0,0,0,0,1,0,0,0,0,0,-2,2624,2624,0,-1,45567,45567,0,-1,46557,1747,44810
15013,170000,136000,0,0,0,0,0,0,0,136331,5000,131331,0,123913,5000,118913,0,122657,5000,117657,0,122225,5000,117225
15014,320000,256000,0,0,1,1,1,0,-1,303849,203849,100000,0,299996,22080,277916,0,307016,10000,297016,0,308110,10000,298110
15015,50000,40000,1,1,1,0,0,1,2,52805,0,52805,2,52546,1489,51057,2,8959,51285,-42326,2,9812,1000,8812
15016,90000,72000,0,1,1,1,1,0,0,102372,13000,89372,0,100794,7000,93794,0,98277,6000,92277,0,96735,7000,89735
15017,360000,288000,0,0,0,0,0,1,0,3113,1024,2089,0,1347,1353,-6,-1,2179,2188,-9,-1,5575,5602,-27
15018,50000,40000,0,1,1,0,0,0,0,47475,1500,45975,2,46730,101,46629,2,27204,1590,25614,2,9662,0,9662
15019,320000,256000,0,0,0,0,0,0,-1,396,396,0,-1,596,596,0,-1,13386,13386,0,-1,396,396,0
15020,80000,64000,0,0,0,0,0,0,2,42281,2200,40081,0,42605,1500,41105,0,47544,5600,41944,0,33115,0,33115
15021,360000,288000,0,0,0,0,0,0,-1,80945,79800,1145,0,54064,42015,12049,0,52342,53710,-1368,-1,33074,33074,0
15022,140000,112000,0,0,0,0,0,0,0,64487,2039,62448,0,53220,3014,50206,0,50051,2514,47537,0,45859,1656,44203
15023,100000,80000,0,0,0,0,0,0,-2,0,0,0,-2,0,0,0,-2,0,0,0,-2,0,0,0
15024,260000,208000,0,0,0,0,0,1,2,2332,2007,325,2,1277,0,1277,2,1996,1020,976,2,1020,0,1020
15025,250000,200000,1,1,1,1,1,0,3,294198,6000,288198,2,278964,5000,273964,2,270046,9600,260446,0,265787,14000,251787
15026,120000,96000,0,0,0,0,0,0,0,26523,2037,24486,0,20554,659,19895,0,19348,802,18546,0,17439,640,16799
15027,50000,40000,0,1,1,1,1,0,0,47892,2000,45892,0,49439,2500,46939,0,48630,2413,46217,0,49160,2000,47160
15028,270000,216000,0,0,0,0,0,0,0,91247,6005,85242,0,91823,4000,87823,0,93164,4000,89164,0,95211,4000,91211
15029,50000,40000,0,0,0,0,0,0,0,12594,2010,10584,0,0,0,0,0,0,0,0,-2,0,0,0
15030,220000,176000,0,1,0,0,0,0,2,184568,8304,176264,0,168683,7356,161327,0,158742,5300,153442,0,161499,5550,155949
15031,260000,208000,0,0,0,0,0,0,-2,1479,1486,-7,-2,173,174,-1,-2,6326,6357,-31,-2,369,370,-1
15032,60000,48000,0,0,0,0,0,0,-2,2933,1000,1933,-2,2933,0,2933,-2,4933,2000,2933,-2,1983,0,1983
15033,150000,120000,0,0,0,0,0,0,-2,0,0,0,-2,0,0,0,-2,0,0,0,-2,0,0,0
15034,50000,40000,0,0,0,0,0,0,0,17304,4000,13304,0,16544,2000,14544,0,14787,3000,11787,0,15975,3000,12975
15035,490000,392000,0,0,0,0,0,0,-1,25409,25458,-49,-1,15926,86,15840,0,8604,8711,-107,-1,8941,5034,3907
15036,400000,320000,0,0,0,0,0,0,0,141712,128000,13712,0,123382,5000,118382,0,125687,5000,120687,0,128018,5000,123018
15037,160000,128000,0,0,0,0,0,0,-2,0,0,0,-2,0,0,0,-2,0,0,0,-2,0,0,0
15038,150000,120000,0,0,0,0,0,0,0,75928,3504,72424,0,66245,2300,63945,0,61833,2199,59634,0,62375,2414,59961
15039,320000,256000,0,0,0,0,0,0,-2,-347,0,-347,-2,-347,0,-347,-2,-347,0,-347,-2,13694,14041,-347
15040,20000,16000,0,0,0,0,0,1,-1,2522,1000,1522,0,1261,0,1261,0,1261,1261,0,-1,930,930,0
15041,240000,192000,0,0,0,0,0,0,-2,0,0,0,-2,0,0,0,-2,0,0,0,-2,0,0,0
15042,150000,120000,0,0,0,0,0,0,-2,-7772,0,-7772,-2,-7772,0,-7772,-2,69762,77534,-7772,-2,71591,2991,68600
15043,20000,16000,0,0,0,0,0,0,0,10903,2181,8722,0,11622,900,10722,0,13280,2000,11280,0,12778,0,12778
15044,30000,24000,0,1,1,1,1,0,2,29709,1800,27909,0,29833,1000,28833,0,29306,1041,28265,0,29348,1138,28210
15045,150000,120000,0,0,0,0,0,0,-2,89742,100483,-10741,-2,116067,116567,-500,-2,97725,50156,47569,-2,76466,10383,66083
15046,50000,40000,0,0,0,0,0,0,0,9715,2000,7715,0,8965,1000,7965,0,6652,500,6152,0,7385,1000,6385
15047,140000,112000,1,1,1,1,1,0,2,142243,0,142243,3,138383,0,138383,2,131645,6000,125645,0,123840,5000,118840
15048,360000,288000,0,0,0,0,0,0,-1,735,3,732,2,-10,0,-10,2,-10,0,-10,-2,-10,0,-10
15049,150000,120000,0,0,0,0,0,0,0,92213,92457,-244,-1,70406,5023,65383,0,70037,4311,65726,0,14461,7030,7431
15050,460000,368000,0,0,0,0,0,0,0,9681,9681,0,-1,3284,3284,0,-1,732,732,0,-1,2732,2000,732
15051,230000,184000,0,0,0,0,0,0,-1,49223,30029,19194,0,66006,27417,38589,0,47412,1016,46396,0,29290,640,28650
15052,10000,8000,0,0,1,1,1,0,0,9484,2257,7227,0,10004,1200,8804,0,10084,500,9584,0,9936,500,9436
15053,240000,192000,0,0,0,0,0,0,-2,0,0,0,-2,262,262,0,-1,0,0,0,-1,1389,1389,0
15054,310000,248000,0,0,0,0,0,0,0,87720,4013,83707,0,76218,3011,73207,0,72090,3000,69090,0,71620,3001,68619
15055,180000,144000,0,0,0,0,0,0,-1,10970,10970,0,-1,12786,12786,0,-1,10300,10300,0,-1,10000,10000,0
15056,50000,40000,0,0,0,0,0,1,0,15061,3100,11961,0,14400,0,14400,2,16000,2000,14000,0,18000,2000,16000
15057,50000,40000,0,0,0,0,0,0,0,30937,2002,28935,0,19420,1002,18418,0,10385,238,10147,0,1308,1011,297
15058,50000,40000,1,1,0,0,0,0,2,50151,39,50112,2,20448,718,19730,0,20464,800,19664,0,20456,800,19656
15059,200000,160000,0,0,0,0,0,0,-1,5635,5652,-17,-1,7518,7529,-11,-1,13226,13226,0,-1,13845,4906,8939
15060,90000,72000,0,0,0,0,0,0,-1,-12,0,-12,-2,3230,3242,-12,-1,387,387,0,-1,1642,1642,0
15061,380000,304000,0,0,0,0,0,0,0,245375,11483,233892,0,249931,9578,240353,0,209711,6884,202827,0,185920,6549,179371
15062,110000,88000,0,0,0,0,0,0,0,42214,2023,40191,0,41405,1574,39831,0,40846,1375,39471,0,40385,1468,38917
15063,130000,104000,0,0,0,0,0,0,0,0,0,0,0,0,0,0,-2,0,0,0,-2,0,0,0
15064,80000,64000,0,1,1,0,0,0,0,78888,3518,75370,0,80466,3558,76908,0,28186,1200,26986,0,28445,1100,27345
15065,180000,144000,0,0,0,0,0,0,-2,1571,1571,0,-2,0,0,0,-2,4775,4775,0,-2,0,0,0
15066,90000,72000,0,1,0,0,0,1,2,91334,2090,89244,2,59253,0,59253,2,58519,2078,56441,0,58443,2900,55543
15067,200000,160000,0,0,0,0,0,0,-2,5892,5892,0,-2,2267,2267,0,-2,11679,11679,0,-2,0,0,0
15068,50000,40000,0,0,0,0,0,0,-1,954,1908,-954,-1,1154,764,390,2,-572,0,-572,2,-962,0,-962
15069,30000,24000,0,0,0,0,0,0,0,15354,1631,13723,0,5023,300,4723,0,5275,375,4900,0,54,54,0
15070,280000,224000,0,1,1,0,0,0,0,273160,9563,263597,0,257689,15017,242672,0,193231,5374,187857,0,191143,5420,185723
15071,130000,104000,0,0,0,0,0,0,0,97727,0,97727,2,98588,3401,95187,0,97129,3509,93620,0,98016,3671,94345
15072,30000,24000,1,1,1,1,0,0,5,31397,0,31397,4,30321,0,30321,3,30000,0,30000,2,28961,5000,23961
15073,150000,120000,0,0,0,0,0,0,0,39051,1566,37485,0,25960,1441,24519,0,12889,259,12630,0,12890,12891,-1
15074,50000,40000,0,0,0,0,0,0,0,18419,1267,17152,0,18786,634,18152,0,19187,665,18522,0,17175,668,16507
15075,200000,160000,0,0,0,0,0,0,-2,653,653,0,-1,653,0,653,2,653,0,653,0,0,0,0
15076,460000,368000,0,0,0,0,0,0,-1,19146,19441,-295,-1,27639,27778,-139,-1,38586,38780,-194,-1,-260,0,-260
15077,150000,120000,0,0,0,0,0,0,0,52714,0,52714,2,56329,4500,51829,2,57311,2500,54811,2,56265,0,56265
15078,140000,112000,0,0,0,0,0,0,0,64992,2226,62766,0,52809,2367,50442,0,51406,1740,49666,0,50328,1754,48574
15079,30000,24000,0,0,0,0,0,0,2,19607,0,19607,2,21778,2500,19278,2,22124,1000,21124,2,22622,1000,21622
15080,150000,120000,0,0,0,0,0,1,2,0,0,0,2,10195,10195,0,-1,24232,24232,0,-1,22000,0,22000
15081,500000,400000,0,0,0,0,0,0,-1,22999,83000,-60001,-1,18339,0,18339,-1,-3876,0,-3876,-1,15586,20000,-4414
15082,50000,40000,0,0,0,0,0,0,0,45811,13000,32811,0,48192,9036,39156,0,9498,6190,3308,0,6733,10135,-3402
15083,20000,16000,0,1,1,1,1,0,0,19690,1302,18388,0,19684,686,18998,0,19697,701,18996,0,19849,855,18994
15084,400000,320000,0,1,1,1,1,0,0,366338,0,366338,2,374255,14000,360255,0,409777,42000,367777,0,527566,126000,401566
15085,140000,112000,0,0,0,0,0,0,0,0,0,0,0,0,0,0,-2,0,0,0,-2,0,0,0
15086,500000,400000,0,0,0,0,0,0,0,293177,20018,273159,0,274539,10000,264539,0,253443,79377,174066,0,253671,52778,200893
15087,50000,40000,0,0,0,0,0,0,0,28405,1800,26605,0,27959,1729,26230,0,27785,945,26840,0,28123,1149,26974
15088,70000,56000,0,0,0,0,0,0,0,24979,1414,23565,0,25665,1100,24565,0,26357,1104,25253,0,26768,1000,25768
15089,130000,104000,0,0,0,0,0,0,-1,780,0,780,2,390,0,390,0,0,0,0,0,780,780,0
15090,50000,40000,0,0,0,0,0,0,0,19468,1300,18168,0,16989,2800,14189,0,17326,619,16707,0,17748,700,17048
15091,70000,56000,0,1,1,1,1,0,0,69699,2699,67000,0,69484,2660,66824,0,71067,2879,68188,0,67568,2568,65000
15092,40000,32000,0,1,1,1,1,0,0,36726,0,36726,2,40985,4898,36087,2,40085,0,40085,3,39354,0,39354
15093,20000,16000,0,0,0,0,0,1,0,6362,1362,5000,0,7256,1000,6256,0,6995,0,6995,2,7228,350,6878
15094,160000,128000,0,1,1,0,0,0,0,158156,5680,152476,0,153699,4950,148749,0,127366,4350,123016,0,117812,4300,113512
15095,60000,48000,0,0,0,0,0,0,-1,42778,20052,22726,0,25163,20007,5156,0,7784,7,7777,2,12332,12332,0
15096,220000,176000,0,0,0,0,0,0,0,31682,1300,30382,0,33407,2000,31407,0,35128,2000,33128,0,37826,3000,34826
15097,100000,80000,0,0,0,0,0,0,0,3252,2000,1252,0,42058,42058,0,-1,33171,500,32671,0,18379,2000,16379
15098,280000,224000,0,0,0,0,0,1,0,110389,10018,100371,0,114874,10000,104874,0,118273,5038,113235,0,114204,5039,109165
15099,50000,40000,0,0,0,0,0,0,0,12128,12128,0,-1,12128,0,12128,0,6000,0,6000,0,0,0,0
15100,460000,368000,0,1,0,0,0,0,0,392625,15000,377625,0,368365,15000,353365,0,377858,15000,362858,0,362132,15000,347132
15101,50000,40000,0,1,1,0,0,0,0,53340,3500,49840,0,45661,1424,44237,0,20180,2000,18180,0,21155,1300,19855
15102,210000,168000,0,0,0,0,0,1,-1,2607,2617,-10,-1,3586,3591,-5,-1,3676,3680,-4,-1,4095,4095,0
15103,100000,80000,0,0,0,1,1,1,0,82006,8000,74006,0,84044,4304,79740,2,84532,3000,81532,2,80828,0,80828
15104,400000,320000,0,0,0,0,0,0,-1,10525,10542,-17,-1,13295,13378,-83,-1,11024,11045,-21,-1,6666,6666,0
15105,50000,40000,1,1,1,1,1,0,2,56828,0,56828,2,55419,2000,53419,0,54054,2000,52054,0,53143,2455,50688
15106,370000,296000,0,1,1,1,1,1,0,355120,13217,341903,0,315740,12000,303740,0,322540,12000,310540,0,319195,12000,307195
15107,100000,80000,0,0,0,1,1,1,0,80910,2929,77981,0,83072,3500,79572,0,87774,6100,81674,0,90579,4367,86212
15108,390000,312000,0,0,0,0,0,0,0,185212,10000,175212,0,187648,7001,180647,0,192538,8001,184537,0,198828,10000,188828
15109,60000,48000,0,0,0,0,0,1,0,32396,2000,30396,0,34657,2800,31857,0,35456,1500,33956,2,34736,0,34736
15110,30000,24000,0,1,1,1,1,0,2,25650,0,25650,2,26416,1500,24916,0,27178,1200,25978,0,28332,1750,26582
15111,270000,216000,0,0,0,0,0,0,0,134297,6800,127497,0,208396,4000,204396,0,106524,4200,102324,0,104447,7000,97447
15112,70000,56000,0,0,0,0,0,0,0,45181,2000,43181,0,46426,2000,44426,0,47380,2000,45380,0,46923,2000,44923
15113,350000,280000,0,1,1,1,0,1,0,324873,12000,312873,0,300004,10400,289604,0,306269,12000,294269,0,273732,12000,261732
15114,180000,144000,0,0,0,0,0,0,0,75159,3333,71826,0,76602,3310,73292,0,76896,2900,73996,0,78588,3040,75548
15115,80000,64000,0,1,0,0,0,1,2,74722,2876,71846,0,40151,2052,38099,0,28424,625,27799,0,29059,693,28366
15116,30000,24000,0,1,1,0,0,1,0,28700,1000,27700,0,29300,600,28700,0,0,0,0,0,0,0,0
15117,50000,40000,0,0,0,0,0,0,0,10000,2700,7300,0,17916,7916,10000,0,6789,0,6789,0,150,150,0
15118,150000,120000,0,0,0,0,0,1,-1,0,0,0,-1,0,0,0,-2,0,0,0,-2,0,0,0
15119,110000,88000,0,1,1,1,1,1,0,111693,4267,107426,0,115073,9455,105618,0,111811,0,111811,2,111719,3991,107728
15120,120000,96000,0,1,1,1,1,0,2,118030,0,118030,2,122443,8990,113453,2,120370,0,120370,2,123766,9000,114766
15121,240000,192000,0,0,0,0,0,0,0,129014,6000,123014,0,131864,5000,126864,0,134744,5000,129744,0,138504,6000,132504
15122,260000,208000,0,0,0,0,0,0,-2,-1,0,-1,-2,-1,0,-1,-2,-1,0,-1,-2,-1,0,-1
15123,280000,224000,0,0,0,0,0,1,-1,36875,1467,35408,0,75016,1200,73816,0,38304,1792,36512,0,27383,15137,12246
15124,440000,352000,0,0,0,0,0,0,0,347445,12611,334834,0,354373,13022,341351,0,307773,10572,297201,0,293357,10270,283087
15125,20000,16000,0,1,1,1,1,0,0,19003,1283,17720,0,19224,1003,18221,0,19050,1000,18050,0,19353,1002,18351
15126,470000,376000,0,0,0,0,0,0,0,47771,4003,43768,0,52979,8003,44976,0,119678,70003,49675,0,94721,5030,89691
15127,90000,72000,0,0,0,0,0,0,0,31470,1900,29570,0,28996,1700,27296,0,26067,1000,25067,0,23292,1000,22292
15128,20000,16000,0,1,1,1,1,0,0,19658,1600,18058,0,19453,830,18623,0,19108,700,18408,0,18868,674,18194
15129,80000,64000,0,0,0,0,0,0,0,5949,2002,3947,0,7144,2005,5139,0,5309,15,5294,0,500,523,-23
15130,150000,120000,0,0,0,0,0,0,-2,490,494,-4,-2,0,0,0,-2,2893,2893,0,-2,0,0,0
15131,30000,24000,0,1,1,1,1,0,0,28299,2013,26286,0,29585,3016,26569,0,27952,759,27193,0,29790,2042,27748
15132,160000,128000,0,0,0,0,0,0,-1,31568,31568,0,-1,17638,353,17285,0,1285,1285,0,-1,2705,2705,0
15133,50000,40000,0,1,1,0,0,0,0,50812,2500,48312,0,50261,1905,48356,0,29720,1500,28220,0,30233,1200,29033
15134,180000,144000,0,0,0,0,0,0,-2,5828,5828,0,-2,0,0,0,-2,2165,2165,0,-2,645,645,0
15135,230000,184000,0,0,0,0,0,0,-1,1906,1906,0,-1,501,501,0,-1,283,283,0,-1,423,423,0
15136,80000,64000,0,0,0,0,0,1,2,23124,0,23124,2,26700,4300,22400,2,27064,1100,25964,2,27685,1200,26485
15137,300000,240000,0,0,0,0,0,0,-1,8157,8157,0,-1,21228,21228,0,-1,326,326,0,-1,1518,1518,0
15138,30000,24000,0,0,0,0,0,1,2,14252,0,14252,2,16205,2200,14005,2,15647,0,15647,2,17091,1700,15391
15139,60000,48000,0,0,0,0,0,1,0,39676,0,39676,2,42407,3700,38707,2,41428,0,41428,2,45576,5000,40576
15140,70000,56000,1,1,1,0,0,1,2,71851,0,71851,2,68539,3100,65439,0,49027,1900,47127,0,48969,2000,46969
15141,60000,48000,0,1,1,1,1,0,0,57187,1000,56187,2,57619,1690,55929,0,57033,1473,55560,0,58493,2354,56139
15142,570000,456000,0,1,1,0,0,0,0,577957,25100,552857,0,563543,15159,548384,0,451401,11732,439669,0,108890,42880,66010
15143,230000,184000,0,0,0,0,0,1,0,4734,2000,2734,0,6642,2000,4642,0,8520,2000,6520,0,9869,1500,8369
15144,240000,192000,0,0,0,0,0,1,-1,208,208,0,-1,0,0,0,-1,44,44,0,-1,19,0,19
15145,230000,184000,0,0,0,0,0,0,-1,500,0,500,2,624,624,0,-1,1090,1090,0,-1,2952,2952,0
15146,220000,176000,0,0,1,1,1,1,2,183039,8000,175039,2,185541,7000,178541,2,187984,7000,180984,2,191837,7000,184837
15147,120000,96000,0,1,1,1,1,1,2,121861,10900,110961,2,117485,0,117485,2,118381,5000,113381,0,115604,4800,110804
15148,230000,184000,0,0,0,0,0,0,-2,1951,1951,0,-2,67101,67101,0,-2,5136,5142,-6,-2,10316,10316,0
15149,60000,48000,0,0,0,0,0,0,2,0,0,0,-2,0,0,0,-2,1524,1524,0,-1,25421,25421,0
15150,180000,144000,0,1,1,0,0,0,0,172308,7296,165012,0,168608,5253,163355,0,132202,4814,127388,0,129918,4816,125102
15151,140000,112000,0,0,0,0,0,1,-1,8431,8579,-148,-1,11034,11034,0,-1,5040,5040,0,-1,7838,7838,0
15152,500000,400000,0,0,0,0,0,0,-2,3572,3763,-191,-2,2749,2749,0,-2,2140,2140,0,-2,3109,3109,0
15153,60000,48000,1,1,0,0,0,0,0,67300,1650,65650,0,590,1180,-590,-1,0,0,0,-1,0,0,0
15154,170000,136000,0,0,0,0,0,0,-2,18406,19000,-594,-2,-979,0,-979,-2,-1304,0,-1304,-2,2371,4000,-1629
15155,30000,24000,0,0,0,0,0,0,-2,1930,1930,0,-2,2072,2072,0,-2,4072,4072,0,-2,0,0,0
15156,400000,320000,0,0,0,0,0,1,2,195498,10000,185498,0,0,0,0,0,0,0,0,-2,0,0,0
15157,140000,112000,0,0,0,0,0,0,0,102527,3000,99527,2,103337,4000,99337,0,105942,4500,101442,0,101830,4000,97830
15158,160000,128000,0,1,1,0,0,1,2,152858,0,152858,2,161801,14025,147776,2,114389,0,114389,2,89684,5300,84384
15159,360000,288000,0,0,0,0,0,1,-2,0,0,0,-2,0,0,0,-2,0,0,0,-2,0,0,0
15160,200000,160000,0,0,0,0,0,0,-2,9855,10145,-290,-1,24091,24091,0,-1,24583,492,24091,0,7354,7354,0
15161,150000,120000,0,0,0,0,0,0,-1,17348,17348,0,-1,6456,6456,0,-1,12256,12256,0,-1,8156,8156,0
15162,90000,72000,0,0,0,0,0,0,2,5257,3000,2257,0,6649,2000,4649,0,8680,3000,5680,0,7844,0,7844
15163,50000,40000,0,1,1,1,0,1,0,48065,1900,46165,0,49158,1898,47260,0,50646,2386,48260,0,12927,629,12298
15164,60000,48000,0,0,0,0,0,0,-1,1562,1562,0,-1,0,0,0,-1,0,0,0,-2,0,0,0
15165,10000,8000,0,0,0,0,0,0,0,9449,3001,6448,0,6376,350,6026,0,6530,3002,3528,0,1506,1606,-100
15166,160000,128000,0,0,0,0,0,0,-2,0,0,0,-2,0,0,0,-2,461,461,0,-1,603,603,0
15167,20000,16000,0,0,1,1,0,0,0,16773,2000,14773,0,18394,2000,16394,0,19268,2000,17268,0,14850,1003,13847
15168,280000,224000,0,0,0,0,0,0,-2,0,0,0,-2,0,0,0,-2,0,0,0,-2,0,0,0
15169,20000,16000,0,1,1,1,1,1,2,17892,0,17892,2,19294,1700,17594,2,19840,1000,18840,2,19376,0,19376
15170,310000,248000,0,0,0,0,0,0,-2,1852,1868,-16,-2,2587,2587,0,-2,8441,8441,0,-2,14761,14761,0
15171,130000,104000,0,0,0,0,0,0,-1,5878,5172,706,0,15306,14593,713,0,8015,727,7288,0,5965,5222,743
15172,60000,48000,0,0,0,0,0,0,2,3800,1038,2762,0,0,0,0,0,0,0,0,-2,0,0,0
15173,80000,64000,0,0,0,0,0,0,0,23059,3070,19989,0,0,0,0,0,526,526,0,-1,678,680,-2
15174,60000,48000,0,0,0,0,0,0,0,48750,1967,46783,0,48916,1424,47492,0,27743,972,26771,0,28646,2000,26646
15175,200000,160000,0,1,1,1,1,0,4,179754,7459,172295,4,182763,7468,175295,4,184570,6275,178295,4,184091,3000,181091
15176,310000,248000,0,0,0,0,0,0,-1,1083,1093,-10,-1,2134,2140,-6,-1,2474,9201,-6727,-1,2097,2103,-6
15177,60000,48000,0,1,1,0,0,1,2,59755,0,59755,3,58194,198,57996,2,38649,1500,37149,0,35361,1300,34061
15178,70000,56000,0,0,0,0,0,1,0,13891,2000,11891,0,13371,0,13371,2,14654,1500,13154,2,14271,0,14271
15179,380000,304000,0,0,0,0,0,0,-2,0,0,0,-2,0,0,0,-2,0,0,0,-2,0,0,0
15180,260000,208000,0,0,0,0,0,0,-1,2609,2609,0,-1,1017,1017,0,-1,1012,1012,0,-1,959,959,0
15181,250000,200000,0,0,0,0,0,0,0,132145,11710,120435,0,88487,6030,82457,0,66701,9150,57551,0,52054,11600,40454
15182,210000,168000,0,0,0,0,0,0,0,26029,4000,22029,0,26816,5000,21816,0,21116,3000,18116,0,10721,3000,7721
15183,50000,40000,0,1,0,0,0,0,0,50115,1661,48454,0,33814,2000,31814,0,34423,3000,31423,0,31988,0,31988
15184,140000,112000,0,0,0,0,0,0,-2,3544,3544,0,-2,0,0,0,-2,0,0,0,-2,0,0,0
15185,20000,16000,0,1,1,1,1,1,0,18621,1000,17621,2,18024,0,18024,2,18434,700,17734,0,19826,1700,18126
15186,100000,80000,0,0,0,0,0,0,0,69111,0,69111,2,64287,2500,61787,0,67838,5500,62338,0,66135,0,66135
15187,100000,80000,0,1,0,0,0,0,0,99156,3740,95416,0,80234,2798,77436,0,80090,2865,77225,0,79494,3020,76474
15188,500000,400000,0,0,0,0,0,0,-1,2111,2111,0,-1,920,920,0,-1,920,920,0,-1,920,920,0
15189,200000,160000,0,0,0,0,0,1,-2,144076,0,144076,-2,8174,8222,-48,-1,8198,300,7898,2,7918,0,7918
15190,500000,400000,0,0,0,0,0,0,0,63994,8078,55916,0,40501,10000,30501,0,11248,10000,1248,0,4189,4200,-11
15191,360000,288000,0,0,0,0,0,0,-2,0,0,0,-2,0,0,0,-2,0,0,0,-2,0,0,0
15192,120000,96000,0,0,0,0,0,0,0,64074,2562,61512,0,64074,0,64074,0,0,0,0,0,0,0,0
15193,150000,120000,0,0,0,0,0,0,-2,0,399,-399,-2,0,0,0,-2,399,399,0,-1,150,150,0
15194,320000,256000,0,0,0,0,0,0,-1,8275,8344,-69,-1,8275,8275,0,-1,7606,7606,0,-1,14611,10000,4611
15195,150000,120000,0,1,1,1,1,0,0,146245,7000,139245,0,141593,6600,134993,0,133721,4700,129021,0,138524,13500,125024
15196,10000,8000,1,1,1,1,1,1,2,10094,0,10094,3,9768,0,9768,2,8430,300,8130,0,20735,2165,18570
15197,100000,80000,0,1,1,0,0,1,2,87095,3300,83795,0,88357,2839,85518,0,77155,3000,74155,0,80108,4000,76108
15198,90000,72000,0,0,0,0,0,0,0,46978,47003,-25,-1,47512,1680,45832,0,48111,1734,46377,0,48761,1828,46933
15199,390000,312000,0,0,0,0,0,0,-1,18982,19051,-69,-1,11700,11754,-54,-1,0,0,0,-1,2978,2978,0
15200,360000,288000,0,0,0,0,0,0,-1,1632,1632,0,-1,1632,1632,0,-1,22379,22379,0,-1,8901,8901,0
15201,100000,80000,0,0,0,0,0,1,2,13609,700,12909,2,14683,1300,13383,2,15001,700,14301,2,15306,700,14606
15202,200000,160000,0,0,0,0,0,0,-1,5647,5647,0,-1,3604,0,3604,2,1802,0,1802,0,1802,1802,0
15203,230000,184000,0,0,0,0,0,0,-2,2932,2932,0,-2,354,354,0,-2,200,200,0,-2,0,0,0
15204,50000,40000,0,1,1,0,0,1,0,49633,2130,47503,0,48707,1184,47523,0,19623,13604,6019,0,13673,496,13177
15205,130000,104000,0,0,0,0,0,0,0,50093,1500,48593,0,49303,0,49303,0,14772,0,14772,0,150,1233,-1083
15206,50000,40000,0,0,0,0,0,0,0,19814,1296,18518,0,20210,692,19518,0,20125,709,19416,0,19010,698,18312
15207,100000,80000,0,1,0,0,0,0,2,95163,3420,91743,2,74656,80,74576,2,65718,1800,63918,0,78474,17000,61474
15208,190000,152000,0,0,0,0,0,0,0,57104,2700,54404,0,57380,2191,55189,0,58225,2300,55925,0,58847,2130,56717
15209,80000,64000,0,1,1,1,1,0,0,71846,3600,68246,0,72372,2720,69652,0,73475,2400,71075,0,74842,2224,72618
15210,500000,400000,0,0,0,0,0,0,-2,9963,9963,0,-2,17145,17223,-78,-2,7645,7645,0,-2,16079,16079,0
15211,390000,312000,0,0,0,0,0,0,-2,1906,1915,-9,-2,0,0,0,-2,2258,2258,0,-1,7028,5001,2027
15212,300000,240000,0,0,0,0,0,0,-1,6493,6493,0,-1,23292,23324,-32,-1,1254,1254,0,-1,7808,7808,0
15213,260000,208000,0,0,0,0,0,0,0,63615,5000,58615,0,71839,10000,61839,0,75506,5000,70506,0,78647,5000,73647
15214,20000,16000,0,0,0,0,0,1,0,0,0,0,0,0,0,0,-2,0,0,0,-2,0,0,0
15215,20000,16000,0,1,1,1,1,0,3,16602,0,16602,2,19521,3200,16321,2,18925,0,18925,2,18806,900,17906
15216,360000,288000,0,0,0,0,0,0,0,75869,2311,73558,0,58219,1570,56649,0,45605,1500,44105,0,32245,983,31262
15217,80000,64000,1,1,1,0,0,0,0,117725,5500,112225,0,118100,4356,113744,0,60745,3000,57745,0,54509,2100,52409
15218,40000,32000,0,0,0,0,0,1,0,21047,1355,19692,0,22360,1668,20692,0,22499,807,21692,0,22969,834,22135
15219,310000,248000,0,0,0,0,0,1,-2,1858,1858,0,-2,3057,3057,0,-2,2538,2538,0,-2,3069,3069,0
15220,100000,80000,0,0,0,0,0,0,0,14378,2000,12378,0,14838,1000,13838,0,15447,1000,14447,0,16539,1500,15039
15221,50000,40000,0,1,1,1,0,0,0,47942,1545,46397,0,48418,1171,47247,0,49530,1658,47872,0,28085,1321,26764
15222,60000,48000,0,0,0,0,0,1,2,40655,0,40655,2,43974,4000,39974,2,46625,3500,43125,2,45590,0,45590
15223,370000,296000,0,0,0,0,0,0,0,254111,9498,244613,0,257816,10827,246989,0,255491,9002,246489,0,255320,9040,246280
15224,60000,48000,0,0,0,0,0,1,0,35525,2000,33525,0,38820,3900,34920,0,38066,0,38066,2,39681,2400,37281
15225,90000,72000,1,1,1,1,1,1,7,108539,0,108539,6,106001,0,106001,5,103816,0,103816,4,101878,0,101878
15226,160000,128000,0,0,0,0,0,1,-2,4150,4150,0,-2,2065,2065,0,-2,0,0,0,-2,500,500,0
15227,360000,288000,0,0,0,0,0,0,-1,0,0,0,-1,1000,1000,0,-1,6344,6344,0,-1,2408,2408,0
15228,410000,328000,0,0,0,0,0,0,0,11546,3056,8490,0,858,968,-110,0,0,0,0,-2,1117,1117,0
15229,80000,64000,0,0,0,0,0,0,-1,631,631,0,-1,1237,1237,0,-1,1529,1529,0,-1,357,357,0
15230,450000,360000,0,0,0,0,0,0,0,12815,5000,7815,0,17782,7000,10782,0,9074,3000,6074,0,8490,2000,6490
15231,140000,112000,0,0,0,0,0,0,-2,0,0,0,-2,0,0,0,-2,50000,50000,0,-1,0,0,0
15232,30000,24000,0,1,1,1,1,0,0,26552,0,26552,2,27703,1902,25801,0,28128,1022,27106,0,28859,1200,27659
15233,100000,80000,0,0,0,0,0,0,-1,0,0,0,-2,0,0,0,-2,5330,5330,0,-1,0,1274,-1274
15234,50000,40000,0,1,1,0,0,0,0,44002,1942,42060,0,44356,1296,43060,0,19344,674,18670,0,19354,693,18661
15235,150000,120000,0,0,0,0,0,0,-2,380,380,0,-1,462,462,0,-1,3,103,-100,-2,166,266,-100
15236,360000,288000,0,0,0,0,0,0,-1,1864,1870,-6,-1,969,969,0,-1,2500,2500,0,-1,0,0,0
15237,80000,64000,0,0,0,0,0,0,-2,8815,8815,0,-2,24012,24012,0,-2,0,1153,-1153,-2,2229,2229,0
15238,130000,104000,0,0,0,0,0,0,-1,2172,2172,0,-1,836,836,0,-1,836,836,0,-1,0,0,0
15239,180000,144000,0,1,1,1,1,1,0,179787,7900,171887,0,181918,6900,175018,0,169664,6200,163464,0,173169,6700,166469
15240,210000,168000,0,0,0,0,0,0,-1,0,0,0,-2,0,0,0,-2,0,0,0,-2,0,0,0
15241,80000,64000,0,1,0,0,0,0,0,68966,3009,65957,0,63972,2009,61963,0,50072,1818,48254,0,51239,2000,49239
15242,20000,16000,0,0,0,0,0,1,0,12298,2300,9998,0,11809,0,11809,2,12333,1015,11318,2,11986,0,11986
15243,280000,224000,0,0,0,0,0,0,0,50108,2007,48101,0,49425,1370,48055,0,48977,1407,47570,0,48459,1359,47100
15244,80000,64000,0,1,1,1,1,0,-1,70239,2564,67675,0,72556,3500,69056,0,75372,4000,71372,0,75406,3000,72406
15245,170000,136000,0,0,0,0,0,0,-1,3000,3000,0,-1,1000,0,1000,0,1000,1000,0,-1,1500,1500,0
15246,30000,24000,0,0,1,1,1,0,0,26404,2500,23904,0,27149,1500,25649,2,27634,1200,26434,0,28215,1142,27073
15247,280000,224000,0,0,0,0,0,0,0,27292,10006,17286,0,16567,6000,10567,0,7021,1000,6021,0,10171,10200,-29
15248,20000,16000,0,0,0,0,0,0,0,5463,1463,4000,0,1379,1379,0,-1,2668,2668,0,-1,390,390,0
15249,180000,144000,0,1,1,0,0,0,0,183363,6973,176390,0,183013,7023,175990,0,142048,7000,135048,0,142570,6000,136570
15250,290000,232000,0,0,0,0,0,1,0,138326,5300,133026,0,128721,4000,124721,0,95657,5000,90657,0,90210,3000,87210
15251,10000,8000,0,0,0,0,0,0,0,4654,1000,3654,0,3080,31,3049,0,0,0,0,0,0,0,0
15252,220000,176000,1,1,1,1,1,1,7,238172,0,238172,6,232446,0,232446,5,227800,0,227800,4,225044,0,225044
15253,50000,40000,0,1,1,0,0,0,0,47771,2060,45711,0,43739,2025,41714,0,29090,1375,27715,0,24317,1035,23282
15254,110000,88000,0,0,0,0,0,0,2,31304,0,31304,2,29291,1600,27691,0,26415,1000,25415,0,23170,1000,22170
15255,110000,88000,0,0,0,0,0,0,2,1426,1426,0,-1,5660,5660,0,-1,5660,0,5660,0,0,0,0
15256,50000,40000,0,0,0,0,0,1,0,18755,1058,17697,0,11112,2000,9112,0,11374,2043,9331,0,5919,5919,0
15257,20000,16000,0,1,0,0,0,0,0,19462,30,19432,2,0,0,0,2,0,0,0,-2,150,150,0
15258,50000,40000,0,1,0,0,0,0,0,49217,1656,47561,0,40882,1750,39132,0,20258,717,19541,0,20303,753,19550
15259,420000,336000,0,0,0,0,0,0,0,90368,4031,86337,0,85616,3040,82576,0,81461,3026,78435,0,77925,3017,74908
15260,440000,352000,0,0,0,0,0,0,0,43399,2000,41399,0,44534,24534,20000,0,25341,5000,20341,0,20000,20000,0
15261,60000,48000,0,0,0,0,0,0,0,37742,2000,35742,0,29450,1400,28050,0,8850,200,8650,0,0,600,-600
15262,260000,208000,0,0,0,0,0,0,-1,129698,4813,124885,0,120375,4039,116336,0,118847,4095,114752,0,120361,4271,116090
15263,20000,16000,0,0,1,1,1,1,0,16706,1600,15106,0,18214,2100,16114,0,18626,1000,17626,2,18196,0,18196
15264,50000,40000,0,1,1,1,1,0,0,48280,2200,46080,0,46978,2000,44978,0,46657,2000,44657,0,48233,5000,43233
15265,230000,184000,0,0,0,0,0,0,-2,150,150,0,-1,1528,1528,0,-1,3028,1500,1528,0,4117,1500,2617
15266,160000,128000,0,0,0,0,0,0,0,15770,15793,-23,-1,27024,11000,16024,0,14490,6000,8490,0,8190,1000,7190
15267,180000,144000,0,1,1,0,0,0,0,174812,7000,167812,0,177252,7100,170152,0,129190,5000,124190,0,130431,5000,125431
15268,230000,184000,0,0,0,0,0,0,-2,6966,6966,0,-2,1935,1935,0,-2,6665,6665,0,-1,11254,8000,3254
15269,160000,128000,0,0,0,0,0,0,-1,0,0,0,-2,0,0,0,-2,0,0,0,-2,0,0,0
15270,290000,232000,0,0,0,0,0,0,-1,237648,237648,0,-1,236463,8900,227563,0,146420,5300,141120,0,148600,5541,143059
15271,20000,16000,0,0,0,0,0,0,-1,679,679,0,-1,679,0,679,2,5679,5000,679,0,7570,2000,5570
15272,30000,24000,0,0,0,0,0,1,-1,0,0,0,-2,2779,2779,0,-1,0,0,0,-1,0,0,0
15273,140000,112000,0,0,0,0,0,0,0,83330,4000,79330,0,57609,3000,54609,0,59526,3000,56526,0,31515,2500,29015
15274,340000,272000,0,0,0,0,0,1,2,24386,24386,0,-1,3570,3570,0,-1,3094,0,3094,2,14645,14645,0
15275,270000,216000,0,0,0,0,0,1,-1,836,836,0,-1,836,836,0,-1,1972,1972,0,-1,986,0,986
15276,20000,16000,0,0,1,1,1,0,0,16394,1300,15094,0,16723,600,16123,0,18056,1600,16456,0,17618,0,17618
15277,500000,400000,0,0,0,0,0,0,-1,17501,17501,0,-1,17194,2194,15000,0,9030,1030,8000,0,2180,2180,0
15278,90000,72000,0,0,0,0,0,1,0,37513,3000,34513,0,38637,3000,35637,0,44088,10000,34088,0,35705,3000,32705
15279,220000,176000,0,0,0,0,0,0,2,189665,15510,174155,2,171669,0,171669,2,167294,5500,161794,2,172042,7250,164792
15280,50000,40000,0,0,0,0,0,1,2,17912,2000,15912,0,19606,2000,17606,0,20969,2000,18969,0,25302,5000,20302
15281,200000,160000,0,0,0,0,0,1,-1,6955,6797,158,0,28300,28314,-14,-1,13227,13291,-64,-1,11202,11258,-56
15282,60000,48000,0,0,0,0,0,0,-2,1668,1668,0,-1,844,844,0,-1,200,1044,-844,-2,2930,2930,0
15283,90000,72000,0,1,0,0,0,0,0,83081,3500,79581,0,60210,3000,57210,0,61221,2600,58621,0,62636,2600,60036
15284,130000,104000,0,0,0,0,0,0,0,104301,4415,99886,0,84132,3600,80532,0,79043,5800,73243,0,78205,2000,76205
15285,50000,40000,0,1,1,1,1,1,2,48913,2000,46913,2,49847,2000,47847,2,50840,1900,48940,2,49502,1900,47602
15286,100000,80000,0,0,0,0,0,0,-1,931,931,0,-1,5983,5983,0,-1,2010,2010,0,-1,1413,1413,0
15287,100000,80000,0,0,0,0,0,0,0,0,0,0,-2,0,0,0,-2,0,0,0,-2,0,0,0
15288,60000,48000,0,0,0,0,0,0,0,38110,1900,36210,0,38525,1300,37225,0,38346,1363,36983,0,37416,1500,35916
15289,360000,288000,0,0,0,0,0,0,-2,0,0,0,-2,0,0,0,-2,0,0,0,-2,0,0,0
15290,30000,24000,0,0,0,0,0,0,0,12085,5000,7085,0,16788,5000,11788,0,18388,2000,16388,0,23228,5000,18228
15291,230000,184000,0,0,0,0,0,0,0,32838,15000,17838,0,35511,6120,29391,0,26828,10000,16828,0,19887,6000,13887
15292,70000,56000,0,1,1,1,1,0,0,69390,2521,66869,0,64457,2400,62057,0,66021,2600,63421,0,67267,2614,64653
15293,300000,240000,0,0,0,0,0,1,-1,4606,0,4606,2,2303,0,2303,0,2768,2768,0,-1,65373,65373,0
15294,120000,96000,0,1,1,1,1,0,0,116281,7175,109106,0,117392,4529,112863,0,117791,4625,113166,0,112505,4029,108476
15295,260000,208000,0,0,0,0,0,0,-2,0,0,0,-2,0,0,0,-2,0,0,0,-2,0,0,0
15296,230000,184000,0,0,0,0,0,0,0,77766,3500,74266,0,70066,2600,67466,0,62865,2500,60365,0,55311,1901,53410
15297,60000,48000,0,1,0,1,0,0,0,48308,0,48308,2,51616,5000,46616,0,56416,5000,51416,0,21680,0,21680
15298,20000,16000,0,1,1,1,1,1,2,18935,0,18935,2,19005,653,18352,0,17862,900,16962,0,20393,3000,17393
15299,110000,88000,0,0,0,0,0,1,2,44126,3000,41126,0,43483,2000,41483,0,43435,2000,41435,0,41010,2000,39010
15300,260000,208000,0,0,0,0,0,0,0,19753,3000,16753,0,21550,3000,18550,0,21032,3000,18032,0,19979,3000,16979
15301,310000,248000,0,0,0,0,0,0,2,84865,3959,80906,0,70995,2807,68188,0,45838,2000,43838,0,36252,3000,33252
15302,100000,80000,0,0,0,0,0,1,2,77147,3451,73696,0,78200,3000,75200,0,78393,2841,75552,0,72214,2620,69594
15303,230000,184000,0,0,0,0,0,0,-1,9079,8089,990,0,11186,2186,9000,0,10159,1159,9000,0,11734,1734,10000
15304,200000,160000,0,0,0,0,0,0,0,119279,6000,113279,0,121782,4300,117482,0,125427,5500,119927,0,140460,17000,123460
15305,60000,48000,0,0,0,0,0,0,0,15231,2000,13231,0,16966,2000,14966,0,17878,1500,16378,0,19085,1500,17585
15306,60000,48000,0,1,1,0,0,1,-1,58058,2186,55872,0,59679,5667,54012,0,5575,1200,4375,0,1733,2000,-267
15307,220000,176000,0,0,0,0,0,0,0,149677,7000,142677,0,152724,7100,145624,0,142064,5000,137064,0,142649,5400,137249
15308,290000,232000,0,0,0,0,0,0,-2,0,0,0,-2,0,0,0,-2,0,0,0,-2,0,0,0
15309,260000,208000,0,0,0,1,1,0,0,203651,8800,194851,0,223837,25000,198837,0,218383,0,218383,2,222960,8000,214960
15310,180000,144000,0,1,1,0,0,0,0,162516,7693,154823,0,163447,5464,157983,0,134939,4893,130046,0,135815,5095,130720
15311,100000,80000,0,0,0,0,0,0,-2,0,0,0,-2,0,0,0,-2,1756,1756,0,-2,0,0,0
15312,90000,72000,0,1,1,1,1,0,3,78174,3400,74774,2,78800,2500,76300,3,77417,0,77417,2,82369,6250,76119
15313,110000,88000,0,1,0,0,0,0,2,100364,5200,95164,0,91061,5000,86061,0,65582,2500,63082,0,67002,2600,64402
15314,500000,400000,0,0,0,0,0,0,-1,39167,39373,-206,-1,4683,4706,-23,-1,7222,7259,-37,-1,35746,35924,-178
15315,280000,224000,0,0,0,0,0,0,0,223810,0,223810,2,158542,5600,152942,0,162244,6300,155944,0,108143,4000,104143
15316,270000,216000,0,0,0,0,0,0,-2,15913,1513,14400,-2,14192,1019,13173,-2,10559,515,10044,-2,7672,302,7370
15317,220000,176000,0,0,0,0,0,0,-2,10567,10567,0,-2,319,319,0,-2,319,319,0,-2,319,319,0
15318,280000,224000,0,0,0,0,0,0,0,77704,40000,37704,0,0,0,0,0,0,0,0,-2,0,0,0
15319,210000,168000,0,0,0,0,0,0,0,119680,6000,113680,0,118070,5102,112968,0,111841,5000,106841,0,111716,5000,106716
15320,350000,280000,0,0,0,0,0,0,-1,11094,11198,-104,-1,4041,4057,-16,-1,4485,4523,-38,-1,9364,9407,-43
15321,120000,96000,0,0,0,0,0,1,2,590,590,0,-1,3617,3617,0,-1,2001,2001,0,-1,0,0,0
15322,520000,416000,1,1,1,0,0,0,0,689627,30500,659127,0,706864,30000,676864,0,383160,15000,368160,0,294641,15000,279641
15323,180000,144000,0,0,0,0,0,0,-2,470,517,-47,-1,0,0,0,-1,0,0,0,-2,800,800,0
15324,80000,64000,0,0,0,0,0,0,-1,10007,10020,-13,-1,3584,2986,598,0,2961,22,2939,0,3831,3835,-4
15325,280000,224000,0,0,0,0,0,0,0,153080,3258,149822,0,156000,3120,152880,0,160000,4000,156000,0,40485,100045,-59560
15326,350000,280000,0,0,0,0,0,0,-2,375,376,-1,-2,187,187,0,-2,242,243,-1,-2,184,184,0
15327,180000,144000,0,0,0,0,0,0,-1,6186,6186,0,-1,6695,6695,0,-1,7173,4000,3173,0,5094,955,4139
15328,170000,136000,0,0,0,0,0,0,-1,0,0,0,-1,376,376,0,-1,0,0,0,-1,376,376,0
15329,280000,224000,0,0,0,0,0,0,-2,19497,19497,0,-2,10164,10173,-9,-2,1089,1089,0,-2,26218,28217,-1999
15330,360000,288000,0,0,0,0,0,1,-2,0,0,0,-2,0,0,0,-2,0,0,0,-2,0,0,0
15331,120000,96000,0,0,0,0,0,0,-1,3790,3818,-28,-1,18508,18564,-56,-1,20737,20988,-251,-1,-28,0,-28
15332,470000,376000,0,0,0,0,0,0,0,69036,5500,63536,0,71466,5000,66466,0,67538,5000,62538,0,70400,4000,66400
15333,220000,176000,0,0,0,0,0,1,-1,1270,1282,-12,-1,0,0,0,-1,1121,1121,0,-1,500,500,0
15334,140000,112000,0,0,0,0,0,0,-1,0,0,0,-2,233,233,0,-1,0,0,0,-1,0,0,0
15335,260000,208000,0,0,0,0,0,0,0,112189,4000,108189,0,114503,4000,110503,0,117031,4200,112831,0,112857,8790,104067
15336,110000,88000,0,0,0,0,0,1,2,50030,5800,44230,2,48940,0,48940,3,48026,0,48026,2,55979,8774,47205
15337,80000,64000,0,0,0,0,0,0,0,9994,2000,7994,0,10704,4000,6704,0,9201,1000,8201,0,6275,1000,5275
15338,260000,208000,0,0,0,0,0,0,-2,0,0,0,-2,0,0,0,-2,200,200,0,-2,0,0,0
15339,50000,40000,0,1,0,0,0,0,0,49660,1875,47785,0,29742,1044,28698,0,29311,1060,28251,0,29739,1211,28528
15340,180000,144000,0,0,0,0,0,0,0,31188,1408,29780,0,32979,2979,30000,0,22526,2526,20000,0,13338,13338,0
15341,150000,120000,0,0,0,0,0,0,0,17467,3000,14467,0,19789,2616,17173,0,20173,1000,19173,0,21696,2000,19696
15342,350000,280000,0,0,0,0,0,0,0,86492,4131,82361,0,91898,7261,84637,0,189555,103801,85754,0,192627,6007,186620
15343,250000,200000,0,1,1,1,1,0,0,221963,9510,212453,0,224949,8160,216789,0,229577,8364,221213,0,234221,8493,225728
15344,170000,136000,0,1,1,1,0,0,0,162960,6116,156844,0,165645,5600,160045,0,168386,5000,163386,0,129230,5000,124230
15345,60000,48000,0,0,0,0,0,0,0,22860,2000,20860,0,25154,3000,22154,0,29387,5000,24387,0,30607,2000,28607
15346,290000,232000,0,1,1,1,1,0,0,253145,15000,238145,0,267412,20000,247412,0,273095,10000,263095,2,278260,9701,268559
15347,280000,224000,0,0,0,0,0,0,0,168463,8100,160363,0,149816,7200,142616,0,128721,5000,123721,0,130406,5000,125406
15348,30000,24000,0,1,1,1,1,1,0,26759,1445,25314,0,27186,1425,25761,0,27208,1000,26208,0,27234,1000,26234
15349,90000,72000,0,0,0,0,0,0,0,23280,2000,21280,0,23812,1220,22592,0,24377,1100,23277,0,24821,1000,23821
15350,280000,224000,0,0,0,0,1,1,0,134910,5000,129910,0,139280,6585,132695,0,139188,6409,132779,0,271388,6046,265342
15351,210000,168000,0,0,0,0,0,0,0,23908,1000,22908,0,5088,5484,-396,-1,792,0,792,0,150,150,0
15352,230000,184000,0,0,0,0,0,1,-1,2557,2557,0,-1,4440,4443,-3,-1,4832,4832,0,-1,6059,6314,-255
15353,400000,320000,0,0,0,0,0,0,-1,15941,16020,-79,-1,5776,5805,-29,-1,5448,5475,-27,-1,15435,5634,9801
15354,180000,144000,0,1,1,1,1,0,0,168711,7000,161711,0,172263,7189,165074,0,174127,6000,168127,0,176335,5100,171235
15355,50000,40000,0,0,0,0,1,1,2,39319,4000,35319,2,38387,0,38387,2,42764,5000,37764,2,41926,0,41926
15356,50000,40000,0,0,0,0,0,0,0,33812,1317,32495,0,20483,698,19785,0,19409,693,18716,0,19318,1000,18318
15357,20000,16000,0,0,1,1,0,0,2,17626,1674,15952,0,18398,1446,16952,0,19052,1100,17952,0,15429,0,15429
15358,450000,360000,0,0,0,0,0,0,0,62728,3000,59728,0,63223,2000,61223,0,63011,8110,54901,0,43156,2600,40556
15359,90000,72000,0,0,0,1,0,0,0,53759,1680,52079,0,56397,20000,36397,0,87349,5000,82349,0,55700,4833,50867
15360,20000,16000,0,0,0,0,0,1,2,1285,1000,285,0,1895,1000,895,0,1340,0,1340,2,950,0,950
15361,10000,8000,0,0,1,1,1,1,0,8926,1602,7324,0,8634,0,8634,2,9442,948,8494,2,9144,0,9144
15362,360000,288000,0,0,0,0,0,0,-1,0,0,0,-2,3000,3000,0,-1,0,0,0,-1,0,0,0
15363,30000,24000,0,1,1,1,1,0,2,27832,2006,25826,0,26897,2000,24897,0,27278,1100,26178,0,27851,1137,26714
15364,300000,240000,0,0,0,0,0,0,-1,4725,4751,-26,-1,2595,2600,-5,-1,2110,2110,0,-1,20984,20984,0
15365,20000,16000,0,0,0,0,0,0,0,12086,2000,10086,0,13180,1600,11580,0,13660,1000,12660,0,14288,1000,13288
15366,30000,24000,1,1,1,1,1,1,0,34359,2215,32144,0,32450,1156,31294,0,30633,1200,29433,0,30628,3000,27628
15367,230000,184000,0,0,0,0,0,0,-1,24962,24962,0,-1,34372,10000,24372,0,32630,943,31687,0,33334,1000,32334
15368,250000,200000,0,0,0,0,0,1,-2,313,313,0,-2,316,316,0,-2,657,657,0,-2,993,993,0
15369,250000,200000,0,0,0,0,0,0,-1,0,0,0,-2,188841,188841,0,-1,194321,8500,185821,0,198156,8000,190156
15370,20000,16000,0,0,0,0,0,1,0,7992,2000,5992,0,13524,11200,2324,0,19320,9386,9934,0,8430,14500,-6070
15371,200000,160000,0,0,0,0,0,0,2,976,0,976,2,1126,563,563,2,563,0,563,2,413,413,0
15372,320000,256000,0,0,0,0,0,0,0,103278,6000,97278,0,62891,3000,59891,0,64948,3000,61948,0,66961,3000,63961
15373,300000,240000,0,0,0,0,0,0,0,60039,10043,49996,0,52009,1065,50944,0,32862,164,32698,0,3730,3748,-18
15374,340000,272000,0,0,0,0,0,0,0,10814,3011,7803,0,7880,5000,2880,0,2338,2338,0,-1,0,0,0
15375,320000,256000,0,0,0,0,0,0,-2,23384,23507,-123,-2,4310,4336,-26,-2,5980,6010,-30,-2,13522,13589,-67
15376,50000,40000,0,0,0,0,0,0,0,16315,1214,15101,0,12225,1155,11070,0,11184,375,10809,0,10133,364,9769
15377,350000,280000,0,0,0,0,0,0,0,86793,5016,81777,0,84406,5000,79406,0,73976,3000,70976,0,75497,3000,72497
15378,180000,144000,0,0,0,0,0,1,-1,536,536,0,-1,1123,1123,0,-1,536,536,0,-1,536,536,0
15379,50000,40000,0,0,0,0,0,0,0,23609,1741,21868,0,22675,1280,21395,0,21628,706,20922,0,20576,700,19876
15380,150000,120000,0,0,0,0,0,0,2,-25,0,-25,2,-25,0,-25,-2,-25,0,-25,-2,-25,0,-25
15381,230000,184000,0,0,0,0,0,0,0,108061,3348,104713,0,87461,2510,84951,0,69221,5000,64221,0,57462,3500,53962
15382,200000,160000,0,0,0,0,0,0,2,499,499,0,-1,499,0,499,0,499,0,499,0,0,0,0
15383,110000,88000,0,0,0,0,0,0,0,47527,2000,45527,0,48735,2000,46735,0,49925,2000,47925,0,50967,2000,48967
15384,120000,96000,0,0,0,0,0,0,-2,-1460,1460,-2920,-2,-1460,0,-1460,-2,-1460,0,-1460,-2,-1460,0,-1460
15385,60000,48000,0,0,0,0,0,0,2,27774,1481,26293,0,28347,1444,26903,0,28515,1002,27513,0,28715,1030,27685
15386,480000,384000,0,1,0,0,0,1,0,471639,20010,451629,0,375196,13013,362183,0,285319,11209,274110,0,209218,9010,200208
15387,50000,40000,0,0,0,0,0,1,0,16246,1242,15004,0,14987,683,14304,0,15298,702,14596,0,15447,553,14894
15388,230000,184000,0,0,0,0,0,0,-2,0,0,0,-2,0,0,0,-2,1004,1004,0,-1,854,0,854
15389,200000,160000,0,0,0,0,0,0,0,148137,4000,144137,0,151505,4000,147505,0,154728,4000,150728,0,157912,4000,153912
15390,130000,104000,0,0,0,0,0,0,0,102946,5300,97646,0,103750,3700,100050,0,105818,3600,102218,0,98401,3700,94701
15391,230000,184000,0,0,0,0,0,0,0,114837,5700,109137,0,116400,5000,111400,0,45643,1855,43788,0,51083,6400,44683
15392,50000,40000,0,0,0,0,0,0,-1,10060,10060,0,-1,0,0,0,-1,0,0,0,-2,0,0,0
15393,350000,280000,0,0,0,0,0,0,0,51961,1700,50261,0,46207,1500,44707,0,35052,2000,33052,0,12536,500,12036
15394,60000,48000,0,0,1,0,0,0,0,48442,2500,45942,0,53444,1000,52444,0,27705,2400,25305,0,28291,1200,27091
15395,130000,104000,0,0,0,0,0,0,0,24976,3000,21976,0,27648,3000,24648,0,29962,3000,26962,0,27422,5000,22422
15396,110000,88000,0,0,0,0,0,0,0,74258,10000,64258,0,66409,3000,63409,0,69895,6000,63895,0,72234,3300,68934
15397,330000,264000,0,0,0,0,0,0,-2,626,626,0,-2,626,626,0,-2,1348,1348,0,-2,5879,5879,0
15398,150000,120000,0,0,0,0,0,0,0,56931,2569,54362,0,96867,45000,51867,0,95085,5000,90085,0,69199,3312,65887
15399,50000,40000,0,0,0,0,0,0,-1,4904,4904,0,-1,2056,2056,0,-1,2515,2515,0,-1,1464,1464,0
15400,160000,128000,0,0,1,0,1,0,0,132179,5000,127179,0,135030,4854,130176,0,135656,10000,125656,0,135448,6000,129448
15401,90000,72000,0,0,0,0,0,0,0,0,0,0,0,0,0,0,-2,0,0,0,-2,0,0,0
15402,80000,64000,1,1,1,0,0,1,0,99205,3451,95754,0,74016,3577,70439,0,48043,2000,46043,0,48545,1800,46745
15403,200000,160000,0,0,0,0,0,0,0,153179,5600,147579,0,156229,5600,150629,0,159708,6000,153708,0,163051,6000,157051
15404,80000,64000,0,0,0,0,0,0,0,29402,1800,27602,0,20983,1700,19283,0,21096,759,20337,0,22252,1500,20752
15405,280000,224000,0,0,0,0,0,0,-2,0,0,0,-2,0,0,0,-2,5360,5360,0,-1,251,251,0
15406,200000,160000,0,1,1,1,1,1,0,194403,7700,186703,0,197746,11100,186646,0,190198,0,190198,2,192015,5600,186415
15407,190000,152000,0,1,0,0,0,0,0,184426,6621,177805,0,104154,2083,102071,0,106014,2500,103514,0,109014,3000,106014
15408,120000,96000,0,1,1,1,1,0,0,118240,5923,112317,0,116142,4533,111609,0,115087,4200,110887,0,117647,4433,113214
15409,160000,128000,0,0,0,0,0,1,0,36263,0,36263,2,43481,7847,35634,2,43515,1026,42489,2,49619,7000,42619
15410,420000,336000,1,1,1,1,1,0,0,517746,20000,497746,0,428655,16000,412655,0,352793,11717,341076,0,350036,12000,338036
15411,50000,40000,0,0,0,0,0,1,2,33017,1550,31467,0,33868,1400,32468,0,38151,5000,33151,0,37253,0,37253
15412,70000,56000,0,0,0,0,0,0,-1,2,10002,-10000,-1,2,0,2,2,2,0,2,2,2,0,2
15413,80000,64000,0,0,0,0,0,0,0,24772,2089,22683,0,20000,6000,14000,0,20000,200,19800,0,20000,0,20000
15414,80000,64000,0,0,0,0,0,1,0,16236,1600,14636,0,16960,1300,15660,0,17777,1100,16677,0,18042,700,17342
15415,360000,288000,0,0,0,0,0,1,-2,0,0,0,-2,0,0,0,-2,0,0,0,-2,0,0,0
15416,500000,400000,0,0,0,0,0,0,0,59534,2001,57533,0,51006,6620,44386,0,44360,6015,38345,0,34229,10001,24228
15417,130000,104000,0,1,0,0,0,0,0,128179,4252,123927,0,75525,3000,72525,0,76862,1537,75325,0,6131,10000,-3869
15418,100000,80000,0,0,0,0,0,0,0,20035,20195,-160,-1,4116,4228,-112,-1,-110,0,-110,-1,3512,3622,-110
15419,80000,64000,1,1,1,0,0,0,4,87801,639,87162,3,81545,0,81545,2,51338,50918,420,0,50826,2000,48826
15420,280000,224000,0,0,0,0,0,0,-2,-7,0,-7,-2,1420,1427,-7,-2,8036,8076,-40,-2,12863,12927,-64
15421,140000,112000,0,0,0,0,0,0,-2,-488,0,-488,-2,-488,0,-488,-2,-488,0,-488,-2,-488,0,-488
15422,190000,152000,0,0,0,0,0,0,0,17574,3000,14574,0,18943,2000,16943,0,20405,2000,18405,0,42921,25921,17000
15423,50000,40000,0,1,0,0,0,0,2,45429,41,45388,2,28927,1617,27310,0,19896,816,19080,0,19475,1003,18472
15424,150000,120000,0,1,1,1,1,0,0,147332,5500,141832,2,149199,5800,143399,2,151978,5400,146578,2,148131,5000,143131
15425,50000,40000,0,0,0,0,0,0,0,24962,2000,22962,0,25557,1000,24557,0,26156,1000,25156,0,26032,1000,25032
15426,10000,8000,0,1,1,0,0,0,2,8876,0,8876,2,10009,1500,8509,2,7169,0,7169,2,8842,3000,5842
15427,150000,120000,0,0,0,0,0,0,0,15000,15000,0,-1,0,0,0,-1,15000,15000,0,-1,0,0,0
15428,240000,192000,0,1,1,1,1,0,2,234364,10200,224164,0,235982,10200,225782,0,239281,8725,230556,0,244329,9068,235261
15429,180000,144000,0,0,0,0,0,0,2,1473,1473,0,-1,1473,1473,0,-1,2705,2705,0,-1,1473,1473,0
15430,230000,184000,0,0,0,0,0,1,-1,4872,5000,-128,-1,0,0,0,-1,1241,1241,0,-1,-383,0,-383
15431,300000,240000,0,0,0,0,0,0,-2,901,901,0,-2,1075,1075,0,-2,0,0,0,-2,66,66,0
15432,50000,40000,0,1,0,0,0,0,0,46641,1690,44951,0,31459,1458,30001,0,28901,1100,27801,0,29523,1076,28447
15433,180000,144000,0,0,0,0,0,0,-2,0,0,0,-2,0,0,0,-2,0,0,0,-2,0,0,0
15434,90000,72000,0,0,0,0,0,0,0,67854,4100,63754,0,53952,3900,50052,0,47277,3000,44277,0,35547,2200,33347
15435,140000,112000,0,0,0,0,0,0,-2,5088,5088,0,-2,4480,4480,0,-2,2338,2338,0,-2,4250,4733,-483
15436,200000,160000,0,0,0,0,0,0,2,1926,1931,-5,-1,3263,3267,-4,-1,1580,7,1573,-1,16874,17894,-1020
15437,210000,168000,0,0,0,0,0,0,0,47836,3000,44836,0,50344,3942,46402,0,51074,2000,49074,0,52229,2000,50229
15438,20000,16000,0,0,1,1,1,1,0,17280,1294,15986,0,18431,1596,16835,0,18341,655,17686,0,19569,1669,17900
15439,500000,400000,0,0,0,0,0,0,-2,2652,2676,-24,-2,-11,1,-12,-2,-213,0,-213,-2,-213,0,-213
15440,320000,256000,0,0,0,0,0,0,0,207050,10000,197050,0,201114,10000,191114,0,190921,10000,180921,0,191781,7000,184781
15441,140000,112000,0,0,0,0,0,0,0,1876,1876,0,-1,1876,1876,0,-1,1876,1876,0,-1,3372,3372,0
15442,90000,72000,0,0,0,0,0,1,0,75342,3615,71727,0,71668,3511,68157,0,49358,2500,46858,0,50296,2000,48296
15443,190000,152000,0,0,0,0,0,0,0,55282,2600,52682,0,50864,2000,48864,0,48782,3000,45782,0,49241,5000,44241
15444,200000,160000,0,0,0,0,0,0,0,0,0,0,0,0,0,0,-2,0,0,0,-2,590,590,0
15445,90000,72000,0,0,0,0,0,0,-1,1881,1886,-5,-1,7638,7650,-12,-1,4464,1005,3459,0,26224,23773,2451
15446,360000,288000,0,0,0,0,0,0,-1,846,852,-6,-1,14998,14998,0,-1,14998,0,14998,0,679,683,-4
15447,100000,80000,0,0,0,0,0,0,2,4100,4107,-7,-1,7980,7980,0,-1,0,0,0,-1,9487,9487,0
15448,30000,24000,0,0,0,0,0,1,2,3895,1309,2586,0,0,0,0,0,0,0,0,-2,0,0,0
15449,300000,240000,0,0,0,0,0,0,-1,16666,16666,0,-1,0,0,0,-1,0,0,0,-2,0,0,0
15450,200000,160000,0,0,0,0,0,1,-1,316,0,316,2,782,782,0,-1,782,316,466,-1,316,0,316
15451,30000,24000,0,0,0,0,0,0,0,12439,1503,10936,0,12530,594,11936,0,12790,610,12180,0,12891,462,12429
15452,270000,216000,0,0,0,0,0,0,-1,165,165,0,-1,165,165,0,-1,0,0,0,-1,601,601,0
15453,240000,192000,0,0,0,0,0,0,-2,0,0,0,-2,0,0,0,-2,0,0,0,-2,0,0,0
15454,220000,176000,0,0,0,0,0,0,0,2080,0,2080,2,2080,2080,0,-1,4160,2080,2080,0,2080,2080,0
15455,120000,96000,0,0,0,0,0,1,2,27941,1600,26341,0,11990,1000,10990,0,390,390,0,-1,390,390,0
15456,50000,40000,0,1,1,1,1,1,2,50029,3000,47029,0,50921,5000,45921,0,48809,0,48809,2,49639,1815,47824
15457,60000,48000,0,0,0,0,0,0,0,16532,2000,14532,0,15782,0,15782,0,17782,2000,15782,0,9450,0,9450
15458,50000,40000,0,0,0,0,0,0,0,0,0,0,0,0,0,0,-2,0,0,0,-2,0,0,0
15459,160000,128000,0,0,0,0,0,0,2,47188,2200,44988,2,46134,0,46134,2,47063,2000,45063,0,50034,3900,46134
15460,10000,8000,0,1,1,1,1,0,0,9070,1000,8070,0,8880,200,8680,0,9580,700,8880,0,9000,200,8800
15461,160000,128000,0,0,0,0,0,1,-2,5105,5109,-4,-2,3326,3328,-2,-2,5482,5494,-12,-2,2698,2864,-166
15462,130000,104000,0,0,0,0,0,1,2,82799,5000,77799,0,86407,5000,81407,0,88959,4000,84959,0,97487,10000,87487
15463,80000,64000,0,0,0,0,0,0,-1,680,680,0,-1,2862,2862,0,-1,5539,5539,0,-1,0,0,0
15464,80000,64000,0,0,0,0,0,0,0,9360,9383,-23,-1,6295,6295,0,-1,14844,10018,4826,0,29065,21939,7126
15465,150000,120000,0,0,0,0,0,0,0,120509,12137,108372,0,74837,9005,65832,0,74391,2528,71863,0,66932,3119,63813
15466,20000,16000,0,0,0,0,0,0,0,15992,16000,-8,-1,14897,600,14297,0,12792,1000,11792,0,10042,500,9542
15467,140000,112000,0,1,1,1,1,0,0,137485,6500,130985,0,137450,6300,131150,0,135638,6000,129638,0,136375,5200,131175
15468,50000,40000,0,0,0,0,0,0,0,32982,6194,26788,2,31857,1200,30657,2,29647,0,29647,2,29585,2000,27585
15469,40000,32000,0,0,0,0,0,0,0,17994,0,17994,2,20671,3000,17671,0,22328,2000,20328,0,21830,0,21830
15470,370000,296000,0,0,0,0,0,0,-1,-400,7,-407,-1,-1900,0,-1900,-2,-1900,0,-1900,-2,-1900,0,-1900
15471,390000,312000,0,0,0,0,0,0,0,250654,9300,241354,0,253336,9402,243934,0,256281,10343,245938,0,257151,7000,250151
15472,200000,160000,0,0,0,0,0,0,-1,1306,1306,0,-1,3142,3332,-190,-1,3332,1686,1646,-1,1686,0,1686
15473,120000,96000,0,0,0,0,0,0,0,73732,0,73732,2,12329,247,12082,0,12329,0,12329,0,0,0,0
15474,50000,40000,0,1,0,0,0,0,0,44006,2300,41706,0,29737,2500,27237,0,30615,1500,29115,2,29975,0,29975
15475,210000,168000,0,0,0,0,0,1,2,2500,0,2500,2,2500,0,2500,2,2500,0,2500,2,2500,0,2500
15476,240000,192000,0,0,0,0,0,0,-1,2500,2500,0,-1,12500,12500,0,-1,749,749,0,-1,2829,2829,0
15477,750000,600000,0,0,0,0,0,0,-1,401003,401003,0,-1,399493,7990,391503,0,400993,11000,389993,0,409483,417990,-8507
15478,230000,184000,0,0,0,0,0,0,-2,0,0,0,-2,1360,1360,0,-1,680,0,680,0,600,600,0
15479,80000,64000,1,1,1,1,1,1,0,157646,3450,154196,0,79061,3000,76061,0,79834,3059,76775,0,81257,2915,78342
15480,310000,248000,0,0,0,0,0,0,0,69195,3095,66100,0,59169,5000,54169,0,12056,2000,10056,0,10032,10058,-26
15481,210000,168000,0,0,0,0,0,0,0,159975,5085,154890,0,138349,4087,134262,0,112371,4220,108151,0,111979,27704,84275
15482,30000,24000,0,1,1,1,1,1,0,29619,1589,28030,0,30224,1351,28873,0,27326,2500,24826,0,30297,4000,26297
15483,20000,16000,0,1,1,1,1,0,2,19360,300,19060,2,20421,1700,18721,2,19832,0,19832,2,18052,804,17248
15484,120000,96000,0,1,0,0,0,0,0,108971,5000,103971,0,83592,5000,78592,0,22321,2000,20321,0,32150,20000,12150
15485,10000,8000,0,0,0,0,0,0,-1,0,0,0,-1,780,780,0,-1,0,0,0,-1,0,0,0
15486,20000,16000,0,0,0,0,0,0,0,11500,2000,9500,0,0,0,0,0,0,0,0,-2,0,0,0
15487,70000,56000,0,0,0,0,0,0,0,28236,1500,26736,0,30750,3000,27750,0,35205,5000,30205,0,37466,3000,34466
15488,70000,56000,0,0,0,0,0,1,2,38355,3100,35255,2,39423,2000,37423,2,38659,0,38659,2,39362,1500,37862
15489,70000,56000,1,1,1,1,1,0,5,95609,0,95609,4,86494,0,86494,3,79359,0,79359,2,74937,2150,72787
15490,70000,56000,0,0,0,0,0,0,-1,11818,7000,4818,0,12889,5000,7889,0,9043,4043,5000,0,26713,5000,21713
15491,50000,40000,0,0,0,0,0,0,0,24777,3000,21777,0,24521,3005,21516,0,16773,3014,13759,0,16524,3632,12892
15492,160000,128000,0,0,0,0,0,0,-1,-379,6,-385,-2,-1464,75,-1539,-2,2110,3574,-1464,-1,1462,5,1457
15493,140000,112000,0,1,1,1,1,0,0,131672,4603,127069,0,133496,5002,128494,0,128509,4505,124004,0,124035,4400,119635
15494,240000,192000,0,0,0,0,0,0,-1,11234,11263,-29,-1,15214,10018,5196,0,9107,21,9086,0,5621,3637,1984
15495,310000,248000,0,0,0,0,0,0,0,225574,10000,215574,0,224001,6000,218001,0,230902,10000,220902,0,105844,39000,66844
15496,50000,40000,0,0,0,0,0,0,0,27095,1428,25667,0,18538,600,17938,0,20100,3000,17100,0,19630,0,19630
15497,340000,272000,0,0,0,0,0,0,0,31051,4674,26377,0,34917,5032,29885,0,32110,360,31750,2,33984,6360,27624
15498,180000,144000,0,0,0,0,0,1,-2,0,0,0,-2,0,0,0,-2,0,0,0,-2,0,0,0
15499,210000,168000,0,0,0,0,0,0,-1,16915,16920,-5,-1,16266,16266,0,-1,571,0,571,-1,18827,19136,-309
15500,80000,64000,1,1,0,0,0,0,0,88361,4100,84261,0,43671,0,43671,2,44541,1596,42945,0,47421,3600,43821
15501,60000,48000,0,0,0,0,0,0,2,6232,6472,-240,-1,6444,6444,0,-1,3783,3219,564,0,3219,0,3219
15502,10000,8000,0,1,1,1,1,1,2,8893,0,8893,3,8928,334,8594,2,9586,801,8785,2,9294,0,9294
15503,80000,64000,0,1,1,0,0,0,0,70730,2745,67985,0,68487,2100,66387,0,57304,1684,55620,0,41345,4000,37345
15504,300000,240000,0,0,0,0,0,1,0,3283,0,3283,2,3961,3961,0,-1,24306,24306,0,-1,22644,0,22644
15505,30000,24000,0,0,0,0,0,0,0,15037,1065,13972,0,2986,1000,1986,0,4212,1226,2986,0,1161,1161,0
15506,50000,40000,0,1,0,0,0,1,0,47471,1400,46071,0,21571,431,21140,0,19005,380,18625,0,772,772,0
15507,30000,24000,0,0,0,0,0,0,-2,249,249,0,-2,5051,5051,0,-2,1188,2202,-1014,-2,375,375,0
15508,210000,168000,0,0,0,0,0,0,0,20296,2000,18296,0,21704,2000,19704,0,24086,3000,21086,0,26414,3000,23414
15509,50000,40000,0,0,0,0,0,0,-2,0,0,0,-2,0,0,0,-2,0,0,0,-2,0,0,0
15510,250000,200000,0,0,0,0,0,0,0,53779,2500,51279,0,54503,2000,52503,0,55685,2000,53685,0,57985,3000,54985
15511,170000,136000,0,0,0,0,0,1,-1,326,326,0,-1,326,326,0,-1,326,326,0,-1,326,326,0
15512,50000,40000,0,0,1,0,0,0,0,49821,51869,-2048,-1,43945,1884,42061,0,29669,1023,28646,0,28469,1173,27296
15513,320000,256000,0,0,0,0,0,0,0,121486,3300,118186,0,22337,6000,16337,0,23358,5000,18358,0,13536,2000,11536
15514,50000,40000,0,1,1,1,1,0,0,47435,1865,45570,0,48290,1720,46570,0,49257,1687,47570,0,49345,1732,47613
15515,320000,256000,0,0,0,0,0,0,-1,7500,7500,0,-1,7500,7500,0,-1,7500,7500,0,-1,7500,7500,0
15516,80000,64000,0,0,0,0,0,0,-1,2154,2154,0,-1,583,583,0,-1,11381,11381,0,-1,9508,190,9318
15517,360000,288000,0,0,0,0,0,0,-1,18144,18500,-356,-1,57687,57697,-10,-1,49519,11000,38519,0,53478,15000,38478
15518,170000,136000,0,0,0,0,0,0,0,11673,2500,9173,0,12770,1600,11170,0,12971,711,12260,0,13312,700,12612
15519,230000,184000,0,0,0,0,0,0,-1,19640,19640,0,-1,13242,13242,0,-1,1782,1782,0,-1,3106,3106,0
15520,180000,144000,0,0,0,0,0,0,0,98354,4000,94354,0,105327,8600,96727,0,107500,4000,103500,2,105614,0,105614
15521,140000,112000,0,0,0,0,0,1,2,46115,1600,44515,2,47053,2000,45053,2,48150,2000,46150,2,49009,1800,47209
15522,370000,296000,0,0,0,0,0,0,0,103000,5000,98000,0,41200,41200,0,-1,1109,1109,0,-1,99723,99723,0
15523,30000,24000,0,0,0,0,0,0,-1,139,120,19,2,19,0,19,2,19,0,19,2,79,60,19
15524,20000,16000,0,1,1,1,1,0,0,17557,1291,16266,0,18666,1400,17266,0,19037,681,18356,0,19434,703,18731
15525,100000,80000,0,0,0,0,0,0,-2,1983,1983,0,-2,3543,3543,0,-2,0,0,0,-2,0,0,0
15526,180000,144000,0,0,0,0,0,0,-2,0,0,0,-2,0,0,0,-2,0,0,0,-2,0,0,0
15527,230000,184000,0,0,0,0,0,0,-1,167,200,-33,-1,3351,3351,0,-1,1644,1644,0,-1,1733,1733,0
15528,90000,72000,0,0,0,0,0,0,0,41150,4000,37150,0,41677,1500,40177,2,42191,1500,40691,2,43371,2000,41371
15529,50000,40000,0,1,0,0,0,1,0,43095,2052,41043,0,29717,1034,28683,0,30368,1100,29268,0,29113,1088,28025
15530,50000,40000,0,1,1,1,1,1,3,50255,2800,47455,2,49104,0,49104,3,51044,3000,48044,2,50933,800,50133
15531,80000,64000,0,0,0,0,0,0,-2,2455,2455,0,-1,2500,2500,0,-1,1307,1307,0,-1,1550,1550,0
15532,470000,376000,0,0,0,0,0,1,0,38423,5000,33423,0,197773,162546,35227,0,202722,5783,196939,0,46980,1689,45291
15533,180000,144000,0,0,0,0,0,0,0,18300,5000,13300,0,16908,10009,6899,0,37319,22000,15319,0,34978,20000,14978
15534,50000,40000,0,1,0,0,0,0,0,45506,1900,43606,0,41471,2000,39471,0,18298,1000,17298,0,19001,1000,18001
15535,20000,16000,0,0,0,0,0,1,2,5075,1000,4075,2,4845,0,4845,2,6753,2000,4753,0,9615,3000,6615
15536,20000,16000,0,0,1,1,1,1,2,19739,4900,14839,2,19194,0,19194,3,38414,800,37614,2,19200,800,18400
15537,150000,120000,1,1,1,1,1,0,0,173918,6200,167718,0,174074,5874,168200,0,178671,10000,168671,0,178869,6054,172815
15538,90000,72000,0,0,0,0,0,0,0,46273,3000,43273,0,46979,1700,45279,0,48139,2000,46139,0,44432,1591,42841
15539,30000,24000,0,0,0,0,0,1,3,12900,0,12900,2,11006,2046,8960,0,5584,0,5584,0,5268,0,5268
15540,80000,64000,0,0,0,0,0,0,0,52775,0,52775,2,53906,2000,51906,0,60099,7100,52999,0,61402,2400,59002
15541,360000,288000,0,0,0,0,0,0,-1,0,0,0,-1,0,0,0,-2,0,0,0,-2,0,0,0
15542,240000,192000,0,0,0,0,0,0,0,12450,12450,0,-1,27255,28969,-1714,-1,6280,6280,0,-1,7619,7619,0
15543,180000,144000,0,0,0,0,0,0,-1,0,0,0,-1,0,0,0,-2,1200,1200,0,-2,0,0,0
15544,50000,40000,0,0,0,0,0,1,0,35603,1700,33903,0,37595,2600,34995,0,29818,0,29818,2,24416,10000,14416
15545,360000,288000,0,0,0,0,0,0,-2,390,2000,-1610,-1,-710,0,-710,-1,260,1500,-1240,-1,10,1000,-990
15546,10000,8000,0,0,0,0,1,0,2,6113,1000,5113,2,8012,2000,6012,0,8873,1000,7873,0,9229,500,8729
15547,370000,296000,0,0,0,0,0,0,-1,12094,12294,-200,-1,30751,30751,0,-1,30131,30131,0,-1,9630,0,9630
15548,50000,40000,0,1,0,0,0,0,0,45461,1005,44456,0,18354,19763,-1409,-1,19118,1000,18118,0,19404,1000,18404
15549,340000,272000,0,0,0,0,0,0,2,20012,1353,18659,2,19728,531,19197,2,19042,14,19028,2,11728,235,11493
15550,20000,16000,0,0,0,0,0,0,-1,467,467,0,-1,500,500,0,-1,0,0,0,-1,647,647,0
15551,460000,368000,0,0,0,0,0,0,0,126758,5032,121726,0,121857,4407,117450,0,122830,4040,118790,0,90219,3001,87218
15552,110000,88000,0,0,0,0,0,1,0,27864,7000,20864,0,25691,0,25691,2,28257,10000,18257,0,24161,4161,20000
15553,130000,104000,0,0,0,0,0,0,-2,98,98,0,-1,98,0,98,2,98,0,98,2,2500,2500,0
15554,350000,280000,0,0,0,0,0,0,0,5338,3000,2338,0,3042,0,3042,2,2418,2500,-82,-1,2233,0,2233
15555,120000,96000,0,0,0,0,0,1,0,11793,2691,9102,0,11307,0,11307,2,14102,3000,11102,0,15871,2000,13871
15556,110000,88000,0,0,0,0,0,0,0,85362,3500,81862,0,74552,4005,70547,0,59902,0,59902,2,42254,1500,40754
15557,130000,104000,0,0,0,0,0,0,0,107700,5433,102267,0,103736,4431,99305,0,101414,6938,94476,0,100157,3467,96690
15558,440000,352000,0,1,1,0,0,0,0,393255,20000,373255,0,370202,15305,354897,0,258387,10070,248317,0,255740,15037,240703
15559,110000,88000,0,0,0,0,0,0,0,47743,1525,46218,0,45654,18236,27418,0,26525,1500,25025,0,22937,2000,20937
15560,150000,120000,0,0,0,0,0,0,0,14587,2500,12087,0,59974,55000,4974,0,51049,1115,49934,0,47079,1000,46079
15561,300000,240000,0,0,0,0,0,0,0,47857,5024,42833,0,48128,6012,42116,0,50332,5191,45141,0,23688,12139,11549
15562,210000,168000,0,0,0,0,0,0,-2,2836,2836,0,-2,2316,2316,0,-2,1446,1446,0,-2,131242,131242,0
15563,80000,64000,0,0,0,0,0,1,2,814,814,0,-1,390,390,0,-1,390,390,0,-1,390,390,0
15564,340000,272000,0,0,0,0,0,0,-1,12411,12824,-413,-1,9119,10,9109,2,29280,29047,233,0,23093,6153,16940
15565,280000,224000,0,0,0,0,0,0,-2,0,0,0,-2,0,0,0,-2,0,0,0,-2,0,0,0
15566,160000,128000,0,0,0,0,0,0,-1,4791,4805,-14,-1,2999,3008,-9,-1,961,1742,-781,-1,994,998,-4
15567,40000,32000,0,0,0,0,0,1,0,7776,1500,6276,2,7502,0,7502,2,7651,274,7377,0,7811,283,7528
15568,50000,40000,0,0,0,0,0,1,0,19602,1500,18102,0,22156,4600,17556,0,22732,1000,21732,0,11378,600,10778
15569,300000,240000,0,0,0,0,0,0,-1,3131,3152,-21,-1,5180,5180,0,-1,1780,1780,0,-1,0,0,0
15570,110000,88000,0,1,1,0,0,1,2,110313,6307,104006,0,108986,5093,103893,0,48641,2008,46633,0,46982,2010,44972
15571,240000,192000,0,0,0,0,0,1,2,133457,5000,128457,2,134749,4800,129949,2,132651,0,132651,2,140600,10000,130600
15572,90000,72000,0,1,0,0,0,0,0,81003,3914,77089,0,68764,2774,65990,0,67957,2620,65337,0,69313,2640,66673
15573,200000,160000,0,1,1,1,1,0,0,178858,8982,169876,0,180101,6758,173343,0,173138,6257,166881,0,176920,6633,170287
15574,100000,80000,0,0,0,0,0,0,2,2342,3141,-799,-1,12016,12021,-5,-1,10203,135,10068,0,5323,507,4816
15575,140000,112000,0,0,0,0,0,1,2,87251,5000,82251,0,88227,3300,84927,0,90170,3500,86670,0,92044,3500,88544
15576,180000,144000,0,0,0,0,0,0,-2,0,0,0,-2,0,0,0,-2,0,0,0,-2,0,0,0
15577,50000,40000,0,0,0,0,0,0,0,4990,4990,0,-1,3596,13616,-10020,-1,1386,1310,76,-2,4775,4789,-14
15578,90000,72000,0,0,0,0,0,0,0,20263,0,20263,2,20145,3000,17145,0,24845,8000,16845,0,23745,5000,18745
15579,480000,384000,0,0,0,0,0,0,-2,-897,0,-897,-2,-897,0,-897,-2,-897,0,-897,-2,-897,0,-897
15580,420000,336000,0,0,0,0,0,0,-1,17516,1150,16366,0,8773,205,8568,0,15437,15442,-5,-1,26376,22292,4084
15581,400000,320000,0,0,0,0,0,0,-1,2190,2190,0,-1,12881,12881,0,-1,7497,0,7497,0,11563,4590,6973
15582,210000,168000,0,0,0,0,0,0,-1,390,390,0,-1,390,390,0,-1,980,980,0,-1,590,0,590
15583,360000,288000,0,0,0,0,0,0,-1,7675,7685,-10,-1,18602,18610,-8,-1,20461,8000,12461,0,33404,21004,12400
15584,300000,240000,0,0,0,0,0,0,0,9775,1164,8611,0,7347,1069,6278,0,4026,81,3945,0,4851,4851,0
15585,210000,168000,0,0,0,0,0,0,-1,0,0,0,-1,0,0,0,-2,312,312,0,-1,0,0,0
15586,30000,24000,0,1,1,1,1,0,0,29322,0,29322,2,28015,1148,26867,0,28610,1195,27415,0,28884,910,27974
15587,230000,184000,0,0,0,0,0,0,-1,376,376,0,-1,47992,48042,-50,-1,3099,3099,0,-1,2389,0,2389
15588,240000,192000,0,1,1,1,1,0,0,245148,10577,234571,0,240343,8302,232041,0,211449,7300,204149,0,215874,7505,208369
15589,500000,400000,0,0,0,0,0,1,-1,11520,11525,-5,-1,12486,12489,-3,-1,11609,11614,-5,-1,12660,12665,-5
15590,130000,104000,0,1,0,0,0,1,0,126194,15066,111128,0,17832,5007,12825,0,-3000,0,-3000,0,0,3000,-3000
15591,390000,312000,0,0,0,0,0,0,-1,10000,10000,0,-1,20666,20666,0,-1,10000,10000,0,-1,10000,10000,0
15592,70000,56000,0,0,0,0,0,1,2,46626,4000,42626,2,47562,2000,45562,2,48651,2000,46651,2,49700,2000,47700
15593,220000,176000,0,0,0,0,0,1,2,179645,6800,172845,0,166753,6640,160113,0,82058,4100,77958,0,20650,1100,19550
15594,50000,40000,0,0,0,0,0,0,2,16490,1700,14790,2,16962,1002,15960,2,15446,2,15444,2,14739,684,14055
15595,290000,232000,0,0,0,0,0,0,-2,10069,10194,-125,-2,4225,4276,-51,-2,-4,0,-4,-2,871,875,-4
15596,300000,240000,0,0,0,0,0,0,0,38354,2196,36158,0,39634,2476,37158,0,21597,3439,18158,0,481,0,481
15597,240000,192000,0,0,0,0,0,0,-1,4745,4774,-29,-1,2430,2442,-12,-1,7792,7829,-37,-1,33196,33361,-165
15598,420000,336000,0,0,0,0,0,0,2,71035,0,71035,2,57503,2000,55503,0,56467,1892,54575,0,53995,1979,52016
15599,420000,336000,0,0,0,0,0,0,-2,5344,5348,-4,-2,5058,5065,-7,-2,2019,2019,0,-2,2443,2443,0
15600,350000,280000,0,0,0,0,0,0,0,52449,15000,37449,0,53581,6000,47581,0,45320,1013,44307,0,43421,1445,41976
15601,50000,40000,0,0,0,0,0,0,-1,326,326,0,-1,15493,15493,0,-1,8210,284,7926,0,8133,371,7762
15602,50000,40000,0,1,1,0,0,0,0,45866,3000,42866,0,46165,2200,43965,0,10142,1200,8942,0,10825,1000,9825
15603,60000,48000,0,0,0,0,0,0,0,28178,1616,26562,0,23199,1008,22191,0,572,1036,-464,0,27425,28848,-1423
15604,30000,24000,0,1,1,0,0,1,0,30299,1600,28699,0,27758,2000,25758,0,22720,2000,20720,0,19136,614,18522
15605,200000,160000,0,0,0,0,0,1,2,2500,0,2500,2,2500,0,2500,2,2500,0,2500,2,2500,0,2500
15606,30000,24000,0,0,0,0,0,0,-2,0,0,0,-2,0,0,0,-2,0,0,0,-2,0,0,0
15607,20000,16000,0,0,0,0,0,0,-2,0,0,0,-2,0,0,0,-2,13007,13007,0,-1,13912,1122,12790
15608,420000,336000,0,0,0,0,0,0,0,94199,6045,88154,0,90395,5000,85395,0,89513,6000,83513,0,92792,5000,87792
15609,60000,48000,0,0,0,0,0,0,0,9356,2000,7356,0,10392,1200,9192,0,11214,1000,10214,0,12028,1000,11028
15610,60000,48000,0,1,0,0,0,0,0,60360,2110,58250,0,38307,1272,37035,0,35519,1257,34262,0,35356,1245,34111
15611,340000,272000,0,0,0,0,0,0,0,282231,11031,271200,0,216946,8000,208946,0,216403,8000,208403,0,218209,8300,209909
15612,420000,336000,0,0,0,0,0,1,0,205276,9600,195676,0,206521,6700,199821,0,209775,7000,202775,0,194883,7042,187841
15613,10000,8000,0,1,1,0,0,0,2,9290,1000,8290,0,9480,190,9290,0,388,388,0,-1,10000,10000,0
15614,300000,240000,0,0,0,0,0,0,-1,0,0,0,-1,0,0,0,-2,0,0,0,-2,0,0,0
15615,350000,280000,0,0,0,1,0,0,0,271726,10766,260960,0,295642,29060,266582,0,283684,55,283629,2,282575,10104,272471
15616,230000,184000,0,0,0,0,0,0,0,30140,1600,28540,0,31067,1500,29567,0,31091,1000,30091,0,28223,1000,27223
15617,110000,88000,0,1,0,0,0,0,0,93984,5000,88984,0,91983,4109,87874,0,90129,3100,87029,0,89925,3322,86603
15618,250000,200000,0,0,0,0,0,1,-1,2533,4500,-1967,-1,1607,0,1607,2,56694,57000,-306,-1,58091,5000,53091
15619,420000,336000,0,0,0,0,0,0,2,0,20,-20,2,24683,24683,0,-2,23702,752,22950,-2,46093,30002,16091
15620,230000,184000,0,0,0,0,0,0,-2,0,0,0,-2,0,0,0,-2,0,0,0,-2,0,0,0
15621,20000,16000,0,1,1,1,1,0,0,17990,1319,16671,0,19671,2000,17671,0,19244,674,18570,0,19443,693,18750
15622,90000,72000,0,0,0,0,0,1,2,32426,0,32426,2,32763,1176,31587,0,33602,1367,32235,0,34193,1300,32893
15623,140000,112000,0,1,1,1,1,0,0,129695,5913,123782,0,130735,4426,126309,0,133467,4580,128887,0,136287,4770,131517
15624,130000,104000,0,0,0,0,0,1,2,106907,4544,102363,0,94152,3200,90952,0,96365,3500,92865,0,97413,3585,93828
15625,220000,176000,0,0,0,0,0,0,0,134420,4700,129720,0,132066,5000,127066,0,131319,5000,126319,0,130478,5000,125478
15626,160000,128000,0,0,0,0,0,1,3,75598,0,75598,2,82277,8000,74277,0,84955,4000,80955,0,87549,4000,83549
15627,200000,160000,0,0,0,0,0,0,0,44030,2000,42030,0,48466,5000,43466,0,49183,2000,47183,0,46919,3000,43919
15628,240000,192000,0,0,0,0,0,0,-1,7448,7448,0,-1,3724,0,3724,0,5814,5814,0,-1,10942,8852,2090
15629,60000,48000,0,0,0,0,0,1,2,27233,0,27233,2,30184,3720,26464,2,29566,0,29566,2,30225,1300,28925
15630,60000,48000,0,1,1,0,0,1,0,61792,4500,57292,2,57619,17,57602,2,12996,500,12496,0,2054,1500,554
15631,50000,40000,0,1,0,0,0,0,0,45344,1818,43526,0,36789,1312,35477,0,28918,879,28039,0,23095,781,22314
15632,180000,144000,0,0,0,0,0,0,-1,2057,2057,0,-1,2392,2392,0,-1,1483,1483,0,-1,2161,2161,0
15633,30000,24000,0,0,0,0,0,0,0,22912,1415,21497,0,14940,1002,13938,0,9365,200,9165,0,1280,104,1176
15634,380000,304000,0,0,0,0,0,0,0,4519,2000,2519,0,3818,2023,1795,0,4096,4102,-6,-1,4058,4448,-390
15635,100000,80000,0,1,1,1,1,1,0,100485,6000,94485,0,101552,3900,97652,0,100752,4100,96652,0,100652,17000,83652
15636,150000,120000,0,1,1,0,0,0,0,148755,6009,142746,0,133414,3259,130155,0,101284,149,101135,0,73255,1866,71389
15637,360000,288000,0,0,0,0,0,1,-2,-3,0,-3,-2,1000,1003,-3,-1,0,0,0,-1,0,0,0
15638,160000,128000,0,0,0,0,0,0,2,0,0,0,2,0,0,0,-2,0,0,0,-2,0,0,0
15639,500000,400000,0,0,0,0,0,1,0,111690,13151,98539,0,78070,0,78070,2,78376,3000,75376,0,80912,5000,75912
15640,360000,288000,0,0,0,0,0,0,-2,0,0,0,-2,0,0,0,-2,0,0,0,-2,0,0,0
15641,330000,264000,0,0,0,0,0,1,0,130567,7000,123567,0,128257,10007,118250,0,116988,6500,110488,0,105961,6600,99361
15642,50000,40000,0,0,0,0,0,0,0,17266,1298,15968,0,18253,1285,16968,0,18618,650,17968,0,37495,825,36670
15643,50000,40000,0,1,1,1,0,0,0,49111,1600,47511,0,48943,1700,47243,0,45775,1700,44075,0,0,0,0
15644,200000,160000,0,0,0,0,0,0,-2,0,0,0,-2,0,0,0,-2,0,0,0,-2,900,900,0
15645,80000,64000,0,0,0,0,0,0,0,23224,1500,21724,0,23141,1700,21441,0,22160,1000,21160,0,21478,1000,20478
15646,50000,40000,0,0,0,0,0,0,0,10950,1481,9469,0,11519,1050,10469,0,11191,0,11191,2,11903,903,11000
15647,360000,288000,0,0,0,0,0,0,0,59194,3721,55473,0,59444,2839,56605,0,-2206,1303,-3509,0,-2206,0,-2206
15648,20000,16000,0,0,0,0,0,0,2,9651,1651,8000,0,10488,1000,9488,0,12314,2000,10314,0,11970,0,11970
15649,80000,64000,0,0,0,0,0,1,0,5812,1060,4752,0,4788,154,4634,0,3758,147,3611,0,3812,127,3685
15650,30000,24000,0,1,1,1,1,0,0,29702,0,29702,2,28839,1500,27339,0,29375,1300,28075,0,32729,4000,28729
15651,80000,64000,0,0,0,0,0,0,2,56049,16,56033,2,50829,2003,48826,0,50687,2013,48674,0,47362,5007,42355
15652,50000,40000,1,1,0,0,0,0,0,96051,300,95751,2,18051,18000,51,0,18767,1000,17767,0,19462,1000,18462
15653,210000,168000,0,0,0,0,0,0,-1,1188,1188,0,-1,2667,2667,0,-1,546,546,0,-1,578,578,0
15654,130000,104000,0,1,0,0,0,0,0,128302,4268,124034,0,125300,89527,35773,0,4125,107,4018,0,4210,500,3710
15655,20000,16000,0,0,1,0,0,0,0,20076,20000,76,0,20035,909,19126,0,14057,1000,13057,0,0,0,0
15656,210000,168000,0,0,0,0,0,0,-2,0,0,0,-2,0,0,0,-2,0,0,0,-2,0,0,0
15657,280000,224000,0,0,0,0,0,0,-2,4887,4919,-32,-1,2067,10,2057,0,6624,6657,-33,-1,1489,1496,-7
15658,140000,112000,0,1,1,1,1,0,2,144229,5350,138879,0,144470,5555,138915,0,144386,5836,138550,0,120586,4191,116395
15659,200000,160000,0,0,0,0,0,0,-1,174406,175000,-594,-1,133073,133100,-27,-1,45373,46000,-627,-1,973,1000,-27
15660,500000,400000,0,0,0,0,0,1,-1,5334,25,5309,2,1911,1920,-9,-1,1774,1783,-9,-1,5351,5377,-26
15661,200000,160000,0,0,0,0,0,0,-1,153377,5228,148149,0,134027,5005,129022,0,135120,5004,130116,0,136512,5151,131361
15662,280000,224000,0,0,0,0,0,0,-1,4132,4170,-38,-1,2693,2703,-10,-1,659,659,0,-1,3277,3297,-20
15663,80000,64000,0,0,0,0,0,0,0,56435,1796,54639,0,40620,2126,38494,0,37356,1539,35817,0,35091,1807,33284
15664,70000,56000,0,0,0,0,0,0,0,47394,1500,45894,0,7879,0,7879,0,-1940,0,-1940,0,27545,30000,-2455
15665,240000,192000,0,0,0,0,0,0,0,189914,12014,177900,0,190434,6075,184359,0,179424,5900,173524,0,183299,5900,177399
15666,50000,40000,0,0,0,0,0,0,-1,0,0,0,-1,0,0,0,-2,0,0,0,-2,0,0,0
15667,200000,160000,0,0,0,0,0,1,2,2500,0,2500,4,2500,0,2500,4,2500,0,2500,4,2500,0,2500
15668,30000,24000,0,1,1,1,1,0,0,30582,3000,27582,0,28983,1404,27579,0,27947,559,27388,0,26630,533,26097
15669,100000,80000,0,0,0,0,0,0,0,16356,2000,14356,0,10144,4000,6144,0,8095,3095,5000,0,10140,5140,5000
15670,160000,128000,0,0,0,0,0,1,-1,3633,3633,0,-1,2707,2702,5,0,6087,6087,0,-1,4852,4852,0
15671,160000,128000,0,0,0,0,0,0,0,6854,2230,4624,0,3759,0,3759,2,3164,16,3148,0,3000,16,2984
15672,160000,128000,0,0,0,0,0,0,-1,550,550,0,-1,550,550,0,-1,550,550,0,-1,550,550,0
15673,140000,112000,0,0,0,0,0,0,-1,18886,19030,-144,-1,9476,10000,-524,-1,5040,10000,-4960,-1,6070,6100,-30
15674,300000,240000,0,0,0,0,0,0,-2,0,0,0,-2,0,0,0,-2,0,0,0,-2,0,0,0
15675,210000,168000,0,0,0,0,0,1,-1,325,325,0,-1,325,325,0,-1,325,325,0,-1,325,325,0
15676,50000,40000,0,0,0,0,0,1,0,36540,2065,34475,0,16077,1246,14831,0,12134,450,11684,0,12389,451,11938
15677,110000,88000,0,0,0,0,0,0,-1,1352,1352,0,-1,1867,1867,0,-1,36986,36986,0,-1,40053,5000,35053
15678,150000,120000,0,0,0,0,0,0,0,108761,4100,104661,0,79044,3150,75894,0,79350,2211,77139,0,80594,2270,78324
15679,200000,160000,0,0,0,0,0,0,0,130884,4734,126150,0,132142,4368,127774,0,118084,4183,113901,0,114281,4227,110054
15680,230000,184000,0,0,0,0,0,0,0,7719,3050,4669,0,7601,5000,2601,0,12140,5000,7140,0,16145,5000,11145
15681,60000,48000,0,0,0,0,0,0,0,36527,2011,34516,0,28170,1200,26970,0,28963,1400,27563,0,29456,1200,28256
15682,190000,152000,0,0,0,0,0,0,0,131891,5000,126891,0,133516,5000,128516,0,135008,5000,130008,0,136486,5100,131386
15683,70000,56000,0,0,0,0,0,1,0,56741,10032,46709,0,25172,8000,17172,0,29186,5139,24047,0,25430,1000,24430
15684,90000,72000,0,0,0,0,0,1,0,20367,1657,18710,0,16680,1000,15680,0,10320,206,10114,0,7601,7601,0
15685,210000,168000,0,0,0,0,0,0,0,156422,6005,150417,0,146954,5200,141754,0,137937,5500,132437,0,134581,5000,129581
15686,50000,40000,0,0,0,0,0,1,3,12476,1200,11276,2,11979,0,11979,2,12880,1100,11780,2,12531,0,12531
15687,60000,48000,0,1,1,1,1,1,0,58647,2190,56457,0,59619,2078,57541,0,57068,2002,55066,0,57668,2062,55606
15688,200000,160000,0,1,1,1,1,1,2,168386,6000,162386,2,164182,0,164182,2,169029,7500,161529,2,172084,6000,166084
15689,80000,64000,0,1,0,0,0,1,0,74598,1688,72910,0,34712,694,34018,0,40452,44492,-4040,-1,39762,1455,38307
15690,30000,24000,0,0,0,0,0,0,0,0,0,0,-2,0,0,0,-2,0,0,0,-2,0,0,0
15691,30000,24000,0,1,1,1,0,0,0,25711,1527,24184,0,26614,1430,25184,0,26948,764,26184,0,14648,530,14118
15692,180000,144000,0,0,0,0,0,0,0,850,850,0,-1,0,0,0,-1,6881,6881,0,-1,10340,10340,0
15693,20000,16000,0,1,1,1,1,0,2,19872,1782,18090,0,20100,1400,18700,0,19704,394,19310,0,18004,0,18004
15694,200000,160000,0,0,0,0,0,0,-1,390,390,0,-1,390,390,0,-1,390,390,0,-1,390,390,0
15695,50000,40000,0,1,0,0,0,1,0,43282,1966,41316,0,14713,1130,13583,0,19583,5000,14583,0,14959,1000,13959
15696,20000,16000,0,0,0,0,0,0,0,0,0,0,0,0,0,0,-2,0,0,0,-2,0,0,0
15697,50000,40000,0,0,0,0,0,1,2,17168,1500,15668,0,18376,1500,16876,0,19068,1000,18068,0,19760,1000,18760
15698,60000,48000,0,0,0,0,0,0,0,33166,3700,29466,0,33528,1200,32328,2,32690,0,32690,2,34661,2500,32161
15699,190000,152000,0,0,0,0,0,0,0,78430,3507,74923,0,77653,3003,74650,0,78395,3003,75392,0,70849,3510,67339
15700,300000,240000,0,0,0,0,0,0,-2,12351,12351,0,-1,6417,0,6417,0,5245,5245,0,-1,12082,7000,5082
15701,50000,40000,0,1,1,1,1,1,0,48350,2200,46150,0,48786,2000,46786,0,49277,2000,47277,0,50151,1755,48396
15702,70000,56000,0,0,0,0,0,0,2,832,832,0,-1,416,0,416,2,416,416,0,-1,1132,1132,0
15703,230000,184000,0,0,0,0,0,0,-1,396,396,0,-1,396,396,0,-1,396,396,0,-1,546,546,0
15704,50000,40000,0,1,1,0,0,0,0,45052,2200,42852,0,44938,2000,42938,0,40655,2000,38655,0,40930,2000,38930
15705,80000,64000,0,1,1,1,1,0,0,78535,3500,75035,0,79296,3322,75974,0,75274,3000,72274,0,78051,5007,73044
15706,320000,256000,0,0,0,0,0,0,-2,0,0,0,-2,1248,1248,0,-1,1479,1479,0,-1,0,0,0
15707,200000,160000,0,0,0,0,0,0,-1,8789,3000,5789,0,0,0,0,0,0,0,0,-2,0,0,0
15708,250000,200000,0,0,0,0,0,0,-2,9737,9737,0,-1,790,790,0,-1,20750,20750,0,-1,0,0,0
15709,240000,192000,0,0,0,0,0,0,0,128940,6349,122591,0,124226,5834,118392,0,113133,3870,109263,0,113966,4000,109966
15710,200000,160000,0,0,0,0,0,0,-1,6336,6336,0,-1,5361,5361,0,-1,4950,3000,1950,0,2413,2502,-89
15711,150000,120000,0,0,0,0,0,0,-2,689,689,0,-1,2943,2943,0,-1,-6159,0,-6159,-1,-6159,0,-6159
15712,10000,8000,0,0,0,0,0,1,4,7995,0,7995,3,7720,0,7720,2,8224,778,7446,2,7944,0,7944
15713,190000,152000,0,0,0,0,0,0,0,10725,11000,-275,-1,1582,11336,-9754,-1,-46,0,-46,-1,4054,4100,-46
15714,400000,320000,0,0,0,0,0,1,0,62200,2000,60200,-2,38000,1000,37000,-2,150,150,0,-1,193,193,0
15715,90000,72000,0,0,0,0,0,0,0,27485,5485,22000,0,29266,5263,24003,0,35598,8598,27000,0,38449,5449,33000
15716,30000,24000,0,0,0,0,0,0,2,300,0,300,2,1126,828,298,2,826,0,826,3,676,0,676
15717,360000,288000,0,0,0,0,0,1,-1,0,0,0,-1,0,0,0,-2,1713,1713,0,-1,4819,4819,0
15718,100000,80000,0,0,0,0,0,0,-1,3775,3775,0,-1,22690,22690,0,-1,21288,0,21288,0,9289,0,9289
15719,500000,400000,0,1,1,1,1,0,0,477183,35530,441653,0,496400,31376,465024,0,505473,70000,435473,0,474459,17670,456789
15720,50000,40000,0,0,0,0,0,0,0,40378,1701,38677,0,39067,2006,37061,0,25481,1041,24440,0,25861,922,24939
15721,360000,288000,0,0,0,0,0,0,0,20067,2000,18067,0,48307,29079,19228,0,12918,1066,11852,0,12375,1000,11375
15722,180000,144000,0,0,0,0,0,0,0,42071,2002,40069,0,39649,2000,37649,0,39221,2000,37221,0,40731,2000,38731
15723,210000,168000,0,0,0,0,0,0,0,59336,3000,56336,0,61349,3000,58349,0,63366,3000,60366,0,65155,3000,62155
15724,10000,8000,0,0,0,0,0,0,0,7377,1103,6274,0,7127,243,6884,0,6931,296,6635,0,6660,280,6380
15725,230000,184000,0,0,0,0,0,0,-1,8389,8389,0,-1,7465,9,7456,0,6549,0,6549,0,576,0,576
15726,60000,48000,0,1,0,0,0,1,2,56912,2100,54812,0,47513,1500,46013,0,42945,1700,41245,0,45648,3500,42148
15727,70000,56000,0,0,0,0,0,0,0,46871,2015,44856,0,41821,2000,39821,0,41344,1500,39844,0,41376,1700,39676
15728,240000,192000,0,0,0,0,0,0,-1,0,0,0,-1,0,0,0,-2,13143,13143,0,-1,27383,27383,0
15729,90000,72000,0,0,0,0,0,0,0,33434,2655,30779,0,0,0,0,0,0,0,0,-2,0,0,0
15730,280000,224000,0,0,0,0,0,0,-1,0,0,0,-2,0,0,0,-2,0,0,0,-2,0,0,0
15731,230000,184000,0,0,0,0,0,1,-1,4080,4080,0,-1,1935,0,1935,2,1656,1656,0,-1,2351,2351,0
15732,60000,48000,0,1,1,0,0,1,0,57251,2600,54651,0,57826,2300,55526,0,22544,3000,19544,0,26675,5000,21675
15733,70000,56000,0,0,0,0,0,1,0,39063,0,39063,2,41592,3500,38092,2,39101,0,39101,2,40310,2000,38310
15734,120000,96000,0,0,0,0,0,0,0,0,0,0,0,0,0,0,-2,0,0,0,-2,0,0,0
15735,110000,88000,0,0,0,0,0,0,0,41796,2000,39796,0,44251,3000,41251,0,42921,3000,39921,0,37748,2000,35748
15736,100000,80000,0,1,0,0,0,0,0,103216,15074,88142,0,88782,16197,72585,0,35146,13112,22034,0,39849,43122,-3273
15737,180000,144000,0,0,0,0,0,0,-2,145,145,0,-2,0,0,0,-2,0,0,0,-2,0,0,0
15738,20000,16000,0,0,0,0,0,0,0,16752,5000,11752,0,15017,370,14647,0,13754,350,13404,0,4699,176,4523
15739,200000,160000,0,0,0,0,0,0,0,36725,3000,33725,0,36749,3000,33749,0,40138,4000,36138,0,42459,3000,39459
15740,90000,72000,0,0,0,0,0,0,0,18467,1313,17154,0,19554,1400,18154,0,20028,800,19228,0,20704,1000,19704
15741,50000,40000,0,0,0,0,0,1,2,21124,1800,19324,2,21480,1000,20480,2,22822,2000,20822,2,22171,0,22171
15742,510000,408000,0,0,0,0,0,0,0,192903,17000,175903,0,181801,0,181801,2,178179,6508,171671,0,223100,50000,173100
15743,90000,72000,0,0,0,0,0,0,-1,0,0,0,-2,0,0,0,-2,0,0,0,-2,0,0,0
15744,20000,16000,1,1,1,1,1,1,2,23719,0,23719,3,23936,900,23036,2,23253,0,23253,2,25871,3000,22871
15745,240000,192000,0,0,0,0,0,0,-1,37046,37046,0,-1,0,0,0,-1,1894,1894,0,-1,1894,0,1894
15746,50000,40000,0,1,0,0,0,0,0,47037,1180,45857,0,12187,1000,11187,0,9962,1000,8962,0,10015,348,9667
15747,60000,48000,0,0,0,0,0,0,0,22298,1396,20902,0,22161,1287,20874,0,18667,654,18013,0,19381,1000,18381
15748,50000,40000,0,1,1,1,1,1,2,48953,4035,44918,2,48851,1000,47851,3,49318,1400,47918,2,51143,2800,48343
15749,100000,80000,0,0,0,0,0,0,-1,2187,2187,0,-1,678,678,0,-1,2040,2040,0,-1,944,0,944
15750,180000,144000,0,0,0,0,0,0,0,18704,7000,11704,0,24410,7000,17410,0,29184,7000,22184,0,7325,5000,2325
15751,90000,72000,0,0,0,0,0,0,0,0,0,0,-2,0,0,0,-2,0,0,0,-2,0,0,0
15752,70000,56000,0,1,1,1,1,1,0,69361,5700,63661,0,69836,2600,67236,2,71179,3000,68179,2,69484,0,69484
15753,60000,48000,0,0,0,0,0,1,2,54952,60994,-6042,-1,32094,1436,30658,0,31232,1047,30185,0,30384,1056,29328
15754,400000,320000,0,0,0,0,0,1,-1,42948,42,42906,2,25962,1202,24760,0,15316,9,15307,0,6813,6813,0
15755,50000,40000,0,0,0,0,0,1,2,7849,1200,6649,0,8018,300,7718,0,8884,1000,7884,0,8593,0,8593
15756,140000,112000,0,0,0,0,0,1,0,13103,0,13103,2,14077,1500,12577,0,15189,1500,13689,0,16275,1500,14775
15757,80000,64000,0,0,0,0,0,1,2,150,150,0,-1,150,0,150,2,800,650,150,2,650,0,650
15758,180000,144000,0,0,0,0,0,0,2,1291,1291,0,-1,1891,600,1291,0,3914,2023,1891,0,26414,22500,3914
15759,300000,240000,0,1,0,0,0,0,0,285524,25000,260524,0,235773,8000,227773,0,221123,22000,199123,0,221269,10060,211209
15760,50000,40000,0,0,0,0,0,1,0,4503,1066,3437,0,5347,1300,4047,0,6375,1500,4875,0,7077,1200,5877
15761,20000,16000,0,0,0,0,0,1,2,1650,0,1650,4,1650,0,1650,4,1650,0,1650,4,1650,0,1650
15762,320000,256000,0,0,0,0,0,1,2,41370,1500,39870,2,40694,2000,38694,2,39606,1500,38106,2,38680,1500,37180
15763,150000,120000,0,0,0,0,0,0,-1,3784,3791,-7,-1,2340,2340,0,-1,5920,5920,0,-1,5400,5400,0
15764,30000,24000,0,0,0,0,0,0,0,22513,2004,20509,0,22391,2001,20390,0,23654,2001,21653,0,22738,1,22737
15765,250000,200000,0,0,0,0,0,0,0,97109,4500,92609,0,99029,5000,94029,0,100871,4000,96871,0,101299,5000,96299
15766,260000,208000,0,0,0,0,0,0,-2,-200,0,-200,-2,2515,2715,-200,-2,0,0,0,-2,20532,20532,0
15767,140000,112000,0,1,0,0,0,0,2,141940,7000,134940,0,113028,3923,109105,0,112667,4000,108667,0,112318,4100,108218
15768,500000,400000,0,0,0,0,0,0,2,-4,0,-4,2,-4,0,-4,-2,1319,1323,-4,-1,2977,3000,-23
15769,180000,144000,0,0,0,0,0,0,-2,74197,1898,72299,-2,-19,0,-19,-2,-19,0,-19,-2,142176,142195,-19
15770,50000,40000,0,0,0,0,0,0,0,29647,0,29647,2,29539,3000,26539,0,31384,4000,27384,0,31924,3000,28924
15771,50000,40000,0,0,0,0,0,0,0,29381,2001,27380,0,29140,1014,28126,0,25022,1006,24016,0,29608,7004,22604
15772,420000,336000,0,0,0,0,0,0,0,22354,1204,21150,0,23150,1000,22150,0,0,0,0,0,15235,15235,0
15773,500000,400000,0,0,0,0,0,0,-1,0,0,0,-2,0,0,0,-2,0,0,0,-2,0,0,0
15774,30000,24000,0,0,0,0,0,0,-2,0,0,0,-2,0,0,0,-2,0,0,0,-2,0,0,0
15775,280000,224000,0,0,0,0,0,0,0,-5,0,-5,0,1175,1180,-5,-1,-23,0,-23,-1,-23,0,-23
15776,240000,192000,0,0,0,0,0,0,0,151780,6000,145780,0,152373,6000,146373,0,145763,6000,139763,0,148276,5500,142776
15777,30000,24000,0,0,0,0,0,1,-1,940,0,940,2,1110,1110,0,-1,0,0,0,-1,0,0,0
15778,60000,48000,0,0,0,0,0,0,-2,-216,108,-324,-2,-324,108,-432,-2,-432,108,-540,-2,-540,108,-648
15779,300000,240000,0,1,1,1,0,1,0,261088,15000,246088,0,257288,9500,247788,0,256369,11000,245369,0,212395,9000,203395
15780,260000,208000,0,0,0,0,0,0,-1,552,552,0,-1,0,0,0,-1,80,80,0,-1,121,121,0
15781,130000,104000,0,0,0,0,0,0,0,44370,3060,41310,0,85115,69000,16115,0,69011,2578,66433,0,70460,2671,67789
15782,400000,320000,0,0,0,0,0,0,-1,13088,13088,0,-1,28540,28540,0,-1,11860,11860,0,-1,3978,3978,0
15783,70000,56000,0,1,1,0,0,0,0,67767,2076,65691,0,69275,2243,67032,0,1058,1058,0,-1,48376,48000,376
15784,120000,96000,0,0,0,0,0,0,-1,176,176,0,-1,-150,0,-150,-1,952,1428,-476,-1,476,0,476
15785,20000,16000,0,0,0,0,0,1,2,1650,0,1650,4,1650,0,1650,4,1650,0,1650,4,1650,0,1650
15786,80000,64000,0,0,0,0,0,1,0,50857,2061,48796,0,39813,1413,38400,0,40248,1460,38788,0,40935,1751,39184
15787,120000,96000,0,0,0,0,0,0,2,621,621,0,-1,-18,0,-18,-1,-18,0,-18,-2,-18,0,-18
15788,320000,256000,0,0,0,0,0,0,-2,4664,4687,-23,-2,3878,3985,-107,-2,22483,22595,-112,-2,4097,4117,-20
15789,20000,16000,0,0,0,0,0,1,2,7255,28,7227,2,3887,0,3887,0,5887,2000,3887,0,0,0,0
15790,240000,192000,0,0,0,0,0,0,0,201463,10000,191463,0,187916,7000,180916,0,149293,10040,139253,0,150614,7000,143614
15791,50000,40000,0,1,0,1,0,0,0,49768,2130,47638,0,27838,1200,26638,0,84810,1012,83798,0,27785,2034,25751
15792,360000,288000,0,0,0,0,0,0,0,-8,0,-8,-2,4635,4643,-8,-1,3875,1019,2856,0,1034,1039,-5
15793,160000,128000,0,0,0,0,0,0,0,0,0,0,-2,0,0,0,-2,0,0,0,-2,0,0,0
15794,400000,320000,0,0,0,0,0,0,0,20734,5030,15704,0,16476,2012,14464,0,17857,4014,13843,0,14656,37,14619
15795,160000,128000,0,0,0,0,0,0,0,2348,2348,0,-1,2447,2447,0,-1,10968,10968,0,-1,10934,531,10403
15796,180000,144000,0,0,0,0,0,0,0,122498,4397,118101,0,123916,4405,119511,0,125661,4711,120950,0,127458,5040,122418
15797,50000,40000,0,0,0,0,0,0,0,36725,1783,34942,0,35346,1200,34146,0,33810,1200,32610,0,32788,1500,31288
15798,180000,144000,0,0,0,0,0,0,-1,98834,130000,-31166,-1,34677,40057,-5380,-1,55634,56000,-366,-1,44325,10000,34325
15799,30000,24000,0,0,0,0,0,0,2,16952,16952,0,-1,15336,16104,-768,-1,24336,14000,10336,-1,436,486,-50
15800,100000,80000,0,1,1,1,1,0,2,97937,4134,93803,0,98893,3952,94941,0,101044,3611,97433,0,96045,3298,92747
15801,50000,40000,0,1,0,0,0,1,0,44301,2100,42201,0,19052,800,18252,0,17569,1000,16569,0,17976,700,17276
15802,180000,144000,0,1,0,0,0,0,0,182341,9300,173041,0,126946,4600,122346,0,127013,5000,122013,0,122277,5000,117277
15803,250000,200000,0,0,0,0,0,0,0,93844,4100,89744,0,74441,3010,71431,0,74553,2205,72348,0,64640,2045,62595
15804,110000,88000,0,0,0,0,0,0,0,54803,2050,52753,0,55729,1895,53834,0,57001,2068,54933,0,58036,1982,56054
15805,120000,96000,0,1,1,0,0,0,0,103840,5500,98340,0,105646,5170,100476,0,86127,3543,82584,0,67269,3000,64269
15806,20000,16000,0,0,0,0,0,0,-1,390,390,0,-1,390,390,0,-1,780,780,0,-1,0,0,0
15807,130000,104000,0,0,0,0,0,0,0,75525,3000,72525,0,76862,1537,75325,0,6131,10000,-3869,-1,27117,21300,5817
15808,200000,160000,0,0,0,0,0,0,2,78669,4000,74669,2,75995,0,75995,2,79781,5500,74281,2,81533,3000,78533
15809,80000,64000,1,1,0,0,0,0,2,87338,4000,83338,0,46927,939,45988,0,80194,80000,194,0,0,0,0
15810,260000,208000,0,0,0,0,0,0,-1,-1,0,-1,-1,-1,0,-1,-2,358,359,-1,-1,492,494,-2
15811,200000,160000,0,0,0,0,0,0,2,13810,1502,12308,0,14815,2000,12815,0,16347,2000,14347,0,17531,1513,16018
15812,470000,376000,0,0,0,0,0,0,0,106390,30002,76388,0,82181,20000,62181,0,79402,40000,39402,0,72121,35000,37121
15813,20000,16000,1,1,1,1,1,0,2,20508,0,20508,4,19933,0,19933,3,19517,0,19517,2,20235,1000,19235
15814,330000,264000,0,0,0,0,0,0,0,256014,10109,245905,0,245244,10053,235191,0,239441,10014,229427,0,242025,9001,233024
15815,320000,256000,0,0,0,0,0,0,0,22693,1681,21012,0,23705,1693,22012,0,24012,1000,23012,0,24703,1077,23626
15816,360000,288000,0,0,0,0,0,0,0,0,0,0,-2,0,0,0,-2,0,0,0,-2,0,0,0
15817,280000,224000,0,0,0,0,0,0,-1,146,0,146,2,1596,1600,-4,-1,1672,1672,0,-1,1596,1562,34
15818,50000,40000,0,1,1,0,0,0,-1,45397,1835,43562,0,45256,3039,42217,0,28355,0,28355,0,16624,7000,9624
15819,200000,160000,0,0,0,0,0,1,-2,0,0,0,-2,0,0,0,-2,0,0,0,-2,0,0,0
15820,200000,160000,0,0,0,0,0,0,-2,218,218,0,-2,4360,4360,0,-2,0,0,0,-2,0,0,0
15821,150000,120000,0,0,0,0,0,0,0,45813,2500,43313,0,44309,1200,43109,0,27428,2618,24810,0,2013,2013,0
15822,30000,24000,0,0,0,0,0,0,-1,17595,17648,-53,-1,24715,25008,-293,-1,22136,509,21627,0,22738,22806,-68
15823,500000,400000,0,1,1,1,1,0,0,445007,40000,405007,0,542653,38000,504653,0,483003,20239,462764,0,473944,13750,460194
15824,70000,56000,0,1,0,0,0,0,2,68645,13,68632,2,28929,1008,27921,0,28597,1103,27494,0,28237,1100,27137
15825,500000,400000,0,0,0,0,0,0,0,26741,7000,19741,0,27854,2000,25854,0,30961,5000,25961,0,54017,25002,29015
15826,30000,24000,0,1,1,1,0,0,0,28998,2000,26998,0,29480,1200,28280,0,29500,1000,28500,0,0,0,0
15827,100000,80000,0,1,0,0,0,0,0,98728,3938,94790,0,74239,2515,71724,0,75704,2516,73188,0,55704,4022,51682
15828,50000,40000,0,0,0,0,0,1,0,3445,3500,-55,-1,99,1000,-901,-1,949,1000,-51,-1,137,200,-63
15829,60000,48000,0,1,1,1,0,1,2,55272,2500,52772,0,55925,2000,53925,0,57063,2030,55033,0,48228,2100,46128
15830,10000,8000,0,0,0,0,0,1,0,6327,1600,4727,0,6055,400,5655,0,0,0,0,0,0,0,0
15831,80000,64000,0,0,0,0,0,0,0,58535,0,58535,2,59730,2169,57561,0,61236,2500,58736,0,70617,10400,60217
15832,30000,24000,0,0,0,0,0,0,-1,396,396,0,-1,792,792,0,-1,396,0,396,0,772,772,0
15833,80000,64000,0,0,0,0,0,0,-1,0,0,0,-1,0,0,0,-2,0,0,0,-2,0,0,0
15834,200000,160000,0,0,0,0,0,0,-1,16636,16754,-118,-1,38409,38522,-113,-1,8958,8983,-25,-1,4573,4585,-12
15835,80000,64000,0,0,0,0,0,0,-2,5210,5215,-5,-2,3882,3882,0,-2,4785,4785,0,-2,1000,1968,-968
15836,140000,112000,0,0,0,0,0,0,0,86612,3340,83272,0,62906,1931,60975,0,83167,22444,60723,0,83315,2441,80874
15837,30000,24000,0,0,0,0,0,0,0,18387,0,18387,2,22047,4000,18047,0,23691,2000,21691,0,25547,2250,23297
15838,80000,64000,0,0,0,0,0,0,0,390,390,0,-1,390,390,0,-1,780,780,0,-1,780,0,780
15839,240000,192000,0,0,0,0,0,0,0,30098,1030,29068,0,366,7,359,0,725,725,0,-1,2576,2217,359
15840,140000,112000,0,1,0,0,0,1,-2,124714,3615,121099,-2,73593,2573,71020,-2,73344,2858,70486,-2,78629,8000,70629
15841,120000,96000,0,0,0,0,0,0,2,64373,4000,60373,0,69164,6500,62664,0,67453,0,67453,2,72997,6639,66358
15842,120000,96000,0,0,0,0,0,0,-1,8067,8152,-85,-1,802,802,0,-1,2706,2706,0,-1,3597,3597,0
15843,20000,16000,0,0,0,0,0,0,0,1436,1000,436,0,363,400,-37,-1,363,0,363,-1,-417,0,-417
15844,170000,136000,0,0,0,0,0,0,0,112300,6000,106300,0,110371,5000,105371,0,113685,5000,108685,0,98489,3000,95489
15845,120000,96000,0,0,0,0,0,0,0,1150,2000,-850,-1,29225,29225,0,-1,25893,2000,23893,0,11707,2000,9707
15846,210000,168000,0,0,0,0,0,0,0,20803,1350,19453,0,21816,1363,20453,0,22250,797,21453,0,22716,825,21891
15847,20000,16000,0,0,0,1,0,0,0,15226,15300,-74,-1,16528,2000,14528,0,16128,0,16128,0,19800,4200,15600
15848,50000,40000,0,0,0,0,0,0,0,32842,2024,30818,0,19748,5004,14744,0,19403,1000,18403,0,19536,1000,18536
15849,10000,8000,0,0,0,0,0,0,0,3421,1500,1921,0,3615,400,3215,0,4402,1000,3402,0,5173,1000,4173
15850,300000,240000,0,0,0,0,0,1,2,56663,1800,54863,2,57428,2100,55328,2,58455,1900,56555,2,57556,0,57556
15851,260000,208000,0,0,0,0,0,0,0,133289,4215,129074,0,134642,4101,130541,0,137065,4000,133065,0,108328,3300,105028
15852,200000,160000,0,0,0,0,0,0,-1,4604,4644,-40,-1,3350,3350,0,-1,0,0,0,-1,0,0,0
15853,10000,8000,0,0,0,1,1,1,0,6793,1200,5593,0,8668,2000,6668,0,8382,0,8382,2,8595,500,8095
15854,500000,400000,0,0,0,0,0,0,-2,65437,70403,-4966,-2,30368,30455,-87,-2,6265,36,6229,-2,44196,45225,-1029
15855,20000,16000,0,0,0,0,0,1,2,11127,3000,8127,2,10657,0,10657,2,11178,1000,10178,0,11840,1000,10840
15856,100000,80000,0,0,0,0,0,0,0,60737,5003,55734,0,66077,8058,58019,0,68990,8000,60990,0,70724,3000,67724
15857,500000,400000,0,0,0,0,0,0,0,275615,30168,245447,0,220088,6022,214066,0,216482,6375,210107,0,136086,5005,131081
15858,210000,168000,0,0,0,0,0,0,-1,291,582,-291,-1,291,291,0,-1,291,291,0,-1,291,291,0
15859,20000,16000,0,1,1,1,1,0,0,19162,1805,17357,0,19293,1400,17893,0,19298,405,18893,0,19198,400,18798
15860,90000,72000,0,1,1,1,1,1,2,89779,4400,85379,0,89214,5013,84201,0,88847,4000,84847,0,88724,4000,84724
15861,50000,40000,0,0,0,0,0,1,0,30785,0,30785,2,31573,1300,30273,0,35191,4300,30891,0,34476,0,34476
15862,80000,64000,0,0,0,0,0,0,-1,13443,13443,0,-1,396,396,0,-1,396,396,0,-1,396,0,396
15863,110000,88000,0,0,0,0,0,1,-1,400,400,0,-1,46952,46952,0,-1,48455,3000,45455,0,47324,3000,44324
15864,260000,208000,0,0,0,0,0,0,-1,718,718,0,-1,500,500,0,-1,5306,5306,0,-1,2091,0,2091
15865,500000,400000,0,0,0,0,0,0,0,5453,1096,4357,0,5540,1020,4520,0,6263,6315,-52,-1,1831,1833,-2
15866,230000,184000,0,0,0,0,0,0,0,157188,7200,149988,0,158490,5820,152670,0,161456,6100,155356,0,164677,6500,158177
15867,170000,136000,0,0,0,0,0,1,-1,0,0,0,-1,0,0,0,-2,0,0,0,-2,0,0,0
15868,50000,40000,0,0,0,0,0,0,0,20746,2011,18735,0,27624,1006,26618,0,16015,1000,15015,0,16746,1000,15746
15869,210000,168000,0,0,0,0,0,0,-2,0,0,0,-2,0,0,0,-2,0,0,0,-2,0,0,0
15870,90000,72000,0,0,0,0,0,0,0,47677,4200,43477,0,46615,0,46615,2,47537,2000,45537,0,48616,2000,46616
15871,360000,288000,0,0,0,0,0,0,0,17917,18117,-200,-1,21057,5371,15686,0,0,0,0,0,0,0,0
15872,360000,288000,0,0,0,0,0,0,-1,20007,20007,0,-1,18498,1590,16908,0,18422,1000,17422,0,1842,1842,0
15873,200000,160000,0,0,0,0,0,0,-1,0,0,0,-1,0,0,0,-2,0,0,0,-2,0,0,0
15874,290000,232000,0,0,0,0,0,0,0,163926,7147,156779,0,97524,5041,92483,0,35353,1581,33772,0,24481,3020,21461
15875,20000,16000,0,0,0,0,1,1,0,15461,1270,14191,0,16200,1000,15200,0,16936,1000,15936,0,17273,619,16654
15876,20000,16000,0,1,1,0,0,0,0,19538,2000,17538,0,17958,1000,16958,0,4968,600,4368,0,780,0,780
15877,120000,96000,0,0,0,0,0,1,-2,0,0,0,-2,0,0,0,-2,-10810,0,-10810,-2,-15296,0,-15296
15878,180000,144000,0,0,0,0,0,1,-1,2745,2745,0,-1,3053,1000,2053,0,1012,1392,-380,-1,1312,1312,0
15879,30000,24000,0,1,1,1,1,1,0,27972,1750,26222,0,28628,1390,27238,0,29005,764,28241,0,29817,1000,28817
15880,20000,16000,0,1,1,1,1,1,0,18606,1613,16993,0,18904,1301,17603,0,19433,830,18603,0,18902,698,18204
15881,20000,16000,0,1,1,1,1,0,0,17703,1400,16303,0,18690,1300,17390,0,19065,643,18422,0,19261,862,18399
15882,30000,24000,0,0,0,0,0,1,0,20606,1321,19285,0,20693,727,19966,0,21134,761,20373,0,22435,2500,19935
15883,90000,72000,0,0,0,0,0,0,0,1051,1052,-1,-1,2422,2422,0,-1,1051,0,1051,0,1051,1051,0
15884,20000,16000,0,1,1,0,0,1,2,17363,1200,16163,0,17569,406,17163,0,0,0,0,0,0,0,0
15885,260000,208000,0,0,0,0,0,0,-2,613,613,0,-2,2339,2339,0,-2,1474,0,1474,-2,1254,1254,0
15886,90000,72000,0,1,1,1,1,0,0,89613,4000,85613,0,89532,3307,86225,0,90362,3453,86909,0,94337,6730,87607
15887,100000,80000,0,0,0,0,0,1,2,64054,3039,61015,0,59014,3315,55699,0,55249,3000,52249,0,47645,3000,44645
15888,50000,40000,0,1,1,1,1,0,0,49459,2200,47259,0,50160,1890,48270,0,49244,2000,47244,0,50531,2000,48531
15889,60000,48000,0,0,0,0,0,0,0,28772,2000,26772,0,19067,1000,18067,0,19467,1000,18467,0,9247,331,8916
15890,80000,64000,0,0,0,0,0,1,0,31923,1411,30512,0,25885,1009,24876,0,20195,605,19590,0,19494,2012,17482
15891,70000,56000,0,0,0,0,0,0,0,54448,1999,52449,0,55700,2181,53519,0,51511,1900,49611,0,52652,2000,50652
15892,150000,120000,0,0,0,0,0,0,0,42306,2100,40206,0,41579,1837,39742,0,40669,1400,39269,0,39301,1486,37815
15893,800000,640000,0,0,0,0,0,0,-1,64535,64657,-122,-1,40814,131,40683,0,12590,247,12343,0,9339,9366,-27
15894,360000,288000,0,0,0,0,0,0,0,102283,5487,96796,0,86370,5043,81327,0,86432,10084,76348,0,73607,5059,68548
15895,220000,176000,0,0,0,0,0,1,0,148133,7038,141095,0,123266,5000,118266,0,125736,4500,121236,0,128342,5000,123342
15896,20000,16000,1,1,1,1,1,0,4,20442,0,20442,3,19773,0,19773,2,20238,1000,19238,0,18062,1000,17062
15897,290000,232000,0,0,0,0,0,0,0,2778,2000,778,0,9981,9000,981,0,23989,23000,989,0,22667,22000,667
15898,80000,64000,0,0,0,0,0,1,0,23416,4790,18626,0,22768,0,22768,2,23243,816,22427,0,23718,833,22885
15899,200000,160000,0,0,0,0,0,0,-1,912,912,0,-1,1140,1140,0,-1,293,293,0,-1,0,0,0
15900,80000,64000,0,0,0,1,0,0,0,56893,4120,52773,0,59021,3069,55952,0,117568,2215,115353,0,72869,30000,42869
15901,620000,496000,0,0,0,0,0,0,0,475333,20004,455329,0,473182,20008,453174,0,481896,14000,467896,0,513798,35804,477994
15902,360000,288000,0,0,0,0,0,0,-1,3300,3300,0,-1,6290,6290,0,-1,8220,8220,0,-1,28410,28410,0
15903,40000,32000,0,1,1,1,1,1,3,38862,2335,36527,2,39125,1200,37925,3,39408,1225,38183,2,40925,2300,38625
15904,180000,144000,0,0,0,0,0,1,2,112073,8564,103509,2,111345,4000,107345,2,98404,0,98404,2,102460,7414,95046
15905,320000,256000,0,0,0,0,0,0,-2,988,991,-3,-2,6420,6452,-32,-2,7174,9757,-2583,-2,-19,0,-19
15906,300000,240000,0,0,0,0,0,1,-2,0,0,0,-2,0,0,0,-2,0,0,0,-2,0,0,0
15907,50000,40000,0,0,0,0,0,1,2,18245,1299,16946,0,18454,807,17647,0,18685,678,18007,0,19271,897,18374
15908,50000,40000,0,0,0,0,0,1,2,2400,0,2400,7,2400,0,2400,7,2400,0,2400,7,2400,0,2400
15909,90000,72000,0,0,0,0,0,0,0,70581,2370,68211,0,67336,2300,65036,0,67069,2300,64769,0,67890,2700,65190
15910,50000,40000,0,1,1,0,0,0,0,49167,3045,46122,0,45077,1660,43417,0,36815,1500,35315,0,38203,2000,36203
15911,160000,128000,0,0,0,0,0,0,-1,2179,2183,-4,-1,5468,5468,0,-1,80,80,0,-1,1314,1314,0
15912,280000,224000,0,0,0,0,0,0,-2,0,0,0,-2,326,326,0,-2,652,652,0,-2,0,0,0
15913,190000,152000,0,0,0,0,0,0,0,146943,5795,141148,0,151905,7408,144497,0,153538,5645,147893,0,156664,5753,150911
15914,130000,104000,0,0,0,0,0,0,0,2522,2522,0,-1,1261,0,1261,0,390,390,0,-1,390,390,0
15915,130000,104000,0,1,0,0,0,0,0,128904,5904,123000,0,101785,4785,97000,0,101849,3849,98000,0,99296,4296,95000
15916,50000,40000,0,1,1,1,1,0,0,49521,2556,46965,0,48830,1665,47165,0,49728,1600,48128,0,50146,1800,48346
15917,280000,224000,0,0,0,1,1,0,0,276979,150062,126917,0,238527,50000,188527,0,239280,4786,234494,0,238926,4779,234147
15918,430000,344000,0,0,0,0,0,0,-1,32878,32887,-9,-1,115683,115683,0,-1,84049,0,84049,0,37210,37210,0
15919,220000,176000,0,0,0,0,0,0,-2,200,0,200,-2,200,0,200,2,11326,11326,0,2,43100,43100,0
15920,200000,160000,0,0,0,0,0,0,0,53693,2629,51064,0,55506,2442,53064,0,63261,10000,53261,0,52979,1502,51477
15921,360000,288000,0,0,0,0,0,0,0,33610,1541,32069,0,34281,1212,33069,0,34944,1200,33744,0,35498,1000,34498
15922,140000,112000,0,0,0,0,0,1,-1,1170,1170,0,-1,1003,1003,0,-1,1003,1003,0,-1,1003,1003,0
15923,90000,72000,0,0,0,0,0,1,-1,1882,200,1682,3,941,0,941,2,266,266,0,-1,-675,0,-675
15924,180000,144000,0,1,1,0,0,0,0,172060,8100,163960,0,166204,8000,158204,0,145146,5600,139546,0,142961,5500,137461
15925,140000,112000,1,1,1,1,1,1,0,140202,0,140202,2,144035,11400,132635,2,140419,550,139869,2,130271,5300,124971
15926,20000,16000,0,0,0,0,0,1,0,13972,1542,12430,0,15730,2300,13430,0,15183,0,15183,2,16182,1400,14782
15927,150000,120000,0,0,0,0,0,0,-2,0,0,0,-2,0,0,0,-2,0,0,0,-2,0,0,0
15928,160000,128000,0,0,0,0,0,1,-1,12094,15000,-2906,-1,2855,2855,0,-1,3803,3803,0,-1,8911,8911,0
15929,200000,160000,0,0,0,0,0,0,-2,611,611,0,-2,0,0,0,-2,0,0,0,-2,150,150,0
15930,300000,240000,0,0,0,0,0,0,-1,11510,11516,-6,-1,10310,0,10310,0,0,0,0,0,0,0,0
15931,210000,168000,0,0,0,0,1,0,0,168218,8000,160218,0,169726,6000,163726,2,173687,7000,166687,2,176510,6000,170510
15932,50000,40000,0,0,0,0,0,1,0,13530,1200,12330,0,14876,5000,9876,0,14157,1000,13157,0,18888,5000,13888
15933,300000,240000,0,1,1,1,1,1,2,273333,0,273333,2,277270,10000,267270,0,284915,12180,272735,0,286837,10000,276837
15934,230000,184000,0,0,0,0,0,0,-1,1487,1487,0,-2,826,830,-4,-1,-4,0,-4,-1,-4,0,-4
15935,100000,80000,0,0,0,0,0,0,-1,10876,10876,0,-1,11714,3000,8714,0,7177,7177,0,-1,10455,10455,0
15936,50000,40000,0,0,0,0,0,1,2,3381,400,2981,2,3559,200,3359,0,1948,500,1448,0,2415,500,1915
15937,240000,192000,0,1,1,0,0,0,0,205728,10000,195728,0,205275,9000,196275,0,192059,6600,185459,0,195620,7100,188520
15938,100000,80000,0,0,0,0,0,0,-1,1195,1195,0,-1,2775,2775,0,-1,890,890,0,-1,2117,2117,0
15939,480000,384000,0,0,0,0,0,0,-2,0,0,0,-2,0,0,0,-2,790,790,0,-2,0,0,0
15940,300000,240000,0,0,0,0,0,0,-1,0,0,0,-1,0,0,0,-2,3330,3330,0,-1,3330,3330,0
15941,50000,40000,0,0,1,0,0,0,0,27935,1384,26551,0,51904,841,51063,0,24147,1013,23134,0,24425,819,23606
15942,130000,104000,0,0,0,0,0,0,0,83032,4200,78832,0,83362,2912,80450,0,84592,2500,82092,0,86027,2300,83727
15943,150000,120000,0,0,0,0,0,0,-2,1597,1597,0,-2,-3,0,-3,-2,1764,1767,-3,-2,718,718,0
15944,250000,200000,0,0,0,0,0,0,0,35960,1820,34140,0,26244,1500,24744,0,26690,1000,25690,0,31222,5000,26222
15945,30000,24000,0,0,0,0,0,1,0,12930,1307,11623,0,13233,2000,11233,0,12595,252,12343,0,12454,249,12205
15946,10000,8000,0,0,0,1,1,0,0,8944,1300,7644,0,8985,1300,7685,0,9301,602,8699,0,9365,350,9015
15947,50000,40000,0,0,0,0,0,0,0,12058,1500,10558,0,13256,1400,11856,0,14437,1400,13037,0,16985,2800,14185
15948,330000,264000,0,0,0,0,0,0,0,19114,2500,16614,0,14093,3000,11093,0,16005,3000,13005,0,4935,170,4765
15949,380000,304000,0,0,0,0,0,0,0,114785,0,114785,2,161444,50005,111439,0,163071,20042,143029,0,160076,20000,140076
15950,70000,56000,0,1,0,0,0,0,0,62648,3182,59466,0,46342,1800,44542,0,46904,1300,45604,0,48558,2000,46558
15951,200000,160000,0,0,0,0,0,0,-2,6817,6876,-59,-1,7756,1009,6747,0,8835,8837,-2,-1,13129,13129,0
15952,90000,72000,0,0,0,0,0,0,-2,34347,36633,-2286,-1,35042,1328,33714,0,46098,11696,34402,0,46658,1350,45308
15953,20000,16000,0,1,1,1,0,1,2,20035,2000,18035,2,19333,0,19333,2,18135,1000,17135,0,14366,500,13866
15954,20000,16000,0,0,1,1,1,1,2,16438,2773,13665,0,16770,605,16165,0,17995,1500,16495,0,17556,0,17556
15955,60000,48000,0,0,0,0,0,0,0,30203,2000,28203,0,30809,1092,29717,0,33323,3000,30323,0,33190,1353,31837
15956,180000,144000,0,0,0,0,0,0,0,109319,5800,103519,0,111343,5700,105643,0,91966,3600,88366,0,82280,3000,79280
15957,260000,208000,0,0,0,0,0,0,0,132873,5000,127873,0,122528,5000,117528,0,111409,4000,107409,0,100032,3600,96432
15958,180000,144000,0,0,0,0,0,0,0,39162,3060,36102,0,5461,109,5352,0,2309,46,2263,0,0,0,0
15959,170000,136000,0,0,0,0,0,0,0,11709,11909,-200,-1,14168,5000,9168,0,9084,16,9068,0,0,0,0
15960,50000,40000,0,0,0,0,0,0,0,15181,1000,14181,2,15928,1000,14928,0,16671,1000,15671,0,17393,1000,16393
15961,60000,48000,0,0,0,0,0,0,0,16982,1500,15482,0,37318,2000,35318,0,18352,1000,17352,0,17869,824,17045
15962,100000,80000,0,0,0,0,0,0,0,58567,2200,56367,0,79527,22004,57523,0,18950,656,18294,0,19667,1000,18667
15963,20000,16000,0,1,1,0,0,0,0,16895,0,16895,2,17470,1000,16470,0,7500,150,7350,0,7500,0,7500
15964,300000,240000,0,0,0,0,0,0,2,1610,1610,0,-1,2749,2768,-19,-1,155,155,0,-1,3167,3167,0
15965,20000,16000,0,0,0,0,0,0,0,6808,1262,5546,0,14046,7500,6546,0,13924,278,13646,0,16924,3000,13924
15966,30000,24000,0,0,0,0,0,0,-1,780,780,0,-1,390,0,390,0,0,0,0,0,780,780,0
15967,210000,168000,0,0,0,0,0,0,0,70660,3100,67560,0,71172,2900,68272,0,71844,2600,69244,0,69923,2700,67223
15968,10000,8000,0,0,1,1,1,0,0,10215,4442,5773,0,9943,0,9943,2,9758,1200,8558,0,9335,1200,8135
15969,430000,344000,0,0,0,0,0,0,-1,-101,0,-101,-1,-1217,0,-1217,-2,-2333,0,-2333,-2,2351,5000,-2649
15970,50000,40000,0,0,0,0,0,1,0,38081,2600,35481,0,16970,2000,14970,0,17695,1000,16695,0,18401,1000,17401
15971,20000,16000,0,0,0,0,0,0,0,16252,1200,15052,0,14877,298,14579,0,9487,5390,4097,0,-5910,4000,-9910
15972,50000,40000,0,0,0,0,0,0,0,3991,2300,1691,0,3748,0,3748,2,3748,0,3748,2,-3148,4999,-8147
15973,50000,40000,0,0,0,0,0,1,0,38591,1800,36791,0,40037,2200,37837,0,32260,1400,30860,0,27649,1100,26549
15974,50000,40000,0,0,0,0,0,0,0,6382,2000,4382,0,6284,1000,5284,0,6681,500,6181,0,6813,243,6570
15975,30000,24000,0,0,0,0,0,1,2,2550,0,2550,7,2550,0,2550,7,2550,0,2550,7,2550,0,2550
15976,160000,128000,0,0,0,0,0,0,-1,509,509,0,-1,15695,15695,0,-1,515,515,0,-1,515,515,0
15977,150000,120000,0,0,0,0,0,1,2,35985,0,35985,2,38687,3300,35387,2,37765,0,37765,2,40352,3200,37152
15978,100000,80000,0,0,0,0,0,1,2,38780,2000,36780,0,43592,5800,37792,0,44117,1540,42577,2,45165,1900,43265
15979,210000,168000,0,0,0,0,0,1,2,390,390,0,-1,1554,1554,0,-1,5705,5705,0,-1,6386,2000,4386
15980,30000,24000,0,0,1,1,1,1,0,27851,5251,22600,0,27098,0,27098,2,29866,3519,26347,2,29276,0,29276
15981,20000,16000,0,0,1,1,1,1,0,17210,1700,15510,0,18098,1500,16598,0,18843,1000,17843,0,19586,1000,18586
15982,30000,24000,0,1,1,1,1,0,0,27868,1301,26567,0,28430,863,27567,0,29077,947,28130,0,29540,836,28704
15983,280000,224000,0,0,0,0,0,0,-1,4951,4951,0,-1,2408,2408,0,-1,8360,8360,0,-1,6202,6202,0
15984,130000,104000,0,0,0,0,0,0,0,100534,5200,95334,0,105347,8000,97347,0,103550,0,103550,2,109733,8100,101633
15985,50000,40000,0,0,0,0,0,0,0,12874,1143,11731,0,13341,610,12731,0,10556,509,10047,0,9396,500,8896
15986,170000,136000,0,0,0,0,0,0,-1,7567,7567,0,-1,0,0,0,-1,499,499,0,-1,576,576,0
15987,300000,240000,0,0,0,0,0,1,-2,10742,10774,-32,-2,1349,1353,-4,-2,10522,10522,0,-2,0,0,0
15988,300000,240000,0,0,0,0,0,0,-2,0,0,0,-2,0,0,0,-2,0,0,0,-2,0,0,0
15989,130000,104000,0,0,0,0,0,0,0,20456,3000,17456,0,20783,2000,18783,0,-290,0,-290,0,-680,0,-680
15990,200000,160000,0,0,0,0,0,0,-1,32105,32130,-25,-1,4476,4476,0,-1,6491,6619,-128,-1,1262,1262,0
15991,50000,40000,0,1,1,0,0,0,0,49921,2050,47871,0,50512,1641,48871,0,20071,1000,19071,0,20277,1000,19277
15992,210000,168000,0,0,0,0,0,1,0,65068,5000,60068,0,73934,10000,63934,0,74752,2800,71952,0,82638,10000,72638
15993,230000,184000,0,0,0,0,0,0,0,32411,2000,30411,0,34162,4000,30162,0,34884,2000,32884,0,35569,2000,33569
15994,50000,40000,0,0,0,0,0,0,-1,23683,1237,22446,0,22833,457,22376,0,1352,1354,-2,-1,20791,20794,-3
15995,140000,112000,0,1,0,0,0,0,0,141555,5700,135855,0,110852,4200,106652,0,113639,4700,108939,0,95052,3800,91252
15996,90000,72000,0,0,0,0,0,0,0,12044,10016,2028,0,27847,25000,2847,0,8251,8000,251,0,26501,26000,501
15997,170000,136000,0,0,0,0,0,0,0,6265,2367,3898,0,5430,5430,0,-1,4898,4898,0,-1,3240,3240,0
15998,50000,40000,0,1,1,1,1,0,0,48659,2120,46539,0,47248,1750,45498,0,48241,1700,46541,0,49196,1800,47396
15999,100000,80000,0,0,0,0,0,1,0,42076,6000,36076,0,41105,0,41105,2,44090,4000,40090,2,48914,5700,43214
16000,150000,120000,0,0,0,0,0,0,0,48849,5849,43000,0,35920,1196,34724,0,37433,2000,35433,0,10791,1000,9791
16001,20000,16000,0,1,0,1,0,0,-1,18534,0,18534,2,18304,8200,10104,0,18473,369,18104,0,0,0,0
16002,540000,432000,0,0,0,0,0,0,0,1464,1485,-21,-1,-2800,16,-2816,-1,13916,20016,-6100,-1,12517,2016,10501
16003,200000,160000,0,0,0,0,1,0,0,156406,5682,150724,0,159650,5850,153800,0,163625,6625,157000,0,167790,6790,161000
16004,200000,160000,0,0,0,0,0,1,-2,0,0,0,-2,0,0,0,-2,0,0,0,-2,0,0,0
16005,50000,40000,0,0,0,0,0,1,0,7754,1168,6586,0,7825,1075,6750,0,7132,218,6914,0,7319,1100,6219
16006,20000,16000,0,1,1,1,1,1,0,17219,0,17219,2,18377,1444,16933,2,17941,0,17941,2,19572,1933,17639
16007,240000,192000,0,1,1,1,1,0,0,238637,19253,219384,0,232995,0,232995,2,206167,7641,198526,0,210100,7522,202578
16008,260000,208000,0,0,0,0,0,0,0,67768,2496,65272,0,69033,2429,66604,0,70166,2599,67567,0,71377,2827,68550
16009,100000,80000,0,0,0,0,0,0,-1,4560,4569,-9,-1,4290,4290,0,-1,6670,5000,1670,0,8844,5000,3844
16010,500000,400000,0,0,0,0,0,1,-2,17252,17252,0,-2,7388,7421,-33,-2,6069,6069,0,-2,0,0,0
16011,260000,208000,0,0,0,0,0,0,0,171913,10051,161862,0,169495,10026,159469,0,167944,7039,160905,0,166881,8057,158824
16012,230000,184000,0,0,0,0,0,1,-1,1990,1,1989,2,1499,9,1490,0,593,594,-1,-1,2553,2560,-7
16013,260000,208000,0,0,0,0,0,0,0,22248,5000,17248,0,26842,5000,21842,0,35997,10000,25997,0,55272,20000,35272
16014,350000,280000,0,0,0,0,0,0,-2,-2,0,-2,-2,-2,0,-2,-2,-2,0,-2,-2,-2,0,-2
16015,150000,120000,0,0,0,0,0,1,0,79713,0,79713,2,64468,4000,60468,0,66488,4000,62488,0,58131,4000,54131
16016,210000,168000,0,0,0,0,0,0,-1,326,326,0,-1,326,326,0,-1,326,326,0,-1,326,326,0
16017,80000,64000,0,0,0,0,0,0,0,17495,1774,15721,0,13198,1000,12198,0,10287,10287,0,-1,3275,3295,-20
16018,200000,160000,0,1,1,0,0,0,0,193898,7157,186741,0,180759,11609,169150,0,160482,5609,154873,0,132870,5059,127811
16019,50000,40000,0,1,1,1,1,1,2,45235,4000,41235,2,45816,1600,44216,2,44970,0,44970,2,47649,3400,44249
16020,80000,64000,0,0,0,0,0,0,0,39456,1560,37896,0,30712,1421,29291,0,29629,1001,28628,0,28241,1000,27241
16021,450000,360000,0,0,0,0,0,0,-2,5965,6001,-36,-2,991,996,-5,-2,-9,0,-9,-2,1974,1983,-9
16022,250000,200000,0,0,0,0,0,0,0,91714,3500,88214,0,88397,3100,85297,0,90312,3200,87112,0,92456,3500,88956
16023,20000,16000,0,1,1,1,0,0,0,19640,1626,18014,0,19114,100,19014,0,18679,600,18079,0,15000,300,14700
16024,220000,176000,0,1,0,0,0,0,0,190995,7500,183495,0,165452,7000,158452,0,170786,8000,162786,0,174213,8000,166213
16025,120000,96000,0,0,0,0,0,0,0,100,100,0,-1,0,0,0,-1,0,0,0,-2,0,0,0
16026,180000,144000,0,0,0,0,0,0,0,49282,3000,46282,0,50159,2000,48159,0,51336,2011,49325,0,54332,4000,50332
16027,220000,176000,0,0,0,0,0,0,-2,2706,2723,-17,-2,0,0,0,-2,0,0,0,-2,92472,92472,0
16028,30000,24000,0,0,0,0,0,0,0,0,0,0,0,0,0,0,-2,0,0,0,-2,0,0,0
16029,420000,336000,0,0,0,0,0,0,0,3254,3016,238,0,-16,0,-16,0,-16,0,-16,-2,-16,0,-16
16030,30000,24000,0,0,0,1,0,1,0,23321,0,23321,2,25809,3316,22493,2,24985,0,24985,2,700,700,0
16031,100000,80000,0,0,0,0,0,0,0,46435,2300,44135,0,4398,1000,3398,0,3437,0,3437,0,3476,1000,2476
16032,20000,16000,0,0,0,0,0,0,-2,0,0,0,-2,1004,1004,0,-1,0,0,0,-1,0,0,0
16033,80000,64000,0,0,0,0,0,1,0,34703,2000,32703,0,36125,2000,34125,0,38374,3000,35374,0,39382,1800,37582
16034,20000,16000,0,0,0,1,1,0,2,572,572,0,-1,19206,20502,-1296,-1,18595,1000,17595,0,19135,840,18295
16035,190000,152000,0,1,1,0,0,0,0,169675,7601,162074,0,171908,7602,164306,0,153857,6010,147847,0,153988,6010,147978
16036,180000,144000,0,0,0,0,0,0,0,68131,2226,65905,0,62704,2271,60433,0,60133,2108,58025,0,59335,3012,56323
16037,50000,40000,0,0,0,0,0,0,0,45536,52014,-6478,-1,38745,1200,37545,0,37395,19959,17436,-1,19247,1402,17845
16038,20000,16000,0,1,1,1,1,1,2,18938,2000,16938,0,19836,1500,18336,0,19390,0,19390,2,19664,1000,18664
16039,450000,360000,0,0,0,0,0,0,-1,2500,2500,0,-1,0,0,0,-2,0,0,0,-2,0,0,0
16040,150000,120000,0,0,0,0,0,0,0,107321,5350,101971,0,106614,2562,104052,0,108805,2629,106176,0,111012,2669,108343
16041,110000,88000,0,1,1,1,1,0,0,108464,5400,103064,0,108829,4100,104729,0,110557,4100,106457,0,106082,4100,101982
16042,140000,112000,0,0,0,0,0,1,2,80561,5000,75561,2,83643,5000,78643,2,82183,0,82183,2,90823,10000,80823
16043,200000,160000,0,0,0,0,0,0,-1,198,198,0,-1,18154,18156,-2,-1,13677,0,13677,0,2018,1150,868
16044,50000,40000,0,0,0,0,0,0,0,28056,1500,26556,0,29584,2000,27584,0,31595,2500,29095,0,30952,0,30952
16045,10000,8000,0,0,0,0,0,0,0,6528,1000,5528,0,4328,4328,0,-1,4328,4328,0,-1,4171,4171,0
16046,50000,40000,0,0,0,0,0,1,0,34984,1432,33552,0,30090,1000,29090,0,23820,2000,21820,0,18012,2036,15976
16047,30000,24000,0,1,1,1,0,0,0,30171,2300,27871,0,29322,1508,27814,0,28572,1000,27572,0,0,0,0
16048,80000,64000,0,0,0,0,0,0,-1,32194,32194,0,-1,1729,1729,0,-1,590,590,0,-1,9628,9628,0
16049,220000,176000,0,0,0,0,0,0,-2,0,0,0,-2,0,0,0,-2,0,0,0,-2,0,0,0
16050,80000,64000,0,0,0,0,0,0,0,37689,1877,35812,0,38580,1768,36812,0,39104,1292,37812,0,39484,900,38584
16051,260000,208000,1,1,0,0,0,0,0,351026,18934,332092,0,170671,23,170648,2,169689,3729,165960,0,159066,4226,154840
16052,180000,144000,0,0,0,0,0,0,-2,0,0,0,-2,0,0,0,-2,1482,1482,0,-1,0,0,0
16053,50000,40000,0,0,0,0,0,0,-2,0,0,0,-2,0,0,0,-2,0,0,0,-2,0,0,0
16054,260000,208000,0,1,0,0,0,0,0,260104,7100,253004,0,253488,135546,117942,0,145630,4500,141130,0,148720,4590,144130
16055,50000,40000,0,0,0,0,0,0,0,12819,1319,11500,0,36424,23924,12500,0,37029,1500,35529,2,36303,0,36303
16056,10000,8000,0,0,0,0,0,0,2,5381,0,5381,2,3791,0,3791,0,3791,0,3791,0,0,0,0
16057,500000,400000,0,0,0,0,0,0,0,274586,11035,263551,0,273718,11035,262683,0,168418,7029,161389,0,167635,8035,159600
16058,250000,200000,0,0,0,0,0,0,0,121786,5000,116786,0,-329,0,-329,0,-494,0,-494,-2,1541,2200,-659
16059,70000,56000,0,0,0,0,0,0,0,68197,15000,53197,0,50756,3000,47756,0,50843,2000,48843,0,46727,1840,44887
16060,230000,184000,0,0,0,0,0,0,-1,2062,2066,-4,-1,2007,2007,0,-1,2104,2108,-4,-1,394,394,0
16061,150000,120000,0,0,0,0,0,0,-1,-240,0,-240,-1,-240,0,-240,-2,-240,0,-240,-2,390,1170,-780
16062,320000,256000,0,0,0,0,0,0,0,194663,10000,184663,0,70074,75940,-5866,-1,5856,20000,-14144,-1,195599,195599,0
16063,280000,224000,0,0,0,0,0,0,-2,320,320,0,-2,2139,2139,0,-2,0,0,0,-2,0,0,0
16064,230000,184000,0,0,0,0,0,0,0,3724,0,3724,2,153400,153400,0,-1,14788,8000,6788,0,21258,10000,11258
16065,30000,24000,0,0,0,0,0,0,0,20701,1138,19563,0,8263,1000,7263,0,0,0,0,0,0,0,0
16066,140000,112000,0,0,0,0,0,0,0,28180,2000,26180,0,29702,2000,27702,0,31223,2000,29223,0,35683,5000,30683
16067,70000,56000,0,0,0,0,0,0,0,31310,1407,29903,0,28929,972,27957,0,29535,1007,28528,0,28160,1028,27132
16068,350000,280000,0,0,0,0,0,1,-1,3094,3094,0,-1,0,0,0,-1,330,330,0,-1,330,0,330
16069,300000,240000,0,0,0,0,0,0,-2,0,0,0,-2,0,0,0,-2,379,379,0,-2,0,0,0
16070,110000,88000,0,1,1,1,1,0,2,98364,0,98364,2,103189,8500,94689,2,99578,0,99578,2,104412,7700,96712
16071,360000,288000,0,0,0,0,0,0,-1,3300,3300,0,-1,0,0,0,-1,1270,1270,0,-1,0,0,0
16072,70000,56000,0,1,0,0,0,0,0,59258,2060,57198,0,47176,1800,45376,0,46157,1700,44457,0,44981,1634,43347
16073,50000,40000,0,0,0,0,0,1,2,11475,3000,8475,2,10999,0,10999,2,12311,1800,10511,2,11973,0,11973
16074,110000,88000,0,0,0,0,0,0,-1,72517,5000,67517,0,72537,5000,67537,0,55600,5000,50600,0,72442,22000,50442
16075,180000,144000,0,0,0,0,0,0,-1,395,395,0,-1,846,848,-2,-1,1027,1027,0,-1,381,381,0
16076,80000,64000,0,1,1,1,1,0,0,80000,3600,76400,0,82025,4000,78025,0,78521,3500,75021,0,78947,3000,75947
16077,130000,104000,0,0,0,0,0,1,3,18491,0,18491,2,20579,2400,18179,2,19950,0,19950,2,21625,2000,19625
16078,400000,320000,0,0,0,0,0,0,-2,11724,11755,-31,-2,10570,10617,-47,-2,15120,15189,-69,-2,11453,11495,-42
16079,50000,40000,0,0,0,0,0,0,0,0,0,0,-2,0,0,0,-2,0,0,0,-2,0,0,0
16080,90000,72000,0,0,0,0,0,0,0,47756,1207,46549,2,45977,1619,44358,0,43936,1576,42360,0,37142,1600,35542
16081,140000,112000,0,0,0,0,0,0,-1,5445,5445,0,-1,5328,5328,0,-1,6243,6243,0,-1,21030,21030,0
16082,30000,24000,0,0,1,1,1,0,0,25529,1730,23799,0,26563,1760,24803,0,28120,2310,25810,0,28558,1033,27525
16083,320000,256000,0,0,0,0,0,0,0,188596,7000,181596,0,192145,6800,185345,0,195813,7000,188813,0,198648,6965,191683
16084,360000,288000,0,0,0,0,0,0,-2,0,0,0,-2,0,0,0,-2,1090,1090,0,-1,8788,7910,878
16085,100000,80000,0,0,0,0,0,0,0,78703,3000,75703,0,76544,3000,73544,0,75360,3000,72360,0,76507,3000,73507
16086,110000,88000,0,0,0,0,0,1,2,67800,0,67800,2,69182,2512,66670,0,73431,5400,68031,0,72132,0,72132
16087,200000,160000,0,0,0,0,0,0,-2,13300,13416,-116,-2,3450,3450,0,-2,13880,13880,0,-2,5147,5147,0
16088,150000,120000,0,0,0,0,0,0,-1,1868,1873,-5,-1,874,876,-2,-1,1735,1741,-6,-1,1940,2245,-305
16089,240000,192000,0,0,0,0,0,0,0,10996,3000,7996,0,13149,3000,10149,0,14655,2000,12655,0,17133,3000,14133
16090,30000,24000,0,1,0,0,0,0,0,29254,1200,28054,0,19837,8697,11140,0,14793,2000,12793,0,404,1000,-596
16091,200000,160000,0,0,0,0,0,0,0,63210,1656,61554,0,57098,5000,52098,0,46455,20000,26455,0,38265,15000,23265
16092,180000,144000,0,0,0,0,0,0,-1,832,416,416,-1,332,332,0,-1,416,500,-84,-1,416,3500,-3084
16093,200000,160000,0,0,0,0,0,0,-2,909,1692,-783,-2,2004,2004,0,-1,2008,4,2004,0,0,54,-54
16094,10000,8000,0,1,1,0,0,0,0,10000,1000,9000,0,10000,0,10000,0,0,0,0,0,0,0,0
16095,100000,80000,0,0,0,0,0,0,0,8022,1149,6873,0,9733,3094,6639,0,17284,1003,16281,0,8540,1004,7536
16096,10000,8000,0,1,1,1,1,1,0,9721,1151,8570,0,9609,339,9270,0,9503,344,9159,0,9771,425,9346
16097,150000,120000,0,0,0,0,0,0,0,22000,3000,19000,0,24614,3000,21614,0,27200,3000,24200,0,30229,3500,26729
16098,100000,80000,0,0,0,0,0,0,-1,0,0,0,-1,0,0,0,-2,0,0,0,-2,0,0,0
16099,90000,72000,0,0,0,1,1,1,0,62540,5000,57540,0,81123,20000,61123,0,80073,10,80063,2,82472,10104,72368
16100,200000,160000,0,0,0,0,0,0,-2,758,760,-2,-2,-2,0,-2,-2,750,752,-2,-2,26903,26983,-80
16101,270000,216000,0,0,0,0,0,0,0,73293,4000,69293,0,72213,4000,68213,0,74734,5000,69734,0,76089,4000,72089
16102,150000,120000,0,0,0,0,0,0,-1,0,0,0,-2,12877,12877,0,-1,1558,1558,0,-1,225,225,0
16103,260000,208000,0,0,0,0,0,0,0,77683,3000,74683,0,163040,7152,155888,0,86008,8000,78008,0,88575,4000,84575
16104,70000,56000,0,0,1,1,1,0,0,57572,2700,54872,0,58130,2110,56020,0,59289,2125,57164,0,61331,3000,58331
16105,50000,40000,0,1,1,0,0,0,3,51278,2536,48742,2,49425,13,49412,2,30113,1199,28914,0,29644,1058,28586
16106,270000,216000,0,0,0,0,0,0,0,55350,30128,25222,0,92141,60183,31958,0,57961,2071,55890,0,45282,2045,43237
16107,140000,112000,0,0,0,0,0,0,0,107113,5000,102113,0,120327,20000,100327,0,62855,10000,52855,0,67243,10000,57243
16108,90000,72000,0,0,0,0,0,0,0,37800,3000,34800,0,37323,3000,34323,0,34396,2000,32396,0,34938,3000,31938
16109,20000,16000,0,0,0,0,0,0,-1,780,1170,-390,-1,390,0,390,0,390,390,0,-1,0,0,0
16110,130000,104000,0,0,0,0,0,0,2,7599,1000,6599,2,9459,2000,7459,0,10303,1000,9303,0,11128,1000,10128
16111,110000,88000,0,0,0,0,0,0,0,0,0,0,-2,0,0,0,-2,0,0,0,-2,0,0,0
16112,70000,56000,0,0,0,0,0,0,0,26194,2000,24194,0,27454,2000,25454,0,28159,1500,26659,0,25775,1500,24275
16113,200000,160000,0,0,0,0,0,0,0,23231,3346,19885,0,6979,3034,3945,0,2428,2440,-12,-1,2099,2109,-10
16114,80000,64000,0,0,0,0,0,0,-1,10843,10843,0,-1,9011,0,9011,2,7560,22,7538,0,7686,7709,-23
16115,80000,64000,1,1,0,0,0,1,2,102872,4300,98572,2,49043,0,49043,2,23962,1000,22962,0,23283,5000,18283
16116,360000,288000,0,0,0,0,0,0,0,43429,15011,28418,0,45895,45919,-24,-1,27851,5036,22815,0,25408,5022,20386
16117,120000,96000,0,0,0,0,0,0,2,3647,3647,0,-1,10730,10752,-22,-1,1835,0,1835,2,5843,5658,185
16118,230000,184000,0,1,0,1,1,0,0,205294,15026,190268,0,194263,15000,179263,0,212257,20000,192257,0,206084,15030,191054
16119,320000,256000,0,0,0,0,0,0,-2,13482,13482,0,-2,2975,2975,0,-2,2029,2029,0,-2,888,888,0
16120,120000,96000,0,1,1,1,1,0,0,117220,4223,112997,0,119599,4296,115303,0,120888,4800,116088,0,117881,4423,113458
16121,30000,24000,0,0,0,0,0,1,0,22299,2000,20299,0,23615,2000,21615,0,23933,1000,22933,0,24901,1500,23401
16122,400000,320000,0,0,0,0,0,0,-1,19143,19143,0,-1,20305,1305,19000,0,22063,2063,20000,0,20695,1695,19000
16123,150000,120000,0,1,0,0,0,0,0,141196,6040,135156,0,105802,5750,100052,0,106478,3000,103478,0,107096,5000,102096
16124,50000,40000,0,0,0,0,0,0,-1,911,911,0,-1,1080,559,521,0,930,390,540,0,390,0,390
16125,50000,40000,0,0,0,0,0,0,0,30220,2016,28204,0,30235,1450,28785,0,28979,1314,27665,0,23593,814,22779
16126,130000,104000,0,1,0,0,0,0,0,109062,5000,104062,0,105252,6000,99252,0,103969,10000,93969,0,104254,10000,94254
16127,40000,32000,0,1,1,1,1,1,2,33239,0,33239,2,33938,1250,32688,0,34694,1300,33394,0,35389,1270,34119
16128,20000,16000,0,0,0,0,0,0,0,14244,12500,1744,0,14065,3000,11065,0,16161,4000,12161,0,11106,2000,9106
16129,140000,112000,0,0,0,0,0,0,-1,0,0,0,-1,1920,1920,0,-1,1180,1180,0,-1,0,0,0
16130,80000,64000,0,0,0,0,0,0,-2,3476,3476,0,-1,3377,3377,0,-1,3377,3377,0,-2,5062,5062,0
16131,40000,32000,0,1,1,1,1,0,0,39121,1800,37321,0,40400,2000,38400,0,40000,0,40000,0,40000,0,40000
16132,280000,224000,0,0,0,0,0,0,-2,51500,52110,-610,-2,35752,35752,0,-2,3955,3955,0,-1,13969,13939,30
16133,210000,168000,0,0,1,0,0,0,0,97223,3272,93951,0,202134,4362,197772,0,102844,5040,97804,0,39995,3195,36800
16134,80000,64000,0,1,1,1,1,0,0,76083,2800,73283,0,81183,6400,74783,0,79906,2870,77036,2,75294,0,75294
16135,70000,56000,0,0,0,0,0,1,2,35878,2000,33878,2,36392,1400,34992,2,36990,1500,35490,2,37751,1500,36251
16136,110000,88000,0,1,1,0,0,0,0,108730,3783,104947,0,112035,6488,105547,0,48492,4850,43642,0,43413,2000,41413
16137,230000,184000,0,0,0,0,0,0,0,87601,4162,83439,0,89762,5000,84762,0,92735,5000,87735,0,95768,5000,90768
16138,240000,192000,0,0,0,0,0,0,-2,3934,3953,-19,-2,6630,6646,-16,-1,6817,6865,-48,-1,7658,7673,-15
16139,50000,40000,1,1,1,0,0,0,4,50125,0,50125,3,48640,0,48640,2,17450,2000,15450,0,60,1003,-943
16140,60000,48000,0,1,0,0,0,0,0,57606,2000,55606,0,33159,3000,30159,0,36183,3800,32383,0,27572,0,27572
16141,280000,224000,0,0,0,0,0,0,-1,4746,4792,-46,-2,2377,2384,-7,-2,2390,2393,-3,-1,3504,3524,-20
16142,150000,120000,0,1,1,0,0,1,0,130982,6100,124882,0,125296,4000,121296,0,122664,5500,117164,0,112055,3002,109053
16143,80000,64000,0,0,0,0,0,0,0,0,0,0,-2,0,0,0,-2,0,0,0,-2,0,0,0
16144,160000,128000,0,0,0,0,0,0,0,52890,4000,48890,0,50275,2500,47775,0,51337,2500,48837,0,53349,3000,50349
16145,50000,40000,0,0,0,0,0,0,-1,24458,159,24299,2,37778,37778,0,-1,39124,2000,37124,0,38585,2000,36585
16146,300000,240000,0,0,0,0,0,0,0,168098,6500,161598,0,181257,20000,161257,0,175362,7000,168362,0,179536,7000,172536
16147,140000,112000,0,0,0,0,0,0,0,27203,1804,25399,0,27209,14000,13209,0,-20006,10968,-30974,0,-30177,0,-30177
16148,140000,112000,0,0,0,0,0,1,3,84107,0,84107,4,82362,0,82362,3,74000,0,74000,2,60977,2600,58377
16149,140000,112000,0,1,1,0,0,1,0,139977,6003,133974,0,136207,4771,131436,0,50464,2103,48361,0,49430,2000,47430
16150,100000,80000,0,0,0,0,0,0,0,30178,5000,25178,0,29735,87,29648,0,14718,14761,-43,-1,29427,29514,-87
16151,160000,128000,0,0,0,0,0,0,2,66526,2500,64026,2,66893,3000,63893,0,66637,3000,63637,0,67877,4000,63877
16152,80000,64000,0,0,0,0,0,0,0,12190,6000,6190,0,4000,6500,-2500,-1,0,0,0,-1,4000,4000,0
16153,120000,96000,0,0,0,0,0,0,0,4390,4390,0,-1,850,0,850,0,850,0,850,0,831,831,0
16154,150000,120000,0,0,0,0,0,0,0,64041,3023,61018,0,60948,2549,58399,0,51510,2000,49510,0,46917,2000,44917
16155,50000,40000,0,0,0,0,0,0,-2,0,0,0,-2,0,0,0,-2,300,300,0,-2,150,0,150
16156,320000,256000,0,0,0,0,0,1,0,32159,5000,27159,0,31851,0,31851,0,3105,0,3105,0,-45,0,-45
16157,20000,16000,0,1,0,0,0,0,0,19812,1201,18611,0,10717,1000,9717,0,13534,3000,10534,0,15298,2000,13298
16158,100000,80000,0,0,0,0,0,0,-1,0,0,0,-2,0,0,0,-2,0,0,0,-2,0,0,0
16159,320000,256000,0,0,0,0,0,0,0,57051,15000,42051,0,161651,105000,56651,0,182265,55000,127265,0,0,0,0
16160,20000,16000,0,0,0,1,0,1,0,16244,1800,14444,0,18300,2800,15500,0,18100,0,18100,0,-1900,0,-1900
16161,50000,40000,0,0,0,0,0,1,2,37166,1200,35966,2,31989,1300,30689,0,33587,2651,30936,0,32514,0,32514
16162,160000,128000,0,0,0,0,0,0,-1,0,0,0,-1,0,0,0,-2,0,0,0,-2,0,0,0
16163,50000,40000,0,1,1,0,0,0,2,47652,2098,45554,0,49336,2782,46554,0,28390,936,27454,0,28985,971,28014
16164,50000,40000,0,1,1,1,1,0,0,45881,5000,40881,0,45784,5000,40784,0,50072,8000,42072,0,49112,4000,45112
16165,180000,144000,0,0,0,0,0,0,0,48316,2111,46205,0,28220,1015,27205,0,29260,1500,27760,0,30173,1400,28773
16166,70000,56000,0,0,0,0,0,0,0,30206,1000,29206,0,0,0,0,0,0,0,0,-2,5000,5000,0
16167,50000,40000,0,0,0,0,0,0,2,12987,0,12987,2,13699,1234,12465,0,15868,2403,13465,0,15474,0,15474
16168,30000,24000,0,0,0,0,0,0,-1,-378,0,-378,-2,920,1298,-378,-1,5448,5448,0,-1,0,0,0
16169,430000,344000,0,0,0,0,0,0,0,48916,10000,38916,0,52021,4000,48021,0,27796,1500,26296,0,29340,2000,27340
16170,100000,80000,0,0,0,0,0,0,-2,0,0,0,-2,0,0,0,-2,0,0,0,-2,0,0,0
16171,30000,24000,0,0,0,0,0,0,0,22269,1668,20601,0,22601,1000,21601,0,23085,1000,22085,0,23646,944,22702
16172,100000,80000,0,0,0,0,0,1,-2,2511,2517,-6,-2,3333,3339,-6,-2,2765,2765,0,-2,900,900,0
16173,230000,184000,0,0,0,0,0,0,0,129832,6000,123832,0,133273,6000,127273,0,139818,10000,129818,0,65649,30000,35649
16174,300000,240000,0,0,0,0,0,0,0,199223,20000,179223,0,202486,11022,191464,0,200935,4935,196000,0,-6,6,-12
16175,150000,120000,0,0,0,0,0,0,-1,70,0,70,2,90000,90000,0,-1,9068,9068,0,-1,2349,0,2349
16176,20000,16000,0,0,0,0,0,1,2,12077,0,12077,2,12779,1212,11567,0,13033,466,12567,0,13308,485,12823
16177,10000,8000,0,0,0,0,0,0,-1,9954,9954,0,-1,9719,9919,-200,-1,6547,0,6547,0,654,654,0
16178,240000,192000,0,0,0,0,0,0,-1,8774,8774,0,-1,1854,1854,0,-1,-9584,0,-9584,-1,-15483,0,-15483
16179,380000,304000,0,0,0,0,0,0,0,299786,11600,288186,0,307801,20009,287792,0,288820,11000,277820,2,266266,0,266266
16180,400000,320000,0,0,0,0,0,0,-1,11867,11867,0,-1,7839,7839,0,-1,14837,14837,0,-1,7959,7959,0
16181,120000,96000,0,0,0,0,0,1,-1,360,360,0,-1,360,360,0,-1,150,150,0,-1,870,870,0
16182,70000,56000,0,1,0,0,0,0,2,68530,49,68481,2,29959,1168,28791,0,29315,1032,28283,0,28805,1200,27605
16183,210000,168000,0,0,0,0,0,0,-1,6730,6730,0,-1,3447,3447,0,-1,16220,16220,0,-1,5566,7564,-1998
16184,60000,48000,0,1,0,0,0,0,0,59108,2373,56735,0,38827,1324,37503,0,39670,1402,38268,0,37503,1460,36043
16185,60000,48000,0,0,0,0,0,0,2,11237,1483,9754,0,11427,673,10754,0,20973,10000,10973,0,31857,11540,20317
16186,60000,48000,0,1,1,0,0,0,0,59137,2570,56567,0,59345,1620,57725,0,29399,1020,28379,0,29339,1050,28289
16187,210000,168000,0,0,0,0,0,1,0,142343,6000,136343,0,69004,2270,66734,0,70596,2500,68096,0,69388,2472,66916
16188,70000,56000,0,0,0,0,0,1,2,13145,0,13145,2,14123,1200,12923,2,13754,0,13754,2,14724,1200,13524
16189,340000,272000,0,0,0,0,0,0,0,179156,9000,170156,0,170491,9000,161491,0,158370,7000,151370,0,151685,6000,145685
16190,110000,88000,0,0,0,0,0,0,-2,77817,1948,75869,-2,64246,1285,62961,-2,65746,1500,64246,-2,57715,60589,-2874
16191,70000,56000,0,0,0,0,0,0,0,67450,26017,41433,0,61902,40000,21902,0,19551,17000,2551,0,27831,24000,3831
16192,30000,24000,0,1,1,1,1,0,3,26185,0,26185,3,25470,0,25470,2,25751,1000,24751,0,27179,2000,25179
16193,50000,40000,0,1,1,0,0,0,0,46658,2009,44649,0,44441,2013,42428,0,18559,700,17859,0,17781,1000,16781
16194,360000,288000,0,0,0,0,0,0,-1,17918,17918,0,-1,19259,19459,-200,-1,26924,26924,0,-1,19049,19049,0
16195,130000,104000,0,0,0,0,0,1,0,19545,1328,18217,0,20217,1000,19217,0,20890,1000,19890,0,21541,1000,20541
16196,50000,40000,0,1,1,1,1,1,0,46400,0,46400,2,49276,3700,45576,2,48286,0,48286,2,47915,2000,45915
16197,270000,216000,0,0,0,0,0,0,0,46765,2000,44765,0,55438,10000,45438,0,54285,1461,52824,0,54198,1492,52706
16198,290000,232000,0,0,0,0,0,0,-2,0,0,0,-2,0,0,0,-2,0,0,0,-2,0,0,0
16199,190000,152000,0,0,0,0,0,0,0,98954,4954,94000,0,101512,4512,97000,0,106708,6708,100000,0,109639,4639,105000
16200,300000,240000,0,0,0,0,0,0,-1,891,891,0,-1,889,889,0,-1,889,889,0,-1,739,739,0
16201,50000,40000,0,0,0,0,0,0,2,16696,2137,14559,2,16134,0,16134,2,17380,1503,15877,2,16958,0,16958
16202,150000,120000,0,1,1,1,1,0,0,146277,6850,139427,0,147946,5664,142282,0,145846,5660,140186,0,143531,5480,138051
16203,100000,80000,0,0,0,0,0,0,-2,0,0,0,-2,338,4838,-4500,-1,9448,9448,0,-1,1183,4183,-3000
16204,100000,80000,0,0,0,0,0,0,0,44285,19462,24823,0,45433,3000,42433,0,3952,302,3650,0,3723,3723,0
16205,200000,160000,0,0,0,0,0,1,2,1436,0,1436,2,1261,1261,0,-1,2849,2849,0,-1,1438,0,1438
16206,160000,128000,0,0,0,0,0,0,2,44255,43500,755,2,43228,0,43228,2,-772,0,-772,2,-772,0,-772
16207,310000,248000,0,0,0,0,0,0,-2,1156,1156,0,-2,1889,1889,0,-2,3367,3367,0,-2,2267,2267,0
16208,230000,184000,0,0,0,0,0,0,-2,2969,2974,-5,-2,3419,3425,-6,-2,0,0,0,-2,1841,1841,0
16209,500000,400000,0,0,0,0,0,0,0,26639,1174,25465,0,22828,1007,21821,0,21293,1013,20280,0,17544,1018,16526
16210,500000,400000,0,0,0,0,0,0,0,122368,12105,110263,0,108543,8610,99933,0,93906,3555,90351,0,82288,4073,78215
16211,260000,208000,0,0,0,0,0,0,0,49512,2655,46857,0,18657,800,17857,0,33296,15000,18296,0,32622,0,32622
16212,150000,120000,0,0,0,0,0,0,-2,8796,8796,0,-2,20359,20375,-16,-2,17329,17329,0,-2,20087,20087,0
16213,100000,80000,0,0,0,0,0,1,-1,3302,2438,864,-1,2430,821,1609,2,805,1,804,0,3415,3110,305
16214,160000,128000,0,0,0,0,0,0,2,72583,2609,69974,0,60565,2037,58528,0,54651,2010,52641,0,48468,2017,46451
16215,70000,56000,0,0,0,0,0,1,2,2400,0,2400,7,2400,0,2400,7,2400,0,2400,7,2400,0,2400
16216,160000,128000,0,0,0,0,0,1,-1,2043,1043,1000,0,3133,1133,2000,0,0,0,0,0,0,0,0
16217,10000,8000,0,0,0,0,0,1,0,6143,0,6143,2,6908,871,6037,2,6652,0,6652,2,6785,244,6541
16218,20000,16000,0,1,1,1,1,0,0,17509,1300,16209,0,17856,637,17219,0,18270,700,17570,0,18967,1000,17967
16219,180000,144000,0,1,1,1,1,0,0,173007,5653,167354,0,168743,6488,162255,0,172275,5138,167137,0,176861,6313,170548
16220,160000,128000,0,0,0,0,0,0,-1,2329,2645,-316,-1,2332,2339,-7,-1,-4,0,-4,-1,-4,0,-4
16221,100000,80000,0,0,0,0,0,0,-1,1238,1238,0,-1,916,916,0,-1,1444,1444,0,-1,1450,1450,0
16222,80000,64000,0,1,0,0,0,0,0,69534,2811,66723,0,60747,1192,59555,0,52280,1516,50764,0,43461,2316,41145
16223,200000,160000,0,0,0,0,0,1,2,5000,0,5000,2,5000,0,5000,2,5000,0,5000,2,5000,0,5000
16224,80000,64000,0,0,0,0,0,0,0,8922,1026,7896,0,3932,3944,-12,-1,2900,3208,-308,-1,0,0,0
16225,210000,168000,0,0,0,0,0,0,0,-564,0,-564,0,4270,6000,-1730,-1,143607,143754,-147,-1,144505,5000,139505
16226,360000,288000,0,0,0,0,0,0,0,19013,1383,17630,0,17929,2000,15929,0,20759,3030,17729,0,3436,2009,1427
16227,140000,112000,0,0,0,0,0,0,0,93649,4324,89325,0,89574,3207,86367,0,90413,4000,86413,0,90596,3500,87096
16228,480000,384000,0,0,0,0,0,0,-2,0,0,0,-2,0,0,0,-2,0,0,0,-2,0,0,0
16229,50000,40000,0,1,1,1,1,0,0,50892,2200,48692,0,50769,1800,48969,0,48813,1900,46913,0,49874,2000,47874
16230,110000,88000,0,0,0,0,1,1,0,75697,12182,63515,0,86483,12201,74282,0,97054,12403,84651,0,105553,10350,95203
16231,150000,120000,0,0,0,0,0,0,-1,1908,2000,-92,-1,1589,1589,0,-1,9918,9918,0,-1,-16586,1157,-17743
16232,130000,104000,0,1,1,1,1,0,0,128714,6208,122506,0,128962,4700,124262,0,131873,5000,126873,0,131482,5000,126482
16233,80000,64000,0,0,0,0,0,0,0,42334,1139,41195,0,39137,40003,-866,-1,39074,2000,37074,0,40103,2100,38003
16234,80000,64000,0,1,1,1,1,0,0,69602,4688,64914,2,70752,2900,67852,2,74183,5200,68983,2,72727,0,72727
16235,80000,64000,0,0,0,1,1,1,2,62882,0,62882,2,69109,7282,61827,2,67401,0,67401,2,68863,2700,66163
16236,260000,208000,0,0,0,0,0,0,-1,6574,6574,0,-1,3551,3551,0,-1,3634,3700,-66,-1,2440,0,2440
16237,180000,144000,0,0,0,0,0,1,-1,291,0,291,2,291,291,0,-1,291,291,0,-1,291,291,0
16238,150000,120000,0,0,0,0,0,0,-2,-632,0,-632,-2,-1264,0,-1264,-2,316,1580,-1264,-1,782,782,0
16239,160000,128000,0,0,0,0,0,0,-1,362,362,0,-1,20680,20680,0,-1,7429,7429,0,-1,527,527,0
16240,50000,40000,0,1,0,0,0,0,0,50125,2227,47898,0,9717,339,9378,0,9549,500,9049,0,9840,600,9240
16241,30000,24000,0,0,0,0,0,0,0,19816,1500,18316,0,18471,1000,17471,0,16305,841,15464,0,0,0,0
16242,50000,40000,0,0,0,0,0,0,0,49724,41000,8724,0,48437,51705,-3268,-1,18712,700,18012,0,19129,718,18411
16243,50000,40000,0,0,0,0,0,0,-1,974,974,0,-1,1224,1300,-76,-1,1224,1050,174,0,1025,1025,0
16244,500000,400000,0,0,0,0,0,0,-2,399,399,0,-1,35528,35129,399,0,10389,0,10389,0,0,0,0
16245,20000,16000,0,0,1,0,0,1,0,16985,2000,14985,0,19985,3000,16985,0,9421,1000,8421,0,9764,500,9264
16246,160000,128000,0,0,0,0,0,0,0,134243,20000,114243,0,12670,30037,-17367,-1,6349,6349,0,-1,10775,11000,-225
16247,30000,24000,0,0,0,0,0,1,2,19702,1000,18702,2,19102,0,19102,2,19508,700,18808,0,19899,700,19199
16248,20000,16000,0,0,0,0,0,0,2,390,390,0,-1,390,390,0,-1,390,390,0,-1,0,0,0
16249,310000,248000,0,0,0,0,0,0,0,80533,3604,76929,0,70343,2366,67977,0,58365,2018,56347,0,51454,2000,49454
16250,90000,72000,0,0,0,0,0,0,0,14155,2000,12155,0,14916,1000,13916,0,15673,1000,14673,0,17404,2000,15404
16251,170000,136000,0,0,0,0,0,0,-1,2429,2429,0,-1,2202,2202,0,-1,598,598,0,-1,1801,1801,0
16252,80000,64000,0,0,0,0,0,0,0,59100,6433,52667,0,53133,0,53133,2,48598,2000,46598,0,48882,2000,46882
16253,70000,56000,0,0,0,0,0,0,0,11402,1000,10402,0,8464,0,8464,0,6464,0,6464,0,-1000,0,-1000
16254,60000,48000,0,1,0,0,0,0,0,52890,2019,50871,0,49066,2236,46830,0,34105,1351,32754,0,32778,1326,31452
16255,280000,224000,0,0,0,0,0,0,-2,0,0,0,-2,0,0,0,-2,0,0,0,-2,5017,5017,0
16256,120000,96000,0,0,0,0,0,0,-1,28466,28466,0,-1,21455,21455,0,-1,15685,0,15685,0,6737,0,6737
16257,300000,240000,0,0,0,0,0,0,0,147077,6000,141077,0,127270,5006,122264,0,129397,5000,124397,0,132142,5000,127142
16258,30000,24000,0,0,0,0,0,0,0,5240,1400,3840,0,400,0,400,0,0,0,0,0,0,0,0
16259,110000,88000,0,0,0,0,0,0,0,3308,3308,0,-1,2527,2527,0,-1,1076,1079,-3,-1,1164,1167,-3
16260,230000,184000,0,0,0,0,0,0,0,34305,4305,30000,0,22752,1000,21752,0,5123,5123,0,0,0,0,0
16261,250000,200000,0,0,0,0,0,0,-1,17904,17911,-7,-1,99464,99738,-274,-1,86180,4055,82125,0,36038,0,36038
16262,50000,40000,0,0,0,0,0,0,0,15264,2000,13264,0,12465,1000,11465,0,13262,1000,12262,0,13523,482,13041
16263,180000,144000,0,0,0,0,0,0,0,31648,23,31625,2,23461,208,23253,0,20671,10,20661,0,17122,51,17071
16264,200000,160000,0,0,0,0,0,0,-2,359,359,0,-2,0,0,0,-2,353,353,0,-2,342,342,0
16265,50000,40000,0,1,0,0,0,0,0,49465,1917,47548,0,40020,2500,37520,0,10407,500,9907,0,9037,500,8537
16266,70000,56000,0,0,0,0,0,0,0,7665,1133,6532,0,8836,1304,7532,0,9532,1000,8532,0,9730,351,9379
16267,290000,232000,0,0,0,0,0,0,0,110481,3700,106781,0,107735,4005,103730,0,100195,4000,96195,0,84268,3000,81268
16268,220000,176000,0,0,0,0,0,0,-1,26390,26390,0,-1,13007,13007,0,-1,7387,0,7387,0,20018,20018,0
16269,30000,24000,0,0,0,0,0,0,2,10534,2399,8135,2,8240,0,8240,2,7027,388,6639,0,7034,260,6774
16270,500000,400000,0,0,0,0,0,0,0,239921,12800,227121,0,184874,4300,180574,0,47774,3063,44711,0,34617,3600,31017
16271,80000,64000,0,0,0,0,0,0,0,56993,7139,49854,0,42663,6000,36663,0,43136,1694,41442,0,43676,2000,41676
16272,160000,128000,0,0,0,0,0,0,-2,0,0,0,-2,0,0,0,-2,0,0,0,-2,0,0,0
16273,80000,64000,0,1,0,0,0,0,0,67528,2403,65125,0,64035,3003,61032,0,60612,3001,57611,0,57532,2401,55131
16274,30000,24000,0,0,0,0,0,0,0,0,0,0,0,157,3160,-3003,-1,24767,25000,-233,-1,24991,1000,23991
16275,80000,64000,0,1,0,0,0,0,0,79693,3039,76654,0,20335,1550,18785,0,0,0,0,0,0,0,0
16276,50000,40000,0,0,0,0,0,0,0,25400,2000,23400,0,24202,1000,23202,0,25904,2000,23904,0,27567,2000,25567
16277,210000,168000,0,0,0,0,0,0,-1,0,0,0,-2,0,0,0,-2,0,0,0,-2,0,0,0
16278,310000,248000,0,0,0,0,0,0,0,197450,8668,188782,0,194834,8247,186587,0,185943,6729,179214,0,183624,6639,176985
16279,260000,208000,0,0,0,0,0,0,-1,491,493,-2,-1,1132,1134,-2,-1,1711,1072,639,-1,1070,2,1068
16280,30000,24000,0,1,1,1,1,1,0,29904,1470,28434,0,32025,3500,28525,0,32479,2000,30479,2,30894,0,30894
16281,90000,72000,0,0,0,0,0,0,2,53295,5000,48295,2,53826,2000,51826,2,54548,2200,52348,2,55525,2000,53525
16282,50000,40000,0,1,1,0,0,0,0,50778,1985,48793,0,48261,1468,46793,0,28768,1175,27593,0,29370,1214,28156
16283,240000,192000,0,0,0,0,0,0,-2,2804,2804,0,-2,3958,3958,0,-2,12157,12157,0,-2,3874,3874,0
16284,160000,128000,0,0,0,0,0,1,-1,1390,1390,0,-1,390,390,0,-1,390,390,0,-1,0,0,0
16285,90000,72000,0,0,0,0,0,0,0,45372,2055,43317,0,46317,2000,44317,0,51292,5913,45379,0,50316,0,50316
16286,140000,112000,0,0,0,0,0,0,0,86543,2083,84460,0,68972,1503,67469,0,47268,1083,46185,0,2299,1121,1178
16287,390000,312000,0,0,0,0,0,0,0,144731,5358,139373,0,145140,5500,139640,0,130727,5000,125727,0,131619,20000,111619
16288,250000,200000,0,0,0,0,0,0,0,32833,3000,29833,0,34055,2500,31555,0,34321,1000,33321,0,23166,3050,20116
16289,260000,208000,0,0,0,0,0,0,-1,5734,5734,0,-1,24898,24898,0,-1,150,3883,-3733,-1,381,381,0
16290,450000,360000,0,0,0,0,0,0,-1,4562,4562,0,-1,5001,5001,0,-1,39243,39292,-49,-1,25512,0,25512
16291,50000,40000,0,1,0,0,0,0,0,46919,3000,43919,0,17459,625,16834,0,17825,647,17178,0,18193,664,17529
16292,170000,136000,0,0,0,0,0,1,2,20619,2000,18619,0,19520,1136,18384,0,5200,1000,4200,0,0,0,0
16293,500000,400000,0,0,0,0,0,0,0,7218,2208,5010,0,2183,11,2172,0,6371,6402,-31,-1,5208,5234,-26
16294,30000,24000,0,1,0,0,0,0,0,28242,1308,26934,0,16498,1300,15198,0,16923,700,16223,0,17649,1000,16649
16295,120000,96000,0,1,1,1,1,0,0,114061,4137,109924,0,116067,4400,111667,0,116294,4320,111974,0,118759,4500,114259
16296,130000,104000,0,0,0,0,0,0,-2,0,0,0,-2,0,0,0,-2,0,0,0,-2,0,0,0
16297,50000,40000,0,1,0,0,0,0,2,48714,4000,44714,0,38653,2000,36653,0,19439,1000,18439,0,14711,521,14190
16298,50000,40000,0,0,0,0,0,0,0,19431,1307,18124,0,19307,683,18624,0,19361,857,18504,0,19738,856,18882
16299,80000,64000,0,0,0,0,0,0,0,64656,2506,62150,0,60537,3008,57529,0,42610,3000,39610,0,42769,2000,40769
16300,50000,40000,1,1,1,1,1,1,2,51170,0,51170,2,51526,3000,48526,0,50524,6000,44524,0,48510,0,48510
16301,290000,232000,0,1,1,0,0,0,0,265115,10000,255115,0,264323,9883,254440,0,221070,7738,213332,0,219295,7813,211482
16302,240000,192000,0,0,0,0,0,0,0,138006,9583,128423,0,136195,6000,130195,0,140860,10000,130860,0,138787,4974,133813
16303,490000,392000,0,0,0,0,0,0,0,17195,1107,16088,0,15691,507,15184,0,14466,1507,12959,0,13908,1500,12408
16304,320000,256000,0,0,0,0,0,0,0,78479,3632,74847,0,71121,5010,66111,0,44698,7059,37639,0,53230,30018,23212
16305,500000,400000,0,0,0,0,0,0,-2,12376,12390,-14,-2,12660,12692,-32,-2,8000,8016,-16,-2,20514,20514,0
16306,360000,288000,0,0,0,0,0,0,-2,2441,2453,-12,-2,5681,5710,-29,-2,65816,66145,-329,-2,17577,17589,-12
16307,340000,272000,0,0,0,0,0,0,-1,1564,1586,-22,-1,7726,7742,-16,-1,4536,1300,3236,0,4961,4985,-24
16308,150000,120000,0,0,0,0,0,1,2,118700,5700,113000,2,115328,0,115328,2,121084,9200,111884,2,123473,4500,118973
16309,20000,16000,0,1,1,1,1,0,0,18652,1666,16986,0,19156,1500,17656,0,19206,592,18614,0,19948,1284,18664
16310,360000,288000,0,0,0,0,0,0,0,268459,14200,254259,0,271691,9200,262491,2,277226,10000,267226,0,283210,10403,272807
16311,160000,128000,0,0,0,0,0,0,-1,7396,7433,-37,-1,5224,5245,-21,-1,16989,17053,-64,-1,1640,1647,-7
16312,210000,168000,0,0,0,0,0,0,0,107150,3885,103265,0,102418,3712,98706,0,97653,3599,94054,0,92653,3346,89307
16313,110000,88000,0,0,0,0,0,0,0,37051,6000,31051,0,36303,0,36303,2,42800,8000,34800,2,38381,0,38381
16314,160000,128000,0,0,0,0,0,0,-1,4027,4059,-32,-1,3100,3100,0,-1,2123,2123,0,-1,4899,4899,0
16315,20000,16000,1,1,0,0,0,1,2,21247,18,21229,2,7475,300,7175,0,0,0,0,0,0,0,0
16316,80000,64000,1,1,1,1,1,0,0,98328,5000,93328,0,93376,5000,88376,0,87491,2000,85491,0,80156,8500,71656
16317,70000,56000,0,1,1,0,0,0,0,72457,3500,68957,0,71058,3000,68058,0,29672,1000,28672,0,28836,1500,27336
16318,360000,288000,0,0,0,0,0,0,-2,0,0,0,-2,0,0,0,-2,0,0,0,-2,0,0,0
16319,140000,112000,0,1,0,0,0,0,0,127237,5900,121337,0,94159,4000,90159,0,95794,3000,92794,0,89345,5000,84345
16320,30000,24000,0,1,1,1,0,1,2,27761,2000,25761,0,28053,1507,26546,0,28249,3100,25149,0,23580,3100,20480
16321,130000,104000,0,0,0,0,0,0,-1,1098,1098,0,-1,2912,2912,0,-1,2910,2910,0,-1,4122,4122,0
16322,360000,288000,0,0,0,0,0,0,-1,0,0,0,-1,0,0,0,-2,1444,1444,0,-1,-1382,1382,-2764
16323,360000,288000,0,0,0,0,0,1,-2,0,0,0,-2,0,0,0,-2,0,0,0,-2,2628,2628,0
16324,20000,16000,0,0,0,0,0,0,0,3372,1000,2372,0,0,0,0,0,0,0,0,-2,0,0,0
16325,220000,176000,0,0,0,0,0,0,2,825,325,500,2,1783,1283,500,0,1205,507,698,0,1205,705,500
16326,30000,24000,0,0,0,0,0,1,-2,0,0,0,-2,0,0,0,-2,0,0,0,-2,0,0,0
16327,50000,40000,0,0,0,0,0,0,0,41329,9000,32329,0,5392,0,5392,2,5722,1000,4722,2,4501,0,4501
16328,500000,400000,0,0,0,0,0,0,-1,42389,42398,-9,-1,19238,19244,-6,-1,34750,34750,0,-1,21464,21464,0
16329,360000,288000,0,0,0,0,0,0,0,10594,10600,-6,-1,31532,30000,1532,0,46342,20000,26342,0,56571,15000,41571
16330,200000,160000,0,0,0,0,0,0,-1,16175,16254,-79,-1,104872,100551,4321,0,22897,12077,10820,0,29339,20182,9157
16331,180000,144000,0,0,0,0,0,0,-2,0,0,0,-2,0,0,0,-2,0,0,0,-2,0,0,0
16332,90000,72000,0,0,0,0,0,0,2,45136,4000,41136,2,46098,2000,44098,2,45059,0,45059,2,79127,35000,44127
16333,360000,288000,0,0,0,0,0,0,0,-5386,2544,-7930,0,250214,261000,-10786,-1,255296,9000,246296,0,261401,10000,251401
16334,140000,112000,1,1,1,1,1,0,0,155737,5677,150060,0,140586,4797,135789,0,136641,15414,121227,0,117308,0,117308
16335,30000,24000,0,0,0,0,0,0,-2,-760,0,-760,-2,-760,0,-760,-2,760,1520,-760,-1,760,0,760
16336,670000,536000,0,0,0,0,0,0,0,229265,8000,221265,0,228114,8500,219614,0,232795,8190,224605,0,237726,9000,228726
16337,130000,104000,0,0,0,0,0,0,2,10018,6000,4018,2,5353,0,5353,2,5465,173,5292,0,4559,326,4233
16338,50000,40000,0,0,0,0,0,0,-1,836,836,0,-1,836,0,836,2,836,836,0,-1,1517,1517,0
16339,90000,72000,0,0,0,0,0,0,0,0,0,0,0,0,0,0,-2,0,0,0,-2,0,0,0
16340,500000,400000,0,0,0,0,0,0,0,33086,2014,31072,0,18304,3030,15274,0,16604,8006,8598,0,9505,1000,8505
16341,80000,64000,0,1,1,1,1,0,0,75973,10000,65973,0,70283,2550,67733,0,73491,5100,68391,0,66976,0,66976
16342,240000,192000,0,0,0,0,1,0,0,189471,7500,181971,0,191623,6300,185323,0,195624,6000,189624,0,199259,6100,193159
16343,160000,128000,0,0,0,0,0,1,-1,0,0,0,-1,0,0,0,-2,0,0,0,-2,0,0,0
16344,50000,40000,0,0,0,0,0,1,2,16227,2000,14227,2,16662,1000,15662,2,16253,0,16253,2,17982,2000,15982
16345,50000,40000,0,0,0,0,0,0,0,19318,1229,18089,0,15949,687,15262,0,14986,2000,12986,0,19401,5000,14401
16346,180000,144000,0,0,0,0,0,0,-1,5960,5960,0,-1,600,600,0,-1,6800,6800,0,-1,12627,12627,0
16347,210000,168000,0,0,0,0,0,0,0,138644,5317,133327,0,141679,5631,136048,0,92170,3345,88825,0,93998,3360,90638
16348,50000,40000,0,0,0,0,0,0,0,31675,2000,29675,0,31849,2000,29849,0,31323,1500,29823,0,32620,3023,29597
16349,180000,144000,0,0,0,0,0,0,2,27555,1300,26255,0,26574,7504,19070,0,23123,1123,22000,0,30680,13000,17680
16350,80000,64000,0,1,1,1,1,0,0,80672,2906,77766,0,79681,2828,76853,0,78569,2790,75779,0,79817,2887,76930
16351,10000,8000,0,0,1,1,1,0,0,9531,2017,7514,0,9904,1000,8904,0,9310,186,9124,0,19000,190,18810
16352,220000,176000,0,1,1,1,1,0,0,203251,9000,194251,0,208355,10000,198355,0,213015,8000,205015,0,217475,8010,209465
16353,330000,264000,0,0,0,0,0,0,-2,0,0,0,-2,3155,3155,0,-1,4550,4550,0,-1,1264,1264,0
16354,50000,40000,0,0,0,0,0,0,0,16394,2000,14394,0,6198,1091,5107,0,7717,2000,5717,0,7722,500,7222
16355,30000,24000,0,1,1,0,0,1,2,26622,1300,25322,2,24022,2,24020,2,24368,1608,22760,2,20859,0,20859
16356,460000,368000,0,0,0,0,0,0,-2,4032,4052,-20,-2,23724,23862,-138,-2,12972,13036,-64,-2,11111,11167,-56
16357,250000,200000,0,0,0,0,0,0,-1,46975,46975,0,-1,10880,10890,-10,-1,8974,8974,0,-1,36805,30000,6805
16358,130000,104000,0,0,0,0,0,0,-2,3726,3726,0,-1,0,0,0,-1,0,0,0,-2,1300,1300,0
16359,140000,112000,0,0,0,0,0,0,0,44710,2100,42610,0,45661,2000,43661,0,50880,6000,44880,0,49934,0,49934
16360,70000,56000,0,0,0,0,0,1,2,24486,42,24444,2,21879,3000,18879,0,13127,3000,10127,0,14149,1400,12749
16361,30000,24000,0,0,0,0,0,0,0,9222,2111,7111,0,6368,2376,3992,0,1000,0,1000,0,3070,2070,1000
16362,230000,184000,0,0,0,0,0,0,0,76049,7100,68949,0,68989,0,68989,2,54450,2700,51750,0,39862,2000,37862
16363,20000,16000,0,0,0,0,0,0,0,0,0,0,0,0,0,0,-2,0,0,0,-2,0,0,0
16364,50000,40000,0,0,0,0,0,0,3,5187,0,5187,2,4643,1022,3621,0,3385,237,3148,0,1839,100,1739
16365,20000,16000,0,1,1,1,1,0,0,17857,1687,16170,0,18310,1140,17170,0,18000,1800,16200,0,17294,1000,16294
16366,360000,288000,0,0,0,0,0,0,-2,0,0,0,-2,0,0,0,-2,0,0,0,-2,0,0,0
16367,210000,168000,0,0,0,0,0,0,-1,24680,24000,680,0,41291,22000,19291,0,10623,20000,-9377,-1,10765,5000,5765
16368,50000,40000,0,1,1,0,0,0,0,49293,2194,47099,0,41941,1842,40099,0,39643,1544,38099,0,39273,1396,37877
16369,20000,16000,0,1,1,1,1,1,2,20498,1600,18898,0,19898,0,19898,0,19906,398,19508,0,18586,0,18586
16370,180000,144000,0,0,0,0,0,0,-1,291,291,0,-1,570,570,0,-1,2260,2260,0,-1,1583,1583,0
16371,300000,240000,0,0,0,0,0,0,-1,5273,5273,0,-1,4345,4598,-253,-1,1106,0,1106,0,1322,2620,-1298
16372,30000,24000,0,1,1,1,1,0,0,28838,1749,27089,0,28085,1200,26885,0,28428,1100,27328,0,29430,1465,27965
16373,50000,40000,0,0,0,0,0,0,0,7000,1000,6000,0,0,0,0,0,0,0,0,-2,0,0,0
16374,150000,120000,0,0,0,0,0,0,-2,0,0,0,-2,0,0,0,-2,268,268,0,-1,118,0,118
16375,20000,16000,0,1,1,1,1,0,0,19382,1571,17811,0,18440,629,17811,0,18826,652,18174,0,17311,618,16693
16376,80000,64000,0,1,0,0,0,0,0,80725,4000,76725,0,50472,1889,48583,0,50340,2000,48340,0,42393,7700,34693
16377,200000,160000,0,0,0,0,0,0,0,111522,6000,105522,0,114171,6000,108171,0,115777,5000,110777,0,118749,5000,113749
16378,80000,64000,0,0,0,0,0,0,0,48428,5000,43428,0,52391,5000,47391,0,23359,3000,20359,0,24597,2000,22597
16379,210000,168000,0,0,0,0,0,0,2,117783,0,117783,2,120126,4302,115824,0,122643,4455,118188,0,125123,4523,120600
16380,500000,400000,0,0,0,0,0,0,-1,6390,1228,5162,0,5477,1000,4477,0,1060,1060,0,0,23726,23726,0
16381,210000,168000,0,0,0,0,0,0,-2,0,0,0,-2,0,0,0,-2,0,0,0,-2,0,0,0
16382,150000,120000,0,0,0,0,0,0,0,125470,6000,119470,0,119007,4055,114952,0,101928,13980,87948,0,103989,4000,99989
16383,140000,112000,0,1,1,0,0,0,0,130095,18000,112095,0,122342,10000,112342,0,77536,10000,67536,0,80783,20000,60783
16384,500000,400000,0,0,0,0,0,0,0,14539,10043,4496,0,13291,6065,7226,0,3645,3648,-3,-1,4763,2003,2760
16385,190000,152000,0,0,0,0,0,1,-2,-472,0,-472,-2,-472,0,-472,-2,-472,0,-472,-2,-472,0,-472
16386,260000,208000,0,0,0,0,0,0,0,189510,7054,182456,0,178738,6500,172238,0,182973,7000,175973,0,187233,7001,180232
16387,50000,40000,0,0,0,0,0,0,0,15464,1195,14269,0,15701,432,15269,0,12192,443,11749,0,12515,526,11989
16388,280000,224000,0,0,0,0,0,0,-1,2550,2550,0,-1,349,349,0,-1,1148,1148,0,-1,785,785,0
16389,240000,192000,0,0,0,0,0,0,-1,643,646,-3,-1,11455,11478,-23,-1,1326,1329,-3,-1,663,3,660
16390,290000,232000,0,0,0,0,0,1,-1,728,730,-2,-1,-2,0,-2,-1,-2,0,-2,-2,-2,0,-2
16391,20000,16000,0,0,0,0,1,0,0,14071,2000,12071,0,15512,2000,13512,0,17081,2000,15081,0,21108,5016,16092
16392,60000,48000,0,0,0,0,0,0,0,17074,1500,15574,0,17684,1291,16393,0,20003,3000,17003,0,21040,2000,19040
16393,360000,288000,0,1,1,1,1,0,0,348485,20013,328472,0,346028,20018,326010,0,338981,15000,323981,0,348032,20000,328032
16394,140000,112000,0,0,0,0,0,0,-1,17378,1220,16158,0,12568,3000,9568,0,15678,3500,12178,0,15620,332,15288
16395,150000,120000,0,0,0,0,0,0,0,56091,4002,52089,0,58919,5000,53919,0,60363,1925,58438,0,40448,5316,35132
16396,50000,40000,0,0,0,0,0,1,0,17422,1702,15720,0,17273,1500,15773,0,18827,2004,16823,0,16996,16,16980
16397,320000,256000,0,0,0,0,0,0,0,19829,1300,18529,0,17692,1600,16092,0,15648,2500,13148,0,15255,0,15255
16398,180000,144000,0,0,0,0,0,1,2,78181,3000,75181,2,82645,5700,76945,2,84739,3500,81239,2,83282,0,83282
16399,500000,400000,0,0,0,0,0,0,-2,17840,17840,0,-2,11303,11642,-339,-2,6943,6943,0,-2,16409,16409,0
16400,80000,64000,0,1,1,1,1,0,0,75285,3300,71985,0,73654,3000,70654,0,75642,3500,72142,0,80984,9050,71934
16401,120000,96000,0,0,0,0,0,0,0,83808,3061,80747,0,85414,3019,82395,0,84569,2987,81582,0,85771,3174,82597
16402,20000,16000,0,0,0,0,0,0,-2,390,390,0,-2,390,390,0,-2,1487,1487,0,-1,3560,3560,0
16403,50000,40000,0,0,0,0,0,0,0,34713,2109,32604,0,19474,1576,17898,0,19508,1000,18508,0,19837,2000,17837
16404,60000,48000,0,0,1,0,0,0,0,58604,31404,27200,0,59427,3000,56427,0,38472,2000,36472,0,39528,2000,37528
16405,200000,160000,0,0,0,0,0,1,-1,770,770,0,-1,2108,2118,-10,-1,0,0,0,-1,0,0,0
16406,360000,288000,0,0,0,0,0,0,-1,17165,10035,7130,0,10000,10000,0,-1,10000,10000,0,-1,10000,10000,0
16407,230000,184000,0,0,0,0,0,0,0,41354,2000,39354,0,42368,2000,40368,0,43161,1800,41361,0,45056,2600,42456
16408,250000,200000,0,0,0,0,0,0,0,44167,20087,24080,0,19806,5093,14713,0,22231,10000,12231,0,6852,6876,-24
16409,220000,176000,0,0,0,0,0,0,0,25463,4000,21463,0,28036,3000,25036,0,34552,7000,27552,0,43827,11000,32827
16410,80000,64000,0,1,1,0,0,1,0,81767,5009,76758,0,78340,5000,73340,0,36895,2000,34895,0,39079,4000,35079
16411,140000,112000,0,0,0,0,0,0,-1,1686,1686,0,-1,1686,0,1686,0,205,205,0,-1,6689,6689,0
16412,60000,48000,0,0,0,0,0,0,0,49580,1940,47640,0,38140,1477,36663,0,29843,1025,28818,0,27719,1006,26713
16413,360000,288000,0,0,0,0,0,0,-2,4024,4044,-20,-2,6643,6715,-72,-2,1947,1956,-9,-2,2066,2076,-10
16414,200000,160000,0,0,0,0,0,1,2,0,0,0,2,0,0,0,-2,0,0,0,-2,0,0,0
16415,390000,312000,0,0,0,0,0,0,0,205228,6093,199135,0,185134,5411,179723,0,181949,6025,175924,0,136559,5000,131559
16416,60000,48000,0,0,0,0,0,0,0,40855,2000,38855,0,37742,2000,35742,0,29450,1400,28050,0,8850,200,8650
16417,100000,80000,0,0,0,0,0,0,0,82466,3000,79466,0,78234,2805,75429,0,75615,2739,72876,0,76849,3085,73764
16418,300000,240000,0,0,0,0,0,0,-2,4019,4019,0,-2,4509,3860,649,-2,7155,5000,2155,-1,5778,5778,0
16419,70000,56000,0,0,0,0,0,0,0,42859,5000,37859,0,0,0,0,0,0,0,0,-2,2254,2254,0
16420,320000,256000,0,0,0,0,0,0,-2,0,0,0,-2,2000,2000,0,-2,700,700,0,-2,760,760,0
16421,100000,80000,0,0,0,0,0,0,0,34300,1600,32700,0,35623,1901,33722,0,35515,1275,34240,0,36413,1470,34943
16422,130000,104000,0,0,0,0,0,0,0,7609,7609,0,-1,8217,2500,5717,0,9741,1600,8141,0,8308,510,7798
16423,50000,40000,0,0,0,0,0,1,3,26976,1200,25776,2,27206,968,26238,2,26631,0,26631,2,27185,998,26187
16424,270000,216000,0,0,0,0,0,0,0,89221,3207,86014,0,86996,3000,83996,0,86384,3200,83184,0,85440,3241,82199
16425,190000,152000,0,0,0,0,0,0,-2,3200,3208,-8,-2,15010,15010,0,-2,4575,4575,0,-2,7279,7279,0
16426,220000,176000,0,0,0,0,0,0,-2,-1,0,-1,-2,300,301,-1,-2,90,90,0,-2,2194,2204,-10
16427,200000,160000,0,0,0,0,0,0,-1,10634,10641,-7,-1,10982,2011,8971,0,1966,9,1957,0,4883,4890,-7
16428,30000,24000,1,1,1,1,1,0,3,34637,2000,32637,2,34127,2000,32127,2,31641,0,31641,3,31344,2000,29344
16429,20000,16000,0,0,0,0,0,1,-1,390,0,390,2,780,780,0,-1,780,0,780,0,0,0,0
16430,210000,168000,0,0,0,0,0,0,-1,6355,6359,-4,-1,18543,18543,0,-1,6022,6022,0,-1,1334,1334,0
16431,300000,240000,0,0,0,0,0,0,0,148925,6825,142100,0,0,0,0,0,0,0,0,-2,0,0,0
16432,30000,24000,0,0,0,0,0,1,0,21293,1400,19893,0,22040,1100,20940,0,22786,1100,21686,0,23410,1003,22407
16433,50000,40000,0,0,0,0,0,0,0,36120,1601,34519,0,36991,1472,35519,0,37744,1500,36244,0,39115,2000,37115
16434,210000,168000,0,0,0,0,0,1,0,94692,3900,90792,0,70484,2868,67616,0,36308,3000,33308,0,33201,2000,31201
16435,390000,312000,0,0,0,0,0,0,0,189792,9000,180792,0,109806,5000,104806,0,69845,2815,67030,0,48101,2111,45990
16436,60000,48000,0,0,0,0,0,0,0,40056,1502,38554,0,39996,1287,38709,0,40261,1322,38939,0,32644,1179,31465
16437,50000,40000,0,1,0,0,0,0,0,49988,1305,48683,0,19287,1000,18287,0,19698,855,18843,0,20228,1000,19228
16438,410000,328000,0,0,0,0,0,0,-2,2300,2300,0,-2,0,0,0,-2,150,150,0,-2,150,150,0
16439,330000,264000,0,0,0,0,0,0,0,14949,5001,9948,0,34292,22000,12292,0,8832,1000,7832,0,11304,11304,0
16440,50000,40000,0,0,0,0,0,0,-1,2050,1050,1000,0,3000,1000,2000,0,0,0,0,0,0,1000,-1000
16441,250000,200000,0,0,0,0,0,0,-2,0,0,0,-2,0,0,0,-2,3394,3394,0,-1,3244,0,3244
16442,130000,104000,0,0,0,0,0,1,2,20832,0,20832,3,21386,1200,20186,2,22227,1200,21027,0,23466,1600,21866
16443,20000,16000,0,1,1,1,1,1,2,19743,0,19743,3,19128,0,19128,2,20560,1744,18816,2,20082,0,20082
16444,170000,136000,0,0,0,0,0,0,0,115762,4002,111760,0,101581,4006,97575,0,100182,3412,96770,0,99565,3486,96079
16445,200000,160000,0,1,1,1,1,1,0,203794,8679,195115,0,189024,6300,182724,0,191803,6000,185803,0,195044,6000,189044
16446,360000,288000,0,0,0,0,0,0,-2,0,0,0,-2,0,0,0,-2,0,0,0,-2,0,0,0
16447,180000,144000,0,0,0,0,0,0,-1,394,0,394,2,904,900,4,0,2514,2000,514,0,4054,4000,54
16448,50000,40000,0,0,0,0,0,0,0,19334,1200,18134,0,18165,13000,5165,0,19322,1500,17822,0,19575,9000,10575
16449,350000,280000,0,0,0,0,0,0,-1,36582,36607,-25,-1,8197,8243,-46,-1,14494,14494,0,-1,54284,54284,0
16450,50000,40000,0,0,0,0,0,0,0,15554,1021,14533,0,8704,200,8504,0,8904,200,8704,0,4687,100,4587
16451,110000,88000,0,0,0,0,0,0,0,22397,2397,20000,0,23305,1305,22000,0,25341,2341,23000,0,30584,5584,25000
16452,20000,16000,0,0,0,0,0,1,0,7458,2000,5458,0,7192,0,7192,2,7923,1000,6923,2,7647,0,7647
16453,100000,80000,0,0,0,0,0,0,0,16045,2000,14045,2,16508,1000,15508,2,15969,0,15969,2,17733,2000,15733
16454,210000,168000,0,0,0,0,0,0,2,0,0,0,2,6299,6299,0,-1,0,0,0,-1,197,197,0
16455,200000,160000,0,0,0,0,0,1,2,123,123,0,-1,200,200,0,-1,123,123,0,-1,280,280,0
16456,30000,24000,0,0,1,1,1,0,0,24864,1415,23449,0,25360,911,24449,0,26999,2051,24948,0,26414,0,26414
16457,100000,80000,0,0,0,0,0,0,2,7042,5000,2042,2,780,0,780,2,390,0,390,0,390,390,0
16458,10000,8000,0,0,0,0,0,1,-1,381,381,0,-1,2977,2986,-9,-1,1000,1203,-203,-1,0,0,0
16459,327680,262144,0,1,1,0,0,1,0,333048,11461,321587,0,277250,9100,268150,0,256365,8345,248020,0,243600,7783,235817
16460,200000,160000,0,0,0,0,0,0,0,42798,2355,40443,0,42142,1550,40592,0,37580,1000,36580,0,4831,500,4331
16461,10000,8000,0,0,0,0,0,1,2,6199,1500,4699,2,5951,0,5951,2,6255,400,5855,0,6401,400,6001
16462,130000,104000,0,0,0,0,0,1,-2,-52,0,-52,-2,-52,0,-52,-2,-52,0,-52,-2,-52,0,-52
16463,20000,16000,0,0,1,1,1,0,0,19970,21490,-1520,-1,19580,600,18980,0,20180,600,19580,0,20000,600,19400
16464,80000,64000,0,0,0,0,0,0,-1,3277,3279,-2,-1,3319,3319,0,-1,1150,1150,0,-1,1150,1150,0
16465,50000,40000,0,1,0,0,0,0,2,50753,2374,48379,0,0,0,0,0,0,0,0,-2,0,0,0
16466,500000,400000,0,0,0,0,0,0,0,137549,4500,133049,0,130893,4500,126393,0,108030,5000,103030,0,144938,50000,94938
16467,20000,16000,0,0,0,0,0,1,-1,199,0,199,2,2780,2780,0,-1,0,0,0,-1,0,0,0
16468,260000,208000,0,0,0,0,0,0,0,108223,5500,102723,0,108860,5000,103860,0,80757,3500,77257,0,79073,3000,76073
16469,210000,168000,0,0,0,0,0,0,-1,19875,19875,0,-1,57751,50000,7751,0,25456,15456,10000,0,10625,10625,0
16470,80000,64000,0,0,1,1,0,0,0,66736,10000,56736,0,74626,10104,64522,0,74092,5000,69092,0,59274,5000,54274
16471,80000,64000,0,0,0,0,0,0,2,55081,0,55081,2,55350,2200,53150,0,55906,2028,53878,0,57538,3000,54538
16472,150000,120000,0,0,0,0,0,0,0,200,200,0,-1,51099,52399,-1300,-1,24487,5063,19424,0,17624,1500,16124
16473,80000,64000,0,0,0,0,0,0,0,47411,1800,45611,0,48443,1700,46743,0,49478,1700,47778,0,43264,1700,41564
16474,90000,72000,0,0,0,0,0,1,0,7884,1061,6823,0,0,0,0,0,0,0,0,-2,0,0,0
16475,30000,24000,0,1,1,1,1,0,0,29037,1427,27610,0,29667,1291,28376,0,29669,1029,28640,0,29995,1229,28766
16476,130000,104000,0,0,0,0,0,0,2,39828,1960,37868,0,40468,1600,38868,0,41315,1650,39665,0,42133,1655,40478
16477,350000,280000,0,0,0,0,0,0,0,16801,2000,14801,0,15238,1500,13738,0,10267,1000,9267,0,9578,1500,8078
16478,340000,272000,0,0,0,0,0,0,0,219702,9222,210480,0,132852,5000,127852,0,124168,4500,119668,0,119568,4500,115068
16479,30000,24000,0,1,1,1,1,0,0,30629,1800,28829,0,29357,1045,28312,0,30143,1250,28893,0,30419,1100,29319
16480,20000,16000,0,0,0,0,0,0,0,14900,1249,13651,0,15916,1265,14651,0,15519,0,15519,2,15829,568,15261
16481,300000,240000,0,0,0,0,0,1,-2,13001,13001,0,-1,12601,0,12601,0,19595,19595,0,-1,203,203,0
16482,80000,64000,0,1,1,1,1,0,0,75039,3500,71539,0,76597,3400,73197,0,78712,4000,74712,0,81365,4000,77365
16483,50000,40000,0,0,0,0,0,0,0,12027,1496,10531,0,12109,578,11531,0,12360,594,11766,0,12602,596,12006
16484,30000,24000,0,0,0,0,0,0,-1,0,0,0,-1,1170,1170,0,-1,780,0,780,0,0,0,0
16485,150000,120000,0,0,0,0,0,0,0,99933,4959,94974,0,102278,5000,97278,0,104710,2790,101920,0,107148,5083,102065
16486,70000,56000,0,0,0,0,0,0,0,24843,1388,23455,0,25338,883,24455,0,25461,906,24555,0,26008,952,25056
16487,140000,112000,0,0,0,0,0,0,0,60992,2300,58692,0,62253,2278,59975,0,69594,9300,60294,0,68262,0,68262
16488,330000,264000,0,0,0,0,0,0,2,66545,2400,64145,2,64877,0,64877,2,66398,2600,63798,0,72113,8758,63355
16489,50000,40000,0,0,1,1,0,0,2,48256,13500,34756,2,47098,0,47098,2,46898,0,46898,0,150,0,150
16490,420000,336000,0,0,0,0,0,0,0,132536,12536,120000,0,131704,11704,120000,0,331059,212059,119000,0,328958,12958,316000
16491,200000,160000,0,1,0,0,0,0,0,201917,8016,193901,0,161221,5000,156221,0,162438,12000,150438,0,157415,6000,151415
16492,100000,80000,0,0,0,0,0,1,2,39750,3500,36250,2,40298,1500,38798,2,40835,1500,39335,2,41529,1500,40029
16493,30000,24000,0,0,0,0,0,0,0,13324,2328,10996,0,5427,1435,3992,0,4521,90,4431,0,0,0,0
16494,110000,88000,0,0,0,0,0,0,0,71730,3200,68530,0,73208,2600,70608,0,75095,3000,72095,0,72530,3100,69430
16495,120000,96000,0,0,0,0,0,1,0,15748,1500,14248,0,15480,2000,13480,0,998,998,0,-1,980,980,0
16496,160000,128000,0,0,0,0,0,1,0,69908,4000,65908,0,78087,10000,68087,0,75255,0,75255,2,78593,5000,73593
16497,360000,288000,0,0,0,0,0,0,-1,416,418,-2,-1,190,190,0,-1,190,0,190,0,66,66,0
16498,430000,344000,0,0,0,0,0,0,-2,95740,145740,-50000,-1,77875,7,77868,2,62675,2500,60175,0,48764,2021,46743
16499,360000,288000,0,0,0,0,0,0,-1,173,173,0,-1,1640,1640,0,-1,287,287,0,-1,2418,2426,-8
16500,50000,40000,0,0,0,0,0,0,0,13125,1300,11825,0,14104,1200,12904,0,13735,0,13735,2,14307,800,13507
16501,310000,248000,0,0,0,0,0,0,0,21033,21033,0,-1,19033,1000,18033,0,9588,192,9396,0,5222,104,5118
16502,360000,288000,0,0,0,0,0,0,-1,4040,4064,-24,-1,151858,152618,-760,-1,48580,48822,-242,-1,1451,1451,0
16503,30000,24000,0,1,1,0,0,1,0,29659,3016,26643,0,29274,1730,27544,2,18770,16,18754,2,13960,1001,12959
16504,110000,88000,0,0,0,0,0,0,0,0,0,0,0,0,0,0,-2,0,0,0,-2,0,0,0
16505,150000,120000,0,0,0,0,0,0,0,82490,5000,77490,0,78890,4000,74890,0,75240,3500,71740,0,75639,3000,72639
16506,20000,16000,0,0,0,1,0,0,2,9984,5000,4984,0,19089,10089,9000,0,18356,0,18356,2,17203,2000,15203
16507,130000,104000,0,0,0,0,0,0,0,100513,2502,98011,0,35288,1512,33776,0,34359,1612,32747,0,33488,2000,31488
16508,500000,400000,0,0,0,0,0,0,-2,26089,27243,-1154,-1,13333,1000,12333,0,13256,13256,0,-1,106200,106354,-154
16509,130000,104000,0,1,0,0,0,0,0,115633,5659,109974,0,96898,4680,92218,0,46425,2325,44100,0,0,0,0
16510,150000,120000,0,0,0,0,0,0,-1,-13,0,-13,-1,4085,4098,-13,-1,4006,4006,0,-1,826,826,0
16511,250000,200000,0,0,0,0,0,0,0,83952,5000,78952,0,87147,5000,82147,0,91191,5000,86191,0,94220,4000,90220
16512,500000,400000,0,0,0,0,0,0,-2,11579,11888,-309,-2,68712,88612,-19900,-2,26476,26476,0,-2,8974,8974,0
16513,250000,200000,0,0,0,0,0,0,-1,4614,4614,0,-1,28790,28796,-6,-1,4418,4418,0,-1,10676,10676,0
16514,10000,8000,0,0,1,1,1,1,2,8226,1122,7104,0,9834,1730,8104,0,9549,0,9549,2,9774,508,9266
16515,10000,8000,0,1,0,1,1,1,2,8403,0,8403,2,9505,1735,7770,2,8889,0,8889,2,10263,2000,8263
16516,50000,40000,0,1,0,0,0,0,2,46043,2000,44043,0,18759,655,18104,0,19161,688,18473,0,19516,666,18850
16517,500000,400000,0,0,0,0,0,0,-2,4199,4199,0,-2,7507,7507,0,-2,4696,4696,0,-2,58292,58292,0
16518,30000,24000,0,0,0,0,0,0,2,6242,6245,-3,-1,4789,3,4786,2,3597,6,3591,2,21234,30006,-8772
16519,30000,24000,0,1,1,1,0,0,0,28792,1599,27193,0,29121,928,28193,0,29368,600,28768,0,13174,627,12547
16520,100000,80000,0,1,1,0,1,1,4,83318,3100,80218,3,81380,0,81380,2,83710,3800,79910,2,88057,5900,82157
16521,210000,168000,0,0,0,0,0,0,0,150349,7000,143349,0,147788,6693,141095,0,145958,5307,140651,0,145667,5441,140226
16522,60000,48000,0,0,0,0,0,0,0,18190,2000,16190,0,27465,10000,17465,0,27643,991,26652,0,27816,1010,26806
16523,60000,48000,0,0,0,0,0,0,2,47551,2400,45151,0,36795,2100,34695,0,30596,1300,29296,0,28354,1300,27054
16524,460000,368000,0,0,0,0,0,0,-1,4856,4872,-16,-1,6696,6696,0,-1,1327,1327,0,-1,0,0,0
16525,80000,64000,1,1,1,0,0,1,2,85266,3448,81818,0,85871,2383,83488,0,47367,1609,45758,0,47812,2000,45812
16526,500000,400000,0,0,0,0,0,0,-1,60560,70160,-9600,-1,104734,104734,0,-1,41018,41018,0,-1,6258,6258,0
16527,130000,104000,0,0,0,0,0,1,0,81929,4000,77929,0,41671,3000,38671,0,42034,2500,39534,0,32219,1500,30719
16528,100000,80000,0,0,0,0,0,0,0,65480,4000,61480,0,66777,2387,64390,0,68176,2472,65704,0,69547,2502,67045
16529,30000,24000,0,1,1,1,1,0,0,29022,2000,27022,0,29201,1033,28168,0,29553,1200,28353,0,29693,1055,28638
16530,20000,16000,0,0,0,0,0,1,0,0,50000,-50000,-2,0,0,0,-2,0,1300,-1300,-2,0,0,0
16531,80000,64000,0,0,0,0,0,1,-2,390,390,0,-2,390,390,0,-2,390,390,0,-2,540,540,0
16532,30000,24000,0,0,0,0,0,1,2,16546,2300,14246,2,15985,0,15985,2,17869,2300,15569,2,17291,0,17291
16533,200000,160000,0,0,0,0,0,0,-1,2785,2798,-13,-1,54271,54271,0,-1,60326,7000,53326,0,63339,4000,59339
16534,230000,184000,0,0,0,0,0,0,-1,8879,8879,0,-1,8034,1100,6934,0,8585,1000,7585,0,7708,1000,6708
16535,20000,16000,0,1,1,1,1,1,2,20542,660,19882,2,19572,0,19572,2,20437,1538,18899,2,19994,0,19994
16536,380000,304000,0,0,0,0,0,0,0,102551,5000,97551,0,101323,5000,96323,0,84087,5000,79087,0,86661,5000,81661
16537,270000,216000,0,0,0,0,0,0,-1,1307,2500,-1193,-1,800,0,800,0,4098,4100,-2,-1,1181,1200,-19
16538,260000,208000,0,0,0,0,0,0,0,174268,7691,166577,0,181592,12831,168761,0,174184,6015,168169,0,153907,6410,147497
16539,410000,328000,0,0,0,0,0,1,2,176857,2,176855,2,175193,5561,169632,0,165929,5432,160497,0,114527,4546,109981
16540,340000,272000,0,0,0,0,0,0,-2,-2,0,-2,-2,498,500,-2,-2,11466,11523,-57,-2,412,414,-2
16541,80000,64000,0,0,0,0,0,0,0,35641,2000,33641,0,36742,2000,34742,0,38127,2000,36127,0,39509,2000,37509
16542,160000,128000,0,0,0,0,0,1,-2,390,780,-390,-2,390,390,0,-2,390,390,0,-2,390,390,0
16543,500000,400000,0,0,0,0,0,1,-2,0,0,0,-2,0,0,0,-2,0,0,0,-2,0,0,0
16544,120000,96000,0,0,0,0,0,0,-2,0,0,0,-2,0,0,0,-2,0,0,0,-2,10614,10614,0
16545,230000,184000,0,1,1,1,1,0,0,201358,7200,194158,2,204067,7500,196567,2,200720,0,200720,2,212403,15079,197324
16546,440000,352000,0,0,0,0,0,0,0,78267,3017,75250,0,71795,2037,69758,0,51812,2019,49793,0,25064,3010,22054
16547,240000,192000,0,0,0,0,0,0,-2,0,0,0,-2,0,0,0,-2,0,0,0,-2,0,0,0
16548,170000,136000,0,0,0,0,0,0,0,99487,5000,94487,0,49017,3000,46017,0,48812,3000,45812,0,0,0,0
16549,70000,56000,0,0,0,0,0,0,0,55362,2010,53352,0,39615,1500,38115,0,40477,1500,38977,0,43295,3500,39795
16550,80000,64000,0,0,1,0,0,0,0,78589,50000,28589,0,78806,3034,75772,0,50663,1800,48863,0,50214,1817,48397
16551,210000,168000,0,0,1,1,0,0,-2,199672,199872,-200,-1,199272,0,199272,0,199272,0,199272,0,0,0,0
16552,180000,144000,0,0,0,0,0,0,0,115839,121,115718,2,105643,10000,95643,0,119358,20000,99358,0,116097,25000,91097
16553,80000,64000,0,1,0,0,0,0,0,69485,2507,66978,0,30396,2140,28256,0,30595,2000,28595,0,29033,1500,27533
16554,20000,16000,0,0,0,0,0,0,0,12102,2795,9307,0,1473,1473,0,-1,18177,18177,0,-1,18046,2046,16000
16555,280000,224000,0,0,0,1,0,0,0,196479,7221,189258,0,196034,7091,188943,0,378323,8013,370310,0,192115,14923,177192
16556,130000,104000,0,0,0,0,0,0,0,51457,0,51457,2,60045,10000,50045,0,47696,10000,37696,0,43677,10000,33677
16557,30000,24000,0,0,0,0,1,0,0,28844,25885,2959,0,25317,1500,23817,0,25885,2170,23715,0,25165,1000,24165
16558,130000,104000,0,0,0,0,1,0,-1,93696,79000,14696,0,79187,3382,75805,0,116374,103001,13373,0,120793,6000,114793
16559,20000,16000,0,0,0,0,0,1,2,8147,1000,7147,0,7247,1300,5947,0,4617,1500,3117,0,0,1680,-1680
16560,360000,288000,0,0,0,0,0,0,-1,923,927,-4,-1,12886,12950,-64,-1,489,491,-2,-1,172,173,-1
16561,30000,24000,0,0,0,0,0,1,2,16762,1000,15762,2,17182,1000,16182,2,17760,1000,16760,2,17327,0,17327
16562,240000,192000,0,0,0,0,0,0,-1,4879,4879,0,-1,11650,11650,0,-1,12614,12614,0,-1,7922,7922,0
16563,20000,16000,0,0,0,0,0,0,0,7853,1288,6565,0,8565,1000,7565,0,9565,1000,8565,0,12065,2500,9565
16564,150000,120000,0,0,0,0,0,0,-2,0,0,0,-2,3180,3180,0,-2,0,0,0,-2,13649,13649,0
16565,210000,168000,0,0,0,0,0,1,2,129104,4000,125104,2,125887,0,125887,2,112439,4000,108439,0,104537,3850,100687
16566,500000,400000,0,0,0,0,0,0,-1,51322,51322,0,-1,12150,12176,-26,-1,12463,12463,0,-1,11872,11872,0
16567,100000,80000,0,0,0,0,0,1,2,35847,0,35847,2,37939,3500,34439,2,38619,1600,37019,2,37868,0,37868
16568,340000,272000,0,0,0,0,0,0,-1,2774,2774,0,-1,43824,43831,-7,-1,11308,11308,0,-1,3540,0,3540
16569,20000,16000,0,1,1,1,1,1,0,19722,0,19722,2,19616,830,18786,0,19228,750,18478,0,19878,1000,18878
16570,80000,64000,0,1,1,1,1,0,3,74847,0,74847,2,79620,6000,73620,2,78257,0,78257,2,79953,3200,76753
16571,50000,40000,0,0,0,0,0,0,0,10339,1500,8839,0,10766,600,10166,0,10945,500,10445,0,11214,600,10614
16572,70000,56000,0,0,0,0,0,1,2,29659,0,29659,2,31767,2600,29167,2,31124,0,31124,2,35511,5100,30411
16573,210000,168000,0,0,0,0,0,0,0,5259,2000,3259,0,-243,0,-243,0,-243,0,-243,-2,-243,0,-243
16574,180000,144000,0,0,0,0,0,1,-1,740,740,0,-1,0,0,0,-1,0,0,0,-2,0,0,0
16575,50000,40000,0,0,0,0,0,0,-2,0,0,0,-2,780,780,0,-2,0,0,0,-2,0,0,0
16576,300000,240000,0,0,1,0,0,1,0,306116,80006,226110,0,291201,10523,280678,0,241557,8565,232992,0,193103,8700,184403
16577,20000,16000,0,0,0,0,0,0,2,780,780,0,-1,0,0,0,-1,390,2000,-1610,-2,390,1170,-780
16578,50000,40000,0,1,1,0,0,0,0,48954,1948,47006,0,46716,1835,44881,0,18685,669,18016,0,19076,692,18384
16579,140000,112000,0,0,0,0,0,1,0,0,0,0,0,0,0,0,-2,0,0,0,-2,0,0,0
16580,260000,208000,0,0,0,0,0,0,-1,28669,28811,-142,-1,1207,1313,-106,-1,2654,2667,-13,-1,1441,1447,-6
16581,320000,256000,0,0,0,0,0,0,0,108924,8000,100924,0,109710,4000,105710,0,116813,9000,107813,0,118984,4000,114984
16582,80000,64000,0,0,0,0,0,0,0,14286,5000,9286,0,1554,1554,0,-1,6554,5000,1554,0,2615,2615,0
16583,100000,80000,0,1,1,0,0,1,0,93566,4098,89468,0,90339,4213,86126,0,66222,3106,63116,0,66871,4000,62871
16584,170000,136000,0,0,0,0,0,0,0,50068,2000,48068,0,56691,7500,49191,0,57367,2200,55167,2,56322,0,56322
16585,310000,248000,0,0,0,0,0,0,-1,0,0,0,-1,0,0,0,-2,0,0,0,-2,0,0,0
16586,200000,160000,0,0,0,0,0,0,-2,3009,3009,0,-2,20311,26257,-5946,-2,15643,15643,0,-2,5696,5696,0
16587,30000,24000,0,1,1,1,1,0,0,31037,2559,28478,2,30908,800,30108,2,29969,600,29369,2,29488,1000,28488
16588,240000,192000,0,0,0,0,0,0,0,61710,3354,58356,0,50106,1800,48306,0,18874,1000,17874,0,18994,1200,17794
16589,200000,160000,0,0,0,0,0,0,0,155170,7200,147970,0,159089,8000,151089,0,160950,6000,154950,0,164691,6500,158191
16590,20000,16000,0,1,1,0,0,1,0,19672,1630,18042,0,19652,1000,18652,0,780,0,780,0,0,0,0
16591,50000,40000,0,0,0,0,0,1,0,27086,761,26325,2,28525,2200,26325,0,30895,2862,28033,0,33003,2770,30233
16592,170000,136000,0,1,1,1,1,0,2,165156,13000,152156,2,161137,0,161137,2,164501,6000,158501,0,166064,12400,153664
16593,130000,104000,0,0,0,0,0,1,0,6230,1400,4830,0,0,0,0,0,0,0,0,-2,0,0,0
16594,50000,40000,0,1,0,0,0,1,2,49987,2600,47387,0,19663,650,19013,0,16769,752,16017,0,16550,596,15954
16595,20000,16000,0,1,1,1,1,1,2,18680,1307,17373,0,19788,1580,18208,0,22265,3100,19165,2,21629,0,21629
16596,120000,96000,0,0,0,0,0,1,2,0,0,0,2,0,0,0,-2,0,0,0,-2,0,0,0
16597,220000,176000,0,0,0,0,0,0,0,135509,4920,130589,0,139774,6520,133254,0,141099,5120,135979,0,155763,17001,138762
16598,500000,400000,0,0,0,0,0,0,-2,4524,4524,0,-2,3518,3518,0,-2,2208,2208,0,-2,2550,2550,0
16599,240000,192000,0,0,0,0,0,0,0,27627,3000,24627,0,161492,135050,26442,0,128496,5000,123496,0,197209,80000,117209
16600,300000,240000,0,0,0,0,0,0,0,16212,3000,13212,0,11304,0,11304,0,11396,5000,6396,0,6138,6202,-64
16601,80000,64000,0,0,0,0,0,0,0,0,0,0,0,0,0,0,-2,1715,1715,0,-1,0,0,0
16602,310000,248000,0,0,0,1,1,0,0,250277,10000,240277,0,265764,20000,245764,0,271231,10000,261231,0,277427,11000,266427
16603,30000,24000,0,0,0,0,0,0,0,7024,7024,0,0,7024,7024,0,-2,7024,7024,0,-2,7024,7024,0
16604,80000,64000,0,0,0,0,0,0,0,18209,8807,9402,0,5471,5500,-29,-1,6896,4000,2896,0,9506,3500,6006
16605,50000,40000,0,0,0,0,0,1,2,28317,2062,26255,2,28568,969,27599,2,27302,700,26602,2,28171,1500,26671
16606,120000,96000,0,0,0,0,0,0,0,24372,1000,23372,2,24670,1000,23670,0,25617,1500,24117,0,26535,1500,25035
16607,130000,104000,0,0,0,0,0,1,0,106971,4500,102471,0,57434,2802,54632,0,58593,2050,56543,0,60504,2800,57704
16608,170000,136000,0,0,0,0,0,0,0,28461,2000,26461,0,13263,1000,12263,0,3637,1000,2637,0,4814,2000,2814
16609,310000,248000,0,0,0,0,0,0,0,117674,6000,111674,0,108103,3272,104831,0,114721,15874,98847,0,105624,4182,101442
16610,360000,288000,0,0,0,0,0,0,-1,10600,10646,-46,-1,51571,51571,0,-1,28310,0,28310,0,14482,14482,0
16611,210000,168000,0,0,0,0,0,0,-2,1772,2631,-859,-2,7293,8132,-839,-1,1508,1563,-55,-1,2498,2506,-8
16612,300000,240000,0,0,0,0,0,0,-1,1496,1500,-4,-1,1496,1500,-4,-1,2490,2494,-4,-1,1996,1006,990
16613,380000,304000,0,0,0,0,0,0,0,152869,25390,127479,0,137442,10000,127442,0,82800,20000,62800,0,42083,1659,40424
16614,210000,168000,0,0,0,0,0,0,-2,517,517,0,-1,-1,0,-1,-1,932,933,-1,-1,1066,1066,0
16615,110000,88000,0,0,0,0,0,0,0,48917,3000,45917,0,46765,2000,44765,0,40212,3000,37212,0,39690,5000,34690
16616,50000,40000,0,1,0,0,0,1,0,48264,2500,45764,0,27806,2000,25806,0,24901,2000,22901,0,25441,941,24500
16617,180000,144000,0,1,1,1,1,0,0,160707,8000,152707,0,162477,6000,156477,0,166861,7000,159861,0,171083,7000,164083
16618,20000,16000,0,0,0,0,0,1,2,5441,0,5441,2,6346,1000,5346,2,6099,0,6099,2,7235,1237,5998
16619,280000,224000,0,0,0,0,0,0,-2,3288,3288,0,-1,0,0,0,-1,0,0,0,-2,0,0,0
16620,310000,248000,0,0,0,0,0,0,0,104341,76651,27690,0,76635,7129,69506,0,46219,3000,43219,0,55045,10000,45045
16621,420000,336000,0,0,0,0,0,1,-2,-3859,0,-3859,-2,172,4031,-3859,-2,3859,3859,0,-2,8274,5000,3274
16622,30000,24000,0,1,1,1,1,0,0,27648,1479,26169,0,27859,1406,26453,0,27084,1097,25987,0,27133,2031,25102
16623,360000,288000,0,0,0,0,0,0,-1,43000,43065,-65,-1,4650,4650,0,-1,12132,12132,0,-1,13953,13953,0
16624,310000,248000,0,0,0,0,0,1,0,144515,6800,137715,0,154587,14000,140587,0,156565,6000,150565,2,153965,0,153965
16625,300000,240000,0,0,0,0,0,0,-2,0,0,0,-2,0,0,0,-2,0,0,0,-2,0,0,0
16626,200000,160000,0,0,0,0,0,0,2,3130,3130,0,-1,7585,5000,2585,0,11056,4000,7056,0,97451,90000,7451
16627,160000,128000,0,0,0,0,0,0,3,48328,2000,46328,2,49183,1800,47383,2,48237,0,48237,2,51937,4500,47437
16628,420000,336000,0,0,0,0,0,0,0,33124,9000,24124,0,31987,7000,24987,0,23703,5000,18703,0,22776,5000,17776
16629,300000,240000,0,1,0,0,0,1,0,256033,11068,244965,0,245772,9035,236737,0,243818,9018,234800,0,245235,9018,236217
16630,200000,160000,0,0,0,0,0,0,-2,316,316,0,-2,499,499,0,-2,672,672,0,-2,100,100,0
16631,40000,32000,0,0,0,0,1,1,0,31772,1000,30772,2,32146,1200,30946,0,33128,1500,31628,0,33923,1500,32423
16632,300000,240000,0,0,0,0,0,0,-2,0,0,0,-2,0,0,0,-2,0,0,0,-2,0,0,0
16633,160000,128000,0,0,0,0,0,0,0,131724,15000,116724,0,131767,10000,121767,0,133195,7000,126195,0,126064,5000,121064
16634,600000,480000,0,1,1,0,0,0,0,520492,20462,500030,0,525749,19445,506304,0,480722,17348,463374,0,460068,16536,443532
16635,50000,40000,0,0,0,0,0,0,0,30609,2000,28609,0,30432,1500,28932,0,30254,1501,28753,0,30088,2105,27983
16636,50000,40000,0,0,0,0,0,1,0,12579,1506,11073,0,29035,19300,9735,0,17878,1000,16878,0,18586,1000,17586
16637,230000,184000,0,0,0,0,0,0,0,18481,1139,17342,0,15609,600,15009,0,5802,800,5002,0,72049,70196,1853
16638,490000,392000,0,0,0,0,0,0,0,46705,5015,41690,0,41125,5007,36118,0,20205,20205,0,-1,6483,3000,3483
16639,20000,16000,0,0,0,0,0,0,0,7307,1000,6307,2,8027,1000,7027,0,8892,1000,7892,0,9739,1000,8739
16640,360000,288000,0,0,0,0,0,0,-2,291,291,0,-2,776,776,0,-2,0,0,0,-2,312,312,0
16641,240000,192000,0,0,0,0,0,1,-2,0,0,0,-2,0,0,0,-2,0,0,0,-2,0,0,0
16642,220000,176000,0,0,0,0,0,0,0,53019,2261,50758,0,143408,143408,0,-1,136786,4754,132032,0,130596,4740,125856
16643,220000,176000,0,0,0,0,0,0,0,175407,6218,169189,0,175170,6220,168950,0,174726,6316,168410,0,175057,6504,168553
16644,430000,344000,0,0,0,0,0,0,-1,13817,13858,-41,-1,7977,8000,-23,-1,3417,3427,-10,-1,2476,2483,-7
16645,230000,184000,0,0,0,0,0,0,0,25981,5000,20981,0,24092,5000,19092,0,65840,65840,0,-1,56538,2000,54538
16646,80000,64000,1,1,0,0,0,1,0,120697,4700,115997,0,60989,4800,56189,0,41023,1200,39823,0,42663,3260,39403
16647,90000,72000,0,0,0,0,0,0,0,49922,2129,47793,0,51290,2497,48793,0,56608,6815,49793,0,55576,0,55576
16648,200000,160000,0,0,0,0,0,0,0,46815,3000,43815,0,52978,7000,45978,0,53970,2000,51970,0,56064,3000,53064
16649,180000,144000,0,0,0,0,0,1,2,12183,0,12183,2,13979,2000,11979,2,13621,0,13621,2,14809,2000,12809
16650,90000,72000,0,0,0,0,0,0,0,48730,2000,46730,0,27535,3000,24535,0,27751,1000,26751,0,29923,3000,26923
16651,100000,80000,0,0,0,0,0,0,0,0,0,0,-2,0,0,0,-2,0,0,0,-2,0,0,0
16652,280000,224000,0,1,1,1,1,1,0,258032,10842,247190,0,263163,10928,252235,0,267083,9700,257383,0,272706,10000,262706
16653,140000,112000,0,1,1,1,1,0,0,130470,5000,125470,0,132038,4866,127172,0,131961,5300,126661,0,124256,5055,119201
16654,20000,16000,0,0,0,0,0,0,-1,500,500,0,-1,0,0,0,-1,0,0,0,-2,1500,1500,0
16655,50000,40000,0,1,0,0,0,0,0,50031,3167,46864,0,20413,682,19731,0,18336,662,17674,0,18405,1000,17405
16656,360000,288000,0,0,0,0,0,0,0,209680,8270,201410,0,213527,8423,205104,0,174907,6753,168154,0,126309,5139,121170
16657,20000,16000,0,0,1,1,1,0,3,17242,1300,15942,2,16668,0,16668,2,17972,1586,16386,2,18316,780,17536
16658,230000,184000,0,0,0,0,0,0,0,58020,2500,55520,0,59580,3000,56580,0,59224,2000,57224,0,61867,4000,57867
16659,130000,104000,0,0,0,0,0,0,0,58103,2000,56103,0,58595,2000,56595,0,59822,2053,57769,0,55572,1964,53608
16660,100000,80000,0,0,0,0,0,0,0,23386,4386,19000,0,25362,5362,20000,0,26318,4344,21974,0,42484,20000,22484
16661,50000,40000,0,1,0,0,0,0,0,44938,2000,42938,0,40655,2000,38655,0,40930,2000,38930,0,40146,3000,37146
16662,50000,40000,0,0,0,0,0,0,0,11968,1206,10762,0,12978,1216,11762,0,13236,474,12762,0,13664,642,13022
16663,10000,8000,0,0,0,0,0,0,0,7434,500,6934,2,7660,500,7160,0,7822,285,7537,0,8191,500,7691
16664,130000,104000,0,0,0,0,0,0,-2,-9850,0,-9850,-2,10311,20161,-9850,-1,10161,0,10161,2,7319,7319,0
16665,20000,16000,0,1,1,1,1,0,2,19717,1500,18217,2,18701,0,18701,2,18726,1000,17726,0,18501,1000,17501
16666,200000,160000,0,0,0,0,0,0,-1,2470,2470,0,-1,0,0,0,-1,1350,1350,0,-1,1006,1006,0
16667,350000,280000,0,0,0,0,0,0,-1,20558,20565,-7,-1,29866,29880,-14,-1,37587,27697,9890,0,15307,5330,9977
16668,140000,112000,0,0,0,0,0,0,0,111000,3200,107800,0,3238,3238,0,-1,89437,89437,0,-1,91136,3228,87908
16669,150000,120000,0,0,0,0,0,0,-1,-4,0,-4,-1,5515,5519,-4,-1,3673,3,3670,2,6106,6134,-28
16670,30000,24000,0,1,1,1,1,0,0,28573,1600,26973,0,29222,1500,27722,0,28451,1000,27451,0,27270,1000,26270
16671,500000,400000,0,0,0,0,0,0,-1,483,485,-2,-1,12988,13052,-64,-1,92539,92539,0,-1,94292,3160,91132
16672,200000,160000,0,0,0,0,0,0,0,144218,6611,137607,0,137975,4282,133693,0,132600,4367,128233,0,121028,4079,116949
16673,20000,16000,0,0,0,0,0,1,2,7626,0,7626,2,8692,1200,7492,0,9541,1000,8541,0,9885,500,9385
16674,70000,56000,0,0,0,0,0,0,0,21699,2000,19699,0,22460,1500,20960,0,20345,3000,17345,0,42123,721,41402
16675,450000,360000,0,0,0,0,0,0,-2,0,0,0,-2,2442,2442,0,-2,14234,14234,0,-1,-2988,452,-3440
16676,70000,56000,0,0,0,0,0,0,0,11231,1404,9827,0,10694,3016,7678,0,27908,20001,7907,0,11192,2000,9192
16677,270000,216000,0,0,0,0,0,0,0,204418,9500,194918,0,197854,8929,188925,0,173743,7265,166478,0,149095,5400,143695
16678,80000,64000,0,1,0,0,0,1,0,79599,3000,76599,0,49552,2038,47514,0,49509,2000,47509,0,49568,1800,47768
16679,150000,120000,0,0,0,0,0,0,2,100064,0,100064,2,104975,8100,96875,2,107147,4000,103147,2,109428,4200,105228
16680,220000,176000,0,0,0,0,0,0,-2,666,1332,-666,-2,1064,1064,0,-2,707,707,0,-1,9213,9325,-112
16681,190000,152000,0,0,0,0,0,0,-1,597,597,0,-1,1640,1648,-8,-1,306,306,0,-1,39506,39506,0
16682,110000,88000,0,0,0,0,0,1,2,56598,2500,54098,2,51908,0,51908,2,48647,2000,46647,0,47862,2000,45862
16683,30000,24000,0,0,0,1,1,1,-1,17498,1500,15998,2,25032,8213,16819,0,25626,1000,24626,0,27191,2000,25191
16684,120000,96000,0,0,0,0,0,0,0,30180,2000,28180,0,30471,1090,29381,0,31110,1129,29981,0,31728,1135,30593
16685,200000,160000,0,0,0,0,0,0,-2,0,0,0,-2,0,0,0,-2,0,0,0,-2,0,0,0
16686,50000,40000,0,0,0,0,0,0,0,7422,1130,6292,0,8292,1000,7292,0,8465,307,8158,0,8650,325,8325
16687,80000,64000,0,0,0,0,0,0,-1,1806,1806,0,-1,-1203,0,-1203,-1,14107,20000,-5893,-1,8575,0,8575
16688,360000,288000,0,0,0,0,0,0,0,161223,7226,153997,0,145172,5032,140140,0,131346,5346,126000,0,134135,15003,119132
16689,210000,168000,0,0,0,0,0,1,0,118191,5000,113191,0,104908,4000,100908,0,95946,3000,92946,0,118796,29066,89730
16690,120000,96000,0,0,0,0,0,0,-1,74,100,-26,-1,374,300,74,0,1549,1584,-35,-1,7101,7010,91
16691,30000,24000,0,0,0,0,0,1,2,2845,12,2833,2,1630,0,1630,0,12037,12037,0,-1,12933,1100,11833
16692,30000,24000,0,0,0,0,0,0,2,22194,3000,19194,2,21542,0,21542,2,24022,3000,21022,2,25473,2000,23473
16693,70000,56000,0,1,1,1,1,0,0,63882,3000,60882,0,64733,2500,62233,0,66680,3000,63680,0,71243,5800,65443
16694,200000,160000,0,0,0,0,0,0,0,116813,16020,100793,0,125616,13000,112616,0,115314,7012,108302,0,114153,5000,109153
16695,360000,288000,0,0,0,0,0,1,0,19783,1100,18683,0,17738,396,17342,0,1262,1266,-4,-1,382,9,373
16696,90000,72000,0,0,0,0,0,0,0,43996,0,43996,2,44069,1750,42319,0,41317,1425,39892,0,36912,1412,35500
16697,20000,16000,0,0,0,0,0,1,2,13492,1000,12492,3,12978,0,12978,2,13962,1200,12762,2,13595,0,13595
16698,50000,40000,0,0,0,0,0,0,0,33059,1593,31466,0,32663,1458,31205,0,29608,1186,28422,0,28939,1198,27741
16699,160000,128000,0,0,0,0,0,0,0,88072,92532,-4460,-1,88783,2859,85924,0,79684,2638,77046,0,78656,3000,75656
16700,360000,288000,0,0,0,0,0,0,0,40165,20856,19309,0,20733,103,20630,0,12525,12587,-62,-1,7482,7518,-36
16701,50000,40000,0,0,0,0,0,0,0,195,1000,-805,-1,4226,4226,0,-1,8956,5000,3956,0,9361,700,8661
16702,170000,136000,0,0,0,0,0,0,-1,272,272,0,-1,755,755,0,-1,759,759,0,-1,602,602,0
16703,290000,232000,0,0,0,0,0,0,-1,396,396,0,-1,396,396,0,-1,396,396,0,-1,396,396,0
16704,50000,40000,0,0,0,0,0,0,0,25326,1900,23426,0,25775,1300,24475,0,0,0,0,0,0,0,0
16705,360000,288000,0,0,0,0,0,0,-1,5287,5295,-8,-1,68445,68454,-9,-1,13881,13889,-8,-1,16240,16250,-10
16706,130000,104000,0,0,0,0,0,0,0,28659,1400,27259,0,26952,600,26352,0,15852,1000,14852,0,0,0,0
16707,50000,40000,1,1,1,1,1,0,4,51841,0,51841,3,50306,0,50306,2,49706,0,49706,0,49706,0,49706
16708,50000,40000,0,1,0,0,0,0,0,49771,2151,47620,0,19375,755,18620,0,71,71,0,-1,19661,19837,-176
16709,210000,168000,0,0,0,0,0,0,-1,1108,0,1108,2,1499,1500,-1,-1,2447,2500,-53,-1,888,1000,-112
16710,70000,56000,0,0,0,0,0,0,0,44205,4100,40105,0,44784,1600,43184,2,43763,0,43763,2,46646,3600,43046
16711,30000,24000,0,1,1,1,1,0,3,26556,1000,25556,2,26818,1000,25818,2,29425,3200,26225,2,28662,0,28662
16712,150000,120000,0,0,0,0,0,0,-2,19601,19608,-7,-2,13262,13280,-18,-2,14329,14329,0,-2,34193,34193,0
16713,20000,16000,0,1,1,1,1,1,0,19327,2400,16927,0,18696,632,18064,0,19233,800,18433,0,19909,1000,18909
16714,450000,360000,0,0,0,0,0,0,-1,0,0,0,-1,0,0,0,-2,0,0,0,-2,0,0,0
16715,310000,248000,0,0,0,0,0,0,-1,0,142,-142,-1,1312,1312,0,-1,4836,4836,0,-1,11795,11795,0
16716,340000,272000,0,0,0,0,0,0,-1,1461,1461,0,-1,1903,1903,0,-2,1492,1492,0,-2,4409,4409,0
16717,160000,128000,0,1,1,1,1,1,2,140777,5000,135777,2,136066,4600,131466,0,143005,14650,128355,0,129960,0,129960
16718,240000,192000,0,1,1,1,0,0,0,242807,9600,233207,0,226872,8896,217976,0,233115,10690,222425,0,239229,223765,15464
16719,170000,136000,0,0,0,0,0,0,0,18894,1054,17840,0,7695,207,7488,0,4777,151,4626,0,3517,147,3370
16720,30000,24000,0,0,0,0,0,1,2,13773,1000,12773,2,14647,1400,13247,2,14713,600,14113,2,14337,0,14337
16721,50000,40000,0,0,0,0,1,1,0,37858,2000,35858,0,38924,2000,36924,0,41170,3200,37970,0,40379,0,40379
16722,50000,40000,0,0,0,0,0,0,0,16177,2000,14177,0,16607,1000,15607,0,17186,1000,16186,0,17749,1000,16749
16723,70000,56000,0,0,0,0,0,0,0,11129,1196,9933,0,11650,1185,10465,0,12997,2000,10997,0,14322,2000,12322
16724,50000,40000,0,0,0,0,0,0,-1,492,493,-1,-1,492,493,-1,-1,492,493,-1,-1,470,471,-1
16725,130000,104000,0,0,0,0,0,0,0,45816,3390,42426,0,47018,3000,44018,0,48550,3000,45550,0,49737,1955,47782
16726,320000,256000,0,0,0,0,0,1,-2,2691,2691,0,-2,291,291,0,-2,291,291,0,-2,291,291,0
16727,140000,112000,0,0,0,0,0,0,0,54794,3000,51794,0,55951,3000,52951,0,57103,3000,54103,0,58210,2500,55710
16728,50000,40000,0,0,0,0,0,0,0,9802,126,9676,2,26781,58542,-31761,-1,28542,3032,25510,0,29235,2000,27235
16729,220000,176000,0,0,0,0,0,0,0,17922,2500,15422,0,20111,2500,17611,0,22261,2500,19761,0,24392,2500,21892
16730,300000,240000,0,0,0,0,0,1,2,238917,11672,227245,0,230083,9700,220383,0,13862,1053,12809,0,8210,2010,6200
16731,310000,248000,0,0,0,0,0,0,0,83123,5000,78123,0,46342,4000,42342,0,44693,3000,41693,0,43296,3000,40296
16732,50000,40000,0,0,0,0,0,1,0,28908,1484,27424,0,29922,1498,28424,0,30517,1093,29424,0,31164,1139,30025
16733,50000,40000,0,1,1,1,0,0,3,43562,0,43562,2,44039,1262,42777,0,45008,1358,43650,0,25775,1275,24500
16734,50000,40000,0,1,1,0,0,1,0,49715,2140,47575,0,49736,1161,48575,0,17599,510,17089,0,16753,503,16250
16735,120000,96000,0,1,1,1,1,0,0,114609,4232,110377,0,118232,5602,112630,0,119052,4123,114929,0,119232,4330,114902
16736,100000,80000,0,0,0,0,0,0,0,76561,3000,73561,0,39434,4200,35234,0,48351,22000,26351,0,20800,1200,19600
16737,50000,40000,0,0,0,0,0,1,0,13247,2000,11247,0,12737,0,12737,2,13732,1200,12532,2,13362,0,13362
16738,50000,40000,0,0,0,0,0,0,0,17832,1300,16532,0,18532,1000,17532,0,19233,1000,18233,0,20650,2000,18650
16739,200000,160000,0,0,0,0,0,0,-1,980,1029,-49,-1,3682,3682,0,-1,3682,0,3682,0,0,0,0
16740,100000,80000,0,0,0,0,0,1,-1,0,0,0,-1,0,0,0,-2,0,0,0,-2,0,0,0
16741,140000,112000,0,0,0,0,0,0,-1,998,1001,-3,-1,955,957,-2,-1,1976,1981,-5,-1,1895,1900,-5
16742,120000,96000,0,1,0,0,0,0,0,107488,4000,103488,0,97021,5000,92021,0,86283,3000,83283,0,87345,3300,84045
16743,60000,48000,0,1,0,0,1,0,0,61800,3000,58800,0,0,0,0,0,51301,51301,0,-1,52327,2029,50298
16744,50000,40000,1,1,0,0,0,0,0,76394,2581,73813,0,24873,1200,23673,0,-2132,2070,-4202,0,28561,31500,-2939
16745,50000,40000,0,0,0,0,0,1,0,15257,3750,11507,0,15410,700,14710,2,15917,900,15017,2,15514,0,15514
16746,30000,24000,0,0,0,0,0,0,0,780,780,0,-1,0,0,0,-1,30525,30525,0,-1,0,0,0
16747,50000,40000,0,0,0,0,0,0,0,17289,1300,15989,0,18396,1400,16996,0,19089,1000,18089,0,19629,1000,18629
16748,360000,288000,0,0,0,0,0,1,-2,0,0,0,-2,0,0,0,-2,0,0,0,-2,0,0,0
16749,110000,88000,0,0,0,0,0,0,2,48572,2100,46472,0,49299,2500,46799,0,47126,2000,45126,0,48215,2250,45965
16750,10000,8000,0,1,0,0,0,0,0,9436,1246,8190,0,5856,210,5646,0,6059,298,5761,0,5999,120,5879
16751,570000,456000,0,0,0,0,0,0,-2,3635,3653,-18,-2,5130,5145,-15,-2,7563,7573,-10,-2,4889,4894,-5
16752,90000,72000,0,0,0,0,0,1,2,41814,0,41814,2,42813,2000,40813,0,43571,1600,41971,0,46350,3500,42850
16753,200000,160000,0,0,0,0,0,0,0,52512,25000,27512,0,71923,20400,51523,0,19923,0,19923,0,-77,0,-77
16754,50000,40000,0,0,0,0,0,0,0,15315,1563,13752,0,16019,1267,14752,0,16336,584,15752,0,16678,605,16073
16755,230000,184000,0,0,0,0,0,0,-1,135099,3826,131273,0,133431,5000,128431,0,53103,5000,48103,0,49586,2000,47586
16756,440000,352000,0,0,0,0,0,0,0,149944,6907,143037,0,113135,3727,109408,0,105280,3800,101480,0,97622,4001,93621
16757,350000,280000,0,0,0,0,0,1,-1,4576,4576,0,-1,0,0,0,-1,0,0,0,-2,1206,1206,0
16758,50000,40000,0,1,1,1,1,1,2,48854,2200,46654,0,50243,3700,46543,0,51187,2000,49187,2,47551,0,47551
16759,120000,96000,0,0,0,0,0,0,0,54425,2559,51866,0,54925,2000,52925,0,59010,5000,54010,0,60191,2300,57891
16760,30000,24000,0,0,0,0,0,1,-1,11311,0,11311,2,11820,1000,10820,0,13558,2100,11458,0,20271,7000,13271
16761,270000,216000,0,0,0,0,0,0,0,51414,5000,46414,0,52993,3000,49993,0,54962,4000,50962,0,56523,3000,53523
16762,60000,48000,0,1,1,0,0,0,0,62130,4905,57225,0,56391,10,56381,2,39083,1600,37483,0,39122,1600,37522
16763,80000,64000,0,1,1,1,1,1,2,73987,3000,70987,2,72199,0,72199,2,76621,5637,70984,2,78451,3200,75251
16764,190000,152000,0,0,0,0,0,1,2,38051,1800,36251,2,38827,1700,37127,2,39488,1600,37888,2,40208,1500,38708
16765,10000,8000,0,0,0,0,0,0,0,6880,3000,3880,0,8830,2509,6321,0,5550,0,5550,0,6195,6195,0
16766,60000,48000,0,1,0,0,0,0,2,55751,2141,53610,0,37851,2000,35851,0,34195,2000,32195,0,33499,2000,31499
16767,340000,272000,0,0,0,0,0,0,0,255166,10000,245166,0,197695,7000,190695,0,201907,7000,194907,0,195961,7000,188961
16768,360000,288000,0,0,0,0,0,0,0,201703,20117,181586,0,189455,15018,174437,0,194373,10027,184346,0,207022,20057,186965
16769,250000,200000,0,0,0,0,0,0,-2,6244,6247,-3,-2,1297,1300,-3,-2,1763,1766,-3,-2,1907,1912,-5
16770,150000,120000,0,0,0,0,0,1,-1,696,0,696,2,696,696,0,-1,873,873,0,-1,1392,1392,0
16771,50000,40000,0,0,0,0,0,0,0,30286,1427,28859,0,26275,941,25334,0,26823,972,25851,0,27371,992,26379
16772,150000,120000,0,1,0,0,0,0,0,132441,6000,126441,0,94493,5000,89493,0,84936,5000,79936,0,77988,5000,72988
16773,80000,64000,0,1,0,0,0,0,0,77461,2810,74651,0,59228,2000,57228,0,46766,2000,44766,0,47630,2000,45630
16774,320000,256000,0,0,0,0,0,0,-1,8240,8240,0,-1,8240,8240,0,-1,15273,15273,0,-1,16106,16106,0
16775,50000,40000,0,0,0,0,0,0,0,8770,2127,6643,0,7251,1500,5751,0,15948,1000,14948,0,8838,1000,7838
16776,200000,160000,0,0,0,0,0,0,0,131111,4814,126297,0,112995,3921,109074,0,107300,4000,103300,0,101918,4365,97553
16777,30000,24000,0,0,0,0,0,1,0,14420,1500,12920,0,15838,2000,13838,0,17331,2000,15331,0,16973,0,16973
16778,80000,64000,0,0,0,0,0,0,0,0,0,0,0,0,0,0,-2,0,0,0,-2,0,0,0
16779,20000,16000,0,0,0,0,0,0,2,8338,0,8338,2,9199,1000,8199,2,9378,471,8907,2,9081,0,9081
16780,450000,360000,0,0,0,0,0,0,-2,19428,19432,-4,-2,2994,3005,-11,-2,23787,23788,-1,-2,41175,41214,-39
16781,500000,400000,0,0,0,0,0,0,0,177859,50000,127859,0,159518,10000,149518,0,186563,50000,136563,0,168083,20000,148083
16782,180000,144000,0,0,0,0,0,0,-1,5683,5834,-151,-1,39351,39000,351,0,3241,3241,0,-1,2614,2614,0
16783,240000,192000,0,0,0,0,0,0,0,13039,3500,9539,0,9439,0,9439,0,11378,5000,6378,0,13046,5000,8046
16784,30000,24000,0,0,0,0,0,0,-2,945,945,0,-1,0,0,0,-1,197,197,0,-1,2995,2995,0
16785,230000,184000,0,1,1,0,0,0,0,237267,9000,228267,0,212105,7800,204305,0,186149,6650,179499,0,159683,5496,154187
16786,30000,24000,0,1,1,1,1,1,3,30789,1060,29729,2,29504,0,29504,2,30276,1251,29025,0,29695,1078,28617
16787,240000,192000,0,1,1,0,0,0,0,204712,8000,196712,0,205344,8400,196944,0,152992,6000,146992,0,140128,5200,134928
16788,200000,160000,0,0,0,0,0,0,-2,5825,5825,0,-1,0,0,0,-1,3217,3217,0,-1,8273,8273,0
16789,200000,160000,0,0,0,0,0,0,0,77516,3200,74316,0,79088,3196,75892,0,80141,2700,77441,0,81833,2714,79119
16790,100000,80000,0,1,0,0,1,0,0,96504,4385,92119,0,22850,1850,21000,0,91081,103300,-12219,-1,92986,3370,89616
16791,160000,128000,0,0,0,0,0,0,0,26666,28800,-2134,-1,839,839,0,-1,26516,26500,16,0,-150,0,-150
16792,310000,248000,0,0,0,0,0,1,0,235796,8406,227390,0,188031,6000,182031,0,170898,5074,165824,0,68369,3000,65369
16793,30000,24000,0,0,0,0,0,0,-1,390,390,0,-1,240,240,0,-1,1320,1470,-150,-1,780,0,780
16794,50000,40000,1,1,0,0,0,1,0,53518,2364,51154,0,4199,2398,1801,0,0,0,0,0,0,0,0
16795,170000,136000,0,0,0,0,0,0,0,66038,3000,63038,0,67934,3000,64934,0,69834,3000,66834,0,71668,3000,68668
16796,120000,96000,0,0,0,0,0,1,0,35160,1021,34139,0,13425,274,13151,0,8517,3001,5516,0,6174,1004,5170
16797,230000,184000,0,0,0,0,0,0,-2,0,0,0,-2,0,0,0,-2,0,0,0,-2,0,0,0
16798,80000,64000,0,0,0,0,0,0,-1,7304,1185,6119,0,5050,1000,4050,0,5357,307,5050,0,5466,109,5357
16799,50000,40000,0,1,1,1,0,0,0,45727,0,45727,2,45515,1200,44315,0,45470,155,45315,0,4220,3000,1220
16800,120000,96000,0,0,0,0,0,0,0,11649,0,11649,2,11435,342,11093,0,11400,521,10879,0,12661,2000,10661
16801,50000,40000,0,0,0,0,0,0,-2,2640,2640,0,-2,0,1500,-1500,-2,1000,1000,0,-2,4702,4702,0
16802,80000,64000,0,0,0,0,0,0,-1,34131,1568,32563,0,34809,1246,33563,0,35539,1291,34248,0,36271,1324,34947
16803,150000,120000,0,0,0,0,0,1,0,100,100,0,-1,802,702,100,-1,802,0,802,2,702,0,702
16804,460000,368000,0,0,0,0,0,0,0,0,0,0,0,6261,6261,0,-1,0,0,0,-1,0,0,0
16805,420000,336000,0,0,0,0,0,0,-1,16615,16615,0,-1,14156,14156,0,-1,9058,9058,0,-1,3281,3281,0
16806,30000,24000,0,0,0,0,0,1,0,14450,2000,12450,0,14903,693,14210,0,16500,2000,14500,0,18715,2500,16215
16807,500000,400000,0,0,0,0,0,0,0,171106,4607,166499,0,174500,4603,169897,0,137406,5224,132182,0,204975,207440,-2465
16808,340000,272000,0,0,0,0,0,0,0,87780,7785,79995,0,1680,1699,-19,-1,1920,1920,0,-1,9151,9151,0
16809,550000,440000,0,0,0,0,0,0,0,49196,5070,44126,0,37784,3017,34767,0,35317,7148,28169,0,7433,2037,5396
16810,500000,400000,0,0,0,0,0,0,-1,1215,1215,0,-1,6461,6461,0,-1,2567,2567,0,-1,735,1470,-735
16811,420000,336000,0,0,0,0,0,0,0,184810,8931,175879,0,131304,4940,126364,0,110930,1796,109134,0,84193,3100,81093
16812,150000,120000,0,0,0,0,0,0,-1,1541,1541,0,-1,1345,4,1341,0,23018,23087,-69,-1,1989,1996,-7
16813,160000,128000,0,0,0,0,0,0,0,25819,1699,24120,0,25754,1050,24704,0,25898,1104,24794,0,25925,1041,24884
16814,390000,312000,0,0,0,0,0,0,0,32860,1548,31312,0,33511,1199,32312,0,34271,1300,32971,0,35040,1337,33703
16815,200000,160000,0,0,0,0,0,0,-2,133,133,0,-2,386,386,0,-2,393,400,-7,-2,286,286,0
16816,150000,120000,0,0,0,0,0,0,-1,600,601,-1,-1,4102,4102,0,-1,4102,0,4102,0,6121,2019,4102
16817,310000,248000,0,0,0,0,0,0,0,145125,4500,140625,0,148388,4500,143888,0,152132,5000,147132,0,155887,5000,150887
16818,200000,160000,0,0,0,0,0,0,-1,5762,5762,0,-1,0,0,0,-1,0,0,0,-2,3117,3117,0
16819,70000,56000,0,1,1,0,0,0,0,71488,4000,67488,0,64601,2013,62588,0,32099,1500,30599,0,26626,1000,25626
16820,200000,160000,0,0,0,0,0,0,-1,998,1000,-2,-1,668,670,-2,-1,9815,9852,-37,-1,36870,40063,-3193
16821,340000,272000,0,0,0,0,0,0,-2,0,0,0,-2,3931,3931,0,-2,2295,2295,0,-2,0,0,0
16822,210000,168000,0,0,0,0,0,0,-1,0,0,0,-1,5619,5619,0,-1,4090,4090,0,-1,581,581,0
16823,100000,80000,0,0,0,0,0,0,0,3708,1000,2708,0,2180,2180,0,-1,1949,1949,0,-1,717,717,0
16824,30000,24000,1,1,1,1,1,0,2,30392,0,30392,2,28314,784,27530,0,29076,984,28092,0,30065,1400,28665
16825,200000,160000,0,0,0,0,0,0,0,32704,1546,31158,0,33351,1193,32158,0,34050,1236,32814,0,36184,2700,33484
16826,50000,40000,0,0,0,0,0,0,0,26026,1011,25015,0,12059,482,11577,0,9765,228,9537,0,10097,365,9732
16827,200000,160000,0,0,0,0,0,0,-1,-19,0,-19,-1,3920,3939,-19,-1,4452,4470,-18,-1,685,3,682
16828,20000,16000,0,0,0,1,1,0,0,11508,5000,6508,0,16953,6000,10953,0,17310,626,16684,0,18466,1441,17025
16829,50000,40000,0,0,0,0,0,0,-1,0,0,0,-2,536,536,0,-1,326,326,0,-1,652,652,0
16830,130000,104000,0,1,0,0,0,0,2,109903,47,109856,2,80909,3000,77909,0,71679,2800,68879,0,66169,2713,63456
16831,50000,40000,0,0,0,0,0,0,-1,435,435,0,-1,1309,1309,0,-1,589,589,0,-1,1210,1210,0
16832,10000,8000,0,0,0,1,1,0,0,7538,1131,6407,0,9322,2155,7167,0,9567,1400,8167,0,9766,1354,8412
16833,10000,8000,0,0,0,1,0,0,0,8518,1000,7518,0,8950,1000,7950,0,9795,1000,8795,0,3274,59,3215
16834,150000,120000,0,0,0,0,0,0,-1,12733,2000,10733,0,6908,1225,5683,0,6713,1244,5469,0,8048,1447,6601
16835,210000,168000,0,0,0,0,0,0,-2,15611,15689,-78,-2,502,504,-2,-2,781,784,-3,-2,754,757,-3
16836,230000,184000,0,0,0,0,0,0,0,5418,1000,4418,0,0,0,0,0,2000,2000,0,-1,987,987,0
16837,180000,144000,0,0,0,0,0,0,0,48705,5705,43000,0,50140,3003,47137,0,60607,10607,50000,0,67976,7976,60000
16838,320000,256000,0,0,0,0,0,0,-1,4022,4022,0,-1,316,316,0,-1,8420,8420,0,-1,316,316,0
16839,80000,64000,0,0,0,0,0,0,-1,3529,3529,0,-1,13207,10207,3000,0,13110,500,12610,0,13116,600,12516
16840,10000,8000,0,0,1,1,0,0,0,9825,2200,7625,0,17506,1300,16206,0,16608,320,16288,0,9176,1820,7356
16841,230000,184000,0,0,0,0,0,1,-1,1958,1972,-14,-1,368,368,0,-1,1613,1613,0,-1,1371,1371,0
16842,50000,40000,0,0,0,0,0,0,0,7161,2000,5161,0,8377,1500,6877,0,8789,1000,7789,0,8813,500,8313
16843,30000,24000,0,0,0,0,0,1,0,20135,1700,18435,0,19529,1679,17850,0,17428,0,17428,2,25227,10000,15227
16844,20000,16000,0,0,0,0,0,0,2,5546,1500,4046,2,6302,1000,5302,2,7193,1000,6193,0,8075,1000,7075
16845,360000,288000,0,0,0,0,0,0,0,0,0,0,0,0,0,0,-2,0,0,0,-2,0,0,0
16846,50000,40000,0,0,0,0,0,0,0,41674,10003,31671,0,15066,5001,10065,0,14066,10032,4034,0,17043,10001,7042
16847,80000,64000,0,0,0,0,0,0,0,17950,1600,16350,0,14699,1419,13280,0,12466,1000,11466,0,11445,1000,10445
16848,50000,40000,0,0,0,0,0,0,0,33392,2000,31392,0,28340,2000,26340,0,24384,2000,22384,0,22643,1000,21643
16849,60000,48000,0,1,0,0,0,0,0,55775,2300,53475,0,28187,1200,26987,0,28978,1200,27778,0,27119,1500,25619
16850,30000,24000,0,1,1,1,0,1,0,32415,2430,29985,0,30324,1300,29024,0,31124,1000,30124,0,25502,34436,-8934
16851,50000,40000,0,0,0,0,0,0,0,7456,1000,6456,0,7608,152,7456,0,7978,370,7608,0,10400,11000,-600
16852,20000,16000,0,0,0,0,0,0,0,12870,1308,11562,0,12726,1000,11726,0,13336,1000,12336,0,2496,50,2446
16853,280000,224000,0,0,0,0,0,0,-2,500,500,0,-2,0,0,0,-2,500,500,0,-2,4778,4778,0
16854,150000,120000,0,0,0,0,0,0,2,46887,8538,38349,2,45832,0,45832,2,52968,8810,44158,0,60034,8942,51092
16855,120000,96000,0,0,0,0,0,0,0,13531,1500,12031,0,10129,1500,8629,0,11581,2000,9581,0,12782,1782,11000
16856,240000,192000,0,0,0,0,0,1,0,186613,9100,177513,0,189470,8244,181226,0,119525,5000,114525,0,121178,5000,116178
16857,410000,328000,0,0,0,0,0,0,-2,-2506,2506,-5012,-2,-2506,0,-2506,-2,-2506,0,-2506,-2,-2506,0,-2506
16858,120000,96000,0,0,0,0,0,0,0,101562,8485,93077,0,94307,524,93783,2,89867,6004,83863,2,81617,5,81612
16859,30000,24000,0,0,0,0,0,0,-1,0,0,0,-1,780,780,0,-1,0,0,0,-1,0,0,0
16860,210000,168000,0,0,0,0,0,0,0,97575,4000,93575,0,93763,3220,90543,0,95790,3400,92390,0,92855,3252,89603
16861,50000,40000,0,1,0,0,0,0,0,49162,2190,46972,0,19969,809,19160,0,19893,3012,16881,0,20282,5795,14487
16862,80000,64000,0,0,0,0,0,0,0,35017,2000,33017,0,36175,2000,34175,0,0,0,0,0,0,0,0
16863,310000,248000,0,0,0,0,0,0,0,12191,1000,11191,0,13775,13775,0,-1,12377,12377,0,-1,34458,34458,0
16864,10000,8000,0,0,0,0,0,0,0,6132,1100,5032,0,5851,197,5654,0,5735,362,5373,0,6087,1000,5087
16865,110000,88000,0,1,0,0,0,1,0,108483,4306,104177,0,73177,1662,71515,0,51043,1170,49873,0,60581,60604,-23
16866,360000,288000,0,0,0,0,0,1,-2,0,0,0,-2,0,0,0,-2,0,0,0,-2,0,0,0
16867,280000,224000,0,0,0,0,0,0,-1,10132,10157,-25,-1,29142,29187,-45,-1,20644,20669,-25,-1,1647,3003,-1356
16868,60000,48000,0,0,0,0,0,0,2,35320,1027,34293,0,0,0,0,0,0,0,0,-2,0,0,0
16869,80000,64000,0,0,0,0,0,0,0,19227,0,19227,2,20593,2000,18593,0,20951,1000,19951,0,21460,1000,20460
16870,110000,88000,0,0,0,0,0,0,0,8383,2393,5990,0,8394,300,8094,2,7709,0,7709,2,8084,500,7584
16871,370000,296000,0,0,0,0,0,0,-2,0,0,0,-2,30100,30100,0,-2,0,0,0,-2,0,0,0
16872,290000,232000,0,0,0,0,0,0,0,150617,6010,144607,0,153351,5600,147751,0,156213,5700,150513,0,158938,5700,153238
16873,20000,16000,0,1,1,1,1,0,0,20234,3000,17234,2,20510,900,19610,3,19897,0,19897,3,19900,500,19400
16874,30000,24000,0,0,0,0,0,1,2,14846,0,14846,2,16098,1500,14598,2,15700,0,15700,2,16784,1500,15284
16875,50000,40000,0,1,0,0,0,0,0,50222,2000,48222,0,20013,1682,18331,0,39721,41803,-2082,-1,30526,1261,29265
16876,120000,96000,0,0,0,0,0,0,0,85280,3074,82206,0,83873,2887,80986,0,78945,2774,76171,0,80597,2871,77726
16877,130000,104000,0,0,0,0,0,1,2,20579,2400,18179,2,19950,0,19950,2,21625,2000,19625,2,21129,0,21129
16878,30000,24000,0,0,1,1,1,0,-1,30452,33299,-2847,-1,29667,1400,28267,0,28596,572,28024,0,29180,584,28596
16879,200000,160000,0,0,0,0,0,0,-2,0,0,0,-2,0,0,0,-2,0,0,0,-2,0,0,0
16880,70000,56000,0,0,0,0,0,1,0,47585,2500,45085,0,48493,2000,46493,0,49559,2000,47559,0,51079,2500,48579
16881,290000,232000,0,0,0,0,0,0,0,66183,3000,63183,0,61332,3000,58332,0,62445,3000,59445,0,59213,3000,56213
16882,200000,160000,0,1,1,1,1,0,0,209286,12200,197086,2,188243,0,188243,2,188668,7000,181668,0,190192,7000,183192
16883,50000,40000,0,0,0,0,0,0,0,16297,10048,6249,0,1000,1003,-3,-1,0,0,0,-1,0,0,0
16884,150000,120000,0,0,0,0,0,0,0,89951,5016,84935,0,86961,5050,81911,0,79284,3026,76258,0,74531,5000,69531
16885,20000,16000,0,0,0,0,0,1,2,6100,1500,4600,2,5856,0,5856,2,6432,822,5610,2,6182,0,6182
16886,200000,160000,0,0,0,0,0,0,-1,165,165,0,-1,0,0,0,-1,0,0,0,-2,0,0,0
16887,150000,120000,0,0,0,0,0,0,3,88909,4500,84409,2,90352,3800,86552,2,91355,3400,87955,2,93241,3500,89741
16888,380000,304000,1,1,1,1,1,0,0,446224,16672,429552,0,419943,14088,405855,0,420016,14500,405516,0,426622,14700,411922
16889,60000,48000,0,0,0,0,0,1,0,21023,2000,19023,0,16973,1000,15973,0,12410,1000,11410,0,11944,6000,5944
16890,20000,16000,0,0,0,0,0,1,0,13348,141,13207,2,512,1048,-536,-1,18141,23261,-5120,-1,11575,134,11441
16891,80000,64000,0,0,0,0,0,0,-1,2110,2110,0,-1,2298,2298,0,-1,1196,1196,0,-1,390,390,0
16892,50000,40000,0,1,0,0,0,1,0,42361,1500,40861,0,19574,1000,18574,0,20295,1800,18495,0,19439,0,19439
16893,80000,64000,0,1,1,1,1,0,0,68690,2511,66179,0,70042,2512,67530,0,70626,2510,68116,0,71700,2590,69110
16894,200000,160000,0,0,0,0,0,0,2,112099,0,112099,2,118764,10000,108764,2,120780,4001,116779,2,123710,5000,118710
16895,130000,104000,0,0,0,0,1,0,0,3995,2000,1995,0,7556,5000,2556,0,125682,128000,-2318,-1,128453,4700,123753
16896,50000,40000,0,0,0,0,0,0,0,7312,1140,6172,0,6959,1048,5911,0,5813,163,5650,0,3985,135,3850
16897,70000,56000,0,1,0,0,0,0,4,70275,2001,68274,3,46045,0,46045,2,42357,1666,40691,0,41026,1505,39521
16898,500000,400000,0,1,0,1,0,0,0,498839,22800,476039,0,411820,15200,396620,0,422671,19000,403671,0,394599,16000,378599
16899,180000,144000,0,0,0,0,0,0,-1,3866,3866,0,-1,6019,3300,2719,0,7602,7602,0,-1,7622,7622,0
16900,200000,160000,0,0,0,0,0,0,-2,0,0,0,-2,0,0,0,-2,0,0,0,-2,0,0,0
16901,200000,160000,0,0,0,0,0,0,0,16905,3024,13881,0,11791,2017,9774,0,7983,173,7810,0,6327,1002,5325
16902,210000,168000,0,0,0,0,0,0,0,57928,10000,47928,0,60359,3000,57359,0,69782,10000,59782,0,83991,15000,68991
16903,60000,48000,0,0,0,0,0,1,0,27403,1724,25679,0,23837,1600,22237,0,23078,1000,22078,0,22618,1000,21618
16904,80000,64000,0,0,0,0,0,0,0,17245,2500,14745,0,13507,0,13507,2,14479,2000,12479,0,14083,2000,12083
16905,190000,152000,0,0,0,0,0,0,0,101452,5452,96000,0,103471,5471,98000,0,104083,4083,100000,0,106359,4359,102000
16906,80000,64000,0,1,0,0,0,1,0,74789,3139,71650,0,45883,2001,43882,0,29616,2081,27535,0,28916,1200,27716
16907,50000,40000,0,0,0,0,0,0,2,33467,3467,30000,0,12870,1229,11641,0,3325,3325,0,-1,5103,2000,3103
16908,50000,40000,0,0,0,0,0,0,0,13239,1239,12000,0,15254,2254,13000,0,16394,1394,15000,0,18124,2000,16124
16909,80000,64000,0,0,0,0,0,0,0,47967,2154,45813,0,48804,1991,46813,0,49624,1811,47813,0,50031,1742,48289
16910,50000,40000,0,0,0,0,0,1,0,18096,2000,16096,0,18425,1500,16925,0,18619,1200,17419,0,19060,900,18160
16911,160000,128000,0,0,0,0,0,1,-1,316,0,316,2,316,316,0,-1,316,316,0,-1,316,316,0
16912,360000,288000,0,0,0,0,0,0,-1,0,0,0,-1,0,0,0,-2,7972,7972,0,-1,8275,435,7840
16913,150000,120000,0,0,0,0,0,0,-1,2021,2021,0,-1,4495,4495,0,-1,15145,10650,4495,0,525,525,0
16914,30000,24000,0,1,0,1,1,0,0,28359,1450,26909,0,24844,889,23955,0,25364,920,24444,0,25935,992,24943
16915,80000,64000,0,0,0,0,0,0,0,47184,2068,45116,0,47059,1833,45226,0,47938,1889,46049,0,48904,1915,46989
16916,220000,176000,0,1,0,0,0,0,2,208464,8027,200437,0,175407,6218,169189,0,175170,6220,168950,0,174726,6316,168410
16917,130000,104000,0,0,0,0,0,0,-1,44404,44404,0,-1,27113,27309,-196,-1,801,801,0,-1,28027,28027,0
16918,240000,192000,0,0,0,0,0,0,2,0,0,0,-2,2240,2240,0,-1,1681,0,1681,0,2267,2267,0
16919,500000,400000,0,0,0,0,0,1,-2,309019,10500,298519,-2,292878,9692,283186,-2,152025,4823,147202,-2,110034,3986,106048
16920,400000,320000,0,0,0,0,0,0,0,13038,1287,11751,0,13751,1000,12751,0,5765,5819,-54,-1,21784,26957,-5173
16921,220000,176000,0,1,1,1,1,0,2,211340,16501,194839,2,209612,3200,206412,2,219064,13000,206064,2,222672,7500,215172
16922,30000,24000,0,1,1,0,0,0,0,26553,1789,24764,0,26554,790,25764,0,18869,471,18398,0,12359,352,12007
16923,50000,40000,0,0,0,0,0,0,0,7471,2000,5471,0,8043,2000,6043,0,19526,3000,16526,0,7564,1000,6564
16924,450000,360000,0,0,0,0,0,0,-1,1096,1105,-9,-1,1968,2012,-44,-1,1575,2007,-432,-1,3889,4019,-130
16925,320000,256000,0,0,0,0,0,0,0,68759,3007,65752,0,69746,3031,66715,0,70040,2367,67673,0,71076,2450,68626
16926,250000,200000,0,0,0,0,0,0,-2,-329,200,-529,-2,-329,0,-329,-2,-329,0,-329,-2,-529,200,-729
16927,160000,128000,0,0,0,0,0,0,0,6057,2000,4057,0,6519,1000,5519,0,7130,1000,6130,0,6578,0,6578
16928,10000,8000,0,0,0,0,1,1,0,2529,2535,-6,-1,390,390,0,-1,9478,9478,0,-1,8170,0,8170
16929,180000,144000,0,0,0,0,0,0,-2,621,621,0,-2,3762,3762,0,-2,0,0,0,-2,0,0,0
16930,300000,240000,0,0,0,0,0,0,0,300,350,-50,-1,5107,5107,0,-1,5107,0,5107,0,3028,3028,0
16931,50000,40000,0,0,0,0,0,0,0,26443,2000,24443,0,30768,5000,25768,0,10778,1000,9778,0,10989,1000,9989
16932,70000,56000,0,0,0,0,0,0,-1,3340,3340,0,-1,0,0,0,-1,0,0,0,-2,0,0,0
16933,240000,192000,0,0,0,0,0,0,-2,2007,2007,0,-1,-40,40,-80,-1,-40,0,-40,-2,8091,8131,-40
16934,350000,280000,0,0,0,0,0,0,0,64839,2089,62750,0,57583,3008,54575,0,45554,1300,44254,0,37063,1500,35563
16935,90000,72000,0,0,0,0,0,0,0,25382,6000,19382,0,27132,5000,22132,0,31675,5000,26675,0,37900,8000,29900
16936,140000,112000,0,0,0,0,0,0,0,42977,2100,40877,0,43960,2000,41960,0,45093,2000,43093,0,46342,2000,44342
16937,20000,16000,0,0,0,0,0,1,3,11021,420,10601,2,11240,402,10838,0,11476,417,11059,0,11708,423,11285
16938,400000,320000,0,0,0,0,0,0,-1,1290,1290,0,-1,0,0,0,-1,0,0,0,-2,3058,3058,0
16939,100000,80000,0,0,0,0,0,0,0,20974,2004,18970,0,19713,616,19097,0,19848,2007,17841,0,18126,1009,17117
16940,160000,128000,0,0,0,0,0,1,2,866,874,-8,-1,0,0,0,-1,892,892,0,-1,0,0,0
16941,120000,96000,0,0,0,0,0,1,-2,-4016,0,-4016,-2,4016,10040,-6024,-1,2008,0,2008,0,8299,8299,0
16942,60000,48000,0,0,0,0,0,1,0,43350,4073,39277,0,42057,0,42057,2,26877,1600,25277,2,26493,0,26493
16943,150000,120000,0,0,0,0,0,0,0,63176,5000,58176,0,52807,10116,42691,0,34199,5000,29199,0,32061,6000,26061
16944,310000,248000,0,0,0,0,0,0,0,50109,2100,48009,0,49339,1700,47639,0,49177,2000,47177,0,48754,1800,46954
16945,360000,288000,0,0,0,0,0,0,0,280535,7500,273035,0,82455,3500,78955,0,83359,2500,80859,0,85171,2500,82671
16946,150000,120000,0,0,0,0,0,0,0,43583,2500,41083,0,45569,3000,42569,0,46533,2000,44533,0,47653,2000,45653
16947,50000,40000,0,0,0,0,0,1,2,23435,2000,21435,2,22765,0,22765,2,22990,900,22090,0,23369,900,22469
16948,50000,40000,0,1,0,0,0,0,0,50245,1311,48934,0,19424,689,18735,0,19829,712,19117,0,20386,879,19507
16949,200000,160000,0,1,1,1,1,0,0,198501,10061,188440,0,194782,7071,187711,0,191172,6514,184658,0,193267,7081,186186
16950,360000,288000,0,0,0,0,0,0,-2,827,827,0,-1,136198,137101,-903,-1,138722,5000,133722,0,141629,5119,136510
16951,220000,176000,0,0,0,0,0,0,0,41308,2,41306,2,39770,3006,36764,0,31840,2000,29840,0,33173,2000,31173
16952,200000,160000,0,0,0,0,0,1,-1,2870,2392,478,0,390,500,-110,-1,1210,1210,0,-1,2551,2551,0
16953,50000,40000,0,0,0,0,0,1,2,32317,1500,30817,2,32787,1300,31487,2,33416,1300,32116,2,34116,1400,32716
16954,90000,72000,0,0,0,0,0,0,-1,414,414,0,-1,6936,6936,0,-1,7272,1000,6272,0,7595,1000,6595
16955,170000,136000,0,0,0,0,0,0,0,103156,5107,98049,0,94090,3600,90490,0,95922,3500,92422,0,99324,5000,94324
16956,130000,104000,0,0,0,0,0,0,0,69945,3786,66159,0,74082,5923,68159,0,75653,2796,72857,0,77259,2815,74444
16957,30000,24000,0,0,0,0,0,0,0,17072,1270,15802,0,15994,367,15627,0,12017,336,11681,0,5614,112,5502
16958,200000,160000,0,0,0,0,0,0,-2,1374,1374,0,-1,24836,74836,-50000,-1,23348,0,23348,0,7058,250,6808
16959,450000,360000,0,0,0,0,0,1,-2,0,0,0,-2,0,0,0,-2,0,0,0,-2,0,0,0
16960,230000,184000,0,0,0,0,0,1,0,76691,3000,73691,0,76952,2723,74229,0,77577,2810,74767,0,78017,2793,75224
16961,50000,40000,0,1,1,1,0,0,0,44639,2000,42639,0,52198,10052,42146,0,43181,2000,41181,0,31473,1136,30337
16962,20000,16000,0,0,0,0,0,1,0,14217,1533,12684,0,14360,676,13684,0,16140,2177,13963,0,16287,559,15728
16963,30000,24000,0,1,1,1,1,1,2,28029,0,28029,5,27120,0,27120,4,26154,0,26154,3,25940,0,25940
16964,100000,80000,0,0,0,0,0,0,3,959,0,959,2,1623,1623,0,-1,1470,0,1470,3,930,0,930
16965,500000,400000,0,0,0,0,0,0,0,353719,16023,337696,0,348365,13009,335356,0,306196,10008,296188,0,303114,10000,293114
16966,180000,144000,0,0,0,0,0,0,0,44959,4000,40959,0,50198,6000,44198,0,52361,3000,49361,0,55510,4000,51510
16967,50000,40000,0,1,0,0,0,0,0,49386,3120,46266,0,19818,4300,15518,0,18540,1000,17540,0,19109,1000,18109
16968,90000,72000,0,0,0,0,0,0,0,71616,3243,68373,0,60177,2390,57787,0,54440,1840,52600,0,45788,1690,44098
16969,110000,88000,0,1,0,0,0,0,0,98270,3648,94622,0,79402,2800,76602,0,80804,3100,77704,0,81024,3133,77891
16970,270000,216000,0,0,0,0,0,0,0,13021,2000,11021,0,4144,2000,2144,0,2291,1000,1291,0,36491,37500,-1009
16971,420000,336000,0,0,0,0,0,1,0,32423,1436,30987,0,18824,1000,17824,0,0,0,0,0,21082,21082,0
16972,130000,104000,0,0,0,0,0,0,-1,6042,6044,-2,-1,1085,1619,-534,-1,947,947,0,-1,495,495,0
16973,130000,104000,0,0,0,0,0,0,-2,388,388,0,-2,0,0,0,-2,418,418,0,-2,0,0,0
16974,100000,80000,0,1,1,1,0,0,0,97453,8000,89453,0,99407,3500,95907,0,95600,3500,92100,0,981,981,0
16975,20000,16000,0,0,0,0,0,0,0,7842,2000,5842,0,9262,2200,7062,0,4335,1200,3135,0,0,0,0
16976,20000,16000,0,0,0,0,0,0,0,15322,2070,13252,0,14779,0,14779,2,15543,1000,14543,2,16139,1000,15139
16977,450000,360000,0,0,0,0,0,0,0,7700,1000,6700,0,9700,2000,7700,0,11700,2000,9700,0,0,0,0
16978,140000,112000,0,0,0,0,0,1,-2,0,0,0,-2,0,0,0,-2,0,0,0,-2,0,0,0
16979,150000,120000,0,0,0,0,0,0,0,25779,5779,20000,0,22303,1300,21003,0,16981,700,16281,0,16837,1000,15837
16980,360000,288000,0,0,0,0,0,0,-1,34766,34766,0,-1,14138,2005,12133,0,14690,2190,12500,0,19792,7300,12492
16981,20000,16000,0,0,1,0,0,0,0,19037,20398,-1361,-1,19939,1300,18639,0,15110,694,14416,0,0,0,0
16982,30000,24000,1,1,1,1,1,0,2,33506,1800,31706,2,41931,9851,32080,2,38638,0,38638,2,35343,1183,34160
16983,110000,88000,0,0,0,0,0,0,-1,54711,5000,49711,0,55926,3000,52926,0,18030,2000,16030,0,18367,1000,17367
16984,50000,40000,0,0,0,0,0,1,0,900,900,0,-1,1900,1000,900,0,2900,1000,1900,0,3000,100,2900
16985,310000,248000,0,0,0,0,0,0,-2,0,0,0,-2,0,0,0,-2,0,0,0,-2,0,0,0
16986,140000,112000,0,1,0,0,0,0,0,130305,3100,127205,0,79775,3000,76775,0,74462,5417,69045,0,74954,0,74954
16987,620000,496000,0,0,0,0,0,0,-1,620,620,0,-1,16022,16032,-10,-1,2581,2856,-275,-1,2867,4197,-1330
16988,50000,40000,0,0,0,0,0,1,2,1465,2000,-535,-1,2282,1000,1282,0,2397,300,2097,0,2470,300,2170
16989,50000,40000,0,1,1,0,0,0,0,50694,2295,48399,0,44858,1572,43286,0,19298,5000,14298,0,19514,1000,18514
16990,360000,288000,0,0,0,0,0,0,2,0,0,0,2,0,0,0,-2,0,0,0,-2,0,0,0
16991,50000,40000,0,0,0,0,0,1,2,31888,1580,30308,0,28639,1621,27018,0,26737,1020,25717,0,24784,2473,22311
16992,230000,184000,0,0,0,0,0,0,-2,909,1000,-91,-2,-1307,0,-1307,-2,-3237,0,-3237,-2,-5459,0,-5459
16993,180000,144000,0,0,0,0,0,0,-1,2000,2000,0,-1,3918,3918,0,-1,710,710,0,-1,6761,6761,0
16994,500000,400000,0,0,0,0,0,0,-1,7667,7667,0,-1,6222,6222,0,-1,9435,9435,0,-1,7235,7235,0
16995,170000,136000,0,0,0,0,1,0,0,130591,6883,123708,0,138404,11600,126804,0,138733,5020,133713,2,137642,1200,136442
16996,570000,456000,0,0,0,0,0,0,0,48474,25000,23474,0,42377,1302,41075,0,41302,1000,40302,0,1666,1666,0
16997,50000,40000,1,1,1,0,0,1,3,50492,0,50492,2,47633,5000,42633,0,18283,3000,15283,0,18610,1000,17610
16998,310000,248000,0,0,0,0,0,0,0,142810,3872,138938,0,125869,3147,122722,0,107986,2912,105074,0,83461,5109,78352
16999,50000,40000,0,0,0,0,0,0,-1,390,390,0,-1,780,780,0,-1,780,0,780,0,0,0,0
17000,250000,200000,0,0,0,0,0,0,0,194318,7606,186712,0,181608,7200,174408,0,172922,6000,166922,0,175302,6303,168999
17001,80000,64000,0,0,0,0,0,0,-2,0,0,0,-2,0,0,0,-2,0,0,0,-2,0,0,0
17002,210000,168000,0,0,0,0,0,0,0,59854,3000,56854,0,61330,2804,58526,0,62394,3000,59394,0,63912,3000,60912
17003,50000,40000,0,0,0,0,0,0,0,34274,3000,31274,0,38668,5000,33668,0,40416,2000,38416,0,20355,3000,17355
17004,80000,64000,0,0,0,0,0,1,0,0,0,0,0,0,0,0,-2,0,0,0,-2,0,0,0
17005,120000,96000,0,0,0,0,0,0,0,9423,438,8985,2,3345,1000,2345,0,2929,0,2929,0,2520,7,2513
17006,500000,400000,0,0,0,0,0,1,-2,0,0,0,-2,0,0,0,-2,881,881,0,-1,881,0,881
17007,50000,40000,0,0,0,0,1,0,0,0,0,0,-2,0,0,0,-2,50108,50108,0,-1,50765,2363,48402
17008,500000,400000,0,0,0,0,0,1,0,120972,106000,14972,0,117088,0,117088,2,121283,8008,113275,2,117583,78,117505
17009,150000,120000,0,0,0,0,0,0,-2,-3,0,-3,-2,-3,0,-3,-2,-3,0,-3,-2,-3,0,-3
17010,180000,144000,0,0,0,0,0,0,-1,7226,7228,-2,-1,5060,5060,0,-1,2832,2832,0,-1,1890,1890,0
17011,330000,264000,0,0,0,0,0,0,-1,0,0,0,-1,3899,3899,0,-1,2707,2707,0,-1,8000,8000,0
17012,150000,120000,0,0,0,0,0,0,2,75888,0,75888,2,77017,2960,74057,0,77706,3100,74606,0,79274,3000,76274
17013,280000,224000,0,0,0,0,0,0,0,166680,6500,160180,0,170691,6000,164691,0,14988,1000,13988,0,16776,2000,14776
17014,120000,96000,0,0,0,0,0,1,-1,1778,1781,-3,-1,1885,1885,0,-1,607,607,0,-1,687,687,0
17015,80000,64000,0,0,0,0,0,0,-1,1814,1817,-3,-1,4811,4817,-6,-1,1379,1381,-2,-1,6136,6137,-1
17016,170000,136000,0,1,1,1,1,0,0,166202,7500,158702,0,161973,6000,155973,0,167201,10000,157201,0,161327,7000,154327
17017,210000,168000,0,0,0,0,0,1,-1,29881,30366,-485,-1,24247,0,24247,0,21664,433,21231,0,1556,1556,0
17018,30000,24000,0,1,1,1,1,1,2,26060,1433,24627,0,26578,951,25627,0,27133,983,26150,0,27783,1099,26684
17019,260000,208000,0,0,0,0,0,0,0,171932,10000,161932,0,175152,9000,166152,0,180719,10000,170719,0,183138,7000,176138
17020,50000,40000,0,0,0,0,0,0,-1,8321,8321,0,-1,4453,4453,0,-1,4038,4038,0,-1,4764,4764,0
17021,20000,16000,0,0,0,0,0,0,-1,1261,1261,0,-1,1170,1170,0,-1,780,0,780,0,390,0,390
17022,30000,24000,0,0,0,0,0,0,-1,11146,11146,0,-1,7779,0,7779,0,8092,8092,0,-1,1565,1565,0
17023,230000,184000,0,0,0,0,0,0,0,108719,3941,104778,0,111039,4123,106916,0,113365,4267,109098,0,115625,4300,111325
17024,350000,280000,0,1,1,1,1,1,2,327193,12000,315193,2,333278,13000,320278,2,340791,13000,327791,2,348006,13000,335006
17025,50000,40000,0,0,0,0,0,0,-1,780,780,0,-1,780,390,390,2,390,0,390,0,390,390,0
17026,100000,80000,0,0,0,0,0,0,0,41800,2301,39499,0,0,0,0,0,0,0,0,-2,0,0,0
17027,80000,64000,0,0,0,0,0,1,3,63154,2500,60654,2,63519,2000,61519,2,64351,2000,62351,2,67122,4000,63122
17028,200000,160000,0,1,1,0,0,0,0,191500,7512,183988,0,187835,7500,180335,0,139070,5100,133970,0,140171,5100,135071
17029,20000,16000,1,1,1,1,1,0,3,20200,0,20200,2,19600,0,19600,0,19600,0,19600,0,20000,400,19600
17030,30000,24000,0,0,0,0,0,1,2,1050,0,1050,2,1050,0,1050,3,1050,0,1050,3,1050,0,1050
17031,140000,112000,0,0,0,0,0,0,0,25852,10048,15804,0,14390,5008,9382,0,13728,2018,11710,0,2905,2005,900
17032,50000,40000,0,1,1,1,1,0,0,47330,1800,45530,0,48337,1800,46537,0,49298,1748,47550,0,50510,1990,48520
17033,60000,48000,0,1,1,1,1,0,0,56127,2100,54027,0,57149,2000,55149,0,53721,2100,51621,0,54703,2000,52703
17034,200000,160000,0,0,0,0,0,0,0,44974,1300,43674,0,30844,2000,28844,0,15833,1000,14833,0,15833,16332,-499
17035,280000,224000,0,0,0,0,0,0,0,185257,6000,179257,0,188344,5083,183261,0,179764,5000,174764,0,167051,5036,162015
17036,50000,40000,0,1,0,0,0,0,0,50275,2097,48178,0,20089,1289,18800,0,19964,712,19252,0,19918,713,19205
17037,70000,56000,0,1,1,1,1,1,2,69670,3000,66670,2,70918,3000,67918,2,72165,3000,69165,2,70755,0,70755
17038,430000,344000,0,1,0,0,0,0,0,375827,13400,362427,0,330644,30696,299948,0,353036,53036,300000,0,355121,12752,342369
17039,20000,16000,0,0,0,0,1,1,0,14786,1554,13232,0,15532,1300,14232,0,16767,1500,15267,0,17104,750,16354
17040,50000,40000,0,0,0,0,0,0,0,34879,1636,33243,0,31820,1800,30020,0,9965,344,9621,0,10017,400,9617
17041,80000,64000,0,0,0,0,0,0,0,25614,1617,23997,0,21053,856,20197,0,18531,672,17859,0,19051,828,18223
17042,450000,360000,0,0,0,0,0,0,-1,390,390,0,-1,390,390,0,-1,389,389,0,-1,990,992,-2
17043,150000,120000,0,0,0,0,0,0,0,101572,3500,98072,0,103062,3000,100062,0,83567,3000,80567,0,85098,3100,81998
17044,20000,16000,0,1,1,1,1,0,0,20330,2000,18330,0,20199,1200,18999,0,19609,0,19609,0,19957,348,19609
17045,130000,104000,0,0,0,0,0,0,0,0,0,0,-2,0,0,0,-2,150,150,0,-1,1000,1000,0
17046,390000,312000,0,0,0,0,0,0,0,88653,20,88633,2,82226,3510,78716,0,71559,3349,68210,0,72492,3000,69492
17047,50000,40000,0,1,1,1,1,0,0,45408,1729,43679,0,48279,3600,44679,0,47406,0,47406,2,48553,2055,46498
17048,420000,336000,0,0,0,0,0,0,-2,1914,1923,-9,-2,1189,1194,-5,-2,1208,1214,-6,-2,4964,4988,-24
17049,50000,40000,0,0,0,0,0,0,2,33533,2231,31302,2,28591,1500,27091,2,28390,1300,27090,0,28739,1700,27039
17050,160000,128000,0,1,0,0,0,0,0,155026,4270,150756,0,79051,2518,76533,0,81089,2994,78095,0,-311,0,-311
17051,150000,120000,0,0,0,0,0,1,0,87265,10575,76690,0,85084,0,85084,2,93323,9717,83606,2,91783,0,91783
17052,120000,96000,0,0,0,0,0,0,0,6344,1000,5344,0,0,1326,-1326,0,0,0,0,-2,0,0,0
17053,200000,160000,0,0,0,0,0,0,-2,0,0,0,-2,0,0,0,-2,0,0,0,-2,0,0,0
17054,150000,120000,0,0,0,0,0,0,-1,-4,0,-4,-1,1494,1498,-4,-1,-6,0,-6,-1,8047,8053,-6
17055,30000,24000,0,1,1,1,1,0,2,27915,1200,26715,2,27185,0,27185,2,28806,2200,26606,2,28208,0,28208
17056,70000,56000,0,0,0,0,0,0,0,42791,3000,39791,0,43797,1718,42079,0,44938,2000,42938,0,47177,3000,44177
17057,390000,312000,0,0,0,0,0,1,2,131386,6000,125386,0,131879,3500,128379,0,115183,5000,110183,0,75131,4500,70631
17058,10000,8000,0,0,0,1,1,1,2,7132,1500,5632,0,8477,1500,6977,0,8292,0,8292,2,9861,1604,8257
17059,130000,104000,0,1,1,0,0,0,0,115939,5802,110137,0,109428,3487,105941,0,90359,2908,87451,0,89216,3013,86203
17060,150000,120000,0,0,0,0,0,0,0,108229,5500,102729,0,109374,4005,105369,0,111279,3241,108038,0,125353,15500,109853
17061,50000,40000,0,1,1,0,0,0,0,50688,2112,48576,0,49739,1400,48339,0,18888,700,18188,0,19290,700,18590
17062,500000,400000,0,0,0,0,0,1,-2,1950,2000,-50,-2,2739,2739,0,-1,2739,0,2739,0,170,170,0
17063,100000,80000,0,1,0,0,0,0,0,89762,3215,86547,0,77986,2792,75194,0,71031,1881,69150,0,66983,1945,65038
17064,260000,208000,0,0,0,0,0,0,0,3923,3945,-22,-1,9059,31086,-22027,-1,3360,3377,-17,-1,3657,3667,-10
17065,100000,80000,0,1,1,1,1,1,2,88223,7300,80923,2,85924,0,85924,3,86803,3200,83603,2,88745,3500,85245
17066,50000,40000,0,0,0,0,0,0,0,6495,2000,4495,0,2207,1000,1207,0,0,0,0,0,0,0,0
17067,90000,72000,0,0,0,0,1,1,0,60050,2771,57279,0,61448,3000,58448,0,73852,13500,60352,0,72551,0,72551
17068,290000,232000,0,0,0,0,0,0,-1,0,0,0,-1,28642,28642,0,-1,4098,0,4098,0,19024,19426,-402
17069,20000,16000,0,1,1,1,0,0,0,18456,1400,17056,0,18424,368,18056,0,18800,376,18424,0,10000,200,9800
17070,260000,208000,0,0,0,0,0,0,-2,6158,6160,-2,-2,9439,9439,0,-2,5492,5492,0,-2,397,397,0
17071,10000,8000,0,0,0,0,1,0,-1,3364,5000,-1636,-1,6129,3000,3129,0,9009,3000,6009,0,9188,329,8859
17072,50000,40000,0,0,0,0,0,0,0,40591,2021,38570,0,31609,1500,30109,0,29662,1009,28653,0,24741,1000,23741
17073,160000,128000,0,0,0,0,0,0,0,4500,0,4500,2,32468,32468,0,-1,22485,2000,20485,0,119853,104465,15388
17074,180000,144000,0,0,0,0,0,0,0,242063,145000,97063,-1,122295,26000,96295,0,-1005,0,-1005,0,1005,101005,-100000
17075,100000,80000,0,0,0,0,0,1,2,23312,0,23312,2,24617,2000,22617,0,25109,1200,23909,0,25654,1100,24554
17076,190000,152000,0,0,0,0,0,0,-2,2131,2131,0,-2,2131,2131,0,-2,2131,2131,0,-2,0,0,0
17077,100000,80000,0,0,0,0,0,0,2,24909,2569,22340,2,24210,0,24210,2,26103,2287,23816,2,27554,2028,25526
17078,200000,160000,0,0,0,0,0,0,-1,2394,2394,0,-1,15612,15648,-36,-1,525,0,525,0,0,0,0
17079,290000,232000,0,1,0,0,1,0,0,276346,16346,260000,0,0,0,0,0,281225,281225,0,-1,288652,11787,276865
17080,310000,248000,0,0,0,0,0,0,2,2745,4000,-1255,-1,-626,0,-626,-1,110,1000,-890,-1,-154,0,-154
17081,40000,32000,0,0,0,0,0,0,3,8885,200,8685,2,10583,2000,8583,2,10269,0,10269,3,9960,0,9960
17082,240000,192000,0,0,0,0,0,0,-1,-563,0,-563,-2,254,1213,-959,-1,-142,0,-142,-1,344,1032,-688
17083,100000,80000,0,0,0,0,0,0,2,0,0,0,2,3198,3198,0,-1,3198,0,3198,0,5198,2000,3198
17084,490000,392000,0,0,0,0,0,0,0,349958,20059,329899,0,340602,12943,327659,0,303047,15049,287998,0,331606,50017,281589
17085,40000,32000,0,1,1,1,1,0,0,37968,2000,35968,0,36155,1500,34655,0,36933,1500,35433,0,37666,1500,36166
17086,210000,168000,0,0,0,0,0,0,-1,815,815,0,-1,910,910,0,-1,58095,58000,95,0,37684,1500,36184
17087,360000,288000,0,0,0,0,0,0,-2,0,0,0,-2,499,499,0,-1,1113,1113,0,-1,392,392,0
17088,20000,16000,0,0,0,0,0,0,-1,900,390,510,-1,704,1094,-390,-1,540,2420,-1880,-1,150,150,0
17089,360000,288000,0,0,0,0,0,0,-1,11044,11044,0,-1,15887,15895,-8,-1,8607,8607,0,-1,8843,8843,0
17090,120000,96000,0,0,0,0,0,0,0,54699,1944,52755,0,54832,5000,49832,0,53693,3692,50001,0,48731,0,48731
17091,200000,160000,0,0,0,0,0,0,0,6989,1106,5883,0,6619,335,6284,0,7362,845,6517,0,7252,1513,5739
17092,500000,400000,0,0,0,0,0,0,-1,1111,1111,0,-1,1175,1175,0,-1,3162,3162,0,-1,1638,33,1605
17093,50000,40000,0,0,0,0,0,1,2,18566,0,18566,2,19918,2000,17918,0,19584,1500,18084,0,18508,1000,17508
17094,450000,360000,0,0,0,0,0,0,-2,2278,2289,-11,-2,4714,4737,-23,-2,768,771,-3,-2,1069,1074,-5
17095,180000,144000,0,0,0,0,0,0,0,82508,3000,79508,0,81808,4000,77808,0,86024,9000,77024,0,67747,0,67747
17096,20000,16000,0,0,0,0,0,0,0,0,0,0,0,0,0,0,-2,0,0,0,-2,0,0,0
17097,220000,176000,0,0,0,0,0,0,-1,4925,4925,0,-1,12554,12606,-52,-1,1036,0,1036,0,522,572,-50
17098,80000,64000,0,0,0,0,0,0,0,7605,1000,6605,0,0,0,0,0,0,0,0,-2,3011,3011,0
17099,100000,80000,0,0,0,0,0,0,-2,1050,1257,-207,-2,0,0,0,-2,0,0,0,-2,0,0,0
17100,200000,160000,0,1,0,0,0,1,2,202668,8756,193912,0,111486,5003,106483,0,118951,10053,108898,0,89077,10066,79011
17101,280000,224000,0,0,0,0,0,0,-2,262,262,0,-2,1203,1203,0,-2,4,150,-146,-2,320,470,-150
17102,330000,264000,1,1,1,1,1,1,7,365250,0,365250,6,358145,0,358145,5,352121,0,352121,4,346216,0,346216
17103,270000,216000,0,0,0,0,0,0,-2,6896,6909,-13,-2,8583,8587,-4,-2,880,880,0,-2,4861,4861,0
17104,660000,528000,0,0,0,0,0,0,0,349361,12113,337248,0,331565,12004,319561,0,329604,12008,317596,0,322581,11503,311078
17105,280000,224000,0,0,0,0,0,0,-2,192,192,0,-2,396,996,-600,-2,0,0,0,-2,396,396,0
17106,480000,384000,0,0,0,0,0,1,-2,148544,149654,-1110,-2,18791,18885,-94,-2,5909,5940,-31,-2,68988,69337,-349
17107,30000,24000,0,1,1,1,1,1,0,30090,4000,26090,0,28908,0,28908,2,30472,2400,28072,2,29483,0,29483
17108,50000,40000,0,0,0,0,0,0,0,36087,1779,34308,0,9636,320,9316,0,9590,500,9090,0,10030,1000,9030
17109,20000,16000,0,1,1,0,0,0,0,20149,1749,18400,0,19870,1250,18620,0,-200,200,-400,0,16636,20901,-4265
17110,50000,40000,0,0,0,0,0,0,-2,0,0,0,-2,0,0,0,-2,0,0,0,-2,2949,2322,627
17111,390000,312000,0,0,0,0,0,0,-1,211996,38142,173854,0,210100,15152,194948,0,206462,38097,168365,0,203201,23080,180121
17112,310000,248000,0,0,0,0,0,0,2,547,547,0,-1,3913,3913,0,-1,670,670,0,-1,2489,2489,0
17113,50000,40000,0,1,0,0,0,0,0,43701,2000,41701,0,40429,1118,39311,0,9727,1000,8727,0,9606,500,9106
17114,200000,160000,0,0,0,0,0,0,-1,105,105,0,-1,0,0,0,-1,7384,7384,0,-1,8588,8588,0
17115,270000,216000,0,0,0,0,0,0,2,149449,7100,142349,0,150893,5500,145393,0,153878,6000,147878,0,157324,6000,151324
17116,50000,40000,0,0,0,0,0,0,2,25098,900,24198,2,24396,0,24396,2,25310,1310,24000,0,25740,1000,24740
17117,20000,16000,0,0,0,0,0,1,0,220,0,220,2,632,632,0,-1,0,0,0,-1,316,316,0
17118,50000,40000,0,0,0,0,0,0,0,11902,5000,6902,0,13871,5000,8871,0,19466,7000,12466,0,8128,3000,5128
17119,90000,72000,0,0,0,0,0,0,0,49899,1502,48397,0,37251,2006,35245,0,33061,1500,31561,0,30869,1500,29369
17120,30000,24000,0,0,0,0,0,0,0,13565,1539,12026,0,15526,2500,13026,0,14979,0,14979,2,15735,1000,14735
17121,80000,64000,0,1,0,0,0,0,0,67150,3000,64150,0,44374,5000,39374,0,48974,37000,11974,0,35396,2000,33396
17122,160000,128000,0,0,0,0,0,0,0,0,0,0,-2,0,0,0,-2,0,0,0,-2,0,0,0
17123,440000,352000,0,0,0,0,0,0,0,150150,5802,144348,0,139178,3577,135601,0,123627,2955,120672,0,48175,12000,36175
17124,350000,280000,0,0,0,0,0,0,0,58719,2200,56519,0,60737,3000,57737,0,63593,4000,59593,0,82202,20000,62202
17125,30000,24000,0,1,1,1,1,0,2,26719,1445,25274,0,27774,1500,26274,0,28809,1500,27309,0,30399,2200,28199
17126,50000,40000,0,0,0,0,0,0,-1,590,590,0,-1,3700,3700,0,-1,1999,1999,0,-1,7300,7300,0
17127,20000,16000,0,0,0,0,0,0,-1,344,344,0,-1,2340,2340,0,-1,6702,4702,2000,0,339,339,0
17128,110000,88000,0,1,0,0,0,0,0,109921,3348,106573,0,67212,2444,64768,0,49120,3869,45251,0,49772,1808,47964
17129,140000,112000,0,0,1,1,1,0,0,116956,5900,111056,0,119334,5800,113534,0,120661,4800,115861,0,123256,4700,118556
17130,30000,24000,0,1,1,1,1,0,0,30005,2000,28005,0,30452,1200,29252,0,29197,1600,27597,0,29381,1211,28170
17131,70000,56000,0,0,0,0,0,0,0,51435,2009,49426,0,51512,2397,49115,0,54709,5912,48797,0,52462,0,52462
17132,50000,40000,0,1,0,0,0,0,0,46549,1660,44889,0,20084,3000,17084,0,20264,1004,19260,0,19064,1003,18061
17133,220000,176000,0,0,1,1,1,0,0,179024,6500,172524,0,183050,7000,176050,0,207481,27640,179841,0,204082,0,204082
17134,90000,72000,0,0,0,0,0,0,-2,1443,1443,0,-2,13982,13982,0,-2,4105,4105,0,-2,1594,1765,-171
17135,300000,240000,0,0,0,0,0,0,-2,2454,2454,0,-2,217960,218000,-40,-2,0,0,0,-2,0,0,0
17136,250000,200000,0,0,0,0,0,1,-1,652,652,0,-1,326,0,326,0,326,326,0,-1,326,326,0
17137,210000,168000,0,0,0,0,0,0,0,82525,5000,77525,0,84353,3200,81153,0,87835,5000,82835,0,79481,3000,76481
17138,80000,64000,0,0,0,0,0,1,2,25917,6142,19775,2,19081,0,19081,2,15200,0,15200,0,13039,0,13039
17139,420000,336000,0,0,0,0,0,0,-1,6244,6500,-256,-1,2970,3004,-34,-1,3608,3797,-189,-1,3019,3103,-84
17140,360000,288000,0,0,0,0,0,0,-2,0,0,0,-2,0,0,0,-2,0,0,0,-2,0,0,0
17141,300000,240000,0,0,0,0,0,0,-1,-337,0,-337,-2,-337,0,-337,-2,-337,0,-337,-2,-337,0,-337
17142,440000,352000,0,0,0,0,0,0,0,274075,11000,263075,0,252584,10000,242584,0,216547,9000,207547,0,179221,7100,172121
17143,130000,104000,0,0,0,0,0,0,0,54735,2635,52100,0,31682,1700,29982,0,0,0,0,0,0,0,0
17144,260000,208000,0,1,1,0,0,1,2,244949,0,244949,2,248273,11000,237273,0,119124,4321,114803,0,132619,20000,112619
17145,50000,40000,0,0,0,0,0,0,-1,0,0,0,-1,0,0,0,-2,0,0,0,-2,0,0,0
17146,370000,296000,0,0,0,0,0,0,0,187344,8000,179344,0,192213,9000,183213,0,193602,7000,186602,0,196470,7000,189470
17147,150000,120000,0,0,0,1,1,0,0,119935,4000,115935,0,124913,6006,118907,0,128108,5000,123108,0,131382,5008,126374
17148,90000,72000,0,0,0,0,0,1,2,13523,1500,12023,2,13704,700,13004,2,13882,700,13182,2,14015,500,13515
17149,70000,56000,0,0,0,0,0,1,0,21307,1300,20007,0,8840,500,8340,0,8131,1000,7131,0,7535,1000,6535
17150,300000,240000,0,0,0,0,0,0,-2,0,0,0,-2,11940,11940,0,-1,17693,17693,0,-1,2402,2402,0
17151,30000,24000,0,1,1,1,1,0,0,26628,1750,24878,0,27678,1800,25878,0,28084,1165,26919,0,30068,2600,27468
17152,400000,320000,0,0,0,0,0,0,-2,13052,13972,-920,-2,12639,13046,-407,-2,12315,13040,-725,-2,7831,7923,-92
17153,340000,272000,0,0,0,0,0,1,-2,-8,0,-8,-2,-8,0,-8,-2,1595,1603,-8,-1,-5,0,-5
17154,150000,120000,0,0,0,0,0,0,0,0,0,0,-2,1662,1662,0,-1,0,0,0,-1,0,0,0
17155,310000,248000,0,0,0,0,0,0,-1,17257,2270,14987,-1,7900,4,7896,2,17161,17161,0,-1,14585,7030,7555
17156,580000,464000,0,0,0,0,0,0,0,38111,8348,29763,0,33497,6593,26904,0,26800,7197,19603,0,22202,10097,12105
17157,170000,136000,0,0,0,0,0,0,-2,6844,6844,0,-2,1467,1467,0,-2,4797,9594,-4797,-2,2659,2659,0
17158,380000,304000,0,0,0,0,0,0,0,120550,3011,117539,0,550,550,0,0,100,100,0,-2,550,1000,-450
17159,130000,104000,0,0,0,0,0,0,-1,11929,11929,0,-1,5722,5722,0,-1,3076,0,3076,0,5250,5250,0
17160,90000,72000,0,0,0,0,0,1,0,25286,5064,20222,0,8773,5007,3766,0,3786,3788,-2,-1,390,390,0
17161,70000,56000,0,1,0,0,0,0,0,58599,1924,56675,0,49179,1726,47453,0,49080,1763,47317,0,49705,2136,47569
17162,360000,288000,0,0,0,0,0,1,-1,-200,0,-200,-2,0,200,-200,-2,5084,5084,0,-1,2500,0,2500
17163,130000,104000,0,0,0,0,0,0,0,10174,1187,8987,0,11036,1439,9597,0,10552,345,10207,0,9934,346,9588
17164,330000,264000,0,0,0,0,0,0,-1,1488,1507,-19,-1,0,0,0,-2,3965,3965,0,-1,8676,8676,0
17165,100000,80000,0,1,0,0,0,0,0,99147,4600,94547,0,74548,3000,71548,0,76284,2940,73344,0,77841,3000,74841
17166,150000,120000,0,0,0,0,0,0,-2,6106,6106,0,-2,4357,4357,0,-2,0,0,0,-2,0,0,0
17167,150000,120000,0,0,0,0,0,1,-2,0,0,0,-2,0,0,0,-2,0,0,0,-2,0,0,0
17168,320000,256000,0,0,0,0,0,0,0,25331,3000,22331,0,25741,1500,24241,0,26800,2000,24800,0,28817,3000,25817
17169,440000,352000,0,0,0,0,0,1,2,204369,54,204315,2,186201,7530,178671,0,183518,7648,175870,0,148169,6310,141859
17170,230000,184000,0,0,0,0,0,0,-1,0,0,0,-2,8780,8780,0,-1,11990,11990,0,-1,0,0,0
17171,320000,256000,0,0,0,0,0,0,-1,36538,12000,24538,0,34603,2000,32603,0,31596,1000,30596,0,30155,1000,29155
17172,20000,16000,0,1,1,1,1,1,2,19082,0,19082,2,18890,667,18223,0,19287,692,18595,0,19751,776,18975
17173,50000,40000,0,0,1,0,0,0,0,50199,38000,12199,0,74405,1500,72905,0,38772,4000,34772,0,39438,2000,37438
17174,330000,264000,0,0,0,0,0,1,-2,34284,10054,24230,-2,2780,2840,-60,-1,20247,21101,-854,-1,1806,1814,-8
17175,500000,400000,0,0,0,0,0,0,-2,22722,22827,-105,-2,7521,7521,0,-2,71439,71439,0,-2,8981,981,8000
17176,220000,176000,0,0,0,0,0,0,-1,-200,0,-200,-2,4040,4240,-200,-1,4040,0,4040,-1,-1269,0,-1269
17177,70000,56000,0,0,0,0,0,0,0,28867,1480,27387,0,29766,1360,28406,0,26522,960,25562,0,27584,1500,26084
17178,200000,160000,0,0,0,0,0,0,0,82692,4000,78692,0,86305,5000,81305,0,88961,5000,83961,0,92513,5000,87513
17179,30000,24000,0,1,1,1,1,0,0,27788,3608,24180,0,25484,0,25484,2,25707,1000,24707,0,25797,1100,24697
17180,190000,152000,0,0,0,1,1,0,0,152886,6000,146886,0,156273,6000,150273,0,159800,6000,153800,0,162570,6000,156570
17181,250000,200000,0,0,0,0,0,0,-2,44179,44385,-206,-2,37145,40682,-3537,-2,46733,46873,-140,-2,46963,47104,-141
17182,310000,248000,0,0,0,0,0,0,0,30488,2000,28488,0,27112,1000,26112,0,24722,1000,23722,0,9862,661,9201
17183,200000,160000,0,0,0,0,0,0,-2,6331,6331,0,-1,6460,129,6331,0,630,630,0,-1,500,500,0
17184,80000,64000,0,0,0,0,0,0,0,10935,10935,0,-1,2318,2324,-6,-1,-711,707,-1418,-1,-708,3,-711
17185,200000,160000,0,0,0,0,0,0,-1,103,103,0,-1,0,0,0,-1,0,0,0,-2,0,0,0
17186,100000,80000,0,0,0,0,0,0,-2,0,0,0,-2,0,0,0,-2,0,0,0,-2,0,0,0
17187,110000,88000,0,0,0,0,0,1,0,74379,3000,71379,0,75878,3000,72878,0,78503,3500,75003,0,80451,3000,77451
17188,140000,112000,0,1,1,1,1,0,0,137909,0,137909,0,138999,5000,133999,0,137275,9100,128175,2,136141,3400,132741
17189,160000,128000,0,0,0,0,0,0,-1,1857,2252,-395,-1,550,9694,-9144,-1,2602,10000,-7398,-1,10381,11797,-1416
17190,70000,56000,0,1,0,0,0,1,0,65867,3068,62799,0,55969,2410,53559,0,41298,0,41298,0,0,0,0
17191,230000,184000,0,0,0,0,0,0,-1,380,380,0,-1,2100,2100,0,-1,530,530,0,-1,2282,2282,0
17192,420000,336000,0,0,0,0,0,0,0,207548,7763,199785,0,211990,7768,204222,0,216362,7768,208594,0,220728,7877,212851
17193,70000,56000,0,1,1,1,1,0,0,68263,3052,65211,0,68927,3348,65579,0,69176,2617,66559,0,70592,2840,67752
17194,330000,264000,0,0,0,0,0,0,-1,291,291,0,-1,1051,1051,0,-1,1011,1011,0,-1,1051,1051,0
17195,190000,152000,0,0,0,0,0,0,0,82179,2912,79267,0,80874,2871,78003,0,81720,3501,78219,0,87685,8001,79684
17196,30000,24000,0,0,0,0,0,0,0,5837,1300,4537,0,6778,1200,5578,0,6912,247,6665,0,7057,256,6801
17197,280000,224000,0,0,0,0,0,0,-1,2711,2711,0,-1,4464,4476,-12,-1,4069,4069,0,-1,5161,5161,0
17198,20000,16000,0,0,0,0,0,1,0,11700,0,11700,2,13474,2000,11474,2,13006,0,13006,2,13743,1055,12688
17199,360000,288000,1,1,1,1,1,0,0,455591,16489,439102,0,430313,14128,416185,0,406010,13210,392800,0,377820,10442,367378
17200,40000,32000,0,0,0,0,0,0,0,2360,1000,1360,0,38639,38639,0,-1,8899,178,8721,0,0,0,0
17201,210000,168000,0,0,0,0,0,0,-2,416,1548,-1132,-1,1132,1132,0,-1,566,0,566,2,416,416,0
17202,400000,320000,0,0,0,0,0,0,-1,629,629,0,-1,0,0,0,-1,303,303,0,-1,219,219,0
17203,30000,24000,1,1,1,1,0,1,0,30031,0,30031,2,29838,597,29241,0,29651,593,29058,0,1567,31,1536
17204,20000,16000,0,0,0,0,0,1,2,10853,10600,253,0,10670,800,9870,0,-120,0,-120,0,-120,0,-120
17205,30000,24000,0,1,1,1,1,1,2,29066,0,29066,2,31236,3000,28236,2,29819,0,29819,2,30058,1500,28558
17206,150000,120000,0,0,0,0,0,0,0,125026,8000,117026,0,108358,5000,103358,0,110070,5000,105070,0,111654,5000,106654
17207,50000,40000,0,0,0,0,0,0,2,31902,32013,-111,-1,11044,11079,-35,-1,0,0,0,-1,0,0,0
17208,120000,96000,0,0,0,0,0,0,-1,3333,3333,0,-1,0,0,0,-1,984,984,0,-1,984,984,0
17209,360000,288000,0,0,0,0,0,0,0,83055,4000,79055,0,85662,4000,81662,0,87458,4000,83458,0,86393,3300,83093
17210,20000,16000,0,1,1,1,1,1,2,19381,2921,16460,2,18772,0,18772,2,19145,685,18460,0,19545,708,18837
17211,360000,288000,0,0,0,0,0,0,-1,1070,1075,-5,-1,-10,0,-10,-1,2107,2117,-10,-1,627,630,-3
17212,30000,24000,0,0,0,0,0,1,0,14911,3000,11911,0,15819,1500,14319,2,15346,0,15346,2,16666,1500,15166
17213,60000,48000,0,1,0,0,0,1,0,54636,1500,53136,0,18293,1000,17293,0,18107,1000,17107,0,18803,1000,17803
17214,10000,8000,0,1,1,1,1,0,0,9414,1150,8264,0,9344,480,8864,0,9545,500,9045,0,9586,348,9238
17215,150000,120000,0,0,0,0,0,1,0,29356,1489,27867,0,30777,2000,28777,0,32193,2000,30193,0,32589,1169,31420
17216,70000,56000,0,0,0,0,0,1,2,13633,3000,10633,2,13117,0,13117,2,14096,1200,12896,2,13727,0,13727
17217,100000,80000,0,0,0,0,0,0,0,50099,2000,48099,0,52259,3000,49259,0,53389,2000,51389,0,55519,3000,52519
17218,130000,104000,0,1,1,1,1,0,0,133745,10000,123745,0,130814,0,130814,2,130758,4500,126258,0,123468,4500,118968
17219,280000,224000,0,1,1,1,1,0,0,267668,12001,255667,0,262905,12000,250905,0,260296,9510,250786,0,254023,10002,244021
17220,150000,120000,0,0,0,0,0,0,0,78407,20028,58379,0,73688,3152,70536,0,56995,2025,54970,0,52887,5211,47676
17221,30000,24000,0,0,0,1,1,0,0,29779,12000,17779,0,29749,6000,23749,0,30053,6000,24053,0,29674,5000,24674
17222,500000,400000,0,1,0,1,0,0,0,467911,13566,454345,2,355531,18975,336556,0,587067,11096,575971,0,323821,35204,288617
17223,80000,64000,0,0,0,0,0,0,-1,5986,5995,-9,-1,188,188,0,-1,1644,1644,0,-1,16872,16872,0
17224,500000,400000,0,0,0,0,0,0,0,205895,8000,197895,0,212010,10010,202000,0,214287,7500,206787,0,218266,7266,211000
17225,180000,144000,0,1,0,0,0,0,0,150710,6606,144104,0,135981,5000,130981,0,136064,4900,131164,0,137343,4900,132443
17226,150000,120000,0,0,0,0,0,1,2,62650,0,62650,2,59255,10000,49255,2,45983,0,45983,2,52986,20000,32986
17227,130000,104000,0,1,1,1,1,0,0,127658,4710,122948,0,127362,4500,122862,0,128726,9400,119326,0,129081,3600,125481
17228,130000,104000,0,0,0,0,0,0,2,1030,1034,-4,-1,357,727,-370,-1,357,0,357,0,370,13,357
17229,180000,144000,0,0,0,0,0,0,-1,2111,2115,-4,-1,1027,1027,0,-1,596,596,0,-1,589,589,0
17230,300000,240000,0,0,0,0,0,0,-1,120927,120927,0,-1,105303,0,105303,0,82475,716,81759,0,33262,25213,8049
17231,190000,152000,0,0,0,0,0,0,-1,3190,0,3190,2,0,0,0,2,0,0,0,-2,0,0,0
17232,70000,56000,0,0,0,1,0,0,0,53264,2888,50376,0,51464,1800,49664,0,96184,2000,94184,0,49104,1900,47204
17233,180000,144000,0,0,0,0,0,1,0,2644,1000,1644,0,1300,1300,0,-1,2644,2644,0,-1,0,0,0
17234,60000,48000,0,0,0,0,0,0,0,21702,1542,20160,0,22360,1200,21160,0,19760,500,19260,0,0,0,0
17235,50000,40000,0,0,1,1,1,0,0,42736,3000,39736,0,43751,1729,42022,0,44619,1597,43022,0,45900,2000,43900
17236,120000,96000,0,0,0,0,0,0,2,70415,3400,67015,2,74443,5800,68643,2,75527,2900,72627,2,77171,3000,74171
17237,150000,120000,0,0,0,0,0,0,0,27882,1765,26117,0,28894,1777,27117,0,29313,1196,28117,0,29924,1233,28691
17238,240000,192000,0,0,0,0,0,0,0,15535,2000,13535,0,17734,3000,14734,0,19734,2000,17734,0,8561,2000,6561
17239,350000,280000,0,0,0,0,0,0,-2,3101,3116,-15,-2,17321,17414,-93,-2,-22,0,-22,-2,4443,4465,-22
17240,20000,16000,0,0,1,1,1,0,2,17164,2000,15164,2,16594,0,16594,2,18158,2000,16158,0,19554,1700,17854
17241,130000,104000,0,0,0,0,0,1,-1,1017,1200,-183,-1,1298,1300,-2,-1,550,964,-414,-1,-286,1698,-1984
17242,310000,248000,1,1,1,0,0,0,0,322273,12131,310142,0,272890,8543,264347,0,208257,10185,198072,0,206609,8290,198319
17243,80000,64000,0,0,0,0,0,0,-1,1845,1856,-11,-1,1799,1804,-5,-1,599,600,-1,-1,-1,0,-1
17244,240000,192000,0,1,1,0,0,0,0,244010,9303,234707,0,239778,8159,231619,0,191762,5449,186313,0,196015,5900,190115
17245,240000,192000,0,0,0,0,0,0,0,187258,17020,170238,0,189435,5268,184167,0,145032,4179,140853,0,147370,4903,142467
17246,280000,224000,0,1,1,1,1,0,0,282851,11234,271617,0,251648,11002,240646,0,255697,10000,245697,0,261691,10000,251691
17247,230000,184000,0,0,0,0,0,0,0,44234,2500,41734,0,45684,2500,43184,0,46653,2000,44653,0,47779,2000,45779
17248,170000,136000,0,0,0,0,0,0,0,0,0,0,0,0,0,0,-2,0,0,0,-2,0,0,0
17249,360000,288000,0,0,0,0,0,0,0,1901,1901,0,-1,2355,2355,0,-1,4206,4206,0,-1,5889,5889,0
17250,310000,248000,0,0,0,0,0,1,2,0,0,0,-2,0,0,0,-2,0,0,0,-2,0,0,0
17251,20000,16000,0,0,0,0,0,0,-1,10785,10785,0,-1,390,390,0,-1,6210,6210,0,-1,1040,1040,0
17252,200000,160000,0,0,0,0,0,0,-2,4846,4850,-4,-2,807,1047,-240,-2,2183,2183,0,-2,210,210,0
17253,30000,24000,1,1,1,1,1,0,0,32779,1580,31199,0,31557,1358,30199,0,30094,895,29199,0,27223,1217,26006
17254,210000,168000,0,0,0,0,0,0,0,43023,2500,40523,0,44005,2000,42005,0,45294,2000,43294,0,46387,2000,44387
17255,170000,136000,0,0,0,0,0,1,-1,1078,1078,0,-1,1392,1392,0,-1,1606,1606,0,-1,9955,9955,0
17256,10000,8000,0,0,0,0,0,1,3,3940,0,3940,3,4720,1000,3720,2,4500,0,4500,3,4282,0,4282
17257,180000,144000,0,0,0,0,0,0,0,112784,4030,108754,0,114794,4211,110583,0,105248,3798,101450,0,107130,4000,103130
17258,360000,288000,0,0,0,0,0,0,-1,3542,3752,-210,-1,6487,6487,0,-1,3437,3437,0,-1,4875,4875,0
17259,500000,400000,0,0,0,0,0,0,0,166739,8009,158730,0,166464,5301,161163,0,168722,5220,163502,0,170299,5419,164880
17260,210000,168000,0,0,0,0,0,0,-2,24329,24259,70,-2,780,780,0,-2,0,0,0,-2,1615,1615,0
17261,150000,120000,0,0,0,0,0,0,-1,12848,4000,8848,0,8445,0,8445,0,6868,0,6868,0,1310,1310,0
17262,500000,400000,0,0,0,0,0,0,2,1800,1800,0,-1,0,0,0,-1,0,0,0,-2,4012,4012,0
17263,200000,160000,0,0,0,0,0,0,-1,9389,9421,-32,-1,18475,14068,4407,0,1016,3,1013,0,4934,4948,-14
17264,200000,160000,0,0,0,0,0,0,-2,3514,3514,0,-2,4042,4042,0,-2,8606,8606,0,-2,1870,1870,0
17265,50000,40000,0,1,1,0,0,0,0,51192,3000,48192,0,50895,3500,47395,0,19535,1000,18535,0,20093,1000,19093
17266,230000,184000,0,0,0,0,0,0,-1,3090,3099,-9,-1,1879,1884,-5,-1,30467,30468,-1,-1,4460,4473,-13
17267,240000,192000,0,0,0,0,0,1,0,72050,4000,68050,0,0,0,0,0,0,0,0,-2,0,0,0
17268,50000,40000,0,0,0,0,0,0,2,20616,700,19916,2,20977,1000,19977,2,23287,2970,20317,2,22637,0,22637
17269,20000,16000,0,0,0,0,0,1,-1,0,0,0,-2,0,0,0,-2,0,0,0,-2,0,0,0
17270,80000,64000,0,0,0,0,0,0,-1,6848,6853,-5,-1,1719,1719,0,-1,1378,1378,0,-1,19942,19942,0
17271,40000,32000,0,0,0,0,0,0,-2,0,0,0,-2,0,0,0,-2,0,0,0,-2,0,0,0
17272,380000,304000,0,0,0,0,0,0,-2,32475,33178,-703,-1,32891,1171,31720,0,33564,1197,32367,0,34056,1250,32806
17273,120000,96000,0,0,0,0,0,0,0,45428,1732,43696,0,34401,2041,32360,0,34360,1000,33360,0,35523,1500,34023
17274,60000,48000,1,1,1,0,0,1,4,64005,0,64005,3,61769,0,61769,2,51722,51722,0,-1,44956,16000,28956
17275,20000,16000,0,0,0,0,0,0,0,2778,0,2778,2,6572,6572,0,-1,5016,5016,0,-1,2508,0,2508
17276,230000,184000,0,0,0,0,0,0,-2,196,196,0,-2,533,533,0,-1,1238,1238,0,-1,957,957,0
17277,100000,80000,0,0,0,0,0,0,2,82342,3600,78742,0,81967,3800,78167,0,82177,3000,79177,0,78840,3000,75840
17278,300000,240000,0,0,0,0,0,1,0,11293,1200,10093,2,12000,1200,10800,2,3458,9427,-5969,-1,56338,55000,1338
17279,200000,160000,0,0,0,0,0,0,-2,390,390,0,-2,390,390,0,-2,540,540,0,-2,390,390,0
17280,140000,112000,0,0,0,0,0,0,-1,1170,1170,0,-1,390,0,390,0,0,0,0,0,930,930,0
17281,50000,40000,0,0,0,0,0,0,-1,390,390,0,-1,390,390,0,-1,0,0,0,-1,780,780,0
17282,130000,104000,0,0,0,0,0,0,0,10341,2000,8341,0,9788,2290,7498,0,7193,1005,6188,0,9006,4078,4928
17283,30000,24000,0,0,0,0,0,0,-1,0,0,0,-1,5780,5780,0,-1,11611,6611,5000,0,0,0,0
17284,130000,104000,0,0,0,0,0,0,0,20487,1644,18843,0,21497,1654,19843,0,21617,774,20843,0,22268,1000,21268
17285,80000,64000,0,1,1,1,1,0,0,78534,3500,75034,0,80016,3400,76616,0,76235,3000,73235,0,78245,3500,74745
17286,300000,240000,0,0,0,0,0,0,-2,0,0,0,-2,0,0,0,-2,0,0,0,-2,0,0,0
17287,410000,328000,0,0,0,0,0,0,0,7267,1031,6236,0,14190,14224,-34,-1,132106,132116,-10,-1,289397,163020,126377
17288,280000,224000,0,0,0,0,0,0,0,62665,3000,59665,0,63730,2315,61415,0,57916,2103,55813,0,59122,2500,56622
17289,320000,256000,0,0,0,0,0,0,-2,1265,1265,0,-2,3031,3031,0,-2,13001,13001,0,-2,8807,8807,0
17290,130000,104000,0,0,0,0,0,0,-1,1958,1010,948,0,1462,1466,-4,-1,2573,2581,-8,-1,2402,2509,-107
17291,300000,240000,0,0,0,0,0,0,-2,0,0,0,-2,0,0,0,-2,0,0,0,-2,0,0,0
17292,80000,64000,0,0,0,0,0,0,-1,1074,1074,0,-1,35783,35000,783,0,35488,1300,34188,0,36020,1400,34620
17293,50000,40000,0,0,0,0,0,0,0,10447,0,10447,2,12247,2020,10227,0,9195,0,9195,0,4995,100,4895
17294,260000,208000,0,0,0,0,0,1,-1,0,0,0,-2,0,0,0,-2,0,0,0,-2,0,0,0
17295,130000,104000,0,0,0,0,0,1,0,111465,11350,100115,0,93557,0,93557,2,95582,3500,92082,0,96226,4200,92026
17296,100000,80000,0,0,0,0,0,0,0,49000,1500,47500,0,-1000,0,-1000,0,0,31000,-31000,-2,0,0,0
17297,270000,216000,0,0,0,0,0,0,-2,27067,27787,-720,-2,40359,40569,-210,-2,51264,53500,-2236,-2,34874,35051,-177
17298,410000,328000,0,0,0,0,0,0,-2,6764,6764,0,-2,1743,3542,-1799,-1,149153,161064,-11911,-1,145597,5072,140525
17299,80000,64000,0,0,0,0,0,0,0,49662,2000,47662,0,48867,1656,47211,0,48278,1693,46585,0,46773,1767,45006
17300,280000,224000,0,0,0,0,0,0,-2,-11,0,-11,-2,-11,0,-11,-2,2572,2583,-11,-1,9532,9566,-34
17301,210000,168000,0,0,0,0,0,0,-1,7526,7526,0,-1,10217,5000,5217,0,11737,5000,6737,0,8114,162,7952
17302,50000,40000,0,0,0,0,0,0,0,25350,10000,15350,0,25738,1500,24238,0,25948,1000,24948,0,26163,1000,25163
17303,210000,168000,0,0,0,0,0,0,0,119812,10100,109712,0,120763,4400,116363,2,118722,0,118722,2,121249,4500,116749
17304,150000,120000,0,0,0,0,0,0,-2,0,0,0,-2,0,0,0,-2,0,0,0,-2,318,318,0
17305,180000,144000,0,0,0,0,0,0,0,16995,6995,10000,0,15324,282,15042,0,6758,0,6758,0,5730,200,5530
17306,20000,16000,0,0,0,0,0,1,2,10467,600,9867,2,11987,2000,9987,2,11503,0,11503,3,11175,0,11175
17307,300000,240000,0,0,0,0,0,0,-2,318,319,-1,-2,2488,2488,0,-2,187,187,0,-2,607,607,0
17308,60000,48000,0,0,0,0,0,1,2,15444,5,15439,2,13695,1000,12695,0,17598,5000,12598,0,17472,1000,16472
17309,380000,304000,0,0,0,0,0,0,-2,5736,5766,-30,-2,900,904,-4,-2,16915,16915,0,-2,936,940,-4
17310,180000,144000,0,0,0,0,0,1,2,0,0,0,-2,0,0,0,-2,0,0,0,-2,0,0,0
17311,280000,224000,0,0,0,0,0,0,-2,0,1195,-1195,-2,5970,5970,0,-2,8628,8628,0,-2,2036,2306,-270
17312,30000,24000,0,1,1,1,1,1,2,30393,1600,28793,0,29785,1585,28200,0,30377,1377,29000,0,30155,1155,29000
17313,200000,160000,0,0,0,0,0,0,-2,3150,3165,-15,-2,0,0,0,-2,0,0,0,-2,0,0,0
17314,360000,288000,0,0,0,0,0,0,0,109845,4031,105814,0,105271,3082,102189,0,96644,7018,89626,0,94973,2755,92218
17315,30000,24000,0,1,1,1,1,1,2,26011,0,26011,2,27353,2078,25275,2,26776,0,26776,2,28620,2291,26329
17316,100000,80000,0,0,0,0,0,0,0,35538,2000,33538,0,34958,2000,32958,0,34039,2000,32039,0,33650,2000,31650
17317,200000,160000,0,0,0,0,0,0,-2,0,0,0,-2,7800,7800,0,-2,30223,30223,0,-2,10715,10715,0
17318,110000,88000,0,0,0,0,0,0,2,45395,1980,43415,0,50402,5987,44415,0,50217,2000,48217,2,48199,1,48198
17319,20000,16000,1,1,1,1,1,0,2,23073,0,23073,2,22857,1653,21204,2,21143,0,21143,2,21482,1940,19542
17320,100000,80000,0,0,0,0,0,0,2,1151,1151,0,-1,35499,35499,0,-1,33051,10000,23051,0,36627,6627,30000
17321,240000,192000,0,0,0,0,0,0,-2,696,696,0,-2,696,696,0,-2,696,696,0,-2,696,696,0
17322,20000,16000,0,1,1,1,1,1,4,17471,0,17471,3,16893,0,16893,2,21318,4726,16592,2,20412,0,20412
17323,20000,16000,0,0,0,0,0,0,-1,181,181,0,-1,891,1100,-209,-1,501,0,501,2,1051,1100,-49
17324,130000,104000,0,0,0,0,0,0,0,9998,1174,8824,0,11007,1183,9824,0,11226,402,10824,0,11460,415,11045
17325,50000,40000,0,0,0,0,0,1,2,37680,1400,36280,2,38462,1700,36762,2,39228,1532,37696,2,40035,1600,38435
17326,100000,80000,0,0,0,0,0,0,0,54590,1966,52624,0,53037,1884,51153,0,54100,1903,52197,0,53889,1940,51949
17327,50000,40000,0,1,1,0,0,1,0,49009,2009,47000,0,50593,2593,48000,0,20218,1000,19218,0,20645,752,19893
17328,150000,120000,0,0,0,0,0,0,-2,0,0,0,-2,12200,12200,0,-1,16961,16961,0,-1,3000,3000,0
17329,20000,16000,0,1,1,1,1,0,0,19145,1330,17815,0,20124,1309,18815,0,20127,702,19425,0,20150,719,19431
17330,130000,104000,0,0,0,0,0,0,-1,10270,5000,5270,0,13576,3500,10076,0,13864,501,13363,0,14636,1000,13636
17331,50000,40000,0,0,1,1,1,0,-1,44316,45361,-1045,-1,45361,1800,43561,0,46135,1503,44632,0,46029,1735,44294
17332,400000,320000,0,0,0,0,0,0,0,29925,14062,15863,0,25423,1824,23599,0,7064,40,7024,0,15920,15673,247
17333,170000,136000,0,0,0,0,0,0,0,58298,2729,55569,0,60343,4000,56343,0,61176,2169,59007,0,62092,2241,59851
17334,50000,40000,0,0,0,0,0,0,0,32612,2011,30601,0,31842,1402,30440,0,27438,3089,24349,0,26127,3482,22645
17335,100000,80000,0,1,0,0,0,0,0,97464,3033,94431,0,80034,2676,77358,0,80533,2796,77737,0,77479,2806,74673
17336,30000,24000,0,1,1,1,1,0,0,26946,1300,25646,0,28957,2400,26557,0,29408,1000,28408,2,29840,1000,28840
17337,80000,64000,0,1,1,1,1,1,2,79347,0,79347,2,81325,5800,75525,2,76550,0,76550,2,78715,4000,74715
17338,330000,264000,0,0,0,0,0,0,-1,0,0,0,-2,0,0,0,-2,0,0,0,-2,0,0,0
17339,70000,56000,0,0,0,0,0,0,0,18397,17831,566,0,17262,17262,0,-1,24921,15001,9920,0,0,0,0
17340,130000,104000,0,1,1,1,1,0,0,132517,12600,119917,0,133747,4900,128847,2,134230,5105,129125,2,131986,0,131986
17341,190000,152000,0,0,0,0,0,0,4,52175,2500,49675,3,51159,0,51159,2,54225,4308,49917,2,54826,1500,53326
17342,20000,16000,0,0,1,1,1,1,0,16986,2301,14685,0,16418,0,16418,2,16615,610,16005,0,16944,604,16340
17343,230000,184000,0,0,0,0,0,0,-1,20590,1256,19334,0,20029,1000,19029,0,17198,1000,16198,0,5177,500,4677
17344,140000,112000,0,0,0,0,0,1,0,89583,4126,85457,0,90432,3231,87201,0,92332,3351,88981,0,94197,3400,90797
17345,210000,168000,0,0,0,0,0,0,0,144968,5065,139903,0,134975,5012,129963,0,136469,5000,131469,0,139866,5078,134788
17346,60000,48000,0,0,0,0,0,1,0,16299,1043,15256,0,-41,0,-41,0,-41,0,-41,-2,-41,0,-41
17347,20000,16000,0,0,0,0,0,1,2,8635,1800,6835,2,8350,0,8350,2,9063,1000,8063,2,8771,0,8771
17348,60000,48000,0,0,0,0,0,1,2,2400,0,2400,2,2400,0,2400,7,2400,0,2400,7,1800,0,1800
17349,410000,328000,0,0,0,0,0,1,-2,0,0,0,-2,0,0,0,-2,0,0,0,-2,0,0,0
17350,170000,136000,0,0,0,0,0,0,0,0,0,0,0,522,522,0,-1,0,0,0,-1,0,0,0
17351,200000,160000,0,0,0,0,0,1,2,105924,4500,101424,2,102663,0,102663,2,97090,3500,93590,0,98045,3500,94545
17352,50000,40000,0,1,1,0,0,0,0,51990,2619,49371,0,50570,2000,48570,0,21095,500,20595,0,19999,714,19285
17353,80000,64000,0,0,0,0,0,0,-2,926,928,-2,-2,-1,0,-1,-2,401,402,-1,-2,0,0,0
17354,70000,56000,0,0,0,0,0,0,0,31273,2000,29273,0,33739,3000,30739,0,34632,1600,33032,0,33746,1500,32246
17355,160000,128000,0,0,0,0,0,0,-2,2916,2916,0,-2,4257,4321,-64,-2,629,700,-71,-2,6267,6267,0
17356,30000,24000,0,1,1,1,1,0,2,28092,0,28092,2,29112,1800,27312,0,29555,1200,28355,0,28536,1083,27453
17357,210000,168000,0,0,0,0,0,0,-1,17307,17307,0,-1,8666,173,8493,0,8666,8666,0,-1,17303,17303,0
17358,750000,600000,0,0,0,0,0,0,-2,3329,3691,-362,-1,38488,38679,-191,-1,9777,9825,-48,-1,66692,67024,-332
17359,220000,176000,0,0,0,0,0,0,0,24175,10000,14175,0,37975,15000,22975,0,39752,9000,30752,0,33351,21000,12351
17360,100000,80000,0,0,0,0,0,1,3,51421,2300,49121,2,52684,2400,50284,2,51400,0,51400,2,0,0,0
17361,60000,48000,0,1,1,0,0,1,0,61952,3300,58652,0,60661,2000,58661,0,29095,900,28195,0,17636,889,16747
17362,80000,64000,0,0,0,0,0,1,0,43576,1,43575,2,28468,2012,26456,0,25971,1091,24880,0,23686,1006,22680
17363,110000,88000,1,1,1,0,0,0,0,168171,5070,163101,0,129227,3362,125865,0,49830,1755,48075,0,50287,2000,48287
17364,50000,40000,0,0,0,0,0,1,0,31428,3505,27923,0,24880,2000,22880,0,26098,8000,18098,0,26886,4000,22886
17365,100000,80000,0,0,0,0,0,0,-1,0,0,0,-1,660,660,0,-1,2030,2030,0,-1,3170,3170,0
17366,30000,24000,0,0,0,0,0,1,3,15693,1000,14693,2,16928,1500,15428,0,18299,1659,16640,0,20129,2129,18000
17367,250000,200000,0,0,0,0,0,0,-2,5285,5674,-389,-1,9138,9527,-389,-1,1187,1187,0,-1,1235,1235,0
17368,50000,40000,0,0,0,0,0,0,2,6945,2500,4445,2,6651,0,6651,2,4060,1000,3060,0,4060,0,4060
17369,200000,160000,1,1,1,0,0,0,0,233553,8182,225371,0,206398,6576,199822,0,145825,5073,140752,0,140249,5095,135154
17370,90000,72000,0,1,1,1,1,1,2,85188,0,85188,2,87112,4200,82912,0,169533,3285,166248,0,90316,7787,82529
17371,260000,208000,0,0,0,0,0,0,0,59934,2961,56973,0,61680,3000,58680,0,65403,5000,60403,0,66745,2700,64045
17372,200000,160000,0,0,0,0,0,0,-1,5094,9500,-4406,-1,9204,9250,-46,-1,9403,5000,4403,0,4602,0,4602
17373,90000,72000,0,0,0,0,0,0,0,13559,1500,12059,0,14331,1000,13331,0,14948,1000,13948,0,15549,1000,14549
17374,140000,112000,0,0,0,0,0,0,0,18624,4548,14076,0,19652,3760,15892,0,23477,5854,17623,0,22330,3039,19291
17375,50000,40000,0,1,1,1,1,0,0,50338,1895,48443,0,48848,2200,46648,0,46709,1595,45114,0,47688,1653,46035
17376,200000,160000,0,0,0,0,0,0,-1,12791,12791,0,-1,40341,28000,12341,0,9238,1000,8238,0,1017,2000,-983
17377,390000,312000,0,0,0,0,0,0,0,72930,20000,52930,0,76543,10000,66543,0,78143,8000,70143,0,77763,6000,71763
17378,100000,80000,0,1,0,0,0,0,2,92041,7690,84351,2,75461,0,75461,2,74233,2800,71433,0,76543,5700,70843
17379,20000,16000,0,0,0,0,0,0,0,780,780,0,-1,0,0,0,-1,0,0,0,-2,0,0,0
17380,50000,40000,0,0,0,0,0,0,0,6828,2000,4828,0,6229,1004,5225,0,390,10,380,0,390,390,0
17381,170000,136000,0,0,0,0,0,0,0,28679,2000,26679,2,29215,3000,26215,0,19415,10000,9415,0,19531,2000,17531
17382,260000,208000,0,0,0,0,0,0,-1,0,0,0,-2,0,0,0,-2,0,0,0,-2,150,150,0
17383,420000,336000,0,0,0,0,0,0,0,105030,5267,99763,0,107146,5347,101799,0,107896,4019,103877,0,110149,4152,105997
17384,200000,160000,0,1,0,0,0,0,0,169311,7035,162276,0,165686,7032,158654,0,162639,6008,156631,0,165627,7002,158625
17385,30000,24000,0,1,1,1,1,0,2,27769,1100,26669,2,28227,1200,27027,2,28642,1000,27642,2,28042,0,28042
17386,70000,56000,0,0,0,0,0,0,0,29340,2000,27340,0,28026,2000,26026,0,28605,1000,27605,0,28705,5000,23705
17387,20000,16000,0,0,1,1,0,0,0,17140,2000,15140,0,18127,1600,16527,0,18605,1030,17575,0,16351,1000,15351
17388,90000,72000,0,0,0,0,0,1,2,46226,5000,41226,0,40920,10009,30911,0,29863,10000,19863,0,19674,0,19674
17389,160000,128000,0,0,0,0,0,0,-2,2579,2717,-138,-2,2313,2324,-11,-2,2287,2298,-11,-2,3442,3462,-20
17390,500000,400000,0,0,0,0,0,0,-1,13519,13519,0,-1,43251,43251,0,-1,34279,0,34279,0,8657,8657,0
17391,300000,240000,0,0,0,0,0,0,0,245210,10633,234577,0,204845,7016,197829,0,190840,10058,180782,0,165498,7125,158373
17392,350000,280000,0,0,1,0,0,0,0,355925,340000,15925,0,353074,20000,333074,0,223209,9000,214209,0,207743,8000,199743
17393,130000,104000,0,0,0,0,0,0,0,51420,8585,42835,0,48140,1620,46520,0,34893,698,34195,0,33986,725,33261
17394,100000,80000,0,0,0,0,0,0,0,77240,4608,72632,0,87919,25140,62779,0,75386,2566,72820,0,69410,2375,67035
17395,250000,200000,0,0,0,0,0,0,2,177530,0,177530,2,181147,6408,174739,0,184784,6478,178306,0,195574,13629,181945
17396,120000,96000,0,0,0,0,0,0,0,97021,5000,92021,0,86283,3000,83283,0,87345,3300,84045,0,81666,3010,78656
17397,80000,64000,0,0,0,0,0,0,0,1524,1524,0,-1,2946,1473,1473,0,1473,1473,0,-1,0,0,0
17398,210000,168000,0,0,0,0,0,0,0,84144,0,84144,2,86894,4000,82894,0,88779,3153,85626,0,90641,3268,87373
17399,50000,40000,0,0,0,0,0,1,0,31180,1300,29880,0,18401,658,17743,0,18785,680,18105,0,19248,773,18475
17400,120000,96000,0,0,0,0,0,0,-1,1026,1026,0,-1,1026,1026,0,-1,1026,1026,0,-1,1026,1026,0
17401,310000,248000,0,0,0,0,0,0,0,32003,7000,25003,0,33885,5040,28845,0,29125,1000,28125,0,17227,7000,10227
17402,90000,72000,0,0,0,0,0,0,0,0,0,0,0,0,0,0,-2,0,0,0,-2,439,439,0
17403,30000,24000,0,1,1,1,1,1,4,25146,0,25146,3,26549,2113,24436,2,25849,0,25849,3,25285,0,25285
17404,390000,312000,0,0,0,0,0,0,-2,1186,1191,-5,-2,1944,1948,-4,-2,4966,4987,-21,-2,2973,2982,-9
17405,80000,64000,0,0,0,0,0,0,0,57075,2655,54420,0,57745,2214,55531,0,59099,2435,56664,0,60489,2669,57820
17406,200000,160000,0,0,0,0,0,0,-1,5935,1011,4924,0,295,297,-2,-1,1867,2923,-1056,-1,0,0,0
17407,50000,40000,0,0,0,0,0,0,0,17775,1600,16175,0,17833,650,17183,0,18246,700,17546,0,18642,700,17942
17408,260000,208000,0,0,0,0,0,1,-1,15475,15482,-7,-1,10981,2000,8981,0,8566,3000,5566,0,4741,1000,3741
17409,360000,288000,0,0,0,0,0,1,-2,0,0,0,-2,0,0,0,-2,0,0,0,-2,0,0,0
17410,170000,136000,0,0,0,0,0,0,0,3653,1000,2653,0,32511,32517,-6,-1,24814,1023,23791,0,25293,10000,15293
17411,170000,136000,0,0,0,0,0,0,-2,1489,1499,-10,-2,362,362,0,-2,451,451,0,-2,620,620,0
17412,200000,160000,0,0,0,0,0,0,0,116094,11084,105010,0,116289,3800,112489,2,112011,0,112011,2,106313,4005,102308
17413,10000,8000,0,1,1,1,1,0,0,9247,1141,8106,0,9431,325,9106,0,8843,331,8512,0,9075,389,8686
17414,220000,176000,0,0,0,0,0,0,-1,14271,10071,4200,0,9884,9884,0,-1,4090,4090,0,-1,6108,6108,0
17415,230000,184000,0,0,0,0,0,0,-2,2163,2174,-11,-2,-40,0,-40,-2,-40,0,-40,-2,8083,8123,-40
17416,90000,72000,0,1,1,1,1,0,0,75526,3500,72026,0,77317,3652,73665,0,85852,10000,75852,0,88290,4000,84290
17417,150000,120000,0,0,0,0,0,0,0,96000,2000,94000,0,98000,2000,96000,0,100000,2000,98000,0,0,0,0
17418,180000,144000,0,0,0,0,0,0,0,19885,4911,14974,0,22355,10355,12000,0,22902,10902,12000,0,15373,3500,11873
17419,260000,208000,0,0,0,0,0,0,-1,390,780,-390,-1,390,390,0,-1,390,390,0,-1,390,390,0
17420,20000,16000,0,1,1,1,1,0,3,19100,0,19100,2,18500,0,18500,0,18500,0,18500,0,18500,0,18500
17421,260000,208000,0,0,0,0,0,0,-2,188,188,0,-2,198,198,0,-2,217,217,0,-2,1825,1825,0
17422,270000,216000,0,0,0,0,0,0,-1,0,0,0,-1,1250,1250,0,-1,2250,1000,1250,0,178,178,0
17423,80000,64000,0,1,1,1,1,0,2,72651,3000,69651,0,74266,2800,71466,0,75892,2800,73092,0,75816,2700,73116
17424,150000,120000,0,0,0,0,0,0,0,40874,4000,36874,0,39922,0,39922,2,40953,2000,38953,0,42136,2000,40136
17425,270000,216000,0,0,0,0,0,0,-2,316,316,0,-2,5116,5116,0,-2,15884,15884,0,-2,10606,10606,0
17426,260000,208000,1,1,1,1,1,1,0,445129,15000,430129,0,452162,12406,439756,0,258010,9279,248731,0,221780,6078,215702
17427,170000,136000,0,0,0,0,0,1,-1,326,326,0,-1,326,326,0,-1,476,476,0,-1,476,476,0
17428,50000,40000,0,0,0,0,0,1,0,35150,1542,33608,0,25104,1475,23629,0,20560,1000,19560,0,8614,350,8264
17429,120000,96000,0,1,1,1,1,1,0,115372,9600,105772,0,112027,0,112027,2,119702,9500,110202,2,121650,4100,117550
17430,20000,16000,0,1,1,1,1,0,0,17848,1302,16546,0,27843,1320,26523,0,19352,1137,18215,0,19938,1000,18938
17431,90000,72000,0,0,0,0,0,1,2,6547,2100,4447,2,7481,1200,6281,2,7212,0,7212,2,7595,500,7095
17432,50000,40000,0,0,0,0,0,0,2,2400,0,2400,2,2400,0,2400,7,2400,0,2400,7,2400,0,2400
17433,20000,16000,0,1,1,1,0,1,2,19464,0,19464,2,18604,700,17904,0,18172,620,17552,0,14444,800,13644
17434,200000,160000,0,0,0,0,0,0,0,21362,1362,20000,0,22000,1000,21000,0,2000,2000,0,0,950,950,0
17435,200000,160000,0,0,0,0,0,0,-2,1898,1906,-8,-2,0,0,0,-2,6062,6062,0,-2,0,0,0
17436,360000,288000,0,0,0,0,0,0,-2,-1,0,-1,-2,377,378,-1,-2,2899,2912,-13,-2,376,377,-1
17437,80000,64000,0,0,1,1,1,1,2,66705,3000,63705,2,68506,3500,65006,2,69787,3000,66787,2,68844,300,68544
17438,190000,152000,0,0,0,0,0,0,0,157158,6358,150800,0,149423,5487,143936,0,115038,4038,111000,0,97756,3803,93953
17439,140000,112000,0,0,0,0,0,0,0,96535,5500,91035,0,98041,4000,94041,2,100504,5000,95504,0,103874,5000,98874
17440,100000,80000,0,0,0,0,0,0,-1,198,198,0,-1,324,324,0,-1,171,171,0,-1,0,0,0
17441,30000,24000,0,1,1,0,0,1,0,27788,1200,26588,0,29784,2196,27588,0,0,2500,-2500,0,0,0,0
17442,50000,40000,0,0,0,0,0,0,0,17144,1300,15844,0,17636,777,16859,0,17850,647,17203,0,18212,658,17554
17443,100000,80000,0,0,0,0,0,0,0,50424,2308,48116,0,51563,3000,48563,0,780,780,0,-1,0,0,0
17444,50000,40000,0,0,0,0,0,0,0,0,0,0,-2,0,0,0,-2,3251,3251,0,-1,3484,274,3210
17445,360000,288000,0,0,0,0,0,0,0,16989,6478,10511,0,12751,14,12737,2,10272,443,9829,0,9631,6093,3538
17446,130000,104000,0,0,0,0,1,0,0,104705,5300,99405,0,105478,4000,101478,0,107725,4000,103725,0,109994,4000,105994
17447,50000,40000,0,1,1,0,0,1,2,47959,0,47959,2,49099,2470,46629,0,28540,1215,27325,0,29114,1231,27883
17448,140000,112000,0,0,0,0,0,1,2,71902,3200,68702,2,72924,2800,70124,2,72335,1200,71135,2,75508,4500,71008
17449,20000,16000,0,0,0,0,0,0,0,2862,1225,1637,0,3247,1000,2247,0,2857,0,2857,0,2467,2500,-33
17450,70000,56000,0,1,1,0,0,0,0,72616,3100,69516,2,68201,15,68186,2,50995,3850,47145,2,48822,0,48822
17451,50000,40000,0,1,1,0,0,0,0,49236,1996,47240,0,43524,2162,41362,0,27062,2000,25062,0,27923,1300,26623
17452,200000,160000,0,0,0,0,0,0,0,26158,3500,22658,0,29486,4008,25478,0,27166,1098,26068,0,25954,1500,24454
17453,40000,32000,0,0,0,0,0,1,2,25927,0,25927,2,28184,2700,25484,2,28723,1300,27423,2,28125,0,28125
17454,30000,24000,0,0,0,0,0,0,0,12070,1500,10570,0,11973,2000,9973,0,10166,1166,9000,0,7966,3500,4466
17455,170000,136000,0,0,1,0,0,0,-2,157499,168499,-11000,-1,160946,12008,148938,0,50228,3000,47228,0,53525,4000,49525
17456,40000,32000,0,0,0,0,0,0,2,21780,1500,20280,2,23114,2000,21114,2,22606,0,22606,2,22903,822,22081
17457,160000,128000,0,0,0,0,0,0,0,88956,4326,84630,0,62768,4000,58768,0,64410,3000,61410,0,82919,20000,62919
17458,300000,240000,0,0,0,0,0,0,-1,2444,2444,0,-1,578,578,0,-1,390,390,0,-1,1424,1424,0
17459,150000,120000,0,0,0,0,0,1,0,21000,1353,19647,0,22013,1366,20647,0,22449,802,21647,0,22922,833,22089
17460,90000,72000,0,0,0,0,0,0,-1,0,0,0,-1,2520,2520,0,-1,1651,1651,0,-1,0,0,0
17461,150000,120000,0,1,1,1,1,0,0,147248,5000,142248,0,139846,4400,135446,0,142808,4500,138308,0,150770,9600,141170
17462,100000,80000,0,1,1,1,1,0,0,100095,4500,95595,0,98569,5000,93569,0,99534,4000,95534,0,100013,3500,96513
17463,50000,40000,0,0,0,0,0,0,2,36121,2000,34121,0,38135,2800,35335,0,37416,0,37416,2,38503,1500,37003
17464,50000,40000,0,0,0,0,0,0,0,29022,1899,27123,0,29368,1245,28123,0,16930,576,16354,0,17284,596,16688
17465,420000,336000,0,0,0,0,0,0,-1,7248,2000,5248,0,7303,2002,5301,0,0,0,0,0,932,932,0
17466,50000,40000,0,0,0,0,0,0,0,6815,2000,4815,0,6068,0,6068,2,7798,2000,5798,0,8511,1000,7511
17467,110000,88000,0,1,1,1,1,1,2,108657,6000,102657,0,108668,8200,100468,0,103867,0,103867,2,111842,9956,101886
17468,50000,40000,0,0,0,0,0,0,0,40610,6000,34610,0,11292,2000,9292,0,3266,2200,1066,0,10012,10000,12
17469,100000,80000,0,0,1,0,0,0,0,84514,8000,76514,0,85496,5000,80496,0,69656,4000,65656,0,61532,3000,58532
17470,140000,112000,0,0,0,0,0,0,0,63636,2500,61136,0,65570,3000,62570,0,67354,3000,64354,0,69073,3000,66073
17471,360000,288000,0,0,0,0,0,0,-2,0,0,0,-2,0,0,0,-2,1526,1526,0,-2,0,0,0
17472,90000,72000,0,0,0,0,0,0,-1,18382,3000,15382,0,21415,5000,16415,0,6654,3000,3654,0,10323,5000,5323
17473,120000,96000,1,1,1,0,0,0,2,120459,0,120459,2,121749,5020,116729,0,81046,6100,74946,0,79608,0,79608
17474,80000,64000,0,0,0,0,0,0,2,22140,2000,20140,0,18349,0,18349,0,3540,3540,0,-1,0,0,0
17475,140000,112000,0,0,0,0,0,0,0,94531,3500,91031,0,96264,3600,92664,0,98135,3881,94254,0,100062,4200,95862
17476,140000,112000,0,0,0,0,0,1,-1,792,792,0,-1,884,488,396,2,488,0,488,0,1092,1000,92
17477,210000,168000,0,0,0,0,0,0,0,18077,2000,16077,0,14113,3000,11113,0,7049,150,6899,0,2026,2026,0
17478,10000,8000,0,0,0,0,0,0,-1,0,0,0,-1,390,390,0,-1,390,390,0,-1,780,780,0
17479,200000,160000,0,0,0,0,1,0,0,142912,30002,112910,0,161874,21876,139998,0,176431,16433,159998,0,180153,5661,174492
17480,260000,208000,0,0,0,0,0,0,-1,1443,1500,-57,-1,1443,1443,0,-1,1443,1443,0,-1,1443,1443,0
17481,70000,56000,0,0,0,0,0,0,0,43333,5000,38333,0,36959,1500,35459,0,27296,546,26750,0,23474,1000,22474
17482,180000,144000,0,0,0,0,0,0,0,87173,3000,84173,0,83205,3100,80105,0,84996,3200,81796,0,89723,7500,82223
17483,360000,288000,0,0,0,0,0,0,-2,0,0,0,-2,0,0,0,-2,0,0,0,-2,0,0,0
17484,90000,72000,0,0,0,0,0,1,0,56599,2057,54542,0,58155,2500,55655,0,60058,3000,57058,0,61250,2189,59061
17485,20000,16000,0,0,0,1,0,0,2,12607,6000,6607,0,16430,5000,11430,0,19230,3000,16230,0,0,0,0
17486,410000,328000,0,0,0,0,0,0,0,243779,10000,233779,0,250399,7250,243149,0,5194,5225,-31,-1,-376,0,-376
17487,80000,64000,0,0,0,0,0,0,0,39750,1663,38087,0,40771,1684,39087,0,42087,2000,40087,0,43409,2000,41409
17488,360000,288000,0,0,0,0,0,0,0,12932,6032,6900,0,91329,99578,-8249,-1,82929,2507,80422,0,70047,5376,64671
17489,160000,128000,0,0,0,0,0,0,0,17164,3181,13983,0,7175,3012,4163,0,1942,1942,0,-1,100025,100025,0
17490,390000,312000,0,0,0,0,0,0,0,31440,2561,28879,0,38001,8122,29879,0,48301,11000,37301,0,28131,20015,8116
17491,350000,280000,0,0,0,0,0,0,0,2071,2081,-10,-1,2915,2929,-14,-1,1011,1016,-5,-1,23620,23738,-118
17492,90000,72000,0,0,0,0,0,0,0,61879,55000,6879,0,56377,3750,52627,0,51068,2500,48568,0,51722,2500,49222
17493,290000,232000,0,0,1,1,1,0,2,243753,16500,227253,0,253145,15000,238145,0,267412,20000,247412,0,273095,10000,263095
17494,200000,160000,0,0,0,0,0,1,0,61827,3927,57900,0,35902,35955,-53,-1,326,0,326,0,1446,5826,-4380
17495,280000,224000,0,0,0,0,0,0,-2,14899,14927,-28,-2,18374,18410,-36,-2,13369,13369,0,-2,8854,8854,0
17496,20000,16000,0,0,0,0,0,0,-1,11869,11869,0,-1,7312,7314,-2,-1,1868,2274,-406,-1,1470,1470,0
17497,50000,40000,0,0,0,0,0,0,0,21343,1622,19721,0,14850,2013,12837,0,12315,500,11815,0,10391,500,9891
17498,400000,320000,0,0,0,0,0,0,0,100229,26621,73608,0,57583,6600,50983,0,8556,406,8150,0,316,316,0
17499,90000,72000,0,0,0,0,0,0,0,0,780,-780,-2,1176,1176,0,-1,0,0,0,-1,0,0,0
17500,230000,184000,0,0,0,0,0,0,0,70854,3500,67354,0,74413,6000,68413,0,72447,0,72447,2,73418,3000,70418
17501,50000,40000,0,0,1,1,1,1,2,42382,5000,37382,2,43190,1800,41390,2,42198,0,42198,2,46572,5232,41340
17502,110000,88000,0,1,1,1,1,0,0,93661,5000,88661,0,96185,5000,91185,0,99667,5000,94667,0,102978,5000,97978
17503,360000,288000,0,0,0,0,0,0,-2,3578,3578,0,-2,3578,3578,0,-2,3578,3578,0,-2,4268,4268,0
17504,30000,24000,0,0,0,0,0,0,-1,0,0,0,-1,0,0,0,-2,0,0,0,-2,359,359,0
17505,500000,400000,0,0,0,0,0,0,-1,25364,25428,-64,-1,19550,9575,9975,0,21096,11116,9980,0,23491,15063,8428
17506,160000,128000,0,0,0,0,0,0,-1,3421,3421,0,-1,2750,2750,0,-1,2750,2750,0,-1,5224,5224,0
17507,210000,168000,0,0,0,0,0,0,1,-3987,0,-3987,-2,-1987,2000,-3987,-2,1697,4000,-2303,-1,4347,3000,1347
17508,300000,240000,0,0,0,0,0,0,-2,2148,2148,0,-1,1800,1800,0,-1,0,0,0,-2,2635,2635,0
17509,230000,184000,0,0,0,0,0,0,0,28472,2000,26472,0,29696,2000,27696,0,31393,2500,28893,0,33222,2500,30722
17510,80000,64000,0,0,0,0,0,0,0,26808,1600,25208,0,27680,3400,24280,0,26658,1300,25358,0,27324,3000,24324
17511,200000,160000,0,0,0,0,0,0,0,31707,31727,-20,-1,44433,44626,-193,-1,4155,18,4137,0,2114,2124,-10
17512,560000,448000,0,0,0,0,0,0,0,7077,1416,5661,2,3416,0,3416,2,3416,3416,0,-1,416,416,0
17513,80000,64000,0,0,0,0,0,1,0,11554,1500,10054,0,7830,1218,6612,0,4305,311,3994,0,5427,1351,4076
17514,360000,288000,0,0,0,0,0,0,0,3773,3000,773,0,17917,18117,-200,-1,21057,5371,15686,0,0,0,0
17515,200000,160000,0,0,0,0,0,0,-1,0,0,0,-1,0,0,0,-2,400,400,0,-1,400,0,400
17516,140000,112000,0,0,0,0,0,0,-1,13816,13816,0,-1,316,316,0,-1,316,316,0,-1,316,316,0
17517,280000,224000,0,0,0,0,0,1,-1,-2,0,-2,-2,5823,5825,-2,-1,2900,2915,-15,-1,42128,42338,-210
17518,190000,152000,0,0,0,0,0,0,-1,991,991,0,-1,666,666,0,-1,991,991,0,-1,1316,1316,0
17519,400000,320000,0,0,0,0,0,0,-2,1191,1191,0,-2,11930,11930,0,-2,11286,11286,0,-2,5766,5766,0
17520,50000,40000,0,0,0,0,0,1,0,29600,1600,28000,0,20150,2004,18146,0,19232,2000,17232,0,17143,1000,16143
17521,80000,64000,0,0,0,0,0,0,2,4258,0,4258,2,7032,7032,0,-1,6348,6348,0,-1,1606,1606,0
17522,20000,16000,0,1,1,1,1,1,2,18967,1700,17267,0,19633,1300,18333,0,18187,651,17536,0,18568,674,17894
17523,510000,408000,0,0,0,0,0,0,-2,22058,22657,-599,-1,23205,11586,11619,0,11571,24637,-13066,-1,12179,12719,-540
17524,740000,592000,0,0,0,0,0,0,0,317219,13200,304019,0,296560,11000,285560,0,285912,10000,275912,0,268257,10000,258257
17525,50000,40000,0,1,0,0,0,0,0,50654,2199,48455,0,20046,691,19355,0,20067,707,19360,0,19703,703,19000
17526,270000,216000,0,0,0,0,0,0,0,92630,5162,87468,0,69669,10150,59519,0,44149,44299,-150,-1,43414,43509,-95
17527,390000,312000,0,0,0,0,0,0,-1,103169,100000,3169,0,95669,5000,90669,0,88080,4000,84080,0,80576,4000,76576
17528,100000,80000,0,0,0,0,0,0,0,66816,3000,63816,0,36448,1500,34948,0,37481,2000,35481,0,37684,1360,36324
17529,500000,400000,0,1,0,0,0,0,2,459273,16004,443269,0,386722,15004,371718,0,366421,15004,351417,0,241182,9814,231368
17530,30000,24000,0,1,1,1,1,1,0,24672,0,24672,2,25317,1233,24084,0,26516,1432,25084,0,26133,0,26133
17531,70000,56000,0,0,0,0,0,0,0,24717,1352,23365,0,19754,3722,16032,0,22032,2500,19532,0,25070,3292,21778
17532,390000,312000,0,0,0,0,0,0,0,221739,6545,215194,0,184529,6601,177928,0,175781,5700,170081,0,173442,6100,167342
17533,530000,424000,0,0,0,0,0,0,-2,15688,15791,-103,-1,24511,12808,11703,0,12144,8090,4054,0,34963,34110,853
17534,180000,144000,0,0,0,0,0,0,-1,307,307,0,-1,0,0,0,-1,0,0,0,-2,0,0,0
17535,70000,56000,0,0,0,0,0,0,0,35287,2200,33087,0,36002,1600,34402,2,37096,2000,35096,0,37999,1500,36499
17536,360000,288000,0,0,0,0,0,0,0,19382,2000,17382,0,13874,5019,8855,0,9398,2000,7398,0,10773,2500,8273
17537,230000,184000,0,0,0,0,0,0,-1,815,815,0,-1,1630,1630,0,-1,815,0,815,0,815,815,0
17538,240000,192000,0,1,1,1,1,0,0,225695,10009,215686,0,210199,10000,200199,0,208307,10000,198307,0,203779,10000,193779
17539,280000,224000,0,0,0,0,0,0,-1,1876,1876,0,-1,1876,1876,0,-1,1876,1876,0,-1,1870,1870,0
17540,200000,160000,0,0,0,0,0,1,-1,1577,1577,0,-1,2424,2424,0,-1,671,671,0,-1,1606,1606,0
17541,70000,56000,0,1,0,0,0,0,0,61580,1659,59921,0,29435,2000,27435,0,26341,1107,25234,0,26949,1200,25749
17542,60000,48000,0,0,0,0,0,1,2,269,269,0,-1,269,269,0,-1,0,0,0,-1,1257,1526,-269
17543,20000,16000,0,0,0,0,0,1,2,11119,0,11119,2,12429,1502,10927,0,12370,443,11927,0,12659,489,12170
17544,210000,168000,0,0,0,0,0,0,-2,401,401,0,-2,63,63,0,-2,684,684,0,-2,0,0,0
17545,200000,160000,0,0,0,0,0,0,0,146660,4600,142060,0,145623,6000,139623,0,144166,4700,139466,0,145141,4800,140341
17546,500000,400000,0,0,0,0,0,0,-1,35937,20046,15891,0,31227,5075,26152,0,21135,5103,16032,0,2632,2646,-14
17547,30000,24000,1,1,0,0,0,0,2,34822,1000,33822,0,15722,18000,-2278,-1,16467,1000,15467,0,17537,1500,16037
17548,80000,64000,1,1,1,1,1,1,2,80774,0,80774,2,80082,3800,76282,0,78545,3125,75420,0,76742,2783,73959
17549,210000,168000,0,0,0,0,0,0,-2,474,474,0,-1,17171,17171,0,-1,16625,0,16625,2,17030,800,16230
17550,210000,168000,0,0,0,0,0,1,-1,179,179,0,-1,1326,1326,0,-1,1326,1326,0,-1,1326,1326,0
17551,70000,56000,0,1,1,1,1,1,4,61873,3614,58259,4,63359,3100,60259,4,64221,2500,61721,4,65706,3100,62606
17552,200000,160000,0,1,0,0,0,0,0,186292,7465,178827,0,133345,4715,128630,0,133634,4804,128830,0,133990,5141,128849
17553,180000,144000,0,0,0,0,0,0,-1,13346,13500,-154,-1,4195,4195,0,-1,9934,10000,-66,-1,3317,3500,-183
17554,30000,24000,0,0,0,0,0,0,0,18339,1500,16839,0,18794,1000,17794,0,23530,5000,18530,0,23531,2000,21531
17555,20000,16000,0,0,0,0,0,1,2,12393,0,12393,2,14185,2000,12185,2,13817,0,13817,2,14434,1000,13434
17556,30000,24000,0,1,1,1,1,0,0,28076,1752,26324,0,25991,1666,24325,0,25429,800,24629,0,26234,1161,25073
17557,60000,48000,0,0,0,0,0,0,0,7735,3000,4735,0,6923,2000,4923,0,7035,2000,5035,0,9175,4000,5175
17558,50000,40000,0,0,0,0,0,1,0,41612,1650,39962,0,18825,10000,8825,0,18019,1000,17019,0,18124,700,17424
17559,50000,40000,0,1,1,1,1,1,2,50880,5160,45720,2,51034,1753,49281,2,46154,0,46154,2,42852,1508,41344
17560,120000,96000,0,1,1,1,1,0,2,115258,6000,109258,2,119620,7800,111820,2,118928,1500,117428,3,121619,4800,116819
17561,210000,168000,0,0,0,0,0,0,2,73783,20012,53771,2,58144,24,58120,2,27617,33,27584,0,14695,0,14695
17562,190000,152000,0,0,0,0,0,0,-1,176,176,0,-1,804,954,-150,-1,478,0,478,2,952,950,2
17563,200000,160000,1,1,1,1,0,1,-1,217016,10000,207016,0,200316,5210,195106,0,169815,4009,165806,0,88071,3186,84885
17564,200000,160000,0,0,0,0,0,0,0,0,0,0,-2,0,0,0,-2,0,0,0,-2,0,0,0
17565,80000,64000,0,1,0,0,0,0,0,74071,4016,70055,0,41008,2109,38899,0,32152,1151,31001,0,32748,1685,31063
17566,200000,160000,0,0,0,0,0,0,-1,2228,2228,0,-1,6338,6338,0,-1,2290,2290,0,-1,3620,3620,0
17567,50000,40000,0,0,0,0,0,0,2,17082,1294,15788,0,18969,2181,16788,0,18524,0,18524,2,18947,731,18216
17568,50000,40000,0,0,0,0,0,0,0,33933,1490,32443,0,28945,1148,27797,0,28131,2370,25761,0,27531,0,27531
17569,250000,200000,0,0,0,0,0,0,-2,-207,0,-207,-2,-207,0,-207,-2,11361,11568,-207,-1,700,700,0
17570,150000,120000,1,1,1,1,1,0,0,193870,5024,188846,0,188045,4051,183994,0,178892,3788,175104,0,167419,3622,163797
17571,90000,72000,0,0,0,0,0,0,-1,0,0,0,-2,0,0,0,-2,0,0,0,-2,0,0,0
17572,90000,72000,0,1,0,0,0,0,0,91049,3137,87912,0,70101,5094,65007,0,28942,1106,27836,0,27508,1001,26507
17573,180000,144000,0,0,0,0,0,0,-1,4278,4278,0,-1,331,334,-3,-1,3456,3456,0,-1,11964,11964,0
17574,90000,72000,0,1,0,0,0,0,0,90370,4444,85926,0,26420,1420,25000,0,27398,1398,26000,0,28295,1345,26950
17575,50000,40000,0,1,0,0,0,0,0,48282,1000,47282,0,0,0,0,0,2068,2068,0,-1,30135,30067,68
17576,130000,104000,0,1,1,0,0,1,2,128380,0,128380,2,126792,4535,122257,0,103497,3900,99597,0,96991,4300,92691
17577,160000,128000,0,0,0,0,0,0,-1,11354,11354,0,-1,13012,2000,11012,0,17388,6000,11388,0,24140,13000,11140
17578,50000,40000,0,0,0,0,0,0,0,0,0,0,-2,0,0,0,-2,15883,15883,0,-1,16617,1000,15617
17579,100000,80000,0,0,0,0,0,0,-2,0,0,0,-2,944,944,0,-1,0,0,0,-1,0,0,0
17580,210000,168000,0,0,0,0,0,0,-1,3298,3298,0,-1,2972,2972,0,-1,975,975,0,-1,3441,3441,0
17581,20000,16000,0,1,1,0,0,0,0,19638,1376,18262,0,17198,1121,16077,0,14253,460,13793,0,18475,6000,12475
17582,500000,400000,0,0,0,0,0,0,-1,7860,7860,0,-1,2983,3047,-64,-1,8767,8831,-64,-1,4691,4734,-43
17583,20000,16000,0,0,0,0,0,0,2,5450,1000,4450,2,4427,1000,3427,0,2661,0,2661,0,895,0,895
17584,50000,40000,0,0,0,0,0,1,-1,390,390,0,-1,390,390,0,-1,930,930,0,-1,390,0,390
17585,200000,160000,0,0,0,0,0,0,0,7408,1500,5908,0,8250,1000,7250,0,9250,1000,8250,0,9750,500,9250
17586,250000,200000,0,0,0,0,0,0,-1,2986,2991,-5,-1,24971,25185,-214,-1,500,500,0,-1,2162,2162,0
17587,340000,272000,0,0,0,0,0,0,-1,14900,10000,4900,0,0,0,0,0,2650,2650,0,-1,1000,0,1000
17588,150000,120000,0,0,0,0,0,0,0,94682,2338,92344,0,89207,2653,86554,0,46259,2001,44258,0,50504,5012,45492
17589,250000,200000,0,0,0,0,0,0,-1,2460,0,2460,2,0,0,0,2,0,0,0,-2,3081,3081,0
17590,540000,432000,0,0,0,0,0,0,0,82860,4380,78480,0,20879,2067,18812,0,3698,564,3134,0,209167,207019,2148
17591,150000,120000,0,0,0,0,0,0,0,57431,1897,55534,0,52754,1552,51202,0,52430,1649,50781,0,41770,2005,39765
17592,120000,96000,0,1,1,1,1,1,2,115581,4400,111181,0,118481,9000,109481,0,116444,0,116444,2,117283,9000,108283
17593,290000,232000,0,0,0,0,0,0,-2,122380,122420,-40,-2,0,0,0,-2,32720,32720,0,-2,-200,200,-400
17594,500000,400000,0,0,0,0,0,0,-1,3766,3766,0,-1,580,580,0,-1,8120,8120,0,-1,1821,1821,0
17595,30000,24000,0,0,0,0,0,1,0,21990,2000,19990,0,15525,5000,10525,0,25242,25242,0,-1,0,0,0
17596,140000,112000,0,0,0,0,0,0,0,77870,2322,75548,0,19353,387,18966,0,8966,1000,7966,0,14300,14300,0
17597,340000,272000,0,0,0,0,0,0,-1,29052,29052,0,-1,50832,30000,20832,0,30272,5034,25238,0,11253,11253,0
17598,90000,72000,0,0,0,0,0,0,2,827,827,0,-1,2040,2040,0,-1,1279,1279,0,-1,1292,1292,0
17599,30000,24000,0,0,0,0,0,0,-2,0,0,0,-2,0,0,0,-2,0,0,0,-2,0,0,0
17600,350000,280000,0,0,0,0,0,0,0,171127,6958,164169,0,173283,6669,166614,0,169815,5596,164219,0,163058,5676,157382
17601,40000,32000,0,0,0,0,0,1,-1,3871,2000,1871,2,1488,0,1488,2,0,0,0,2,0,0,0
17602,460000,368000,0,0,0,0,0,0,0,373370,15481,357889,0,285926,10000,275926,0,264644,9072,255572,0,247298,8945,238353
17603,60000,48000,0,0,0,0,0,1,0,22447,2000,20447,0,24337,2269,22068,0,23808,0,23808,2,24610,1200,23410
17604,280000,224000,0,0,0,0,0,1,0,15883,2000,13883,0,15547,1600,13947,0,14472,1000,13472,0,15086,1000,14086
17605,450000,360000,0,1,1,1,1,0,0,455701,20000,435701,0,451559,17000,434559,0,429235,16300,412935,0,391559,14108,377451
17606,20000,16000,0,1,1,0,0,0,0,19394,1467,17927,0,39950,1096,38854,0,0,1000,-1000,0,0,0,0
17607,100000,80000,0,0,0,0,0,0,0,42373,1994,40379,0,37088,1457,35631,0,75672,1205,74467,0,31645,1162,30483
17608,80000,64000,0,0,0,0,0,1,0,48525,2000,46525,2,49423,2000,47423,2,46132,0,46132,2,47233,2000,45233
17609,200000,160000,0,0,0,0,0,0,-2,-1,0,-1,-2,228,229,-1,-2,1374,1380,-6,-2,380,381,-1
17610,50000,40000,0,1,0,0,0,1,2,48951,2600,46351,0,17744,635,17109,0,36230,657,35573,0,37128,750,36378
17611,50000,40000,0,0,0,0,0,0,0,38972,1918,37054,0,47584,12530,35054,0,28055,1001,27054,0,28571,1035,27536
17612,90000,72000,0,1,1,0,0,0,-2,88129,3069,85060,-2,76209,2028,74181,-2,65295,2110,63185,-2,27224,2142,25082
17613,160000,128000,0,0,0,0,0,1,-2,3640,3660,-20,-2,2935,3135,-200,-2,1603,1650,-47,-2,14129,14200,-71
17614,500000,400000,0,0,0,0,0,0,-1,3943,4283,-340,-1,3338,3338,0,-1,1224,1224,0,-1,31022,31022,0
17615,30000,24000,1,1,0,1,1,0,0,51026,1500,49526,0,27400,4200,23200,0,26823,0,26823,2,28621,2252,26369
17616,50000,40000,0,0,0,0,0,0,-2,2185,2185,0,-2,0,0,0,-2,19777,19777,0,-1,19910,629,19281
17617,80000,64000,0,0,0,0,0,0,-2,0,0,0,-2,2165,2165,0,-2,39881,39881,0,-2,14691,14691,0
17618,240000,192000,0,0,0,0,0,1,2,136539,6702,129837,0,137487,5000,132487,0,141291,6019,135272,0,20143,6099,14044
17619,350000,280000,0,0,0,0,0,0,0,166106,7174,158932,0,100151,4200,95951,0,50340,2400,47940,0,51400,2400,49000
17620,80000,64000,0,0,0,0,0,1,2,23772,3000,20772,2,23092,0,23092,2,24806,2100,22706,2,24272,0,24272
17621,200000,160000,0,0,0,0,0,0,-1,4882,4882,0,-1,10955,11034,-79,-1,10435,10435,0,-1,1665,1665,0
17622,90000,72000,0,0,0,0,0,0,0,0,0,0,0,0,0,0,-2,0,0,0,-2,0,0,0
17623,50000,40000,0,1,0,0,0,1,0,42256,1200,41056,0,6501,300,6201,0,6638,242,6396,0,7027,500,6527
17624,30000,24000,0,0,0,0,0,0,-2,0,0,0,-2,0,0,0,-2,0,0,0,-2,0,0,0
17625,100000,80000,0,1,1,1,1,0,0,100402,4617,95785,0,97141,3600,93541,0,97143,3865,93278,0,97532,3850,93682
17626,30000,24000,0,1,1,1,1,0,0,26570,2000,24570,0,26829,1600,25229,0,26839,1000,25839,0,27449,1000,26449
17627,200000,160000,0,0,0,0,0,1,-1,0,0,0,-1,0,0,0,-2,0,0,0,-2,259,259,0
17628,70000,56000,0,1,1,0,0,0,0,67622,1900,65722,0,68922,2000,66922,0,1223,1223,0,-1,70027,70027,0
17629,120000,96000,0,0,0,0,0,0,0,77262,5000,72262,0,78783,5000,73783,0,75252,2726,72526,0,77090,4000,73090
17630,60000,48000,0,1,0,0,0,1,0,59461,2538,56923,0,37170,1000,36170,0,18464,2000,16464,0,15822,1000,14822
17631,170000,136000,0,0,0,0,0,0,0,46967,2200,44767,0,48872,3000,45872,0,51049,3000,48049,0,81018,31018,50000
17632,140000,112000,0,0,0,0,0,1,2,56128,2600,53528,2,56713,2100,54613,2,55796,600,55196,2,56251,1500,54751
17633,460000,368000,0,0,0,0,0,0,0,197014,10089,186925,0,179698,8077,171621,0,167727,6184,161543,0,136894,8047,128847
17634,30000,24000,0,0,0,0,0,0,2,8892,2500,6392,2,8563,0,8563,2,-510,0,-510,2,390,1290,-900
17635,80000,64000,0,0,0,0,0,1,-1,0,0,0,-1,2332,2332,0,-1,4320,4320,0,-1,0,0,0
17636,50000,40000,0,0,0,0,0,1,2,35683,1900,33783,2,36200,1400,34800,2,36808,1500,35308,2,37671,1600,36071
17637,60000,48000,0,0,0,0,0,1,2,40673,0,40673,2,43342,3348,39994,2,44299,1800,42499,2,45222,1800,43422
17638,50000,40000,0,0,0,0,0,0,0,14195,1353,12842,0,14859,1017,13842,0,9446,1000,8446,0,7246,1000,6246
17639,360000,288000,0,0,0,0,0,0,-1,-820,0,-820,-1,-813,7,-820,-2,-2292,0,-2292,-2,-2292,0,-2292
17640,50000,40000,0,0,0,0,0,0,0,27231,50499,-23268,-1,26852,1000,25852,0,27820,1500,26320,0,25529,1500,24029
17641,180000,144000,0,0,0,0,0,0,0,56300,2627,53673,0,56831,2063,54768,0,57958,2072,55886,0,59330,2303,57027
17642,40000,32000,0,0,0,0,0,0,0,25921,5000,20921,0,25209,0,25209,2,26636,2000,24636,0,29197,3000,26197
17643,200000,160000,0,0,0,0,0,0,-1,1287,1350,-63,-1,54531,54531,0,-1,55229,2200,53029,0,56836,2500,54336
17644,210000,168000,0,1,0,0,0,0,0,190227,8000,182227,0,127436,5000,122436,0,129714,5000,124714,0,131440,5000,126440
17645,50000,40000,0,0,0,0,0,1,0,24870,1609,23261,0,18740,1279,17461,0,17861,1500,16361,0,17433,0,17433
17646,50000,40000,0,0,0,0,0,1,0,34923,3500,31423,0,37192,3000,34192,0,39341,3000,36341,0,27561,5000,22561
17647,80000,64000,0,0,0,0,0,1,-1,390,780,-390,-1,-390,0,-390,-1,0,390,-390,-2,1560,1780,-220
17648,310000,248000,0,0,0,0,0,0,0,176904,30000,146904,0,174117,10054,164063,0,125526,10000,115526,0,108107,10000,98107
17649,170000,136000,0,0,0,0,0,0,-1,2633,2640,-7,-1,1291,1294,-3,-1,3117,3126,-9,-1,1267,1270,-3
17650,20000,16000,0,0,0,0,0,1,0,10523,2000,8523,2,12043,2000,10043,2,13542,2000,11542,3,14728,2000,12728
17651,180000,144000,0,0,0,0,0,0,-1,396,396,0,-1,396,396,0,-1,396,396,0,-1,396,396,0
17652,50000,40000,0,0,0,0,1,1,2,44015,5021,38994,2,36724,0,36724,2,45751,10000,35751,2,46497,2005,44492
17653,290000,232000,0,0,0,0,0,0,-2,2476,2485,-9,-2,9746,9793,-47,-2,7092,7123,-31,-2,5449,5460,-11
17654,70000,56000,0,0,0,0,0,0,0,12071,2000,10071,0,12866,1000,11866,0,14644,2000,12644,0,16230,2000,14230
17655,20000,16000,0,0,0,0,1,0,0,5622,2010,3612,0,19263,15000,4263,0,18433,4000,14433,0,26132,2000,24132
17656,360000,288000,0,0,0,0,0,1,-2,1088,1088,0,-2,7870,7870,0,-2,5988,5988,0,-2,342,342,0
17657,50000,40000,0,0,0,0,0,0,0,36445,2500,33945,0,24788,1000,23788,0,24967,1500,23467,0,28652,28939,-287
17658,130000,104000,0,0,0,0,0,0,-1,390,390,0,-1,390,390,0,-1,390,390,0,-1,390,390,0
17659,10000,8000,0,0,0,0,0,0,0,8492,1000,7492,0,8138,1009,7129,0,4990,1000,3990,0,1598,1598,0
17660,210000,168000,0,0,0,0,0,1,-1,390,390,0,-1,4962,4962,0,-1,0,0,0,-1,780,780,0
17661,20000,16000,0,1,1,0,0,0,0,19399,1400,17999,0,19962,1009,18953,0,14938,307,14631,0,3039,1200,1839
17662,20000,16000,0,0,0,0,0,1,2,689,689,0,-1,0,0,0,-1,0,0,0,-2,0,0,0
17663,80000,64000,0,0,0,0,0,1,0,14207,700,13507,2,14643,672,13971,0,14856,600,14256,0,15160,550,14610
17664,80000,64000,0,0,0,0,0,0,0,57045,1900,55145,0,50652,1800,48852,0,48476,1920,46556,0,49815,2300,47515
17665,20000,16000,0,0,0,0,0,1,-1,15703,0,15703,2,9914,1000,8914,0,8200,0,8200,0,11876,5000,6876
17666,80000,64000,0,0,0,0,0,0,-1,1838,1838,0,-1,2899,2899,0,-1,1376,1376,0,-1,1320,1320,0
17667,130000,104000,0,0,0,0,0,0,0,0,0,0,0,1207,1207,0,-1,0,0,0,-1,0,0,0
17668,140000,112000,0,0,0,0,0,0,0,47928,2100,45828,0,48731,1900,46831,0,49793,2000,47793,0,50812,2000,48812
17669,300000,240000,0,0,0,0,0,0,-1,-5,0,-5,-2,1578,1583,-5,-1,1307,1307,0,-1,0,0,0
17670,330000,264000,0,0,0,0,0,0,0,39305,2000,37305,0,40251,3000,37251,0,41683,3000,38683,0,38978,3000,35978
17671,60000,48000,1,1,1,0,0,0,0,77423,3000,74423,0,70653,3000,67653,0,22552,5000,17552,0,23708,3000,20708
17672,360000,288000,0,0,0,0,0,0,0,161295,4899,156396,0,199803,202074,-2271,-2,198614,200395,-1781,-1,2383,2383,0
17673,210000,168000,0,0,0,0,0,0,-2,435,437,-2,-2,18950,19053,-103,-2,6804,6838,-34,-2,59999,59999,0
17674,110000,88000,0,0,0,0,0,0,0,57944,2900,55044,0,53857,2000,51857,0,35036,2000,33036,0,31973,2000,29973
17675,180000,144000,0,0,0,0,0,0,-1,25900,1743,24157,0,22964,1200,21764,0,21878,2000,19878,0,13715,2000,11715
17676,490000,392000,0,0,0,0,0,0,0,202400,11365,191035,0,46634,1700,44934,0,47622,1740,45882,0,50844,4026,46818
17677,200000,160000,0,0,0,0,0,0,-1,1082,1082,0,-1,541,0,541,0,541,541,0,-1,541,541,0
17678,110000,88000,0,1,0,0,0,0,0,108895,5000,103895,0,78194,2700,75494,0,76385,2901,73484,0,76858,3000,73858
17679,30000,24000,0,0,0,0,0,1,-1,888,0,888,2,656,656,0,-1,1957,1957,0,-1,1536,0,1536
17680,300000,240000,0,0,0,0,0,0,-1,26041,26171,-130,-1,18158,18249,-91,-1,18147,18238,-91,-1,45199,45301,-102
17681,110000,88000,0,0,0,0,0,0,0,26054,2000,24054,0,22918,3000,19918,0,23216,6000,17216,0,14371,2340,12031
17682,50000,40000,0,1,1,1,1,1,0,46450,4000,42450,0,45402,0,45402,2,48677,4000,44677,2,47740,0,47740
17683,20000,16000,0,0,0,1,1,0,2,17549,1600,15949,2,18907,3570,15337,2,19114,801,18313,2,19186,901,18285
17684,450000,360000,0,1,1,1,1,1,2,387398,14062,373336,0,395655,14700,380955,0,403568,14500,389068,0,418182,21077,397105
17685,100000,80000,0,0,0,0,0,1,2,74489,6600,67889,2,78660,6000,72660,2,76797,0,76797,2,78404,3000,75404
17686,360000,288000,0,0,0,0,0,0,-1,11142,11253,-111,-1,0,0,0,-1,0,0,0,-2,0,0,0
17687,280000,224000,0,0,0,0,0,0,-1,2663,2664,-1,-1,867,867,0,-1,3060,3060,0,-1,858,858,0
17688,240000,192000,0,0,0,0,0,0,-2,0,0,0,-2,0,0,0,-2,0,0,0,-2,0,0,0
17689,50000,40000,0,1,0,0,0,0,0,50280,2324,47956,0,18762,1000,17762,0,18290,1000,17290,0,19165,1165,18000
17690,20000,16000,0,0,0,0,0,1,2,1050,0,1050,2,1050,0,1050,3,1050,0,1050,3,1050,0,1050
17691,240000,192000,1,1,1,1,1,0,0,468202,80167,388035,0,442401,15167,427234,0,419209,16000,403209,0,425061,13133,411928
17692,360000,288000,0,0,0,0,0,0,-1,328,328,0,-1,3721,3721,0,-1,3150,3150,0,-2,150,150,0
17693,20000,16000,0,1,0,1,1,1,2,16090,0,16090,2,20648,5148,15500,2,19759,0,19759,4,19160,0,19160
17694,90000,72000,0,0,0,0,0,0,-2,528,528,0,-2,0,0,0,-2,528,528,0,-2,264,264,0
17695,20000,16000,0,0,1,1,1,0,3,17046,1600,15446,2,16676,200,16476,2,16704,600,16104,2,16984,700,16284
17696,30000,24000,0,1,1,1,1,0,2,27189,1500,25689,2,28235,1800,26435,0,28669,1200,27469,0,29355,1300,28055
17697,50000,40000,1,1,0,0,0,1,2,51400,0,51400,2,0,0,0,2,0,0,0,-2,0,0,0
17698,160000,128000,0,0,0,0,0,0,-1,390,0,390,2,1080,1080,0,-1,540,0,540,2,390,390,0
17699,100000,80000,0,0,0,0,0,1,0,42283,10000,32283,0,51539,10000,41539,0,50583,0,50583,2,52588,2846,49742
17700,190000,152000,0,0,0,0,0,0,0,4886,1797,3089,0,6258,1785,4473,0,8969,3142,5827,0,9009,490,8519
17701,60000,48000,0,0,0,0,0,0,0,18423,5000,13423,0,13099,4000,9099,0,14537,2000,12537,0,16928,5000,11928
17702,400000,320000,0,0,0,0,0,0,-1,43775,43947,-172,-1,10644,10183,461,0,42195,42195,0,-1,12246,12246,0
17703,80000,64000,0,0,0,0,0,0,2,0,0,0,2,0,0,0,-2,0,0,0,-2,0,0,0
17704,420000,336000,0,0,0,0,0,0,0,200431,7529,192902,0,200252,10005,190247,0,202789,8015,194774,0,205082,10018,195064
17705,50000,40000,0,0,0,0,0,0,0,27451,1815,25636,0,19431,695,18736,0,19837,719,19118,0,20232,724,19508
17706,280000,224000,0,0,0,0,0,0,-1,2219,2226,-7,-1,3008,3008,0,-2,849,1255,-406,-2,1763,152446,-150683
17707,30000,24000,0,0,0,0,0,1,2,21972,3005,18967,2,21321,0,21321,2,21897,930,20967,0,22395,1000,21395
17708,80000,64000,0,0,0,0,0,1,0,51536,2000,49536,0,52782,2100,50682,0,53781,2000,51781,0,55389,2500,52889
17709,200000,160000,0,0,0,0,0,0,-2,1265,1667,-402,-2,2473,2473,0,-2,0,0,0,-2,0,0,0
17710,130000,104000,0,0,0,0,0,0,0,39138,2000,37138,0,40023,2000,38023,0,40536,1469,39067,0,41697,2000,39697
17711,290000,232000,0,0,0,0,0,0,0,57094,3007,54087,0,55293,2004,53289,0,54738,2101,52637,0,55435,2503,52932
17712,10000,8000,0,0,0,0,0,1,-2,-1000,0,-1000,-2,-1000,0,-1000,-2,-1000,0,-1000,-2,-1000,0,-1000
17713,130000,104000,0,0,0,0,0,0,-1,3895,3895,0,-1,1500,1500,0,-1,450,450,0,-1,5289,5289,0
17714,360000,288000,0,0,0,0,0,0,0,23497,10000,13497,0,13128,5000,8128,0,13485,3500,9985,0,0,0,0
17715,50000,40000,1,1,1,0,0,0,0,78692,3068,75624,0,79543,2309,77234,0,19738,694,19044,0,19759,716,19043
17716,10000,8000,0,0,0,0,0,0,0,7308,1000,6308,0,5736,115,5621,0,6236,500,5736,0,-764,180,-944
17717,140000,112000,0,0,0,0,0,0,0,13035,1004,12031,0,5753,115,5638,0,2296,46,2250,0,1398,1398,0
17718,70000,56000,0,0,0,0,0,1,0,46920,2056,44864,0,47184,1700,45484,0,48058,2000,46058,0,48888,2000,46888
17719,170000,136000,0,0,0,0,0,0,0,72741,6000,66741,0,76149,5000,71149,0,84474,10000,74474,0,92400,10000,82400
17720,200000,160000,0,0,0,0,0,0,-1,20426,21008,-582,-1,15592,16026,-434,-1,12541,60,12481,0,8667,8667,0
17721,20000,16000,0,0,0,0,0,0,0,11016,1000,10016,2,12027,1500,10527,0,12030,500,11530,0,12535,700,11835
17722,30000,24000,0,1,1,1,1,1,0,26716,1408,25308,0,26918,1000,25918,0,27089,964,26125,0,26277,1136,25141
17723,230000,184000,0,0,0,0,0,1,2,35043,0,35043,2,35678,1513,34165,2,36730,1730,35000,2,35994,2000,33994
17724,80000,64000,0,0,0,0,0,1,-1,3001,3001,0,-1,21306,21306,0,-1,5051,5051,0,-1,2450,2450,0
17725,50000,40000,0,1,0,0,0,0,0,49094,2500,46594,0,1884,942,942,-1,19792,19792,0,-1,19809,727,19082
17726,50000,40000,0,0,0,0,0,0,2,26649,1481,25168,0,27584,1416,26168,0,28135,967,27168,0,28878,1156,27722
17727,600000,480000,0,0,0,0,0,0,-2,349,349,0,-2,-9,9,-18,-2,-9,0,-9,-2,-9,0,-9
17728,140000,112000,0,1,1,1,1,0,0,128812,4700,124112,0,131374,4706,126668,0,135353,6100,129253,0,137238,5300,131938
17729,50000,40000,0,0,0,0,0,1,2,11257,1000,10257,2,11772,1000,10772,2,12574,1000,11574,0,13369,1000,12369
17730,150000,120000,0,0,0,0,0,0,0,110884,5500,105384,0,111706,4145,107561,0,113942,4186,109756,0,116626,4630,111996
17731,280000,224000,0,0,0,0,0,0,-2,0,0,0,-2,0,0,0,-2,0,0,0,-2,0,0,0
17732,110000,88000,0,0,0,0,0,0,0,78925,2745,76180,0,49341,2341,47000,0,50289,1959,48330,0,44221,5000,39221
17733,200000,160000,0,0,0,0,0,1,-1,0,0,0,-1,832,1248,-416,-1,416,0,416,0,416,416,0
17734,280000,224000,0,0,0,0,0,0,0,223383,9401,213982,0,162196,6001,156195,0,165129,6001,159128,0,168295,6201,162094
17735,230000,184000,0,0,0,0,0,0,-1,13013,13013,0,-1,14265,1252,13013,0,13659,3659,10000,0,0,0,0
17736,180000,144000,0,0,0,0,0,0,-2,0,0,0,-2,0,0,0,-2,0,0,0,-2,0,0,0
17737,150000,120000,0,0,0,0,0,0,-2,0,0,0,-2,0,0,0,-2,0,0,0,-2,0,0,0
17738,20000,16000,0,0,0,0,0,1,0,2829,0,2829,2,3920,1700,2220,2,1997,0,1997,2,1317,100,1217
17739,50000,40000,0,1,1,0,0,1,0,47209,2138,45071,0,47471,1400,46071,0,21571,431,21140,0,19005,380,18625
17740,140000,112000,0,0,0,0,0,0,-1,92990,4070,88920,0,93960,3225,90735,0,96724,4137,92587,0,91539,3100,88439
17741,280000,224000,0,0,0,0,0,0,-1,12984,13046,-62,-1,-5,5,-10,-1,1411,1416,-5,-1,5654,5654,0
17742,30000,24000,0,0,0,1,1,0,0,24630,2000,22630,0,24813,888,23925,0,25333,920,24413,0,25911,1000,24911
17743,60000,48000,0,1,1,1,1,1,0,54733,3000,51733,0,55618,1888,53730,0,56827,2000,54827,0,58040,2000,56040
17744,60000,48000,0,0,0,0,0,1,0,31556,2000,29556,0,32345,1315,31030,0,33663,2000,31663,0,34945,2000,32945
17745,130000,104000,0,0,0,0,0,0,0,33328,1559,31769,0,34310,1541,32769,0,35059,1290,33769,0,44458,10000,34458
17746,340000,272000,0,0,0,0,0,0,0,326074,160444,165630,0,276519,10143,266376,0,251815,7190,244625,0,218706,6283,212423
17747,70000,56000,0,0,0,0,0,0,0,19685,2000,17685,0,18887,1000,17887,0,19073,2000,17073,0,20208,3003,17205
17748,280000,224000,1,1,1,0,0,0,0,334612,24612,310000,0,262625,22625,240000,0,172344,12344,160000,0,182776,12776,170000
17749,10000,8000,0,1,0,1,0,0,3,8101,0,8101,2,8995,1000,7995,2,8216,0,8216,2,7756,500,7256
17750,230000,184000,0,0,0,0,0,1,2,5346,5500,-154,-1,6971,4000,2971,0,10707,11000,-293,-1,15392,5000,10392
17751,80000,64000,0,0,0,0,0,0,0,17427,41,17386,2,67659,65007,2652,2,63815,53,63762,2,48670,3228,45442
17752,150000,120000,1,1,1,1,1,0,0,151591,0,151591,2,151549,4845,146704,0,146417,8046,138371,0,137835,9200,128635
17753,110000,88000,0,1,0,0,0,0,0,109836,4823,105013,0,44356,2000,42356,0,45932,2000,43932,0,47473,2000,45473
17754,20000,16000,1,1,1,1,1,0,2,25026,1700,23326,2,23073,0,23073,2,22857,1653,21204,2,21143,0,21143
17755,130000,104000,0,0,0,0,0,0,0,47329,1807,45522,0,45854,1800,44054,0,46822,1701,45121,0,47567,2002,45565
17756,90000,72000,0,0,0,0,0,0,0,36190,1354,34836,0,17754,2906,14848,0,11104,370,10734,0,11234,381,10853
17757,40000,32000,0,0,0,0,0,0,2,16345,3100,13245,2,16531,750,15781,2,16467,500,15967,2,16061,0,16061
17758,260000,208000,0,0,0,0,0,1,-2,0,0,0,-2,0,0,0,-2,0,0,0,-2,1150,1150,0
17759,110000,88000,0,1,1,1,1,0,0,107164,6000,101164,0,105988,4000,101988,0,108617,5000,103617,0,103497,4000,99497
17760,110000,88000,0,0,0,0,0,0,2,150,0,150,7,150,0,150,7,150,0,150,7,150,0,150
17761,50000,40000,0,0,0,0,0,0,0,21507,1700,19807,0,17827,2000,15827,0,7655,500,7155,0,7881,500,7381
17762,180000,144000,0,0,0,0,0,0,0,44561,1712,42849,0,45130,1894,43236,0,47790,4000,43790,0,48222,1837,46385
17763,80000,64000,0,0,0,0,0,0,-1,36751,3000,33751,0,390,0,390,0,390,390,0,-1,390,390,0
17764,250000,200000,0,0,1,1,1,0,0,205635,10800,194835,0,212608,12018,200590,2,207919,3000,204919,2,205377,5000,200377
17765,160000,128000,0,0,0,0,0,1,-2,-1027,0,-1027,-2,603,1630,-1027,-1,277,0,277,0,1451,1500,-49
17766,20000,16000,0,0,0,1,1,1,2,15855,10000,5855,2,16295,1000,15295,2,17023,1000,16023,0,17388,639,16749
17767,50000,40000,0,1,1,1,1,0,0,45409,2500,42909,0,47718,3500,44218,0,46480,0,46480,2,48756,2800,45956
17768,100000,80000,0,0,0,0,0,0,-1,1672,0,1672,2,836,0,836,0,836,836,0,-1,836,836,0
17769,250000,200000,0,0,0,0,0,0,-2,947,947,0,-1,7385,7385,0,-1,3806,5301,-1495,-1,22319,46660,-24341
17770,50000,40000,0,0,0,0,0,0,0,22574,5000,17574,0,20483,0,20483,2,20121,729,19392,0,20191,793,19398
17771,50000,40000,0,0,0,0,0,0,0,30180,1000,29180,0,0,0,0,0,0,0,0,-2,0,0,0
17772,50000,40000,0,0,0,0,0,0,0,13355,1182,12173,0,13622,449,13173,0,11550,565,10985,0,11713,504,11209
17773,200000,160000,0,0,0,0,0,0,-2,0,0,0,-2,0,0,0,-2,0,0,0,-2,0,0,0
17774,70000,56000,0,1,0,0,0,0,0,70207,2808,67399,0,30348,2455,27893,0,28320,1337,26983,0,28704,2000,26704
17775,600000,480000,0,0,0,0,0,0,-2,1095,1096,-1,-2,899,4,895,-2,598,601,-3,-2,-2,0,-2
17776,100000,80000,0,0,0,0,0,0,2,11440,6000,5440,0,7470,0,7470,0,44097,44097,0,-1,56328,15000,41328
17777,310000,248000,0,0,0,0,0,0,0,110375,6000,104375,0,84373,4000,80373,0,57779,3000,54779,0,14163,1000,13163
17778,90000,72000,0,0,0,0,0,0,0,62082,2500,59582,0,61436,1479,59957,0,27507,1000,26507,0,29218,3473,25745
17779,80000,64000,0,0,0,0,0,0,-2,0,0,0,-2,0,0,0,-2,0,0,0,-2,0,0,0
17780,110000,88000,0,0,0,0,0,0,-1,0,0,0,-1,0,0,0,-2,0,0,0,-2,0,0,0
17781,90000,72000,0,1,1,0,0,0,0,85744,3110,82634,0,79963,4677,75286,0,70021,3200,66821,0,70853,2500,68353
17782,400000,320000,0,0,0,0,0,0,0,12762,1302,11460,0,13043,1052,11991,0,10137,510,9627,0,8249,305,7944
17783,30000,24000,0,1,1,1,1,0,2,30615,1753,28862,0,29304,1200,28104,0,28996,1041,27955,0,28970,1194,27776
17784,80000,64000,0,0,0,0,0,0,0,63342,10000,53342,0,51529,4000,47529,0,41484,2000,39484,0,34097,3000,31097
17785,240000,192000,0,0,0,0,0,1,-1,1473,1473,0,-1,1473,1473,0,-1,1473,1473,0,-1,1473,1473,0
17786,160000,128000,0,0,0,0,0,0,-1,0,0,0,-1,6795,6795,0,-1,0,0,0,-1,0,0,0
17787,80000,64000,0,1,1,1,1,0,0,71181,3500,67681,0,68997,3000,65997,0,70364,2503,67861,0,71842,2596,69246
17788,30000,24000,0,0,0,0,0,1,0,22092,1672,20420,0,23104,1684,21420,0,23420,1000,22420,0,24045,1000,23045
17789,90000,72000,0,0,0,0,0,0,-2,23968,4000,19968,-2,13574,13574,0,-1,6800,14,6786,0,1830,5,1825
17790,300000,240000,0,0,0,0,0,0,-2,10841,1000,9841,-2,11900,1059,10841,-2,0,0,0,-2,0,0,0
17791,60000,48000,0,0,0,0,0,0,-1,749,0,749,2,749,749,0,-1,58852,58852,0,-1,6295,6295,0
17792,50000,40000,0,0,0,0,0,0,0,16834,0,16834,2,15970,1166,14804,0,14502,452,14050,0,12671,451,12220
17793,200000,160000,0,0,0,0,0,0,-1,483,486,-3,-1,5452,6175,-723,-1,389,1,388,0,389,390,-1
17794,50000,40000,0,1,1,1,1,0,2,48608,1939,46669,0,48423,2000,46423,0,49023,1700,47323,0,49681,1750,47931
17795,420000,336000,0,0,0,0,0,0,-2,-13,5000,-5013,-2,2666,2679,-13,-2,1614,1622,-8,-2,6066,6080,-14
17796,500000,400000,0,0,0,0,0,0,0,6061,1280,4781,0,7289,1791,5498,0,8313,1528,6785,0,6490,1512,4978
17797,30000,24000,0,0,0,0,0,0,-2,0,0,0,-2,0,0,0,-2,0,0,0,-2,379,379,0
17798,140000,112000,0,0,0,0,0,0,-2,0,0,0,-2,0,0,0,-2,0,0,0,-2,0,0,0
17799,100000,80000,0,0,0,0,0,0,0,43348,3000,40348,0,42782,1900,40882,0,40779,1550,39229,0,40618,1430,39188
17800,240000,192000,0,0,0,0,0,0,2,2288,2100,188,2,2100,405,1695,2,405,0,405,0,1665,1665,0
17801,500000,400000,0,0,0,0,0,1,-2,0,0,0,-2,0,0,0,-2,0,0,0,-2,0,0,0
17802,20000,16000,0,0,0,0,0,1,2,8541,2869,5672,2,8560,305,8255,2,8274,0,8274,2,9135,1000,8135
17803,330000,264000,0,0,0,0,0,0,0,229947,10000,219947,0,233122,8507,224615,0,246414,17215,229199,0,253338,11000,242338
17804,30000,24000,0,0,0,0,0,0,-2,-220,0,-220,-2,780,1000,-220,-1,0,0,0,-1,0,0,0
17805,20000,16000,0,1,0,0,0,0,0,18768,1768,17000,0,1261,1261,0,-1,390,390,0,-1,390,390,0
17806,60000,48000,0,1,1,1,1,1,2,55764,0,55764,2,64522,9700,54822,2,62945,0,62945,4,61700,0,61700
17807,80000,64000,0,1,1,1,1,0,0,72368,3500,68868,0,77505,7000,70505,0,78845,3100,75745,0,74182,3000,71182
17808,230000,184000,0,0,0,0,0,0,-2,0,0,0,-2,0,0,0,-2,0,0,0,-2,0,0,0
17809,100000,80000,0,0,0,0,0,0,-2,1261,1261,0,-2,390,390,0,-2,390,390,0,-2,390,390,0
17810,10000,8000,0,1,1,1,1,1,0,10038,1305,8733,0,9784,1000,8784,0,9984,200,9784,0,9780,196,9584
17811,50000,40000,0,0,0,0,0,0,0,23618,1300,22318,0,26009,3000,23009,0,24731,0,24731,2,46882,25000,21882
17812,30000,24000,0,1,0,0,0,1,0,29239,2000,27239,0,9435,1920,7515,0,724,724,0,-2,724,724,0
17813,150000,120000,0,1,1,1,1,0,0,142991,4847,138144,0,146745,4997,141748,0,149526,4120,145406,0,147034,4133,142901
17814,30000,24000,0,0,0,1,1,0,2,23952,1500,22452,0,27052,3500,23552,0,28631,2336,26295,0,28037,0,28037
17815,70000,56000,0,0,0,0,0,1,2,21790,1400,20390,2,21142,0,21142,2,23772,3000,20772,2,24930,1700,23230
17816,360000,288000,0,0,0,0,0,0,-1,34635,34825,-190,-1,26645,26674,-29,-1,18088,18112,-24,-1,8703,8719,-16
17817,50000,40000,0,1,1,0,0,0,0,47875,2100,45775,0,48110,1300,46810,0,18576,700,17876,0,15339,1000,14339
17818,180000,144000,0,0,0,0,0,0,-1,2766,2766,0,-1,97996,97996,0,-1,55156,1861,53295,0,36213,1196,35017
17819,100000,80000,0,0,0,0,0,0,-1,0,0,0,-2,0,0,0,-2,0,0,0,-2,0,0,0
17820,120000,96000,0,0,0,0,0,0,0,98109,5007,93102,0,74387,5000,69387,0,75237,5000,70237,0,78967,5000,73967
17821,20000,16000,0,0,0,0,0,1,2,2400,0,2400,2,2400,0,2400,7,2400,0,2400,7,1800,0,1800
17822,80000,64000,1,1,1,1,1,0,2,81472,0,81472,2,82332,2989,79343,0,84067,3105,80962,0,78510,2973,75537
17823,70000,56000,0,0,0,0,0,0,2,45772,1900,43872,2,46611,1900,44711,2,47508,1800,45708,2,48476,1900,46576
17824,10000,8000,0,0,0,0,0,0,2,4789,0,4789,2,6199,1500,4699,2,5951,0,5951,2,6255,400,5855
17825,20000,16000,1,1,1,1,1,0,0,107828,3650,104178,0,102937,3120,99817,0,98525,3200,95325,0,77711,2900,74811
17826,220000,176000,0,0,0,0,0,0,-2,4292,4323,-31,-2,1803,1812,-9,-2,2970,2985,-15,-2,6348,6379,-31
17827,130000,104000,0,0,0,0,0,0,-1,2448,2774,-326,-1,5457,5457,0,-1,3855,3855,0,-1,4684,4684,0
17828,50000,40000,0,0,0,0,0,1,0,30659,1712,28947,0,30963,1016,29947,0,30505,2500,28005,0,28696,0,28696
17829,200000,160000,0,0,0,0,0,0,0,7892,8082,-190,-1,1961,2580,-619,-1,1357,1357,0,-1,1357,0,1357
17830,80000,64000,0,0,0,0,0,0,0,23213,5000,18213,0,27547,6000,21547,0,31151,5000,26151,0,37673,8000,29673
17831,170000,136000,0,0,0,0,0,0,0,37589,3037,34552,0,29079,5018,24061,0,27134,5006,22128,0,27734,3024,24710
17832,20000,16000,0,0,1,0,0,1,2,18331,2346,15985,0,19111,1400,17711,0,15211,304,14907,0,13562,271,13291
17833,360000,288000,0,0,0,0,0,0,2,1861,0,1861,2,1457,1457,0,-1,-129,2500,-2629,-1,-2629,326,-2955
17834,30000,24000,0,1,1,1,0,0,2,28236,0,28236,2,29383,2000,27383,2,24131,0,24131,2,26979,5000,21979
17835,360000,288000,0,0,0,0,0,1,-2,512,512,0,-1,2512,2000,512,0,2593,2473,120,0,0,0,0
17836,20000,16000,0,0,0,0,0,0,0,6401,1000,5401,0,4300,0,4300,0,1304,1304,0,0,0,0,0
17837,100000,80000,1,1,0,0,0,0,2,106101,1867,104234,0,54707,5026,49681,0,54924,2800,52124,2,52141,2800,49341
17838,30000,24000,1,1,1,1,1,0,0,32406,1500,30906,0,32167,1500,30667,0,31728,1300,30428,0,31061,1261,29800
17839,20000,16000,0,1,1,0,0,0,2,20037,1400,18637,0,19640,393,19247,0,15378,308,15070,0,7284,1000,6284
17840,260000,208000,0,0,0,0,0,0,-1,879,879,0,-1,697,697,0,-1,396,396,0,-1,3635,3635,0
17841,20000,16000,0,1,1,1,1,0,0,20205,1290,18915,0,19998,694,19304,0,20367,869,19498,0,20399,2102,18297
17842,310000,248000,0,0,0,0,0,0,0,26198,1600,24598,0,26766,1000,25766,0,27341,1000,26341,0,28891,2000,26891
17843,180000,144000,0,0,0,0,0,0,0,116352,3013,113339,0,55698,3034,52664,0,37315,4069,33246,0,16696,3018,13678
17844,220000,176000,0,0,0,0,0,0,0,107102,6000,101102,0,27361,3000,24361,0,29340,2340,27000,0,33933,5000,28933
17845,200000,160000,0,0,0,0,0,0,0,113809,5000,108809,0,35797,1412,34385,0,36087,1300,34787,0,38505,3000,35505
17846,160000,128000,0,0,0,0,0,0,0,13420,1329,12091,0,13873,1098,12775,0,13833,374,13459,0,13818,400,13418
17847,200000,160000,0,1,1,1,1,0,0,192220,7048,185172,0,180090,6000,174090,0,184603,6500,178103,0,189340,7430,181910
17848,170000,136000,0,0,0,0,0,0,0,21014,5020,15994,0,18517,2000,16517,0,9058,3000,6058,0,5035,1000,4035
17849,80000,64000,0,0,0,0,0,1,0,61513,5000,56513,0,59769,0,59769,2,61937,3000,58937,0,66088,5000,61088
17850,220000,176000,0,0,0,0,0,0,-1,16436,17571,-1135,-1,16071,0,16071,0,96,0,96,0,480,549,-69
17851,90000,72000,0,0,0,0,0,0,2,1062,1062,0,-1,1062,1062,0,-1,1062,0,1062,0,0,0,0
17852,90000,72000,0,0,0,0,0,0,0,63686,7400,56286,0,65233,3200,62033,2,66637,2600,64037,2,67882,2500,65382
17853,50000,40000,0,0,0,0,0,0,-1,390,390,0,-1,390,390,0,-1,390,390,0,-1,390,390,0
17854,50000,40000,0,0,0,1,1,0,0,40226,2000,38226,0,41256,1700,39556,0,43962,3400,40562,0,44913,1800,43113
17855,320000,256000,0,0,0,0,0,0,0,18079,1403,16676,0,18077,18084,-7,-1,1792,1801,-9,-1,18344,18352,-8
17856,200000,160000,0,0,0,0,0,0,-2,10000,10000,0,-2,10301,10301,0,-2,10000,10000,0,-2,10000,10000,0
17857,30000,24000,0,0,0,0,0,0,0,21949,2000,19949,0,24116,2535,21581,0,23430,0,23430,2,25044,2000,23044
17858,50000,40000,0,0,0,0,0,1,2,32847,1900,30947,2,33308,1300,32008,2,33755,1300,32455,2,34565,1500,33065
17859,180000,144000,0,0,0,0,0,0,-1,3762,3772,-10,-1,5231,5254,-23,-1,2092,2098,-6,-1,3395,3403,-8
17860,200000,160000,0,0,0,0,0,0,-1,11109,11119,-10,-1,9471,9473,-2,-1,11132,11140,-8,-1,9633,9636,-3
17861,320000,256000,0,0,0,0,0,0,0,86047,5036,81011,0,82233,5075,77158,0,72175,5017,67158,0,77831,10077,67754
17862,230000,184000,0,0,0,0,0,0,0,66321,4023,62298,0,66271,5000,61271,0,62401,5000,57401,0,61510,5267,56243
17863,200000,160000,0,0,0,0,0,1,-1,2058,2064,-6,-1,1546,1550,-4,-1,2215,2229,-14,-1,1828,1833,-5
17864,340000,272000,0,0,0,0,0,0,0,159464,59503,99961,0,155685,3330,152355,0,137838,40,137798,0,6556,6556,0
17865,90000,72000,0,0,0,0,0,0,0,44388,2500,41888,0,45348,2000,43348,0,48454,4000,44454,0,47524,0,47524
17866,290000,232000,0,0,0,0,0,0,0,112394,5620,106774,0,113459,10000,103459,0,123967,20000,103967,0,131735,10000,121735
17867,30000,24000,0,0,0,0,0,1,0,10928,2000,8928,0,11445,1000,10445,0,12108,1000,11108,0,12753,1000,11753
17868,500000,400000,0,0,0,0,0,0,-1,7544,7594,-50,-1,14459,14484,-25,-1,9736,9762,-26,-1,9123,9142,-19
17869,250000,200000,0,0,0,0,0,0,-2,-29,0,-29,-2,-29,0,-29,-2,-29,0,-29,-2,-29,0,-29
17870,50000,40000,0,0,0,0,0,0,0,34602,3000,31602,0,35172,1477,33695,0,27568,2000,25568,0,28467,1500,26967
17871,50000,40000,0,1,1,1,0,0,0,46546,3000,43546,0,46033,2400,43633,0,48656,3023,45633,0,41674,5000,36674
17872,260000,208000,0,0,0,0,0,1,-1,832,832,0,-1,0,0,0,-1,284,284,0,-1,463,463,0
17873,130000,104000,0,0,0,0,0,0,-1,396,396,0,-1,396,396,0,-1,396,396,0,-1,396,396,0
17874,310000,248000,0,0,0,0,0,1,-1,7488,5000,2488,0,10276,6000,4276,0,96059,93000,3059,0,6434,3000,3434
17875,280000,224000,0,0,0,0,0,0,0,126953,5400,121553,0,106551,5006,101545,0,99592,3250,96342,0,100607,3400,97207
17876,260000,208000,0,0,0,0,0,0,0,36638,5022,31616,0,122388,130000,-7612,-1,127402,7000,120402,0,131074,6000,125074
17877,50000,40000,0,0,0,0,0,1,-1,580,590,-10,-1,1380,1400,-20,-1,0,0,0,-1,390,390,0
17878,320000,256000,0,0,0,0,0,0,0,99672,4520,95152,0,101953,5050,96903,0,102284,3590,98694,0,104090,3700,100390
17879,130000,104000,0,0,0,0,0,0,0,101618,5000,96618,0,-32,3000,-3032,0,-32,0,-32,-2,-32,0,-32
17880,50000,40000,0,0,0,0,0,0,0,19195,6200,12995,0,13134,3000,10134,0,13398,2000,11398,0,13549,2000,11549
17881,360000,288000,0,0,0,0,0,0,2,0,0,0,-2,0,0,0,-2,0,0,0,-2,0,0,0
17882,280000,224000,0,0,0,0,0,0,-1,390,390,0,-1,390,390,0,-1,390,390,0,-1,150,150,0
17883,260000,208000,0,0,0,0,0,0,0,107853,3670,104183,0,103031,4000,99031,0,98487,4000,94487,0,77783,3000,74783
17884,80000,64000,0,1,0,1,1,0,0,71755,2571,69184,0,66175,2500,63675,0,67573,2500,65073,0,69083,2600,66483
17885,240000,192000,0,0,0,0,0,0,0,17242,2000,15242,0,18450,1500,16950,0,18013,0,18013,2,19406,1700,17706
17886,700000,560000,0,0,0,0,0,0,-2,804,804,0,-2,778,778,0,-2,1913,1916,-3,-2,200,200,0
17887,80000,64000,0,1,1,0,0,0,0,77657,3096,74561,0,70105,1887,68218,0,39751,1081,38670,0,14765,2044,12721
17888,120000,96000,0,0,0,0,0,0,-2,0,0,0,-2,0,0,0,-2,0,0,0,-2,0,0,0
17889,310000,248000,0,0,0,0,0,0,0,125072,5006,120066,0,126416,5006,121410,0,132772,10004,122768,0,137519,8007,129512
17890,200000,160000,0,0,0,0,0,0,-2,0,0,0,-2,1107,1107,0,-2,586,586,0,-2,0,0,0
17891,130000,104000,1,1,1,1,1,0,0,147035,11700,135335,0,136542,0,136542,2,137586,10000,127586,0,141191,12500,128691
17892,50000,40000,0,0,0,0,0,0,2,0,0,0,2,0,0,0,-2,0,0,0,-2,0,0,0
17893,170000,136000,0,0,0,0,0,0,-1,2754,2754,0,-1,2754,2754,0,-1,2754,2754,0,-1,2754,2754,0
17894,10000,8000,0,1,1,0,0,0,0,10051,1030,9021,0,9850,1000,8850,0,8214,1000,7214,0,8054,2000,6054
17895,110000,88000,0,0,0,0,0,0,0,48942,1808,47134,0,49959,1825,48134,0,50951,1817,49134,0,52019,1882,50137
17896,300000,240000,0,0,0,0,0,0,-2,0,0,0,-2,0,0,0,-2,0,0,0,-2,0,0,0
17897,70000,56000,0,1,0,1,1,1,0,67375,3700,63675,0,71270,71270,0,-1,71157,3000,68157,0,71008,3000,68008
17898,50000,40000,0,0,0,0,0,0,-1,-60,0,-60,-1,-210,0,-210,-2,-360,0,-360,-2,-510,0,-510
17899,110000,88000,0,0,0,0,0,0,0,75540,2805,72735,0,75724,3406,72318,0,74785,2670,72115,0,76079,2751,73328
17900,80000,64000,0,0,1,1,1,1,0,68204,5500,62704,0,69484,3000,66484,2,68247,0,68247,2,71110,4000,67110
17901,280000,224000,0,0,0,0,0,0,2,1688,1688,0,-1,1226,1226,0,-1,6394,7000,-606,-1,1626,0,1626
17902,20000,16000,0,0,0,0,0,0,2,13863,2800,11063,2,13369,0,13369,5,12582,0,12582,4,12088,0,12088
17903,240000,192000,0,0,0,0,0,0,-1,0,0,0,-2,0,0,0,-2,0,0,0,-2,0,0,0
17904,270000,216000,0,0,0,0,0,0,0,135741,7000,128741,0,126197,5000,121197,0,118340,5000,113340,0,110557,5000,105557
17905,140000,112000,0,0,0,0,0,0,-1,1249,1249,0,-1,1872,1872,0,-1,1453,1453,0,-1,1453,1453,0
17906,460000,368000,0,0,0,0,0,0,0,8642,1288,7354,0,9151,1123,8028,0,9702,1000,8702,0,9752,502,9250
17907,270000,216000,0,0,0,0,0,0,0,166672,5532,161140,0,170000,5572,164428,0,173547,5763,167784,0,177013,5804,171209
17908,170000,136000,0,0,0,1,1,0,2,139869,6513,133356,0,139956,6548,133408,0,141431,5300,136131,0,149946,11001,138945
17909,230000,184000,0,0,0,0,0,0,0,65888,3000,62888,0,66645,2300,64345,0,67865,2300,65565,0,69231,2500,66731
17910,230000,184000,0,0,0,0,0,0,0,165107,6607,158500,0,105508,3773,101735,0,108101,4290,103811,0,110094,4164,105930
17911,120000,96000,0,0,0,0,0,0,2,39730,0,39730,2,42148,3400,38748,2,44509,3200,41309,2,45643,2000,43643
17912,120000,96000,0,0,0,0,0,0,-1,856,856,0,-1,856,856,0,-1,856,856,0,-1,856,856,0
17913,500000,400000,0,0,0,0,0,0,-1,0,0,0,-1,0,0,0,-2,0,0,0,-2,0,0,0
17914,500000,400000,0,0,0,0,0,0,0,75559,5560,69999,0,76426,2426,74000,0,56197,3521,52676,0,42998,1641,41357
17915,10000,8000,0,0,0,0,0,0,0,8775,1027,7748,0,7092,176,6916,0,7410,1253,6157,0,7311,2311,5000
17916,20000,16000,0,1,1,1,0,0,0,18269,1408,16861,0,38082,1180,36902,0,19923,1000,18923,0,6825,500,6325
17917,220000,176000,0,0,0,0,0,0,0,137788,5170,132618,0,106713,4054,102659,0,96588,4500,92088,0,22743,1225,21518
17918,160000,128000,0,0,0,0,0,1,-1,2688,2688,0,-1,2142,2142,0,-1,7139,7139,0,-1,1872,1872,0
17919,200000,160000,0,0,0,0,0,0,0,32808,5000,27808,0,28298,5000,23298,0,26538,2000,24538,0,24645,5000,19645
17920,300000,240000,0,0,0,0,0,0,0,169901,10017,159884,0,170540,9123,161417,0,152188,10259,141929,0,101485,5079,96406
17921,240000,192000,0,0,0,0,0,0,-2,7655,7655,0,-2,23918,23925,-7,-2,265852,265852,0,-2,2225,2225,0
17922,470000,376000,0,0,0,0,0,0,0,318025,13111,304914,0,248281,10000,238281,0,254175,10014,244161,0,256613,9598,247015
17923,430000,344000,0,0,0,0,0,1,0,237297,10300,226997,0,240682,9000,231682,0,245337,8541,236796,0,242481,9054,233427
17924,230000,184000,0,0,0,0,0,1,-2,0,0,0,-2,0,0,0,-2,0,0,0,-2,0,0,0
17925,170000,136000,0,0,0,0,0,0,-1,1104,1108,-4,-1,190,191,-1,-1,4786,4786,0,-1,2714,2714,0
17926,280000,224000,0,0,0,0,0,0,-1,0,0,0,-1,0,0,0,-2,0,0,0,-2,261,261,0
17927,240000,192000,0,0,0,0,0,0,-1,58422,116904,-58482,-1,54755,54762,-7,-2,43605,43705,-100,-1,26293,26293,0
17928,150000,120000,0,0,0,0,0,0,-2,629,629,0,-1,349,3,346,2,2825,2825,0,2,2240,0,2240
17929,70000,56000,0,1,0,0,0,0,2,66948,0,66948,2,30406,1001,29405,0,29128,944,28184,0,23597,5000,18597
17930,130000,104000,0,1,1,0,0,0,0,111780,5000,106780,0,116357,8000,108357,0,96936,4000,92936,0,98173,4000,94173
17931,110000,88000,0,0,0,0,0,0,0,46987,4100,42887,0,45165,0,45165,2,44636,1800,42836,0,45094,2000,43094
17932,230000,184000,0,0,0,0,0,0,0,60991,3000,57991,0,37289,1848,35441,0,37368,1457,35911,0,37357,4443,32914
17933,200000,160000,0,0,0,0,0,0,0,12100,1500,10600,0,13900,2000,11900,0,15900,2000,13900,0,0,0,0
17934,20000,16000,0,0,1,1,1,0,2,18047,3100,14947,2,17326,0,17326,2,17326,400,16926,0,17680,354,17326
17935,200000,160000,0,0,0,0,0,0,-1,696,696,0,-1,696,696,0,-1,846,846,0,-1,696,696,0
17936,10000,8000,0,0,1,1,1,0,0,9199,1200,7999,0,9558,500,9058,0,9136,500,8636,0,9392,500,8892
17937,190000,152000,0,0,0,0,0,1,-1,18666,18666,0,-1,19623,2000,17623,0,21268,3000,18268,0,23038,3000,20038
17938,150000,120000,0,0,0,0,0,0,2,1377,5000,-3623,-1,4007,5960,-1953,-1,7742,5000,2742,0,11376,5000,6376
17939,310000,248000,0,0,0,0,0,0,-1,91059,91059,0,-2,155,155,0,-1,28100,28490,-390,-1,4544,0,4544
17940,10000,8000,0,0,1,1,1,0,0,9564,2300,7264,0,9264,0,9264,2,9862,900,8962,2,10050,500,9550
17941,450000,360000,0,0,0,0,0,0,0,4549,4549,0,-1,16885,16885,0,-1,6440,129,6311,0,7440,1000,6440
17942,210000,168000,0,0,0,0,0,0,0,16765,3023,13742,0,18641,5014,13627,0,18654,5012,13642,0,16229,2012,14217
17943,150000,120000,0,0,0,0,0,0,0,64763,3000,61763,0,66093,1839,64254,0,62568,1773,60795,0,63828,1792,62036
17944,70000,56000,0,0,0,0,0,0,0,8159,0,8159,2,8241,1000,7241,0,9103,1000,8103,0,9361,409,8952
17945,290000,232000,0,0,0,0,0,0,0,131218,5113,126105,0,124556,5006,119550,0,127300,6006,121294,0,129357,5501,123856
17946,100000,80000,0,0,0,0,0,0,0,41718,1663,40055,0,41536,1471,40065,0,42243,1360,40883,0,42929,1212,41717
17947,100000,80000,0,1,0,0,0,0,0,92887,5000,87887,0,0,0,0,0,0,0,0,-2,0,0,0
17948,240000,192000,0,0,0,0,0,0,-1,0,0,0,-1,540,540,0,-1,100,100,0,-1,2600,2600,0
17949,50000,40000,0,0,0,0,0,1,4,12755,3,12752,3,8400,17,8383,2,3150,0,3150,0,0,0,0
17950,50000,40000,0,0,0,0,0,0,0,34239,2021,32218,0,14448,930,13518,0,28799,31074,-2275,-1,29199,1503,27696
17951,170000,136000,0,0,0,0,0,0,-1,2394,0,2394,2,7794,8000,-206,-1,5920,1500,4420,0,2798,2798,0
17952,100000,80000,0,0,0,0,0,0,0,57952,2900,55052,0,58627,2408,56219,0,46055,1689,44366,0,43176,1820,41356
17953,180000,144000,0,0,0,0,0,0,0,8432,2000,6432,0,9977,2000,7977,0,10030,500,9530,0,10836,1100,9736
17954,320000,256000,0,0,0,0,0,0,0,186223,9334,176889,0,114605,4106,110499,0,117159,4405,112754,0,119733,4678,115055
17955,50000,40000,0,0,0,0,0,0,0,8900,0,8900,2,8565,453,8112,0,8590,312,8278,0,19894,1500,18394
17956,400000,320000,0,1,0,0,0,0,0,360270,12374,347896,0,325340,11643,313697,0,328627,11868,316759,0,329948,18000,311948
17957,230000,184000,0,0,0,0,0,0,-2,2889,2889,0,-2,17978,17993,-15,-2,9462,9468,-6,-2,8134,8949,-815
17958,200000,160000,0,0,0,0,0,0,-1,4897,4927,-30,-1,5065,5089,-24,-1,19468,19561,-93,-1,0,0,0
17959,90000,72000,0,0,0,0,0,0,0,51790,3005,48785,0,50346,1700,48646,0,48745,1722,47023,0,46842,1414,45428
17960,130000,104000,0,1,1,1,1,1,2,129669,5000,124669,2,131057,5000,126057,2,128857,0,128857,2,131469,4928,126541
17961,200000,160000,0,0,0,0,0,0,-1,24274,24277,-3,-1,5196,4996,200,0,4996,0,4996,0,16890,16890,0
17962,30000,24000,0,0,0,0,0,1,2,19807,3000,16807,2,20186,1000,19186,2,19725,0,19725,2,22225,3000,19225
17963,100000,80000,0,0,0,0,0,0,-2,-1114,0,-1114,-2,880,1994,-1114,-1,414,0,414,2,1098,1000,98
17964,50000,40000,0,0,0,0,0,1,2,28071,1800,26271,2,27326,0,27326,2,28769,2200,26569,2,28170,0,28170
17965,70000,56000,1,1,1,1,1,0,0,129498,5900,123598,0,131216,6000,125216,0,136744,9200,127544,0,133413,0,133413
17966,30000,24000,0,0,0,0,0,0,-2,12403,12403,0,-1,17849,8359,9490,0,4935,4935,0,-1,6491,3000,3491
17967,180000,144000,0,0,0,0,0,0,-1,760,762,-2,-1,0,0,0,-1,0,0,0,-2,245,245,0
17968,260000,208000,0,0,0,0,0,0,0,151583,5179,146404,0,155493,5276,150217,0,158624,4537,154087,0,161902,4670,157232
17969,250000,200000,0,0,0,0,0,0,0,70004,2351,67653,0,64953,1886,63067,0,51507,1616,49891,0,50338,1756,48582
17970,100000,80000,0,0,0,0,0,0,2,54720,2000,52720,0,55808,1998,53810,0,56976,2068,54908,0,58108,2079,56029
17971,230000,184000,0,0,0,0,0,0,0,9938,5000,4938,0,9865,5828,4037,0,6981,6981,0,-1,12157,6157,6000
17972,210000,168000,0,1,0,0,1,0,0,187501,8600,178901,0,167142,6500,160642,0,170910,6500,164410,0,174336,6300,168036
17973,140000,112000,0,0,0,0,0,0,0,82083,3900,78183,0,83029,3200,79829,0,84737,3200,81537,0,94101,10800,83301
17974,500000,400000,0,0,0,0,0,0,-1,12021,12021,0,-1,132906,132906,0,-1,122256,0,122256,0,37380,37380,0
17975,80000,64000,0,0,0,0,0,0,0,49481,1508,47973,0,38427,1500,36927,0,34683,1600,33083,0,159,279,-120
17976,200000,160000,0,0,0,0,0,1,-1,2655,2655,0,-1,2200,0,2200,-1,0,0,0,-2,0,0,0
17977,60000,48000,0,0,0,0,0,0,0,8270,1144,7126,0,9287,1161,8126,0,10076,950,9126,0,10612,700,9912
17978,20000,16000,0,1,1,1,1,0,0,21158,4000,17158,0,20511,0,20511,2,20316,800,19516,0,20474,1000,19474
17979,240000,192000,0,0,0,0,0,1,2,132640,0,132640,2,135320,4500,130820,0,138523,5000,133523,0,141618,5000,136618
17980,150000,120000,0,0,0,0,0,0,-1,2988,2988,0,-1,2232,2232,0,-1,4535,4535,0,-1,0,0,0
17981,180000,144000,0,0,0,0,0,0,-1,174,174,0,-1,1974,1800,174,0,3462,2600,862,0,4114,2000,2114
17982,80000,64000,0,0,0,0,0,0,0,53728,2354,51374,0,31989,2027,29962,0,20058,800,19258,0,196,196,0
17983,140000,112000,0,0,0,0,0,1,-2,0,0,0,-2,0,0,0,-2,0,0,0,-2,0,0,0
17984,50000,40000,0,1,1,1,1,0,0,41843,1701,40142,0,42839,1697,41142,0,43690,1548,42142,0,44232,1620,42612
17985,280000,224000,0,0,0,0,0,1,-1,0,0,0,-1,327,327,0,-1,168,0,168,0,168,0,168
17986,30000,24000,0,0,0,0,0,1,0,14802,0,14802,2,15523,1276,14247,0,18470,3223,15247,0,18834,805,18029
17987,30000,24000,0,1,1,1,1,1,2,28690,2659,26031,2,27633,0,27633,2,29184,2309,26875,2,28776,1087,27689
17988,20000,16000,0,0,0,0,0,1,0,2800,1028,1772,0,11052,11052,0,-1,10522,311,10211,0,9150,183,8967
17989,180000,144000,0,0,0,0,0,0,-2,100,100,0,-2,100,100,0,-2,100,100,0,-2,100,100,0
17990,180000,144000,0,0,0,0,0,0,3,131327,0,131327,2,131288,7326,123962,0,100116,4124,95992,0,86644,8693,77951
17991,100000,80000,0,0,0,0,0,0,-1,6010,6010,0,-2,2789,2789,0,-2,2973,2973,0,-1,3611,3611,0
17992,360000,288000,0,0,0,0,0,0,-2,4500,5048,-548,-2,71028,72133,-1105,-1,5019,25,4994,0,28028,28168,-140
17993,110000,88000,0,0,0,0,0,1,2,78326,0,78326,2,44890,2000,42890,0,41394,1500,39894,0,42727,2000,40727
17994,660000,528000,0,0,0,0,0,0,0,325889,38507,287382,0,342408,20000,322408,0,19903,2000,17903,0,20843,1000,19843
17995,290000,232000,0,1,0,0,0,0,0,242309,8507,233802,0,238609,10902,227707,0,238712,8600,230112,0,237847,8671,229176
17996,300000,240000,0,0,0,0,0,0,-2,899,899,0,-2,0,0,0,-2,0,0,0,-2,0,0,0
17997,50000,40000,0,0,0,0,0,0,0,39937,1650,38287,0,25864,1500,24364,0,6990,2000,4990,0,9990,3000,6990
17998,50000,40000,0,0,0,0,0,0,0,23459,2083,21376,0,16175,2000,14175,0,17753,2000,15753,0,18302,1000,17302
17999,230000,184000,0,0,0,0,0,0,0,3864,2000,1864,0,3242,2000,1242,0,1428,300,1128,0,2358,2000,358
18000,180000,144000,0,1,0,0,0,0,2,153515,50,153465,2,130864,14500,116364,2,131569,4500,127069,2,128983,296,128687
18001,200000,160000,0,0,0,0,0,1,-2,0,0,0,-2,0,0,0,-2,0,0,0,-2,0,0,0
18002,110000,88000,0,0,0,0,0,0,0,9649,2000,7649,0,11472,2000,9472,0,13267,2000,11267,0,15048,2000,13048
18003,260000,208000,0,0,0,0,0,0,0,198181,10087,188094,0,143561,6030,137531,0,110982,5001,105981,0,72514,10002,62512
18004,50000,40000,0,0,0,0,0,1,2,3679,0,3679,2,596,700,-104,-1,446,0,446,2,2699,2300,399
18005,210000,168000,0,0,0,0,0,1,-1,1080,1080,0,-1,1567,1567,0,-1,788,788,0,-1,0,0,0
18006,60000,48000,0,0,0,0,0,0,0,41300,1616,39684,0,40840,1566,39274,0,40366,1700,38666,0,39737,1600,38137
18007,280000,224000,0,0,0,0,0,0,-2,3615,3615,0,-2,1963,1963,0,-2,2086,2086,0,-2,1297,1297,0
18008,90000,72000,0,0,0,0,0,1,3,1776,0,1776,2,-1170,0,-1170,2,390,1560,-1170,-1,390,390,0
18009,50000,40000,0,0,0,0,0,0,0,40134,1299,38835,0,16764,3007,13757,0,15215,1450,13765,0,16733,3000,13733
18010,470000,376000,0,0,0,0,0,0,0,238161,10400,227761,0,240607,10000,230607,0,230142,25000,205142,0,198171,8000,190171
18011,50000,40000,0,1,0,0,0,0,0,44688,2220,42468,0,19823,1000,18823,0,13645,1500,12145,0,10876,1000,9876
18012,30000,24000,0,1,1,1,1,0,0,26491,1774,24717,0,27132,1415,25717,0,27672,955,26717,0,28253,991,27262
18013,180000,144000,0,0,0,0,0,0,0,-1659,0,-1659,0,111077,112736,-1659,-1,112738,5000,107738,0,115746,5300,110446
18014,230000,184000,0,0,0,0,0,1,-1,0,0,0,-2,0,0,0,-2,0,0,0,-2,0,0,0
18015,130000,104000,0,0,0,0,0,0,0,21783,1505,20278,0,9421,1000,8421,0,8809,500,8309,0,8596,1000,7596
18016,160000,128000,0,0,0,0,0,0,-2,0,0,0,-2,0,0,0,-2,0,0,0,-2,1000,1000,0
18017,500000,400000,0,0,0,0,0,0,-1,216931,7815,209116,0,207423,7372,200051,0,197914,7113,190801,0,188329,6967,181362
18018,160000,128000,0,0,0,0,0,0,0,119200,120377,-1177,-1,115893,3612,112281,0,113309,3100,110209,0,110073,3200,106873
18019,200000,160000,0,0,0,0,0,0,2,0,0,0,2,0,0,0,-2,0,0,0,-2,4549,4549,0
18020,320000,256000,0,0,0,0,0,0,-2,0,0,0,-2,0,0,0,-2,1999,1999,0,-2,1999,1999,0
18021,20000,16000,0,0,0,0,0,0,-1,13771,0,13771,2,362,28,334,2,5308,22073,-16765,-1,0,0,0
18022,50000,40000,0,0,0,0,0,0,-1,6713,1055,5658,0,6452,184,6268,0,6188,182,6006,0,4048,153,3895
18023,120000,96000,0,0,0,0,0,0,0,13903,5000,8903,0,13858,5000,8858,0,14777,5000,9777,0,46061,10000,36061
18024,50000,40000,1,1,1,0,0,1,0,96487,2079,94408,0,43639,2650,40989,0,5290,106,5184,0,41302,41302,0
18025,170000,136000,0,0,0,0,0,0,-1,0,0,0,-1,1546,1546,0,-1,4981,4981,0,-1,4769,4769,0
18026,30000,24000,0,0,0,0,0,0,-2,2118,2118,0,-2,4171,4171,0,-2,1714,1714,0,-2,2001,2001,0
18027,280000,224000,0,0,0,0,0,0,-2,2874,2888,-14,-2,2874,2888,-14,-2,2874,2888,-14,-2,2854,2868,-14
18028,20000,16000,0,0,0,0,0,1,0,8036,1140,6896,0,9597,1700,7897,0,9294,0,9294,2,10242,1100,9142
18029,120000,96000,0,0,0,0,0,0,-1,1980,1980,0,-1,0,0,0,-1,0,0,0,-2,10853,42138,-31285
18030,210000,168000,0,0,0,0,0,0,-2,18062,18145,-83,-1,3019,3019,0,-1,5587,5587,0,-1,28210,28210,0
18031,80000,64000,0,1,0,0,0,0,0,74297,3075,71222,0,33412,1126,32286,0,30070,1091,28979,0,30254,1074,29180
18032,260000,208000,0,0,0,0,0,0,-2,1580,1586,-6,-1,920,920,0,-1,730,730,0,-2,466,466,0
18033,230000,184000,0,0,0,0,0,0,-1,326,326,0,-1,326,326,0,-1,326,326,0,-1,326,326,0
18034,100000,80000,0,0,0,0,0,1,-2,0,0,0,-2,0,0,0,-2,0,0,0,-2,0,0,0
18035,120000,96000,0,0,0,0,0,0,0,90809,5000,85809,0,67313,5000,62313,0,16040,4000,12040,0,116654,110000,6654
18036,300000,240000,0,0,0,0,0,0,0,35228,1377,33851,0,12512,1149,11363,0,12570,2000,10570,0,13022,615,12407
18037,20000,16000,0,0,1,0,0,0,-1,20200,20200,0,-1,20000,0,20000,0,0,0,0,0,0,0,0
18038,30000,24000,0,0,1,1,1,0,0,26985,5000,21985,0,29497,3000,26497,0,29290,2000,27290,0,28693,3150,25543
18039,200000,160000,0,0,0,0,0,0,0,51023,7518,43505,0,56627,7122,49505,0,60693,5627,55066,0,59596,0,59596
18040,90000,72000,0,1,1,0,0,0,0,88884,4400,84484,0,82163,3566,78597,0,22601,7694,14907,0,22029,1000,21029
18041,240000,192000,0,0,0,0,0,0,0,186160,10009,176151,0,191355,10014,181341,0,192406,8500,183906,0,190086,10000,180086
18042,50000,40000,0,0,0,0,0,1,0,27485,1729,25756,0,27477,1111,26366,0,27651,1137,26514,0,27853,1188,26665
18043,140000,112000,0,0,0,0,0,1,2,326,326,0,-1,326,326,0,-1,476,476,0,-1,326,326,0
18044,16000,12800,0,0,0,0,0,0,2,5366,1089,4277,0,5473,196,5277,0,5750,365,5385,0,6995,1500,5495
18045,200000,160000,0,0,0,0,0,0,-2,0,0,0,-2,0,0,0,-2,0,0,0,-2,0,0,0
18046,270000,216000,0,0,0,0,0,0,-1,192008,8000,184008,0,166364,7800,158564,0,141918,5000,136918,0,141984,5500,136484
18047,190000,152000,0,0,0,0,0,0,0,115325,9800,105525,0,112063,0,112063,2,114484,4300,110184,0,121179,8700,112479
18048,120000,96000,0,0,0,0,0,0,0,49587,2000,47587,2,50961,2500,48461,0,53597,4100,49497,0,55094,2500,52594
18049,60000,48000,0,1,0,0,0,1,0,56414,2507,53907,0,47643,1000,46643,0,28208,28512,-304,-1,27570,994,26576
18050,20000,16000,0,1,1,1,1,0,2,17031,0,17031,2,19715,3300,16415,2,19806,700,19106,2,18747,0,18747
18051,30000,24000,0,0,0,0,0,0,0,19082,2000,17082,0,19145,2500,16645,0,15839,2000,13839,0,9335,2000,7335
18052,240000,192000,0,0,0,0,0,0,-1,3708,3700,8,0,20694,20739,-45,-1,19771,10003,9768,0,38603,40115,-1512
18053,50000,40000,0,0,0,0,0,0,0,18760,1312,17448,0,19132,684,18448,0,19533,709,18824,0,19936,728,19208
18054,130000,104000,0,0,0,0,0,0,0,43760,2037,41723,0,31540,1218,30322,0,23675,2182,21493,0,15841,1003,14838
18055,40000,32000,0,0,0,0,0,1,2,12655,2000,10655,2,12156,0,12156,2,20897,9000,11897,2,20411,0,20411
18056,230000,184000,0,0,0,0,0,0,0,7633,7021,612,0,9202,8008,1194,0,2553,0,2553,0,6015,6015,0
18057,30000,24000,0,0,0,0,0,0,0,18920,1314,17606,0,19297,691,18606,0,19699,713,18986,0,20091,718,19373
18058,340000,272000,0,0,0,0,0,1,-1,12347,12353,-6,-1,8612,8619,-7,-1,5479,0,5479,0,0,0,0
18059,230000,184000,0,0,0,0,0,0,-1,5816,5838,-22,-1,1288,7,1281,0,23196,23312,-116,-1,15072,15147,-75
18060,210000,168000,0,0,0,0,0,0,-2,3977,3988,-11,-2,5365,5381,-16,-2,789,791,-2,-2,1086,1088,-2
18061,220000,176000,0,1,0,0,0,0,0,225648,10050,215598,0,-2,2,-4,0,-2,0,-2,-2,-2,0,-2
18062,100000,80000,0,0,0,0,0,1,-1,390,390,0,-1,390,390,0,-1,390,390,0,-1,390,390,0
18063,250000,200000,0,0,0,0,0,0,0,30349,1500,28849,0,29568,1917,27651,0,30188,1097,29091,0,30786,1101,29685
18064,90000,72000,0,0,0,0,0,0,0,14770,1281,13489,0,13306,1173,12133,0,10465,500,9965,0,9704,1000,8704
18065,280000,224000,0,0,0,0,0,1,-2,0,0,0,-2,0,0,0,-2,0,0,0,-2,0,0,0
18066,50000,40000,0,0,0,0,0,0,-2,0,0,0,-2,0,0,0,-2,0,0,0,-2,0,0,0
18067,450000,360000,0,0,0,0,0,0,-1,396,396,0,-1,396,396,0,-1,396,396,0,-1,546,546,0
18068,230000,184000,0,0,0,0,0,0,-2,0,0,0,-2,0,0,0,-2,1715,1715,0,-1,0,0,0
18069,20000,16000,0,0,0,0,0,0,0,13593,2015,11578,0,10236,3000,7236,0,17541,10005,7536,0,16322,3414,12908
18070,50000,40000,0,0,0,0,0,1,2,29532,2000,27532,2,28758,0,28758,2,30287,2000,28287,2,31133,1500,29633
18071,50000,40000,0,0,0,0,0,0,0,22309,1500,20809,0,22315,1000,21315,0,22934,978,21956,0,23243,839,22404
18072,50000,40000,0,0,0,0,0,0,0,19100,19100,0,-1,18900,0,18900,0,0,0,0,0,3900,3900,0
18073,50000,40000,0,1,1,1,1,1,0,43032,2100,40932,2,47242,5215,42027,2,46212,0,46212,4,45205,0,45205
18074,240000,192000,0,0,0,0,0,0,-2,-40,0,-40,-2,1160,1200,-40,-1,1160,0,1160,0,0,0,0
18075,340000,272000,0,0,0,0,0,0,0,134467,4435,130032,0,129891,4091,125800,0,113919,3548,110371,0,106675,4535,102140
18076,20000,16000,0,1,1,1,1,1,0,17606,0,17606,2,18708,1400,17308,0,20093,1700,18393,0,20721,1100,19621
18077,10000,8000,0,0,1,1,0,0,-1,8898,1000,7898,2,9517,1000,8517,0,8505,170,8335,0,4557,0,4557
18078,140000,112000,0,0,0,0,0,0,-2,0,0,0,-2,0,0,0,-2,0,0,0,-2,1079,1079,0
18079,60000,48000,0,0,0,0,0,0,0,25326,2000,23326,0,27914,3000,24914,0,30476,3000,27476,0,31982,2000,29982
18080,60000,48000,0,0,0,0,0,0,2,33907,0,33907,2,36032,3000,33032,0,38114,3000,35114,0,40332,3000,37332
18081,140000,112000,0,0,0,0,0,0,0,59133,2200,56933,0,53193,2000,51193,0,47352,2000,45352,0,41627,2000,39627
18082,50000,40000,0,1,1,1,1,1,0,43050,2019,41031,0,43650,2026,41624,0,45217,3000,42217,0,46044,2000,44044
18083,300000,240000,0,0,0,0,0,0,-1,736,736,0,-1,1025,1025,0,-1,27289,27000,289,0,28142,2000,26142
18084,60000,48000,0,0,0,0,0,1,2,20347,1342,19005,0,21669,1664,20005,0,23005,2000,21005,0,22499,0,22499
18085,100000,80000,0,0,0,0,0,1,-1,0,0,0,-1,0,0,0,-2,0,0,0,-2,0,0,0
18086,230000,184000,0,0,0,0,0,0,-1,1816,1816,0,-1,1806,1806,0,-1,764,774,-10,-1,3368,3368,0
18087,10000,8000,0,0,1,1,1,1,2,8480,600,7880,2,9089,895,8194,2,8658,0,8658,3,8372,0,8372
18088,50000,40000,0,0,0,0,0,0,0,38280,1800,36480,0,12305,1130,11175,0,6436,2000,4436,0,0,0,0
18089,20000,16000,0,0,0,0,0,1,2,1473,1473,0,-1,780,780,0,-1,390,0,390,0,1738,1766,-28
18090,90000,72000,0,0,0,0,0,1,0,10420,6000,4420,0,14420,4000,10420,0,9855,5000,4855,0,9097,3500,5597
18091,10000,8000,0,0,0,0,0,1,-1,264,264,0,-1,264,264,0,-1,264,264,0,-1,264,264,0
18092,20000,16000,1,1,1,1,1,0,0,24258,1800,22458,0,24172,2350,21822,0,21959,0,21959,2,20898,1000,19898
18093,350000,280000,0,1,0,0,0,0,0,296868,10095,286773,0,237193,8389,228804,0,233591,8474,225117,0,237351,7640,229711
18094,60000,48000,0,1,1,1,1,0,0,56594,2648,53946,0,57097,2050,55047,0,56854,2084,54770,0,58325,2437,55888
18095,120000,96000,0,0,0,0,0,0,0,32916,2000,30916,0,30947,1500,29447,0,22974,2000,20974,0,19539,0,19539
18096,80000,64000,0,0,0,0,0,0,-1,8308,8314,-6,-1,4082,4082,0,-1,538,0,538,2,4085,4085,0
18097,140000,112000,0,0,0,0,0,0,-1,1139,1139,0,-1,380,380,0,-1,2340,2340,0,-1,837,837,0
18098,150000,120000,0,0,0,0,0,0,-2,2902,2918,-16,-2,6468,6506,-38,-2,1883,1893,-10,-2,1519,1527,-8
18099,20000,16000,0,0,0,0,0,1,3,7278,1000,6278,2,7013,0,7013,2,7398,500,6898,0,8775,1500,7275
18100,50000,40000,0,0,0,0,0,0,0,14147,2500,11647,0,13626,0,13626,2,15194,2000,13194,0,16929,2000,14929
18101,230000,184000,0,0,0,0,0,0,-2,976,976,0,-2,416,416,0,-2,416,416,0,-2,416,416,0
18102,290000,232000,0,0,0,0,0,0,-2,0,0,0,-2,0,0,0,-2,0,0,0,-2,0,0,0
18103,90000,72000,0,0,0,0,0,0,-1,922,922,0,-1,552,0,552,0,182,0,182,0,312,500,-188
18104,90000,72000,0,1,1,1,1,0,2,86671,0,86671,2,91280,6800,84480,2,85868,0,85868,2,91047,6500,84547
18105,260000,208000,0,0,0,0,0,1,2,396,396,0,-1,396,396,0,-1,792,792,0,-1,396,0,396
18106,200000,160000,0,0,0,0,0,0,-1,0,0,0,-2,0,0,0,-2,5032,5032,0,-1,0,0,0
18107,110000,88000,0,0,0,0,0,1,2,4770,1087,3683,0,5819,1532,4287,0,4807,0,4807,2,5579,1000,4579
18108,330000,264000,0,0,0,0,0,0,-2,-200,0,-200,-2,150,350,-200,-1,150,0,150,2,350,200,150
18109,260000,208000,0,1,1,0,0,1,0,253704,10000,243704,0,255353,5000,250353,0,175022,5000,170022,0,130299,5000,125299
18110,160000,128000,0,0,0,0,0,0,-1,17002,17016,-14,-1,17170,17185,-15,-1,14685,14685,0,-1,4328,4328,0
18111,50000,40000,0,1,0,0,0,0,0,49583,1500,48083,0,19695,1000,18695,0,20004,1000,19004,0,19904,1000,18904
18112,20000,16000,0,1,0,0,0,1,2,19055,0,19055,2,15335,550,14785,0,10812,288,10524,0,6483,400,6083
18113,20000,16000,0,0,0,0,0,0,-1,0,0,0,-1,0,0,0,-2,0,0,0,-2,0,0,0
18114,200000,160000,0,0,0,0,0,0,-1,371,371,0,-1,2977,2977,0,-1,3784,3784,0,-1,10579,10579,0
18115,160000,128000,0,0,0,0,0,0,-1,390,390,0,-1,0,0,0,-1,780,1170,-390,-1,390,0,390
18116,30000,24000,0,0,0,0,0,0,-1,1260,1260,0,-1,1179,1181,-2,-1,-101,101,-202,-1,890,991,-101
18117,150000,120000,0,0,0,0,0,0,0,35757,10036,25721,0,33789,18002,15787,0,33219,10000,23219,0,5621,5621,0
18118,30000,24000,0,1,1,1,1,0,0,27806,1710,26096,0,25142,1046,24096,0,25667,1079,24588,0,26179,1089,25090
18119,500000,400000,0,0,0,0,0,0,0,311641,30000,281641,0,326298,20507,305791,0,270968,50000,220968,0,315889,50047,265842
18120,260000,208000,0,0,0,0,0,0,-1,13392,13419,-27,-1,22209,22209,0,-1,54807,54807,0,-1,62534,62534,0
18121,100000,80000,0,0,0,0,0,0,0,7855,1279,6576,0,8076,500,7576,0,8297,500,7797,0,9349,1349,8000
18122,200000,160000,0,0,0,0,0,0,-1,-2,0,-2,-1,-2,0,-2,-2,-2,0,-2,-2,-2,0,-2
18123,390000,312000,0,0,0,0,0,0,-1,63661,63701,-40,-1,60616,1214,59402,0,61357,1241,60116,0,2798,2812,-14
18124,40000,32000,0,0,0,0,0,0,-2,0,0,0,-2,0,0,0,-2,2605,2605,0,-1,3554,1000,2554
18125,150000,120000,0,0,0,0,0,1,-2,0,0,0,-2,0,0,0,-2,0,0,0,-2,0,0,0
18126,90000,72000,0,0,0,0,0,0,0,54704,5023,49681,0,37660,5030,32630,0,32074,11000,21074,0,18372,9765,8607
18127,20000,16000,0,1,1,0,0,1,0,20404,4183,16221,0,19621,0,19621,2,14051,281,13770,0,0,0,0
18128,80000,64000,0,0,0,0,0,1,-1,3370,0,3370,2,5018,5018,0,-1,950,0,950,-1,-3827,0,-3827
18129,240000,192000,0,1,1,0,0,0,0,206312,11000,195312,0,205804,6000,199804,0,122740,3000,119740,0,137740,15000,122740
18130,500000,400000,0,0,0,0,0,0,-1,15673,15691,-18,-1,9393,9393,0,-1,69526,69526,0,-1,37940,5000,32940
18131,90000,72000,0,0,0,0,0,0,0,300,300,0,-1,0,0,0,-1,0,0,0,-2,0,0,0
18132,110000,88000,0,0,0,0,0,0,-1,4957,6960,-2003,-1,6037,6055,-18,-1,7628,7651,-23,-1,2746,8,2738
18133,30000,24000,0,0,0,1,0,0,2,22981,1682,21299,0,24996,2697,22299,0,24309,0,24309,2,26980,3219,23761
18134,50000,40000,0,0,0,0,0,0,0,18765,1298,17467,0,19145,678,18467,0,19229,687,18542,0,19026,691,18335
18135,30000,24000,0,0,0,0,0,0,-1,2230,2230,0,-1,1390,1390,0,-1,4040,4040,0,-1,3080,3080,0
18136,40000,32000,0,0,0,0,0,1,-2,0,0,0,-2,0,0,0,-2,0,0,0,-2,0,0,0
18137,200000,160000,0,1,1,1,1,0,0,176894,6101,170793,0,170754,5898,164856,0,172332,6053,166279,0,175960,6288,169672
18138,30000,24000,0,0,0,0,0,0,-1,7090,1314,5776,0,10000,10000,0,0,18438,18438,0,-1,17068,733,16335
18139,490000,392000,0,0,0,0,0,0,-1,22595,22595,0,-1,755,762,-7,-1,7000,7000,0,-1,0,0,0
18140,100000,80000,0,0,0,0,0,1,-1,316,316,0,-1,316,316,0,-1,2588,2588,0,-1,782,1098,-316
18141,160000,128000,0,0,0,0,0,1,2,22983,0,22983,2,22983,200,22783,0,0,0,0,0,0,0,0
18142,60000,48000,0,1,1,1,1,0,0,57656,2100,55556,0,58290,2100,56190,0,58213,2200,56013,0,57076,2100,54976
18143,100000,80000,0,0,0,0,0,0,-1,0,0,0,-1,0,0,0,-2,0,7600,-7600,-2,0,0,0
18144,110000,88000,0,0,0,0,0,0,2,49519,2000,47519,2,48421,0,48421,2,50644,3000,47644,2,51662,2000,49662
18145,50000,40000,0,0,0,0,0,0,0,17815,1512,16303,0,16362,532,15830,0,14694,514,14180,0,13520,524,12996
18146,20000,16000,0,0,1,1,1,0,0,16878,5000,11878,0,19624,3000,16624,0,20036,689,19347,0,18309,1000,17309
18147,150000,120000,0,0,0,0,0,1,-2,329,331,-2,-2,39919,40118,-199,-2,263,264,-1,-2,263,264,-1
18148,520000,416000,0,0,0,0,0,0,-1,10000,10000,0,-1,10317,10317,0,-1,10000,10000,0,-1,126247,126247,0
18149,220000,176000,0,1,1,1,0,0,0,202596,11000,191596,0,198845,6000,192845,0,194885,10082,184803,0,92905,3400,89505
18150,370000,296000,0,0,0,0,0,0,-2,8204,8204,0,-2,15398,15413,-15,-2,4792,4792,0,-2,13453,13453,0
18151,200000,160000,0,1,1,1,1,0,0,175701,7900,167801,0,181235,10000,171235,0,192713,14400,178313,0,189449,0,189449
18152,90000,72000,0,0,0,0,0,1,-1,-180,0,-180,-1,2320,2500,-180,-1,1286,2000,-714,-1,1132,1132,0
18153,50000,40000,0,0,0,0,0,0,0,5500,5500,0,-1,21709,21709,0,-1,21056,916,20140,0,20061,1161,18900
18154,50000,40000,0,0,0,0,0,1,2,17259,4000,13259,2,16684,0,16684,2,18017,1600,16417,2,17581,0,17581
18155,360000,288000,0,0,0,0,0,0,0,19567,4000,15567,0,16658,0,16658,0,17249,2000,15249,0,247,247,0
18156,60000,48000,0,1,0,0,0,0,0,58221,2577,55644,0,16305,1525,14780,0,3124,3124,0,-1,29484,29484,0
18157,150000,120000,0,0,0,0,0,0,-1,10042,20132,-10090,-1,129691,129665,26,0,88173,127,88046,0,63034,315,62719
18158,380000,304000,0,0,0,0,0,0,0,230898,9000,221898,0,237118,10068,227050,0,240452,8768,231684,0,245499,9087,236412
18159,320000,256000,0,0,0,0,0,0,0,226752,11000,215752,0,222278,5000,217278,0,224190,4519,219671,0,226836,2646,224190
18160,50000,40000,1,1,1,1,0,1,0,77882,1558,76324,0,79471,1589,77882,0,81121,1650,79471,0,1685,9980,-8295
18161,10000,8000,0,0,0,0,0,0,0,3745,1300,2445,0,4642,1000,3642,0,5642,1000,4642,0,6342,700,5642
18162,400000,320000,0,0,0,0,0,0,0,202937,10232,192705,0,169138,12115,157023,0,144434,6285,138149,0,124802,11106,113696
18163,300000,240000,0,0,0,0,0,0,0,27007,10140,16867,0,360,360,0,-1,257,257,0,-1,21140,21346,-206
18164,200000,160000,0,0,0,0,0,0,0,14562,5000,9562,0,22457,10000,12457,0,15569,5000,10569,0,9819,602,9217
18165,120000,96000,0,0,0,0,0,1,-1,416,416,0,-1,0,0,0,-1,832,832,0,-1,416,416,0
18166,70000,56000,0,0,0,0,0,1,2,34757,1000,33757,2,35888,2000,33888,2,35180,0,35180,2,35941,1500,34441
18167,90000,72000,0,0,0,0,0,1,0,39902,1600,38302,0,39200,1280,37920,0,38531,1310,37221,0,32991,1432,31559
18168,190000,152000,0,0,0,0,0,0,0,116043,50030,66013,0,107533,130,107403,2,89331,5000,84331,0,91477,4000,87477
18169,70000,56000,0,0,0,0,0,0,2,9456,1178,8278,0,9528,1250,8278,0,7481,300,7181,0,7794,400,7394
18170,180000,144000,0,0,0,0,0,0,-1,13613,13694,-81,-1,8401,8401,0,-1,1859,1859,0,-1,429,429,0
18171,330000,264000,0,0,0,0,0,0,-2,14922,2500,12422,-2,17722,3000,14722,-2,3390,3390,0,-2,0,0,0
18172,160000,128000,0,1,0,0,0,0,0,162998,4000,158998,0,0,0,0,0,0,0,0,-2,0,0,0
18173,50000,40000,0,0,0,0,0,0,0,26283,0,26283,2,28198,4087,24111,2,23159,0,23159,2,23089,1798,21291
18174,20000,16000,0,0,0,0,0,0,-2,0,0,0,-2,0,0,0,-2,0,0,0,-2,0,0,0
18175,100000,80000,0,1,1,1,1,0,0,101125,3544,97581,0,96765,3519,93246,0,99823,5000,94823,0,96165,3500,92665
18176,150000,120000,0,0,0,0,1,0,0,109374,4005,105369,0,111279,3241,108038,0,125353,15500,109853,0,126913,4000,122913
18177,50000,40000,0,0,0,0,0,0,-1,2866,2866,0,-1,4406,4406,0,-1,2821,2821,0,-1,1854,1854,0
18178,30000,24000,0,1,1,1,1,0,0,29754,1600,28154,2,28583,0,28583,2,29739,2220,27519,2,28412,0,28412
18179,100000,80000,0,1,1,1,0,0,0,92293,3269,89024,0,92434,3407,89027,0,95478,5024,90454,0,40514,5056,35458
18180,210000,168000,0,0,0,0,0,0,-1,1527,3054,-1527,-1,1901,2189,-288,-1,0,0,0,-1,2706,2706,0
18181,30000,24000,0,1,1,1,1,1,3,29472,0,29472,3,56952,0,56952,2,28476,600,27876,0,28296,600,27696
18182,10000,8000,0,0,0,0,0,0,-2,0,0,0,-2,0,0,0,-2,0,0,0,-2,0,0,0
18183,20000,16000,0,0,0,0,0,1,3,13634,0,13634,2,14401,1300,13101,0,16257,2101,14156,0,15713,0,15713
18184,140000,112000,0,0,0,0,0,0,-1,291,291,0,-1,291,291,0,-1,291,291,0,-1,441,441,0
18185,20000,16000,1,1,1,1,0,1,2,20075,0,20075,2,19492,1500,17992,0,19859,805,19054,0,19232,7000,12232
18186,50000,40000,0,0,0,0,0,0,0,14149,1600,12549,0,15162,1252,13910,0,15463,553,14910,0,15788,574,15214
18187,180000,144000,0,0,0,0,0,0,0,124718,100000,24718,0,133102,12000,121102,0,124279,0,124279,2,123748,4800,118948
18188,250000,200000,0,0,0,0,0,0,2,32631,32812,-181,-1,43399,43932,-533,-1,2323,2323,0,-1,46895,47356,-461
18189,50000,40000,0,0,0,0,0,0,0,20879,2000,18879,0,18573,2000,16573,0,17318,1000,16318,0,17936,1000,16936
18190,250000,200000,0,0,0,0,0,1,3,1573,1400,173,2,1400,0,1400,2,0,0,0,2,0,0,0
18191,100000,80000,0,1,1,0,0,0,0,88597,3900,84697,0,84861,3000,81861,0,69750,2000,67750,0,47394,2000,45394
18192,310000,248000,0,0,0,0,0,0,-1,4158,4318,-160,-1,8408,8408,0,-1,542,542,0,-1,2314,2314,0
18193,200000,160000,0,0,0,0,0,0,-2,1301,1301,0,-2,7066,7070,-4,-2,3486,3688,-202,-2,12191,12191,0
18194,250000,200000,0,0,0,0,0,1,-1,4898,5033,-135,-1,19351,19619,-268,-1,4858,4874,-16,0,6973,7050,-77
18195,260000,208000,0,1,1,0,0,1,0,234260,9014,225246,0,227884,11002,216882,0,202178,7503,194675,0,198467,7502,190965
18196,230000,184000,0,0,0,0,0,0,0,38940,3013,35927,0,37150,4000,33150,0,36306,5006,31300,0,33563,3000,30563
18197,20000,16000,0,0,0,1,1,0,0,15564,1300,14264,0,16600,1300,15300,0,17025,700,16325,0,17381,630,16751
18198,160000,128000,0,0,0,0,0,0,-2,1397,1397,0,-2,690,690,0,-1,0,0,0,-1,0,0,0
18199,200000,160000,0,0,0,0,0,0,-2,3908,3908,0,-2,-5,5,-10,-2,1060,1065,-5,-2,2996,3000,-4
18200,30000,24000,0,0,0,0,0,0,2,23964,1522,22442,0,24434,1200,23234,0,21340,428,20912,0,5624,112,5512
18201,260000,208000,0,0,0,0,0,0,0,119649,6000,113649,0,122448,8000,114448,0,-3353,40000,-43353,0,123939,127292,-3353
18202,40000,32000,0,1,1,0,0,0,0,35866,2500,33366,0,36691,2014,34677,0,31672,250,31422,0,27945,2000,25945
18203,60000,48000,0,1,0,0,0,0,0,60164,3001,57163,0,31211,3003,28208,0,30374,2000,28374,0,30432,2001,28431
18204,100000,80000,0,0,0,0,0,0,0,15868,4031,11837,0,8275,3012,5263,0,5954,2006,3948,0,7075,3121,3954
18205,130000,104000,0,0,0,0,0,1,2,93182,4000,89182,2,90851,0,90851,2,96576,7200,89376,2,98452,3500,94952
18206,50000,40000,0,1,0,0,0,0,0,43656,1462,42194,0,29466,1038,28428,0,29936,1086,28850,0,30350,1069,29281
18207,220000,176000,0,0,0,0,0,0,0,88004,5003,83001,0,31237,3047,28190,0,15980,5000,10980,0,529,1000,-471
18208,30000,24000,0,0,1,1,1,1,0,25331,1500,23831,0,26347,1439,24908,0,27508,1600,25908,0,30118,3200,26918
18209,320000,256000,0,0,0,0,0,0,0,30737,1224,29513,0,26875,739,26136,0,26318,742,25576,0,25880,751,25129
18210,500000,400000,0,0,0,0,0,0,-1,28119,28119,0,-1,29698,2000,27698,0,32229,3200,29029,0,27912,3000,24912
18211,70000,56000,0,1,0,0,0,0,0,66601,1646,64955,0,29401,600,28801,0,28949,28468,481,0,29795,1327,28468
18212,50000,40000,0,1,0,0,0,0,0,49889,1500,48389,0,20459,1933,18526,0,19727,600,19127,0,19354,461,18893
18213,50000,40000,0,0,0,0,0,0,0,19906,19906,0,-1,11132,11132,0,-1,0,0,0,-1,0,0,0
18214,100000,80000,0,0,0,0,0,1,-1,0,0,0,-1,780,780,0,-1,0,0,0,-1,0,0,0
18215,160000,128000,0,0,0,0,0,1,2,34775,0,34775,2,34073,142848,-108775,-1,15676,1800,13876,0,99436,90000,9436
18216,60000,48000,0,0,0,0,0,1,0,11082,2000,9082,0,12133,1242,10891,0,16891,5000,11891,0,17615,1000,16615
18217,290000,232000,0,0,0,0,0,1,-2,0,0,0,-2,0,0,0,-2,0,0,0,-2,0,0,0
18218,140000,112000,0,1,1,0,0,0,0,139888,5962,133926,0,126590,4878,121712,0,111187,4100,107087,0,111414,4200,107214
18219,400000,320000,0,0,0,0,0,0,2,16199,3383,12816,2,3320,20,3300,2,111353,112679,-1326,-1,103569,3699,99870
18220,20000,16000,0,0,0,0,0,1,2,6689,1000,5689,0,0,0,0,0,0,0,0,-2,0,0,0
18221,60000,48000,0,0,0,0,0,0,0,44788,3600,41188,0,47728,3700,44028,0,48617,1800,46817,2,49669,2000,47669
18222,200000,160000,0,1,1,1,1,1,0,184792,7000,177792,0,195062,15000,180062,0,195156,7500,187656,0,192436,7500,184936
18223,280000,224000,0,0,0,0,0,0,2,191098,8000,183098,0,160149,6000,154149,0,154421,5000,149421,0,156022,10000,146022
18224,240000,192000,0,0,0,0,0,0,-1,696,696,0,-1,18334,18334,0,-1,27638,10000,17638,0,696,696,0
18225,360000,288000,0,0,0,0,0,0,-1,31029,31051,-22,-1,7731,7731,0,-1,1154,0,1154,0,799,799,0
18226,360000,288000,0,0,0,0,0,0,-1,6664,6704,-40,-1,11358,11415,-57,-1,15479,15556,-77,-1,20934,21039,-105
18227,200000,160000,0,0,0,0,0,1,0,46472,2000,44472,0,48692,3000,45692,0,50571,3000,47571,0,51756,2000,49756
18228,20000,16000,1,1,1,1,0,1,2,20581,0,20581,4,19860,0,19860,3,19690,0,19690,2,1735,500,1235
18229,20000,16000,0,0,0,0,0,0,0,12482,1446,11036,0,10528,500,10028,0,9293,500,8793,0,17099,8000,9099
18230,50000,40000,0,1,1,0,0,0,2,50047,2424,47623,0,43142,2355,40787,0,10677,363,10314,0,10105,361,9744
18231,150000,120000,0,0,0,0,0,0,2,20346,1150,19196,0,19447,664,18783,0,8420,500,7920,0,8631,500,8131
18232,50000,40000,0,1,0,0,0,0,0,48587,2000,46587,0,37211,1432,35779,0,28248,988,27260,0,28430,1600,26830
18233,330000,264000,0,0,0,0,0,1,-2,0,0,0,-2,0,0,0,-2,0,0,0,-2,0,0,0
18234,140000,112000,0,0,0,0,0,0,0,36615,1683,34932,0,28354,929,27425,0,18093,1000,17093,0,6723,134,6589
18235,220000,176000,0,0,0,0,0,1,-2,0,0,0,-2,0,0,0,-2,4488,4488,0,-2,540,540,0
18236,470000,376000,0,0,0,0,0,0,0,5719,1751,3968,0,1730,1012,718,0,-7,0,-7,0,24672,24679,-7
18237,50000,40000,0,0,0,0,0,0,-1,18356,9252,9104,-1,1851,1859,-8,-1,8362,8362,0,-1,810,810,0
18238,130000,104000,0,0,0,0,0,0,0,96191,3533,92658,0,88934,3301,85633,0,90633,3607,87026,0,91459,5516,85943
18239,170000,136000,0,0,0,0,0,0,0,112125,5300,106825,0,109579,3800,105779,0,107030,3880,103150,0,101130,3500,97630
18240,420000,336000,0,0,0,0,0,0,-1,13513,13523,-10,-1,80831,80854,-23,-1,39333,787,38546,0,26831,850,25981
18241,50000,40000,0,0,0,0,0,0,0,16431,1300,15131,0,17056,900,16156,0,17581,800,16781,0,18089,800,17289
18242,150000,120000,0,0,0,0,0,0,-1,2160,2166,-6,-1,-2,0,-2,-1,-2,0,-2,-2,-2,0,-2
18243,30000,24000,0,0,0,1,1,0,-1,-1581,0,-1581,-1,28419,30000,-1581,-1,29016,1055,27961,0,30908,2376,28532
18244,220000,176000,0,0,0,0,0,0,0,1522,1,1521,2,5198,3980,1218,0,3974,20,3954,0,-38,0,-38
18245,230000,184000,0,0,0,0,0,0,-1,2100,2100,0,-1,530,530,0,-1,2282,2282,0,-1,1390,1390,0
18246,30000,24000,0,1,1,1,1,0,2,30419,2033,28386,0,30097,1420,28677,0,25887,0,25887,0,25707,92,25615
18247,140000,112000,0,0,0,0,0,0,-2,1497,1497,0,-1,1039,1039,0,-1,1139,1139,0,-1,0,0,0
18248,20000,16000,0,1,1,1,1,0,0,19583,1200,18383,0,19983,534,19449,0,20196,700,19496,0,19705,1000,18705
18249,280000,224000,0,0,0,0,0,0,-1,99036,5000,94036,0,96383,3027,93356,0,86060,6025,80035,0,62312,2001,60311
18250,180000,144000,0,0,0,0,0,0,0,129440,6000,123440,0,128571,5000,123571,0,128631,5000,123631,0,129813,5000,124813
18251,30000,24000,0,1,1,1,1,0,2,29777,1700,28077,0,29478,1700,27778,0,30290,1500,28790,0,27803,1500,26303
18252,180000,144000,0,0,0,0,0,0,-1,9040,9044,-4,-1,1288,1290,-2,-1,1419,1421,-2,-1,2385,2386,-1
18253,60000,48000,0,0,0,0,0,0,0,0,0,0,-2,1411,1411,0,-1,1455,1455,0,-1,4486,4486,0
18254,500000,400000,0,0,0,0,0,0,0,302966,14846,288120,0,300000,6000,294000,0,400000,100000,300000,0,0,0,0
18255,150000,120000,0,0,0,0,0,0,-1,5200,5200,0,-1,1561,0,1561,0,1633,72,1561,0,230,460,-230
18256,50000,40000,0,0,0,0,0,1,0,5742,2000,3742,0,0,8,-8,0,-30481,0,-30481,-2,58,40058,-40000
18257,40000,32000,0,0,0,0,0,0,-2,5151,5151,0,-2,3434,3434,0,-2,1143,1143,0,-2,0,0,0
18258,450000,360000,0,0,0,0,0,0,-1,2343,2343,0,-1,2313,2313,0,-1,8295,8295,0,-1,699,1806,-1107
18259,30000,24000,0,0,0,0,0,0,0,16108,1300,14808,0,17888,4894,12994,0,16505,1000,15505,0,16511,800,15711
18260,220000,176000,0,0,0,0,0,0,-1,0,0,0,-2,0,0,0,-2,0,0,0,-2,0,0,0
18261,440000,352000,0,0,0,0,0,0,0,265058,50000,215058,0,142132,7000,135132,0,92400,9000,83400,0,0,0,0
18262,500000,400000,0,0,0,0,0,0,-1,10894,10909,-15,-1,29161,29161,0,-1,28238,28238,0,-1,33272,33272,0
18263,30000,24000,0,0,0,0,0,1,2,2400,0,2400,7,2400,0,2400,7,2400,0,2400,7,1800,0,1800
18264,260000,208000,0,0,0,0,0,0,-1,1183,1186,-3,-1,2270,2287,-17,-1,0,0,0,-1,0,0,0
18265,180000,144000,0,0,0,0,0,0,-1,5248,5248,0,-1,4167,5,4162,0,780,780,0,-1,467,467,0
18266,330000,264000,0,0,0,0,0,0,-2,906,906,0,-2,2342,2342,0,-2,1702,1702,0,-2,882,882,0
18267,20000,16000,0,1,1,0,0,0,0,17658,1368,16290,0,16576,547,16029,0,13529,504,13025,0,10387,347,10040
18268,60000,48000,0,0,0,0,0,1,0,28108,1213,26895,0,21993,648,21345,0,19899,768,19131,0,19771,1140,18631
18269,150000,120000,0,0,0,0,0,1,-1,33850,33850,0,-1,4625,4625,0,-1,1035,1035,0,-1,520,0,520
18270,300000,240000,0,0,0,0,0,0,-1,0,0,0,-1,0,0,0,-2,3427,3427,0,-1,1098,1098,0
18271,170000,136000,0,1,0,0,0,0,0,160847,10002,150845,0,87399,3046,84353,0,74761,5000,69761,0,67855,0,67855
18272,200000,160000,0,0,0,0,0,0,-2,5991,5991,0,-2,7298,7298,0,-2,9225,2105,7120,-2,4072,10249,-6177
18273,30000,24000,0,0,0,0,0,0,0,18432,2500,15932,0,17844,1000,16844,0,18237,1000,17237,0,10900,3000,7900
18274,430000,344000,0,0,0,0,0,0,-1,5271,5319,-48,-1,757,757,0,-1,157,157,0,-1,157,157,0
18275,160000,128000,0,0,0,0,0,0,-1,-175,0,-175,-2,3392,3567,-175,-1,3567,175,3392,0,0,0,0
18276,50000,40000,0,0,0,0,0,0,0,16846,1284,15562,0,17562,1000,16562,0,18275,1000,17275,0,18711,740,17971
18277,300000,240000,0,0,0,0,0,0,0,17239,1249,15990,0,18237,1247,16990,0,18600,610,17990,0,17939,611,17328
18278,230000,184000,0,0,0,0,0,0,-2,200,200,0,-2,43998,43998,0,-1,23400,52,23348,0,13000,13000,0
18279,180000,144000,0,0,0,0,0,0,0,28418,1864,26554,0,16084,600,15484,0,14210,600,13610,0,711,711,0
18280,70000,56000,0,1,1,0,0,0,2,68034,3000,65034,0,68602,3000,65602,0,30252,1508,28744,0,47363,20000,27363
18281,250000,200000,0,0,0,0,0,0,-2,450,1390,-940,-1,330,660,-330,-1,-60,0,-60,-1,1540,1600,-60
18282,220000,176000,0,0,0,0,0,0,-1,6615,6615,0,-1,15799,15799,0,-1,13526,1526,12000,0,8726,0,8726
18283,50000,40000,0,0,0,0,0,0,0,7959,2000,5959,0,8978,1019,7959,0,7357,3007,4350,0,7841,3008,4833
18284,200000,160000,0,0,0,0,0,1,2,2500,0,2500,2,2500,0,2500,2,0,0,0,2,0,0,0
18285,70000,56000,0,1,1,1,1,1,0,71229,4792,66437,0,70747,3000,67747,0,68154,3019,65135,0,69815,8010,61805
18286,350000,280000,0,0,0,0,0,0,0,3042,0,3042,2,2418,2500,-82,-1,2233,0,2233,2,7176,5000,2176
18287,40000,32000,0,0,0,0,0,1,-1,2872,2872,0,-1,396,0,396,0,2462,2462,0,-1,396,0,396
18288,240000,192000,0,0,0,0,0,1,0,165662,4729,160933,0,144277,5682,138595,0,112210,5500,106710,0,116047,5000,111047
18289,280000,224000,0,0,0,0,0,0,-1,4712,4720,-8,-1,1728,1728,0,-1,2076,2076,0,-1,1709,1709,0
18290,180000,144000,0,0,0,0,0,0,-2,0,0,0,-2,900,900,0,-1,0,0,0,-1,0,0,0
18291,90000,72000,0,0,0,0,0,0,0,67475,3000,64475,0,69136,3000,66136,0,51217,2000,49217,0,50490,2000,48490
18292,530000,424000,0,0,0,0,0,0,0,393664,20000,373664,0,235392,10000,225392,0,232640,10000,222640,0,239004,10000,229004
18293,60000,48000,0,0,0,0,0,0,-1,438,438,0,-1,2575,2575,0,-1,0,0,0,-1,4532,4532,0
18294,360000,288000,0,0,0,0,0,0,-1,7714,5463,2251,0,4502,2251,2251,0,1896,1896,0,-1,5117,5117,0
18295,50000,40000,0,0,0,0,0,0,0,6525,1000,5525,0,3660,73,3587,0,0,0,0,0,0,0,0
18296,30000,24000,0,0,0,0,0,0,0,1394,1000,394,0,1594,200,1394,0,566,0,566,0,0,0,0
18297,10000,8000,0,0,0,0,0,0,2,4883,0,4883,2,5155,353,4802,0,5275,375,4900,0,0,0,0
18298,60000,48000,0,1,1,0,0,0,0,58906,0,58906,2,59210,2150,57060,0,44521,800,43721,0,31497,1000,30497
18299,330000,264000,0,0,0,0,0,0,-1,0,0,0,-2,0,0,0,-2,0,0,0,-2,0,0,0
18300,120000,96000,0,0,0,0,0,0,0,72962,2830,70132,0,58163,1600,56563,0,33358,3600,29758,0,16829,300,16529
18301,10000,8000,0,0,0,1,0,0,2,8145,2000,6145,0,9000,2000,7000,0,9000,0,9000,0,0,0,0
18302,160000,128000,0,0,0,0,0,1,2,34073,142848,-108775,-1,15676,1800,13876,0,99436,90000,9436,0,90927,3300,87627
18303,260000,208000,0,0,0,0,0,0,0,152856,6243,146613,0,142605,7000,135605,0,144240,5500,138740,0,144213,5500,138713
18304,300000,240000,0,0,0,0,0,1,-2,0,0,0,-2,0,0,0,-2,0,0,0,-2,0,0,0
18305,240000,192000,0,1,1,0,1,0,0,238641,9963,228678,0,230758,8013,222745,0,196830,6658,190172,0,201112,7059,194053
18306,260000,208000,0,0,0,0,0,0,-1,-810,0,-810,-1,2190,3000,-810,-1,810,0,810,0,0,0,0
18307,50000,40000,0,0,0,0,0,1,2,37395,0,37395,2,32284,1302,30982,0,32805,1191,31614,0,33751,1492,32259
18308,400000,320000,0,0,0,0,0,0,0,48815,1776,47039,0,49831,1792,48039,0,50821,1782,49039,0,51884,1844,50040
18309,220000,176000,0,0,0,0,0,0,0,27171,4000,23171,0,22067,1420,20647,0,17831,2000,15831,0,15671,3000,12671
18310,20000,16000,0,0,0,0,0,1,2,-1050,0,-1050,2,-1440,0,-1440,-2,-1830,0,-1830,-2,780,3000,-2220
18311,50000,40000,0,1,0,0,0,1,2,50061,1728,48333,0,37766,1730,36036,0,29433,1015,28418,0,27537,1000,26537
18312,270000,216000,0,0,0,0,0,0,-1,4246,4246,0,-1,4875,4875,0,-1,836,836,0,-1,5949,5949,0
18313,140000,112000,0,0,0,0,0,0,0,76412,20000,56412,0,70091,3043,67048,0,63279,2359,60920,0,56854,2187,54667
18314,70000,56000,0,0,0,0,0,1,2,37424,2000,35424,2,38512,2000,36512,2,37596,0,37596,2,39877,3055,36822
18315,90000,72000,0,0,0,0,0,0,-2,0,0,0,-2,0,0,0,-2,0,0,0,-2,0,0,0
18316,100000,80000,0,0,0,0,0,0,0,0,0,0,-2,0,0,0,-2,0,0,0,-2,0,0,0
18317,210000,168000,0,0,0,0,0,0,0,17950,10000,7950,0,18915,2000,16915,0,19359,1000,18359,0,21604,3000,18604
18318,80000,64000,0,0,0,0,0,0,0,25351,10000,15351,0,25981,1000,24981,0,26464,1000,25464,0,23714,1000,22714
18319,180000,144000,0,0,0,0,0,0,0,132295,4600,127695,0,130166,4600,125566,0,129158,4700,124458,0,127963,4972,122991
18320,20000,16000,0,0,0,0,0,1,0,14360,0,14360,2,14921,800,14121,0,15328,800,14528,0,16474,1400,15074
18321,230000,184000,0,0,0,0,0,0,-2,3243,3251,-8,-1,20172,20174,-2,-1,26446,12000,14446,0,58598,46100,12498
18322,220000,176000,0,0,0,0,0,0,0,93180,10000,83180,0,99097,8000,91097,0,106391,10000,96391,0,97337,10000,87337
18323,50000,40000,0,0,0,0,0,0,-1,4149,4149,0,-1,2766,0,2766,0,1383,0,1383,0,1383,1383,0
18324,150000,120000,0,0,0,0,0,0,-1,476,476,0,-1,476,476,0,-1,1102,1102,0,-1,476,0,476
18325,50000,40000,0,0,0,0,0,0,0,17623,1293,16330,0,17974,644,17330,0,18350,666,17684,0,18721,676,18045
18326,50000,40000,0,0,0,0,0,0,0,10000,1000,9000,0,0,0,0,0,0,0,0,-2,0,0,0
18327,340000,272000,0,0,0,0,0,0,0,170491,9000,161491,0,158370,7000,151370,0,151685,6000,145685,0,143623,5400,138223
18328,30000,24000,0,0,0,0,0,1,0,12702,3500,9202,0,12206,0,12206,2,12701,1000,11701,0,13839,1500,12339
18329,150000,120000,0,0,0,0,0,1,2,77836,3000,74836,0,75277,6000,69277,0,66249,0,66249,2,60021,2066,57955
18330,320000,256000,0,0,0,0,0,0,0,12549,1600,10949,0,10853,1098,9755,0,11755,1000,10755,0,7559,272,7287
18331,210000,168000,0,0,0,0,0,0,0,108971,9145,99826,0,96011,12,95999,2,87644,3004,84640,0,82077,3000,79077
18332,50000,40000,0,0,0,0,0,0,-2,0,0,0,-2,0,0,0,-2,414,414,0,-1,0,0,0
18333,50000,40000,0,0,0,0,0,1,0,18460,3972,14488,0,17749,0,17749,2,18936,1448,17488,0,5925,492,5433
18334,200000,160000,0,0,0,0,0,0,0,99016,4500,94516,0,101661,5200,96461,0,103011,4500,98511,0,103384,3950,99434
18335,230000,184000,1,1,0,0,0,0,0,344026,10806,333220,0,160377,20266,140111,0,85681,15120,70561,0,-371,343,-714
18336,30000,24000,0,0,0,0,0,1,2,11339,1200,10139,2,12841,2000,10841,3,13836,1500,12336,3,14514,1500,13014
18337,50000,40000,0,1,1,0,0,0,2,47891,0,47891,2,98284,5400,92884,0,19950,1000,18950,0,20007,900,19107
18338,450000,360000,0,0,0,0,0,0,-2,0,0,0,-2,0,0,0,-2,0,0,0,-2,0,0,0
18339,150000,120000,0,0,0,0,0,0,0,10652,3652,7000,0,32330,33866,-1536,-1,15681,410,15271,0,6173,200,5973
18340,160000,128000,0,0,0,0,0,0,0,40453,2002,38451,0,40951,1500,39451,0,40709,2000,38709,0,35569,1000,34569
18341,240000,192000,0,0,0,0,0,0,0,17812,3000,14812,0,14328,2880,11448,0,11110,306,10804,0,7567,2000,5567
18342,150000,120000,0,0,0,0,0,0,0,21196,1500,19696,0,21715,1000,20715,0,0,0,0,0,0,0,0
18343,20000,16000,0,0,0,0,0,1,-1,780,0,780,2,390,0,390,0,0,0,0,0,780,2000,-1220
18344,150000,120000,0,0,0,0,0,0,0,23320,1200,22120,0,24085,965,23120,0,24149,64,24085,0,3323,509,2814
18345,20000,16000,0,0,0,0,0,0,0,11841,2000,9841,0,4725,1200,3525,0,9135,5000,4135,0,18355,10000,8355
18346,150000,120000,0,0,0,0,0,1,2,71434,3300,68134,2,72365,2700,69665,2,73377,2800,70577,2,75052,3000,72052
18347,10000,8000,0,0,0,0,0,0,2,5941,1257,4684,0,6984,1300,5684,0,7120,400,6720,0,7267,410,6857
18348,50000,40000,0,0,1,1,1,1,-1,48257,48799,-542,-1,48455,1773,46682,0,48195,1711,46484,0,48828,1785,47043
18349,320000,256000,0,0,0,0,0,0,-1,143588,143588,0,-1,82261,82691,-430,-1,44242,44242,0,-1,22999,24010,-1011
18350,100000,80000,0,1,1,0,0,0,2,100783,4000,96783,2,89898,49,89849,2,58404,5000,53404,0,35078,4000,31078
18351,230000,184000,0,0,0,0,0,0,-2,1443,1443,0,-2,1443,1443,0,-2,1443,1443,0,-2,1443,1443,0
18352,210000,168000,0,0,0,0,0,0,-2,1000,1005,-5,-2,2000,2000,0,-2,500,500,0,-2,5305,5305,0
18353,150000,120000,0,0,0,0,0,0,2,20950,20962,-12,-1,3601,1,3600,0,696,696,0,-1,696,0,696
18354,290000,232000,0,0,0,0,0,1,0,193030,8500,184530,0,195356,7020,188336,0,207180,15000,192180,0,211614,8000,203614
18355,80000,64000,0,0,0,0,0,0,0,40630,1200,39430,0,23697,0,23697,0,6557,5000,1557,0,32763,37000,-4237
18356,60000,48000,0,0,0,0,0,1,2,47830,4000,43830,2,48458,2000,46458,2,47176,0,47176,2,47461,2000,45461
18357,230000,184000,0,0,0,0,0,0,-1,0,0,0,-1,6264,6264,0,-1,6392,128,6264,0,2538,0,2538
18358,100000,80000,0,0,0,0,0,0,-1,390,390,0,-1,390,390,0,-1,390,390,0,-1,0,0,0
18359,180000,144000,0,0,0,0,0,0,0,136707,6434,130273,0,139438,6506,132932,0,143513,10813,132700,0,141119,0,141119
18360,140000,112000,1,1,1,1,1,0,0,249664,10200,239464,0,253418,9000,244418,0,258909,9000,249909,0,255232,10000,245232
18361,90000,72000,0,0,0,0,0,0,-2,0,0,0,-2,0,0,0,-2,0,0,0,-2,0,0,0
18362,420000,336000,0,0,0,0,0,1,2,88997,3500,85497,0,93971,6600,87371,0,92203,0,92203,2,93059,4000,89059
18363,140000,112000,0,0,0,0,0,0,0,31206,2012,29194,0,31730,1536,30194,0,30535,837,29698,0,28301,989,27312
18364,50000,40000,0,0,0,0,0,0,-1,195,195,0,-1,197,197,0,-1,197,197,0,-1,197,197,0
18365,70000,56000,0,0,0,0,0,0,0,20539,1400,19139,0,23066,2882,20184,0,23684,1000,22684,0,24182,879,23303
18366,50000,40000,0,1,1,0,0,1,0,48560,2110,46450,0,46978,2558,44420,0,19640,19640,0,-1,18937,683,18254
18367,70000,56000,0,1,0,0,0,1,3,69405,0,69405,2,34045,1220,32825,0,34995,1500,33495,0,36025,1725,34300
18368,60000,48000,0,0,0,0,0,1,2,18841,1000,17841,2,18241,0,18241,2,18946,1000,17946,0,20634,2000,18634
18369,240000,192000,0,0,0,0,0,0,0,172591,10000,162591,0,145144,7500,137644,0,141134,5600,135534,0,127242,5500,121742
18370,140000,112000,0,1,1,0,1,1,2,139902,0,139902,2,142729,6800,135929,0,142406,40000,102406,0,142694,5600,137094
18371,100000,80000,0,0,0,0,0,0,0,12327,2101,10226,0,10793,216,10577,0,5309,0,5309,0,900,900,0
18372,360000,288000,0,0,0,0,0,0,-2,-103,0,-103,-2,-103,0,-103,-2,-103,0,-103,-2,-103,0,-103
18373,50000,40000,0,1,1,1,1,0,0,49803,2128,47675,0,49830,2079,47751,0,49539,1896,47643,0,50418,1803,48615
18374,80000,64000,0,0,0,0,0,0,0,32990,2003,30987,0,30059,1500,28559,0,28786,1200,27586,0,29371,1200,28171
18375,20000,16000,0,1,1,1,1,0,0,18977,1289,17688,0,18335,647,17688,0,18718,669,18049,0,18475,664,17811
18376,200000,160000,0,0,0,0,0,0,-2,5033,5069,-36,-2,1125,1130,-5,-2,1088,1093,-5,-2,4469,4491,-22
18377,70000,56000,0,1,0,0,0,0,0,69340,2310,67030,0,39191,1600,37591,0,40009,1600,38409,0,40893,1700,39193
18378,20000,16000,0,1,1,0,1,0,0,18821,1200,17621,0,19307,1000,18307,0,19260,6000,13260,0,20028,1000,19028
18379,270000,216000,0,0,0,0,0,0,0,47625,3000,44625,0,49332,3000,46332,0,22950,3000,19950,0,25561,3000,22561
18380,210000,168000,0,0,0,0,0,0,0,86928,3200,83728,0,89471,4000,85471,0,91282,3300,87982,0,93309,3500,89809
18381,20000,16000,0,1,1,1,1,1,2,19649,800,18849,2,19978,950,19028,2,20512,1000,19512,2,20831,800,20031
18382,490000,392000,0,0,0,0,0,0,-2,3367,3384,-17,-2,-46,0,-46,-2,9285,9331,-46,-2,-14,0,-14
18383,80000,64000,0,0,0,0,0,0,-1,390,390,0,-1,390,390,0,-1,390,390,0,-1,540,540,0
18384,100000,80000,0,0,0,0,0,0,-1,78671,78671,0,-1,60430,3000,57430,0,60647,2500,58147,0,61153,3000,58153
18385,150000,120000,0,0,0,0,0,0,0,36143,1510,34633,0,33567,1170,32397,0,32447,1183,31264,0,32592,1140,31452
18386,80000,64000,0,0,0,0,0,0,-1,880,883,-3,-1,0,0,0,-1,0,0,0,-2,0,0,0
18387,520000,416000,0,0,0,0,0,0,0,7894,1200,6694,0,6426,505,5921,0,4045,502,3543,0,1806,100,1706
18388,500000,400000,0,0,0,0,0,0,-1,-24702,472,-25174,-1,23804,113935,-90131,-1,92715,108041,-15326,-1,6655,33,6622
18389,80000,64000,0,0,0,0,0,0,0,25528,1425,24103,0,26034,931,25103,0,26615,1000,25615,0,28173,2000,26173
18390,60000,48000,0,1,0,0,0,0,0,53407,5000,48407,0,19443,2000,17443,0,16597,1000,15597,0,18423,2000,16423
18391,80000,64000,0,0,0,0,0,0,-1,9970,9970,0,-1,4250,4250,0,-1,4574,4574,0,-1,0,0,0
18392,320000,256000,0,0,0,0,0,1,-2,0,0,0,-2,0,0,0,-2,0,0,0,-2,0,0,0
18393,50000,40000,0,1,1,1,0,1,0,48945,3600,45345,0,47994,0,47994,2,48704,1500,47204,0,41189,1500,39689
18394,110000,88000,0,0,0,0,0,0,-2,1000,1000,0,-1,0,0,0,-1,0,0,0,-2,0,0,0
18395,250000,200000,0,0,0,0,0,0,0,33726,4000,29726,0,36823,4000,32823,0,34829,5000,29829,0,23994,4000,19994
18396,100000,80000,0,0,0,0,0,0,-1,780,780,0,-1,0,0,0,-1,0,0,0,-2,0,0,0
18397,50000,40000,0,0,0,0,0,0,0,13738,1206,12532,0,6326,1000,5326,0,1452,600,852,0,1612,500,1112
18398,180000,144000,0,0,0,0,0,1,2,126202,4200,122002,0,127677,3000,124677,0,99764,5000,94764,0,0,2000,-2000
18399,120000,96000,0,0,0,0,0,0,-1,0,0,0,-2,0,0,0,-2,0,0,0,-2,0,0,0
18400,20000,16000,0,0,0,0,0,0,0,12874,1174,11700,0,8350,4000,4350,0,7500,150,7350,0,8500,1000,7500
18401,160000,128000,0,0,0,0,0,0,-1,1256,1276,-20,-1,14160,14160,0,-1,6180,6180,0,-1,2000,2000,0
18402,90000,72000,0,0,0,0,0,0,0,48425,0,48425,2,50611,3000,47611,0,52764,3000,49764,0,55898,4000,51898
18403,340000,272000,0,1,1,0,0,0,0,315601,13775,301826,0,318616,10631,307985,0,243586,8900,234686,0,248766,9200,239566
18404,300000,240000,0,0,0,0,0,0,0,44095,2600,41495,0,46502,3000,43502,0,47578,2000,45578,0,48959,2000,46959
18405,80000,64000,0,0,0,0,0,0,-1,964,0,964,3,964,0,964,2,964,0,964,0,5953,5953,0
18406,450000,360000,0,0,0,0,0,1,-1,46727,46727,0,-1,46367,1400,44967,0,46191,924,45267,0,20019,400,19619
18407,10000,8000,0,0,0,0,0,1,0,7560,1166,6394,0,7134,2000,5134,0,7280,146,7134,0,0,0,0
18408,40000,32000,0,0,0,0,0,0,2,26190,1435,24755,0,26710,955,25755,0,27274,993,26281,0,29551,2734,26817
18409,50000,40000,0,0,0,0,0,0,2,38605,1500,37105,2,32455,0,32455,2,15865,628,15237,0,23753,10362,13391
18410,190000,152000,0,0,0,0,0,1,0,109736,6500,103236,0,111487,5000,106487,0,114878,5117,109761,0,118541,5644,112897
18411,380000,304000,0,0,0,0,0,0,0,80828,3000,77828,0,82583,3100,79483,0,84687,3500,81187,0,84832,3500,81332
18412,50000,40000,0,0,0,0,0,0,-2,0,0,0,-2,0,0,0,-2,0,0,0,-2,0,0,0
18413,50000,40000,0,0,0,0,0,0,0,0,0,0,0,0,0,0,-2,0,0,0,-2,0,0,0
18414,180000,144000,0,0,0,0,0,0,-1,316,316,0,-1,316,316,0,-1,316,316,0,-1,316,316,0
18415,20000,16000,0,0,0,0,0,0,0,14503,0,14503,2,15238,1400,13838,0,14838,0,14838,0,15141,303,14838
18416,250000,200000,0,0,0,0,0,0,-2,110801,110801,0,-2,0,0,0,-2,18805,18805,0,-2,0,0,0
18417,50000,40000,0,0,0,0,0,0,-1,2299,2321,-22,-1,4800,4800,0,-1,9810,9810,0,-1,660,660,0
18418,500000,400000,0,0,0,0,0,0,-1,37272,37272,0,-1,24445,0,24445,0,77828,65428,12400,0,61029,1221,59808
18419,110000,88000,0,0,0,0,0,1,0,55489,1827,53662,0,49958,5400,44558,0,50524,1473,49051,2,50361,2100,48261
18420,130000,104000,1,1,0,0,0,1,0,140558,4229,136329,0,90522,3211,87311,0,90917,3297,87620,0,92330,3312,89018
18421,140000,112000,0,0,0,0,0,0,0,13650,4015,9635,0,12371,600,11771,0,12511,500,12011,0,10697,800,9897
18422,180000,144000,0,0,0,0,0,0,0,143809,30018,113791,0,112323,4011,108312,0,112208,3802,108406,0,113887,4106,109781
18423,90000,72000,0,0,0,0,0,0,-1,4487,4511,-24,-1,3169,3174,-5,-1,3847,3852,-5,-1,5403,5417,-14
18424,180000,144000,0,0,0,0,0,0,0,78070,3045,75025,0,50730,3500,47230,0,48039,2700,45339,0,47665,2720,44945
18425,200000,160000,0,0,0,0,0,0,0,85944,5000,80944,0,87539,4000,83539,0,90231,4000,86231,0,86284,5000,81284
18426,140000,112000,0,0,0,0,0,1,0,59395,9395,50000,0,73225,15000,58225,0,56999,0,56999,2,61050,5000,56050
18427,210000,168000,0,0,0,0,0,0,0,6316,4000,2316,0,6504,514,5990,0,326,326,0,-1,89599,89599,0
18428,60000,48000,0,1,1,1,1,1,0,58787,0,58787,2,58472,2304,56168,0,57777,2261,55516,0,60985,4600,56385
18429,100000,80000,0,0,0,0,0,0,0,0,0,0,0,674,674,0,-1,0,0,0,-1,980,980,0
18430,50000,40000,1,1,0,0,0,0,0,55122,4000,51122,0,33975,53083,-19108,-1,18827,1268,17559,0,19222,708,18514
18431,340000,272000,0,0,0,0,0,0,-2,0,0,0,-2,0,0,0,-2,0,0,0,-2,0,0,0
18432,30000,24000,0,0,0,0,0,0,0,-440,0,-440,-2,-830,0,-830,-2,-1220,0,-1220,-2,-1220,0,-1220
18433,300000,240000,0,0,0,0,0,0,-2,63037,63354,-317,-1,1137,1140,-3,-1,3916,3939,-23,-1,4803,4817,-14
18434,50000,40000,0,0,0,0,0,1,-1,3674,3675,-1,-1,1392,1392,0,-1,3085,3086,-1,-1,3450,3492,-42
18435,70000,56000,0,0,0,0,0,0,0,28978,1272,27706,0,17008,1212,15796,0,13780,1000,12780,0,14593,1020,13573
18436,80000,64000,0,0,0,0,0,1,0,0,0,0,0,0,0,0,-2,0,0,0,-2,0,0,0
18437,80000,64000,0,0,0,0,0,0,-1,6011,6011,0,-1,5783,5783,0,-1,2257,2257,0,-1,8257,6000,2257
18438,200000,160000,0,0,1,0,0,0,0,182868,116000,66868,0,166755,3771,162984,0,111450,2229,109221,0,53049,37609,15440
18439,220000,176000,0,1,0,0,0,0,0,211733,10000,201733,0,80965,10000,70965,0,78992,6000,72992,0,77537,6000,71537
18440,50000,40000,0,0,0,0,0,0,-1,316,350,-34,-1,316,316,0,-1,316,316,0,-1,316,316,0
18441,20000,16000,0,1,1,1,1,1,7,19930,0,19930,6,19434,70,19364,5,18577,0,18577,4,18011,0,18011
18442,200000,160000,0,0,0,0,0,0,-1,1951,1951,0,-1,1951,0,1951,0,3124,3124,0,-1,3259,3259,0
18443,120000,96000,0,0,0,0,0,1,0,20908,1400,19508,0,21560,1000,20560,0,22214,1000,21214,0,22845,1000,21845
18444,20000,16000,0,0,0,0,0,1,2,250,0,250,2,250,0,250,7,250,0,250,7,250,0,250
18445,310000,248000,0,0,0,0,0,0,0,12296,3000,9296,0,15083,3000,12083,0,17840,3000,14840,0,20376,3000,17376
18446,60000,48000,0,1,1,1,1,0,0,51608,2500,49108,0,52642,2500,50142,0,52806,2000,50806,0,53530,2100,51430
18447,50000,40000,0,1,1,0,0,1,0,48166,2200,45966,0,49167,2150,47017,0,26032,1000,25032,0,26235,1000,25235
18448,140000,112000,0,1,0,0,0,0,0,116399,4189,112210,0,112055,5411,106644,0,107364,3800,103564,0,107762,4024,103738
18449,80000,64000,0,0,0,0,0,0,-1,1863,0,1863,2,3309,1446,1863,0,1446,0,1446,0,390,0,390
18450,110000,88000,0,0,0,0,0,0,-1,776,776,0,-1,776,776,0,-1,926,926,0,-1,776,776,0
18451,200000,160000,0,0,0,0,0,0,-2,488,488,0,-2,488,488,0,-2,0,0,0,-2,1915,1915,0
18452,60000,48000,0,1,1,1,1,0,0,58411,3000,55411,0,58743,2500,56243,0,60042,2500,57542,0,57781,2300,55481
18453,210000,168000,0,0,0,0,0,0,-1,971,980,-9,-1,3764,4000,-236,-1,2221,266,1955,0,266,0,266
18454,270000,216000,0,0,0,0,0,1,0,180535,6700,173835,0,187524,10027,177497,0,185895,6700,179195,0,190396,7500,182896
18455,50000,40000,0,0,0,0,0,0,-1,-3650,0,-3650,-2,-3650,0,-3650,-2,-3650,0,-3650,-2,-3650,0,-3650
18456,350000,280000,0,0,0,0,0,0,-1,1000,1000,0,-1,630,630,0,-1,0,0,0,-1,0,0,0
18457,120000,96000,0,1,1,1,1,1,2,120990,5000,115990,2,121795,4200,117595,2,113328,0,113328,2,120615,9200,111415
18458,260000,208000,0,0,0,0,0,0,-2,120909,10000,110909,-2,102524,3000,99524,-1,40157,40157,0,-1,40805,1466,39339
18459,50000,40000,0,0,0,0,0,0,0,33499,1304,32195,0,19227,680,18547,0,19334,696,18638,0,19735,717,19018
18460,340000,272000,0,0,0,0,0,0,-1,15449,15449,0,-1,9610,9610,0,-1,4173,4373,-200,-1,12929,12929,0
18461,200000,160000,0,0,0,0,0,0,-1,3529,3529,0,-1,11711,11726,-15,-1,38079,35000,3079,0,0,0,0
18462,360000,288000,0,0,0,0,0,0,-1,64069,64535,-466,-1,49005,8907,40098,0,8676,53,8623,0,19487,19584,-97
18463,50000,40000,0,0,0,0,0,0,0,37561,1719,35842,0,36725,1783,34942,0,35346,1200,34146,0,33810,1200,32610
18464,350000,280000,0,0,0,0,0,0,-1,360,360,0,-1,360,360,0,-1,510,510,0,-1,510,510,0
18465,400000,320000,0,0,0,0,0,0,-2,16046,16046,0,-1,2483,2483,0,-1,10719,10719,0,-1,1722,1722,0
18466,20000,16000,0,0,0,0,0,0,0,9290,1200,8090,0,6636,1156,5480,0,2941,1000,1941,0,642,700,-58
18467,200000,160000,0,0,0,0,0,0,-2,0,0,0,-2,0,0,0,-2,0,0,0,-2,0,0,0
18468,460000,368000,0,0,0,0,0,0,0,325663,13039,312624,0,324067,11127,312940,0,324749,11017,313732,0,327929,11110,316819
18469,150000,120000,0,0,0,0,0,0,0,5162,5162,0,-1,4068,1000,3068,0,249,249,0,-1,249,249,0
18470,500000,400000,0,0,0,0,0,0,-1,25509,25585,-76,-1,9857,3,9854,0,8945,18,8927,0,9985,5034,4951
18471,180000,144000,0,0,0,0,0,0,0,28674,1588,27086,0,14834,1526,13308,0,1415,66,1349,2,47417,57317,-9900
18472,140000,112000,0,0,0,0,0,0,0,62411,2300,60111,0,64372,3000,61372,0,70015,6700,63315,0,68745,0,68745
18473,180000,144000,0,0,0,0,0,0,0,18100,2000,16100,0,19900,2000,17900,0,-100,0,-100,0,-100,0,-100
18474,30000,24000,0,1,1,1,1,0,0,27594,1500,26094,0,28157,1000,27157,0,28723,1000,27723,0,28059,1000,27059
18475,130000,104000,0,0,0,0,0,1,-2,4388,4402,-14,-2,0,0,0,-2,0,0,0,-2,1109,1109,0
18476,140000,112000,0,1,0,0,0,0,0,140057,4500,135557,0,100177,3500,96677,0,100873,4000,96873,0,98363,4000,94363
18477,20000,16000,1,1,1,1,1,0,5,21461,1000,20461,4,20835,0,20835,4,20219,0,20219,3,20487,760,19727
18478,50000,40000,0,0,0,0,0,1,0,18064,1306,16758,0,19076,1318,17758,0,19453,695,18758,0,19862,721,19141
18479,70000,56000,0,0,0,0,0,0,-2,44446,44446,0,-1,21436,41,21395,0,19987,19995,-8,-1,19939,6000,13939
18480,80000,64000,0,0,0,0,0,0,-1,-789,0,-789,-2,1042,2000,-958,-1,1042,0,1042,0,0,0,0
18481,350000,280000,0,0,0,0,0,0,0,268598,10334,258264,0,250304,5728,244576,0,251436,8242,243194,0,249891,13138,236753
18482,130000,104000,0,0,0,0,0,0,0,31467,1000,30467,0,-440,0,-440,0,-240,200,-440,-2,-240,0,-240
18483,180000,144000,0,0,0,0,0,0,-1,651,651,0,-1,2688,2688,0,-1,1000,20,980,0,2253,2253,0
18484,350000,280000,0,0,0,0,0,0,0,63179,2047,61132,0,57987,1750,56237,0,53948,1703,52245,0,39965,1721,38244
18485,20000,16000,0,0,0,0,0,1,2,300,0,300,2,300,0,300,2,300,0,300,2,300,0,300
18486,170000,136000,0,0,0,0,0,0,2,19041,19136,-95,-1,12769,64,12705,2,6283,6314,-31,-1,3093,3107,-14
18487,150000,120000,0,0,0,0,0,0,0,28151,1650,26501,0,27697,1500,26197,0,18981,1004,17977,0,6155,500,5655
18488,80000,64000,0,0,0,0,0,1,-1,4303,4321,-18,-1,3850,3869,-19,-2,0,0,0,-2,0,0,0
18489,300000,240000,0,0,0,0,0,0,-1,2316,3016,-700,-1,58284,58438,-154,-1,6877,20,6857,0,5970,5987,-17
18490,150000,120000,0,0,0,0,0,1,0,84302,5045,79257,0,74986,2563,72423,0,67369,3006,64363,0,60434,3000,57434
18491,230000,184000,0,0,0,0,0,0,0,6182,1000,5182,0,0,0,0,0,0,0,0,-2,0,0,0
18492,10000,8000,0,0,0,0,0,1,-1,390,390,0,-1,3622,3622,0,-1,3695,108,3587,0,3126,246,2880
18493,170000,136000,0,0,0,0,0,0,0,107396,13000,94396,0,96064,3593,92471,0,96984,3020,93964,0,93711,3090,90621
18494,80000,64000,0,0,0,0,0,0,0,27911,1589,26322,0,11687,1000,10687,0,11926,239,11687,0,11926,0,11926
18495,240000,192000,0,0,0,0,0,1,-1,3250,3250,0,-1,2391,2391,0,-1,1182,1182,0,-1,321,321,0
18496,500000,400000,0,0,0,0,0,0,0,100809,5095,95714,0,104716,7229,97487,0,101568,0,101568,2,92150,2843,89307
18497,180000,144000,0,0,0,1,1,0,-1,0,0,0,-1,245863,245863,0,-1,250472,5009,245463,0,251024,5040,245984
18498,140000,112000,0,0,0,0,0,0,0,65341,2365,62976,0,66674,2413,64261,0,68003,2431,65572,0,69424,2514,66910
18499,30000,24000,0,1,1,1,0,0,0,28791,1615,27176,0,29078,902,28176,0,30125,1374,28751,0,8941,767,8174
18500,130000,104000,0,0,0,0,0,0,-1,547,548,-1,-1,226,226,0,-1,73,105,-32,-2,-121,89,-210
18501,20000,16000,0,0,0,0,0,0,-2,904,913,-9,-2,304,304,0,-2,0,0,0,-2,302,302,0
18502,30000,24000,0,0,0,0,0,0,0,10923,1056,9867,0,10549,500,10049,0,4747,500,4247,0,4864,1000,3864
18503,220000,176000,0,0,0,0,0,0,-2,8183,8194,-11,-2,21189,22000,-811,-2,7838,7838,0,-2,321,321,0
18504,110000,88000,0,0,0,0,0,0,0,35254,4000,31254,0,30250,0,30250,2,21436,1000,20436,0,25325,5000,20325
18505,310000,248000,0,0,0,0,0,1,0,220421,7984,212437,0,224801,8029,216772,0,229520,8324,221196,0,234145,8435,225710
18506,80000,64000,0,0,0,0,0,0,0,28116,7000,21116,0,30656,5004,25652,0,24750,3000,21750,0,25543,4000,21543
18507,50000,40000,0,0,0,0,0,0,2,38859,1962,36897,0,39475,1562,37913,0,40187,1500,38687,0,40992,1474,39518
18508,200000,160000,0,0,0,0,0,1,-1,0,0,0,-1,0,0,0,-2,0,0,0,-2,0,0,0
18509,400000,320000,0,0,0,0,0,0,2,11471,11495,-24,-1,1779,1779,0,-1,0,0,0,-1,3470,3470,0
18510,110000,88000,0,1,1,1,1,0,0,104079,5300,98779,0,104829,4000,100829,0,107400,4200,103200,0,105694,4000,101694
18511,140000,112000,0,1,1,1,1,0,0,129752,6500,123252,0,132554,6500,126054,0,268084,5000,263084,0,137061,5000,132061
18512,360000,288000,0,0,0,0,0,0,-2,830,830,0,-1,0,0,0,-1,1271,1271,0,-1,179,179,0
18513,100000,80000,0,0,0,0,0,0,-1,4159,4159,0,-1,3542,1000,2542,0,1980,1080,900,0,3980,2000,1980
18514,80000,64000,0,0,0,0,0,0,0,16393,1139,15254,0,16724,470,16254,0,17086,500,16586,0,17431,490,16941
18515,30000,24000,0,1,1,0,0,0,0,29831,1679,28152,0,29992,1230,28762,0,21754,827,20927,0,18519,1000,17519
18516,20000,16000,0,1,1,1,0,0,0,19328,1462,17866,0,19035,1522,17513,0,19262,1165,18097,0,12308,0,12308
18517,50000,40000,0,0,0,0,0,0,0,26331,1403,24928,0,24749,1000,23749,0,25269,919,24350,0,26847,2000,24847
18518,250000,200000,0,0,0,0,0,0,0,177321,7992,169329,0,177580,6475,171105,0,170956,6050,164906,0,158503,6197,152306
18519,20000,16000,0,0,0,0,0,0,0,14012,2006,12006,0,11965,2011,9954,0,11867,7000,4867,0,12850,2000,10850
18520,160000,128000,0,0,0,0,0,0,0,48928,0,48928,2,49812,2000,47812,0,50855,2000,48855,0,52354,2500,49854
18521,50000,40000,0,0,0,0,0,0,0,27334,1800,25534,0,28374,1800,26574,0,28804,1200,27604,0,29488,1300,28188
18522,50000,40000,0,0,0,0,0,1,2,34909,5,34904,2,33528,1309,32219,0,16205,800,15405,0,16593,800,15793
18523,510000,408000,0,0,0,0,0,0,0,113654,70000,43654,0,104449,3500,100949,0,95937,4000,91937,0,96634,3500,93134
18524,350000,280000,0,0,0,0,0,0,0,63012,5631,57381,0,47172,20036,27136,0,19482,5000,14482,0,125875,125000,875
18525,500000,400000,0,0,0,0,0,0,-2,23095,23111,-16,-2,49379,49397,-18,-2,35313,35313,0,-2,23024,23856,-832
18526,260000,208000,0,0,0,0,0,0,-1,419,437,-18,-1,529,529,0,-1,0,0,0,-1,4090,4090,0
18527,60000,48000,0,0,0,0,0,0,0,30534,1500,29034,0,28442,1404,27038,0,24544,1100,23444,0,24998,1000,23998
18528,220000,176000,0,0,0,0,0,0,-1,1582,1582,0,-1,1109,1109,0,-1,3319,3319,0,-1,2113,2113,0
18529,490000,392000,0,0,0,0,0,1,-1,0,0,0,-1,0,0,0,-2,2236,2236,0,-1,3052,3052,0
18530,100000,80000,0,0,0,0,0,0,0,41963,1766,40197,0,43012,1942,41070,0,33270,1200,32070,0,33967,1233,32734
18531,110000,88000,0,0,0,0,0,0,0,50827,3686,47141,0,51834,1850,49984,0,52921,1917,51004,0,54013,1968,52045
18532,320000,256000,0,0,0,0,0,0,-2,14331,14331,0,-1,16591,9433,7158,0,9433,0,9433,0,398,0,398
18533,80000,64000,0,0,0,0,0,0,-1,836,836,0,-1,836,836,0,-1,836,836,0,-1,836,836,0
18534,240000,192000,0,0,0,0,0,0,0,0,0,0,0,0,0,0,-2,0,0,0,-2,0,0,0
18535,420000,336000,0,0,0,0,0,0,0,64513,64513,0,-1,65592,2420,63172,0,57438,1473,55965,0,31029,1062,29967
18536,170000,136000,0,0,0,0,0,0,0,93345,5000,88345,0,93812,5000,88812,0,95613,5000,90613,0,95972,4400,91572
18537,200000,160000,0,0,0,0,0,0,0,7957,3008,4949,0,4667,3500,1167,0,76187,73000,3187,0,74900,2700,72200
18538,160000,128000,0,0,0,0,0,1,0,10091,1036,9055,0,5905,309,5596,0,6210,500,5710,0,4302,0,4302
18539,80000,64000,0,1,1,1,1,0,0,69776,3000,66776,0,70985,2500,68485,0,72444,2500,69944,0,69685,2500,67185
18540,90000,72000,0,1,0,0,0,0,0,89853,4111,85742,0,69362,2100,67262,0,70537,2200,68337,0,56775,2510,54265
18541,280000,224000,0,0,0,0,0,0,-2,-288,0,-288,-2,-288,0,-288,-2,-288,0,-288,-2,2124,2412,-288
18542,160000,128000,0,0,0,0,0,0,0,40460,2400,38060,0,41149,2000,39149,0,-1,0,-1,0,-1,0,-1
18543,50000,40000,0,0,0,0,0,0,0,49624,23000,26624,0,19880,838,19042,0,20431,1000,19431,0,19559,1000,18559
18544,100000,80000,0,0,0,0,0,0,0,43417,1662,41755,0,43872,1670,42202,0,42215,1525,40690,0,42917,2000,40917
18545,180000,144000,0,1,1,1,1,0,0,171820,5900,165920,0,160018,6000,154018,0,164717,7000,157717,0,151235,7000,144235
18546,80000,64000,0,0,0,0,0,0,0,5750,1150,4600,0,1361,1361,0,-1,1402,1402,0,-1,1911,1000,911
18547,260000,208000,0,0,0,0,0,0,0,46407,2000,44407,0,38874,2000,36874,0,31324,2000,29324,0,24031,2000,22031
18548,170000,136000,0,0,0,0,0,0,0,83733,20000,63733,0,89389,8000,81389,0,97696,10000,87696,0,101063,5000,96063
18549,30000,24000,0,0,0,0,0,0,0,-720,0,-720,-2,-1500,0,-1500,-2,0,1500,-1500,-2,0,0,0
18550,450000,360000,0,0,0,0,0,0,-2,4700,4700,0,-2,20916,20916,0,-2,9695,9695,0,-2,6361,6361,0
18551,200000,160000,0,0,0,0,0,0,-1,34369,2003,32366,0,14240,1000,13240,0,23762,26068,-2306,-1,18198,10019,8179
18552,500000,400000,0,0,0,0,0,0,-2,297,297,0,-2,9342,9342,0,-2,3518,3518,0,-2,5597,5597,0
18553,400000,320000,0,0,0,0,0,0,-2,16593,16596,-3,-2,18569,18572,-3,-2,16947,16947,0,-2,28590,28590,0
18554,140000,112000,0,0,1,1,1,0,0,125702,20000,105702,0,124182,2000,122182,2,124155,3500,120655,2,137176,15000,122176
18555,80000,64000,0,1,0,0,0,0,0,68034,2442,65592,0,55674,1810,53864,0,48649,1661,46988,0,47041,1668,45373
18556,30000,24000,0,1,1,1,1,0,2,27226,0,27226,2,28427,2000,26427,0,28752,1000,27752,0,28447,1100,27347
18557,500000,400000,0,0,0,0,0,1,-2,0,0,0,-2,0,0,0,-2,0,0,0,-2,0,0,0
18558,150000,120000,0,0,0,0,0,0,0,122634,3764,118870,0,74711,2700,72011,0,76532,3000,73532,0,76452,3000,73452
18559,30000,24000,1,1,1,0,1,0,2,30311,0,30311,2,30270,957,29313,0,28958,7000,21958,0,30974,4530,26444
18560,210000,168000,0,0,0,0,0,0,0,51591,15065,36526,0,67772,30002,37770,0,71846,5023,66823,0,68876,2149,66727
18561,240000,192000,0,0,0,0,0,0,0,186450,6881,179569,0,190523,7181,183342,0,194405,7281,187124,0,182630,6638,175992
18562,290000,232000,0,0,0,0,0,0,-2,0,0,0,-2,0,0,0,-2,440,440,0,-2,0,0,0
18563,90000,72000,0,0,0,0,0,0,-2,0,0,0,-2,0,0,0,-2,0,0,0,-2,0,0,0
18564,100000,80000,0,0,0,0,0,0,2,66362,6700,59662,2,61417,60,61357,2,57893,2200,55693,0,58212,2500,55712
18565,220000,176000,0,0,0,0,0,0,0,7413,7397,16,0,3697,0,3697,2,3703,3703,0,-1,3500,3500,0
18566,400000,320000,0,0,0,0,0,0,-1,33508,33508,0,-1,9506,9506,0,-1,8967,8967,0,-1,4326,4326,0
18567,80000,64000,0,0,0,0,0,1,2,48781,0,48781,2,50170,2500,47670,0,51237,2500,48737,0,52360,2100,50260
18568,180000,144000,0,0,0,0,0,0,-2,-6674,330,-7004,-2,18084,36550,-18466,-2,16481,16481,0,-2,19359,21264,-1905
18569,80000,64000,0,1,1,0,0,0,0,76081,3500,72581,0,76526,1959,74567,0,27571,982,26589,0,28783,2000,26783
18570,50000,40000,0,0,0,0,0,1,3,652,0,652,2,326,0,326,0,0,0,0,0,1454,1454,0
18571,50000,40000,0,1,1,1,1,0,0,51221,5896,45325,0,49759,0,49759,2,49820,2000,47820,0,50525,1988,48537
18572,360000,288000,0,0,0,0,0,1,0,26439,1289,25150,0,25932,1000,24932,0,28396,4000,24396,0,28611,2000,26611
18573,30000,24000,0,0,0,0,0,0,0,19442,1323,18119,0,20741,1622,19119,0,21162,900,20262,2,20671,0,20671
18574,250000,200000,0,0,0,0,0,0,-1,2255,2255,0,-1,3183,1000,2183,0,2324,2324,0,-1,1657,1657,0
18575,210000,168000,0,0,0,0,0,0,-2,6456,6462,-6,-2,0,0,0,-2,2746,2746,0,-2,11613,11613,0
18576,50000,40000,0,0,0,0,0,0,0,1600,1600,0,-1,5087,5087,0,-1,4270,4270,0,-1,7881,7881,0
18577,30000,24000,0,0,0,0,0,1,2,2400,0,2400,2,2400,0,2400,7,2400,0,2400,7,2400,0,2400
18578,50000,40000,0,1,1,0,0,1,0,49943,9331,40612,0,50412,1500,48912,0,30970,4549,26421,0,30362,0,30362
18579,100000,80000,0,0,0,0,0,0,0,83745,5000,78745,0,79107,3000,76107,0,63811,3000,60811,0,48863,1732,47131
18580,70000,56000,0,0,0,0,0,0,-1,5960,5979,-19,-1,11780,11780,0,-1,1360,1360,0,-1,468,468,0
18581,100000,80000,0,1,1,1,1,0,0,86977,3428,83549,0,89575,3399,86176,0,91382,2546,88836,0,93320,2671,90649
18582,180000,144000,0,0,0,0,0,0,0,35884,30000,5884,0,31057,1000,30057,0,29052,1000,28052,0,25933,1000,24933
18583,210000,168000,0,0,0,0,0,0,0,85022,103,84919,2,90779,10000,80779,2,84209,0,84209,2,70162,3000,67162
18584,20000,16000,0,0,0,0,0,1,2,1050,0,1050,3,1050,0,1050,3,1050,0,1050,3,1050,0,1050
18585,120000,96000,0,0,0,0,0,0,0,14795,1942,12853,0,14313,0,14313,2,14762,626,14136,0,14902,478,14424
18586,20000,16000,0,0,0,0,0,0,2,3455,1096,2359,0,4359,1000,3359,0,4448,89,4359,0,4704,256,4448
18587,80000,64000,0,0,0,0,0,0,0,44031,1848,42183,0,48089,6084,42005,-1,44789,38,44751,2,30423,4,30419
18588,160000,128000,0,0,0,0,0,0,-2,3,13333,-13330,-2,3,13333,-13330,-2,13333,26663,-13330,-2,0,0,0
18589,140000,112000,0,0,0,0,0,0,-1,776,1552,-776,-1,380,380,0,-1,1157,1157,0,-1,768,783,-15
18590,30000,24000,0,1,0,0,0,1,2,28804,3400,25404,2,22335,0,22335,2,17448,0,17448,0,17448,0,17448
18591,230000,184000,0,0,0,0,0,0,-1,2403,2403,0,-1,2205,0,2205,2,1210,0,1210,0,291,291,0
18592,50000,40000,0,0,0,0,0,0,0,35082,2000,33082,0,38286,3800,34486,0,37543,0,37543,2,0,1546,-1546
18593,160000,128000,0,0,0,0,0,0,0,29169,4000,25169,0,28406,0,28406,2,28836,1200,27636,0,30208,2000,28208
18594,80000,64000,0,0,0,0,0,0,0,39571,2000,37571,0,40775,1867,38908,0,40592,1784,38808,0,20650,1050,19600
18595,20000,16000,0,0,0,0,0,0,0,8163,2000,6163,0,8874,1000,7874,2,9722,1000,8722,0,12386,3000,9386
18596,30000,24000,0,1,1,0,0,1,0,28777,1500,27277,0,27962,3000,24962,0,26306,3000,23306,0,28994,9000,19994
18597,300000,240000,0,0,0,0,0,0,-1,-649,0,-649,-1,129798,130447,-649,-1,558,560,-2,-1,522,524,-2
18598,30000,24000,0,1,1,1,1,0,2,29192,0,29192,2,31103,2700,28403,2,31771,1300,30471,2,30404,0,30404
18599,450000,360000,0,0,0,0,0,0,-1,17563,17651,-88,-1,12483,12554,-71,-1,26081,26212,-131,-1,22985,23114,-129
18600,310000,248000,0,0,0,0,0,1,0,105063,4000,101063,0,107113,3633,103480,0,109263,3671,105592,0,120347,12600,107747
18601,500000,400000,0,0,0,0,0,0,-2,14364,14364,0,-2,123903,124081,-178,-2,71463,71541,-78,-2,54924,54924,0
18602,30000,24000,0,0,0,0,0,0,0,19798,0,19798,2,20217,700,19517,0,21435,1500,19935,0,19239,0,19239
18603,30000,24000,0,1,1,1,1,1,2,26444,0,26444,2,28694,3000,25694,2,27936,0,27936,2,29930,2600,27330
18604,100000,80000,0,1,0,0,0,0,0,95375,3590,91785,0,54612,1118,53494,0,30306,720,29586,0,60897,50000,10897
18605,180000,144000,0,0,0,0,0,1,-1,440,440,0,-1,440,440,0,-1,440,440,0,-1,440,440,0
18606,280000,224000,0,0,0,0,0,0,0,39070,3000,36070,0,40545,2000,38545,0,42995,3000,39995,0,46278,4000,42278
18607,150000,120000,0,0,0,0,0,0,0,2629,2634,-5,-1,2584,1008,1576,0,1371,506,865,0,0,0,0
18608,130000,104000,0,1,1,1,1,1,2,118539,11323,107216,2,115029,0,115029,2,115793,4294,111499,0,118335,4700,113635
18609,220000,176000,0,0,0,0,0,0,-1,839,840,-1,-2,-3,3,-6,-2,1856,1859,-3,-2,1528,2134,-606
18610,400000,320000,0,0,0,0,0,0,2,62303,10000,52303,0,63928,10023,53905,0,52882,20000,32882,0,48387,5000,43387
18611,120000,96000,0,0,0,0,0,0,-1,89799,3520,86279,0,89913,2931,86982,0,88484,3180,85304,0,90477,3432,87045
18612,50000,40000,0,1,1,1,1,1,0,50810,2006,48804,0,50814,2010,48804,0,50927,2123,48804,0,50438,2138,48300
18613,240000,192000,0,0,0,0,0,0,-1,186673,187473,-800,-1,5517,5517,0,-1,2660,2660,0,-2,1480,1480,0
18614,270000,216000,0,0,0,0,0,0,-1,6098,6098,0,-1,3500,3500,0,-1,7324,7324,0,-1,9466,9466,0
18615,140000,112000,0,1,1,0,0,0,0,139110,7000,132110,0,138262,4228,134034,0,49675,1505,48170,0,46121,2000,44121
18616,80000,64000,0,0,0,0,0,1,-2,21197,21197,0,-1,20400,0,20400,2,20000,0,20000,2,20000,0,20000
18617,40000,32000,0,0,0,0,0,0,0,28777,4110,24667,0,29107,1100,28007,2,29693,1200,28493,2,30456,1400,29056
18618,50000,40000,0,0,0,0,0,1,0,20366,3000,17366,0,22710,3000,19710,0,23541,1500,22041,2,23027,0,23027
18619,260000,208000,0,0,0,0,0,0,-2,0,0,0,-2,0,0,0,-2,0,0,0,-2,0,0,0
18620,30000,24000,0,0,0,0,0,0,0,12040,1301,10739,0,12739,1000,11739,0,7610,152,7458,0,7000,140,6860
18621,360000,288000,0,0,0,0,0,0,-2,0,0,0,-2,0,0,0,-2,0,0,0,-2,0,0,0
18622,50000,40000,0,0,0,0,0,0,2,27687,1500,26187,2,28424,1500,26924,0,29311,1500,27811,0,30169,1500,28669
18623,290000,232000,0,0,0,0,0,1,0,229566,11014,218552,0,148812,5800,143012,0,53157,1820,51337,0,47998,2000,45998
18624,220000,176000,0,0,0,0,0,0,0,183453,8000,175453,0,176900,8000,168900,0,118965,6000,112965,0,172907,60000,112907
18625,10000,8000,0,0,0,1,1,0,-1,7392,1400,5992,0,8265,1000,7265,0,8631,500,8131,0,17974,500,17474
18626,50000,40000,0,0,0,0,0,1,-1,3962,3962,0,-1,0,0,0,-1,660,660,0,-1,1840,1840,0
18627,20000,16000,0,1,1,1,1,0,0,19979,1302,18677,0,20107,694,19413,0,19472,707,18765,0,19719,835,18884
18628,20000,16000,0,0,0,0,0,0,-1,-610,0,-610,-2,390,1390,-1000,-1,0,0,0,-1,19993,20773,-780
18629,20000,16000,0,1,1,1,0,0,0,20279,1400,18879,0,19887,398,19489,0,19887,0,19887,0,0,0,0
18630,150000,120000,0,0,0,0,0,0,-1,17822,18040,-218,-1,32353,32353,0,-1,25007,25000,7,0,16708,16708,0
18631,150000,120000,0,0,0,0,0,1,0,81491,3000,78491,0,77078,2000,75078,0,66927,5000,61927,0,50881,5055,45826
18632,80000,64000,0,0,0,0,0,1,-2,0,0,0,-2,0,0,0,-2,0,0,0,-2,0,0,0
18633,200000,160000,0,0,0,0,0,1,2,92504,7421,85083,2,90120,0,90120,2,93629,5000,88629,2,96980,5000,91980
18634,40000,32000,0,0,0,0,0,1,2,2400,0,2400,7,2400,0,2400,7,2400,0,2400,7,2400,0,2400
18635,70000,56000,0,0,0,0,0,1,0,45775,1764,44011,0,46911,1900,45011,0,48128,2000,46128,0,51182,4000,47182
18636,320000,256000,0,0,0,0,0,0,-1,945,13,932,2,-37,0,-37,2,-37,0,-37,-2,-37,0,-37
18637,240000,192000,0,0,0,0,0,0,0,27488,6000,21488,0,17891,3000,14891,0,6696,0,6696,0,4129,0,4129
18638,150000,120000,0,0,0,0,0,1,-1,291,291,0,-1,291,291,0,-1,658,658,0,-1,441,441,0
18639,20000,16000,0,0,0,0,0,1,2,2400,0,2400,2,2400,0,2400,7,2400,0,2400,7,2400,0,2400
18640,360000,288000,0,0,0,0,0,0,2,22285,0,22285,2,21359,687,20672,0,21581,3864,17717,0,16065,1065,15000
18641,160000,128000,0,0,0,0,0,0,-2,0,0,0,-2,0,0,0,-2,0,0,0,-2,0,0,0
18642,80000,64000,0,0,0,0,0,1,2,0,19800,-19800,2,0,0,0,-2,0,0,0,-2,0,0,0
18643,80000,64000,0,0,0,0,0,0,-2,641,641,0,-2,658,658,0,-2,2019,2019,0,-2,0,0,0
18644,50000,40000,0,0,0,0,0,0,0,26675,2000,24675,0,16948,592,16356,0,16303,604,15699,0,18019,2000,16019
18645,360000,288000,0,0,0,0,0,0,-1,141,141,0,-1,7054,7054,0,-1,-2946,1941,-4887,-1,-2946,0,-2946
18646,330000,264000,0,0,0,0,0,0,0,17586,1157,16429,0,12580,1331,11249,0,16254,4005,12249,0,8213,299,7914
18647,60000,48000,0,0,0,0,0,0,2,48871,3000,45871,3,47669,0,47669,3,48135,1500,46635,2,50056,3000,47056
18648,50000,40000,0,0,0,0,0,0,0,14565,5000,9565,0,15421,1500,13921,0,16061,1000,15061,0,4344,500,3844
18649,50000,40000,0,1,0,0,0,0,0,49878,2139,47739,0,16748,700,16048,0,17177,700,16477,0,17691,800,16891
18650,420000,336000,0,0,0,0,0,0,-1,0,0,0,-2,0,0,0,-2,20,20,0,-2,0,0,0
18651,310000,248000,0,1,0,0,0,0,0,303686,12100,291586,0,226605,8000,218605,0,224937,8000,216937,0,228912,9000,219912
18652,80000,64000,0,0,0,0,0,0,0,10704,4000,6704,0,9201,1000,8201,0,6275,1000,5275,0,2678,1000,1678
18653,160000,128000,0,0,0,0,0,0,0,119017,10000,109017,0,104417,3017,101400,2,62975,0,62975,2,53299,3000,50299
18654,410000,328000,0,1,0,0,0,0,0,367247,13000,354247,0,304903,13000,291903,0,310333,12000,298333,0,317330,12000,305330
18655,20000,16000,0,0,0,0,0,0,0,14120,4932,9188,0,12266,9,12257,2,10783,286,10497,0,5131,1000,4131
18656,160000,128000,0,0,0,0,0,1,-1,6437,6437,0,-1,16520,10428,6092,0,14374,463,13911,0,10969,426,10543
18657,50000,40000,0,0,0,0,0,0,0,19722,2200,17522,0,19305,806,18499,2,19409,1000,18409,0,20221,2000,18221
18658,50000,40000,0,1,0,0,0,1,0,48859,1285,47574,0,10076,332,9744,0,8442,306,8136,0,8610,308,8302
18659,360000,288000,0,0,0,0,0,1,-2,3240,3240,0,-2,1943,1943,0,-2,0,0,0,-2,0,0,0
18660,150000,120000,0,0,0,0,0,0,0,34409,3045,31364,0,93241,70092,23149,0,67549,2521,65028,0,62479,3000,59479
18661,50000,40000,1,1,1,1,1,0,2,56272,2500,53772,0,53663,2000,51663,0,51507,2000,49507,0,50616,3200,47416
18662,220000,176000,0,0,0,0,0,0,-1,29390,29390,0,-1,8460,8489,-29,-1,19000,19000,0,-1,13550,13550,0
18663,230000,184000,0,0,0,0,0,0,-2,2809,2809,0,-1,4595,4606,-11,-1,792,792,0,-1,3404,3404,0
18664,200000,160000,0,0,0,0,0,0,-1,0,0,0,-1,253,253,0,-1,0,0,0,-1,0,0,0
18665,230000,184000,0,0,0,0,0,0,0,12299,3116,9183,0,5860,5029,831,0,0,0,0,0,0,0,0
18666,430000,344000,0,0,0,0,0,0,0,44692,2300,42392,0,45648,2000,43648,0,47884,3000,44884,0,136701,90000,46701
18667,250000,200000,0,0,0,0,0,0,0,168186,10000,158186,0,175369,10000,165369,0,178156,7200,170956,0,189259,14000,175259
18668,60000,48000,0,1,1,0,0,0,0,59626,3400,56226,0,55775,2300,53475,0,28187,1200,26987,0,28978,1200,27778
18669,60000,48000,0,1,1,0,0,0,2,54647,2249,52398,0,56071,2604,53467,0,29199,983,28216,0,29815,1023,28792
18670,250000,200000,0,0,0,0,0,0,-1,0,0,0,-2,2576,2576,0,-1,20552,20739,-187,-1,0,0,0
18671,60000,48000,0,1,1,0,0,0,0,59568,2303,57265,0,61298,2669,58629,0,29587,1032,28555,0,27267,1000,26267
18672,20000,16000,0,0,0,0,0,0,0,17054,1240,15814,0,2333,2333,0,-1,1300,0,1300,0,0,0,0
18673,50000,40000,0,1,1,1,1,0,0,47145,1814,45331,0,47658,1717,45941,0,48209,1658,46551,0,48579,1858,46721
18674,180000,144000,0,0,0,0,0,0,-1,1730,1731,-1,-1,2215,2215,0,-1,1525,1525,0,-1,1050,1050,0
18675,300000,240000,0,0,0,0,0,0,-2,0,0,0,-2,507,507,0,-1,0,0,0,-1,629,629,0
18676,380000,304000,0,0,0,0,0,0,0,193992,35000,158992,0,174675,5000,169675,0,171253,6000,165253,0,169121,5000,164121
18677,270000,216000,0,0,0,0,0,0,-2,9190,9190,0,-2,2072,2072,0,-2,637,637,0,-2,238,238,0
18678,270000,216000,0,0,0,0,0,0,0,198551,7500,191051,0,201945,8000,193945,0,203636,7409,196227,0,205104,7869,197235
18679,50000,40000,0,1,1,1,1,0,0,51636,2743,48893,0,53561,2668,50893,0,53283,1712,51571,0,53057,1762,51295
18680,430000,344000,0,0,0,0,0,0,-2,4153,4153,0,-2,4196,4196,0,-2,447,447,0,-2,0,0,0
18681,430000,344000,0,0,0,0,0,0,2,14099,3000,11099,0,15128,3500,11628,0,14647,0,14647,2,16317,2000,14317
18682,200000,160000,0,0,0,0,1,0,2,163143,4842,158301,3,161906,3000,158906,2,165807,8000,157807,2,169599,7000,162599
18683,30000,24000,0,0,0,0,0,0,0,22428,1374,21054,0,23747,1693,22054,0,24154,1100,23054,0,25808,2200,23608
18684,50000,40000,0,1,1,0,0,1,0,49412,2000,47412,0,49590,1000,48590,0,0,0,0,0,0,0,0
18685,50000,40000,0,0,0,0,0,0,-2,0,0,0,-2,0,0,0,-2,0,0,0,-2,0,0,0
18686,190000,152000,0,1,0,0,1,0,0,152251,0,152251,2,153820,5600,148220,0,163265,11950,151315,0,166627,6200,160427
18687,320000,256000,0,0,0,0,0,1,-2,-46127,28,-46155,-2,-50616,12,-50628,-2,-53007,208,-53215,-2,-94625,8,-94633
18688,60000,48000,1,1,1,1,1,1,0,62736,2232,60504,0,59133,2152,56981,0,57662,2226,55436,0,53059,1908,51151
18689,210000,168000,0,0,0,0,0,0,0,53615,6500,47115,0,55117,3000,52117,0,57192,3000,54192,0,63229,7000,56229
18690,180000,144000,0,1,1,1,1,0,2,176869,16000,160869,2,347813,6000,341813,2,171041,0,171041,2,181637,15000,166637
18691,160000,128000,0,0,0,0,0,0,-1,99,99,0,-1,398,398,0,-1,99,99,0,-1,569,569,0
18692,500000,400000,0,0,0,0,0,0,0,25747,8078,17669,0,5749,2000,3749,0,10370,5000,5370,0,14161,6000,8161
18693,50000,40000,0,0,0,0,0,0,0,0,0,0,0,3794,3794,0,-1,0,0,0,-1,0,0,0
18694,20000,16000,0,0,1,1,1,0,0,16986,1500,15486,0,18656,2000,16656,0,19101,1000,18101,0,20345,1500,18845
18695,100000,80000,0,0,0,0,0,0,0,24689,2000,22689,0,25699,1700,23999,0,26809,1500,25309,0,25836,1500,24336
18696,80000,64000,0,0,0,0,0,0,-1,1604,1100,504,0,3612,3612,0,-1,2608,600,2008,0,1604,600,1004
18697,130000,104000,0,0,0,0,0,0,0,103438,40354,63084,0,49319,20000,29319,0,91191,43608,47583,0,82168,103,82065
18698,60000,48000,0,0,0,0,0,0,0,22691,1246,21445,0,22816,720,22096,0,26587,4780,21807,0,22917,1700,21217
18699,220000,176000,0,0,0,0,0,0,0,3791,3791,0,-1,7982,8493,-511,-1,5850,5850,0,-1,11304,11304,0
18700,20000,16000,0,0,0,0,0,0,-1,2006,2006,0,-1,-2830,1441,-4271,-1,-7220,0,-7220,-2,-11610,0,-11610
18701,90000,72000,0,0,0,0,0,0,-1,280,420,-140,-1,140,0,140,0,133,133,0,-1,2506,2513,-7
18702,160000,128000,0,0,0,0,0,0,-2,6204,6204,0,-1,6204,0,6204,0,0,0,0,0,0,0,0
18703,340000,272000,0,0,0,0,0,0,-2,6097,6097,0,-2,2272,2272,0,-2,4336,4336,0,-2,2581,2581,0
18704,80000,64000,0,0,0,0,0,0,0,3377,1000,2377,0,-6,6,-12,0,2188,2194,-6,-2,5808,5825,-17
18705,80000,64000,0,0,0,0,0,0,0,11966,3000,8966,0,14493,3000,11493,0,20328,8000,12328,0,23506,3506,20000
18706,50000,40000,0,0,0,0,0,0,0,19726,3000,16726,0,20074,1500,18574,0,20121,1000,19121,0,17021,1600,15421
18707,340000,272000,0,0,0,0,0,0,0,872,872,0,-1,981,981,0,-1,22936,22936,0,-1,8097,5000,3097
18708,40000,32000,0,1,1,1,1,0,0,36093,2000,34093,0,36891,2000,34891,0,37019,1318,35701,0,40734,4610,36124
18709,90000,72000,0,0,0,0,0,0,0,0,0,0,0,0,0,0,-2,0,0,0,-2,0,0,0
18710,120000,96000,0,0,0,0,0,1,-1,5456,5463,-7,-1,0,0,0,-1,2777,2777,0,-1,0,0,0
18711,170000,136000,0,1,1,0,0,0,0,165068,7500,157568,0,166227,6778,159449,0,109682,4000,105682,0,112906,5000,107906
18712,20000,16000,0,1,1,1,1,1,2,17848,0,17848,2,19103,1574,17529,0,19229,700,18529,0,18856,688,18168
18713,220000,176000,0,0,0,0,0,0,-2,1496,1503,-7,-2,5199,5233,-34,-2,20718,20828,-110,-2,12428,12490,-62
18714,200000,160000,0,0,0,0,0,0,-1,0,0,0,-1,0,0,0,-2,0,0,0,-2,980,980,0
18715,180000,144000,0,0,0,0,0,1,-2,780,780,0,-2,0,0,0,-2,0,0,0,-2,0,0,0
18716,80000,64000,0,0,0,0,0,0,0,49645,1745,47900,0,50235,1725,48510,0,47014,1704,45310,0,47575,1730,45845
18717,20000,16000,0,0,0,0,0,1,2,6218,1000,5218,2,5970,0,5970,2,8945,3100,5845,0,9896,1100,8796
18718,50000,40000,0,0,0,0,0,1,-2,0,0,0,-2,0,0,0,-2,0,0,0,-2,0,0,0
18719,70000,56000,0,0,0,0,0,0,-1,25566,25566,0,-1,26227,1066,25161,0,26375,1091,25284,0,26510,1100,25410
18720,40000,32000,0,1,1,1,1,0,-2,37356,1600,35756,-2,38184,1401,36783,-2,38724,1607,37117,-2,37255,1800,35455
18721,180000,144000,0,0,0,0,0,0,0,11705,4000,7705,0,14900,4000,10900,0,7180,3000,4180,0,-10,0,-10
18722,360000,288000,0,0,0,0,0,1,-2,2489,2489,0,-2,786,786,0,-2,0,0,0,-2,486,486,0
18723,20000,16000,1,1,1,1,1,1,2,21936,0,21936,8,21631,0,21631,7,21026,0,21026,6,20130,0,20130
18724,490000,392000,0,0,0,0,0,1,-1,5606,6000,-394,-1,3136,3136,0,-1,3353,3353,0,-1,12336,12336,0
18725,500000,400000,0,0,0,0,0,0,0,20189,6056,14133,0,12058,3063,8995,0,14692,14725,-33,-1,8274,206,8068
18726,30000,24000,0,0,0,0,0,0,2,17437,0,17437,2,18448,1306,17142,0,18815,673,18142,0,19210,698,18512
18727,260000,208000,0,0,0,0,0,0,0,46703,5000,41703,0,47500,5000,42500,0,45030,4000,41030,0,48249,5000,43249
18728,30000,24000,0,1,1,0,0,0,0,28945,2138,26807,0,29373,1102,28271,0,0,0,0,0,0,0,0
18729,290000,232000,0,0,0,0,0,0,0,16293,1300,14993,0,7760,0,7760,0,2000,2000,0,-1,0,1000,-1000
18730,160000,128000,0,0,0,0,0,0,-2,0,0,0,-2,850,850,0,-2,763,763,0,-2,0,0,0
18731,50000,40000,0,1,0,0,0,0,0,43378,2122,41256,0,28048,1600,26448,0,28477,1000,27477,0,29056,1000,28056
18732,270000,216000,0,0,0,0,0,0,-2,10069,10069,0,-1,9214,186,9028,0,199,199,0,0,0,0,0
18733,10000,8000,0,0,0,1,1,1,-2,780,780,0,-2,17585,17585,0,-1,18301,1000,17301,0,18663,667,17996
18734,10000,8000,0,0,1,1,1,1,-1,8459,1166,7293,0,9493,1200,8293,0,9678,300,9378,0,9634,1000,8634
18735,150000,120000,0,0,0,0,0,0,-1,18488,18516,-28,-1,45489,35701,9788,0,9069,9099,-30,-1,20203,20226,-23
18736,80000,64000,0,0,0,0,0,0,0,10787,1156,9631,0,6226,1200,5026,0,1936,8,1928,0,37201,37201,0
18737,50000,40000,0,0,0,0,0,0,-2,0,0,0,-2,1000,1000,0,-1,0,0,0,-1,0,0,0
18738,140000,112000,0,0,0,0,0,0,0,39505,1650,37855,0,40894,2007,38887,0,39229,1500,37729,0,40679,2100,38579
18739,200000,160000,0,0,0,0,0,0,-1,811,4,807,2,2754,3071,-317,-1,17557,17557,0,-1,1144,1144,0
18740,50000,40000,0,0,0,0,0,1,2,1050,0,1050,3,1050,0,1050,3,1050,0,1050,3,1050,0,1050
18741,580000,464000,0,0,0,0,0,0,0,166127,6565,159562,0,169365,5951,163414,0,168755,6006,162749,0,167964,5894,162070
18742,200000,160000,0,0,0,0,0,0,-2,4900,4942,-42,-2,1508,1508,0,-2,2451,2467,-16,-2,2966,2972,-6
18743,200000,160000,0,0,0,0,0,1,-1,4670,4670,0,-1,4670,4670,0,-1,4670,4670,0,-1,4670,4670,0
18744,50000,40000,0,1,1,1,1,1,2,48502,1842,46660,0,49170,1770,47400,0,49891,1751,48140,0,50570,3894,46676
18745,370000,296000,0,0,0,0,0,0,-2,0,0,0,-2,0,0,0,-2,0,0,0,-2,0,0,0
18746,100000,80000,1,1,0,0,0,1,0,115214,10000,105214,0,83649,11000,72649,0,59993,3000,56993,0,62813,4000,58813
18747,70000,56000,0,1,1,1,1,1,0,69252,2600,66652,0,70415,2700,67715,0,69212,2500,66712,0,70514,2800,67714
18748,260000,208000,0,0,0,0,0,0,0,3856,3856,0,-1,12996,13000,-4,-1,8788,0,8788,0,15104,15104,0
18749,60000,48000,0,0,0,0,0,0,-1,14366,14583,-217,-1,4889,4889,0,-1,273,273,0,-1,11736,13557,-1821
18750,30000,24000,0,0,0,0,0,0,0,4075,1000,3075,0,3668,1000,2668,0,0,1000,-1000,0,0,1800,-1800
18751,20000,16000,0,0,0,0,0,0,-1,1346,0,1346,2,587,300,287,2,338,0,338,2,1239,1000,239
18752,90000,72000,0,0,0,0,0,0,0,66929,3000,63929,0,67797,3000,64797,0,47739,3000,44739,0,48163,2000,46163
18753,100000,80000,0,0,0,0,0,0,2,0,0,0,-2,0,0,0,-2,0,0,0,-2,0,0,0
18754,100000,80000,0,0,0,0,0,0,0,46605,1810,44795,0,48795,3000,45795,0,48968,1734,47234,0,49752,1944,47808
18755,500000,400000,0,0,0,0,0,1,2,4957,0,4957,2,4957,0,4957,2,4957,0,4957,2,4957,0,4957
18756,180000,144000,0,0,0,0,0,0,-1,1165,1165,0,-1,4685,4685,0,-1,1165,0,1165,0,3472,3472,0
18757,60000,48000,0,0,0,0,0,1,2,7604,1500,6104,2,7603,270,7333,2,7332,0,7332,2,7712,500,7212
18758,280000,224000,0,0,0,0,0,0,-2,4425,4447,-22,-2,23083,23198,-115,-2,489,491,-2,-2,2937,2951,-14
18759,100000,80000,0,1,1,0,0,0,0,97831,3656,94175,0,93937,3677,90260,0,78063,2763,75300,0,79707,2787,76920
18760,210000,168000,0,0,0,0,0,1,-2,404,404,0,-2,2851,2851,0,-2,2959,2959,0,-2,693,782,-89
18761,260000,208000,0,0,0,0,0,0,0,55185,3049,52136,0,82040,58312,23728,0,60867,3018,57849,0,59005,3020,55985
18762,80000,64000,0,0,0,0,0,0,0,46104,1800,44304,0,48327,3000,45327,0,53549,6000,47549,0,52457,2900,49557
18763,50000,40000,0,0,0,0,0,0,0,28278,2016,26262,0,16983,1272,15711,0,8888,1000,7888,0,9218,1000,8218
18764,50000,40000,0,0,0,0,0,0,-1,1922,1922,0,-1,1473,1473,0,-1,1865,1865,0,-1,835,835,0
18765,200000,160000,0,0,0,0,0,0,-1,0,0,0,-1,0,0,0,-2,990,990,0,-1,0,0,0
18766,50000,40000,0,0,0,0,0,0,0,7333,1300,6033,0,8349,1300,7049,0,8362,300,8062,0,8727,500,8227
18767,180000,144000,0,0,0,0,0,0,-2,0,0,0,-2,0,0,0,-2,0,0,0,-2,1031,1031,0
18768,230000,184000,0,0,0,0,0,0,-1,380,380,0,-1,2350,2350,0,-1,103030,103030,0,-1,380,380,0
18769,30000,24000,0,0,0,1,1,0,0,24706,4900,19806,0,25022,2000,23022,0,26405,2100,24305,0,25861,0,25861
18770,250000,200000,0,0,0,0,0,1,2,0,0,0,-2,0,0,0,-2,0,0,0,-2,0,0,0
18771,120000,96000,0,0,0,0,0,0,-1,792,792,0,-1,0,0,0,-1,396,396,0,-1,396,396,0
18772,450000,360000,0,0,0,0,0,0,-2,0,0,0,-2,0,0,0,-2,0,0,0,-2,0,0,0
18773,120000,96000,0,0,0,0,0,1,-2,0,0,0,-2,0,0,0,-2,0,0,0,-2,0,0,0
18774,120000,96000,1,1,1,0,0,1,2,126516,4940,121576,0,123530,4806,118724,0,95921,4107,91814,0,88090,4026,84064
18775,20000,16000,0,0,1,1,1,0,0,17282,1292,15990,0,18293,1303,16990,0,18661,671,17990,0,20157,1800,18357
18776,500000,400000,0,0,0,0,0,0,0,46940,1635,45305,0,45607,2000,43607,0,41412,3450,37962,0,31200,3000,28200
18777,20000,16000,0,1,1,1,0,0,0,18894,1500,17394,0,19693,1250,18443,0,19894,451,19443,0,3473,160,3313
18778,60000,48000,0,0,0,0,0,0,-2,0,0,0,-2,0,0,0,-2,479,479,0,-2,27485,27485,0
18779,130000,104000,0,0,0,0,0,1,-2,0,0,0,-2,0,0,0,-2,0,0,0,-2,0,0,0
18780,70000,56000,0,1,0,0,0,0,0,68287,3000,65287,0,28163,1500,26663,0,27220,1000,26220,0,28124,2000,26124
18781,110000,88000,0,1,0,0,0,0,0,103381,27,103354,2,75794,4000,71794,0,76947,3000,73947,0,79105,3000,76105
18782,30000,24000,0,0,0,0,0,0,0,22880,2620,20260,0,22217,0,22217,2,23694,2000,21694,0,24151,1000,23151
18783,360000,288000,0,0,0,0,0,0,0,213527,8423,205104,0,174907,6753,168154,0,126309,5139,121170,0,97746,5000,92746
18784,500000,400000,0,0,0,0,0,0,0,300165,0,300165,0,281019,21420,259599,0,44528,1002,43526,0,40325,935,39390
18785,30000,24000,0,0,0,0,0,0,3,2646,0,2646,2,2646,0,2646,7,2646,0,2646,7,2646,0,2646
18786,50000,40000,0,0,0,0,0,0,0,6509,1000,5509,0,4417,5254,-837,-1,0,4166,-4166,-1,4331,8497,-4166
18787,20000,16000,0,1,1,1,1,0,2,19447,1500,17947,0,19312,1000,18312,0,17987,1000,16987,0,17822,1000,16822
18788,150000,120000,0,0,0,0,0,0,-2,0,0,0,-2,0,0,0,-2,0,0,0,-2,399,399,0
18789,70000,56000,0,0,0,0,0,0,0,42413,2004,40409,0,42946,1537,41409,0,43843,1589,42254,0,44714,1598,43116
18790,50000,40000,0,0,0,0,0,0,0,35827,5000,30827,0,32834,5716,27118,0,29052,3000,26052,0,28288,2000,26288
18791,50000,40000,0,1,0,0,0,1,2,44856,1600,43256,0,32461,871,31590,0,49916,30347,19569,0,29117,0,29117
18792,30000,24000,0,0,0,0,0,0,0,13505,2000,11505,0,12677,0,12677,2,12995,1000,11995,0,13443,1000,12443
18793,60000,48000,0,0,0,1,1,1,2,47476,5000,42476,0,54735,8100,46635,0,53584,0,53584,3,54703,2150,52553
18794,170000,136000,0,0,0,0,0,0,-1,316,316,0,-1,316,316,0,-1,948,948,0,-1,632,0,632
18795,230000,184000,0,0,0,0,0,0,-1,5711,5739,-28,-1,5770,5799,-29,-1,7652,7690,-38,-1,17825,17914,-89
18796,20000,16000,0,1,1,1,0,0,-1,20042,1391,18651,0,20115,1207,18908,0,20000,602,19398,0,16433,707,15726
18797,130000,104000,0,1,1,1,1,0,0,131990,5151,126839,0,127512,4464,123048,0,128683,5000,123683,0,129669,4702,124967
18798,80000,64000,0,0,0,0,0,0,-1,3133,3133,0,-1,1473,0,1473,2,1473,1473,0,-1,390,390,0
18799,170000,136000,0,0,0,0,0,0,0,128440,15000,113440,0,124909,0,124909,2,127393,6059,121334,0,130243,5068,125175
18800,20000,16000,0,1,1,1,1,0,0,21274,3300,17974,0,20109,0,20109,2,19976,1000,18976,0,20143,1000,19143
18801,180000,144000,0,0,0,0,0,0,0,9744,1144,8600,0,8907,1907,7000,0,557,557,0,-1,0,0,0
18802,120000,96000,0,0,0,0,0,1,-1,390,390,0,-1,1878,1878,0,-1,390,0,390,0,930,930,0
18803,500000,400000,0,0,0,0,0,0,0,45422,13000,32422,0,46483,2100,44383,0,39598,37000,2598,0,40622,1234,39388
18804,10000,8000,0,0,0,1,0,0,0,7648,1300,6348,0,8758,1400,7358,0,9410,1000,8410,0,4373,304,4069
18805,250000,200000,0,0,0,0,0,0,0,19509,1504,18005,0,42394,25000,17394,0,46739,10000,36739,0,55573,10002,45571
18806,360000,288000,0,0,0,0,0,0,-2,0,0,0,-2,0,0,0,-2,0,0,0,-2,0,0,0
18807,140000,112000,0,0,0,0,0,0,0,60180,2290,57890,0,43920,3499,40421,0,42670,1800,40870,0,41584,2000,39584
18808,360000,288000,0,0,0,0,0,0,-1,3760,3760,0,-1,752,752,0,-1,0,0,0,-1,0,0,0
18809,30000,24000,0,0,0,0,0,0,-1,11458,1328,10130,0,7500,1000,6500,0,7000,7000,0,0,5192,5192,0
18810,200000,160000,0,0,0,0,0,1,2,119576,5000,114576,0,123551,5000,118551,0,129486,7000,122486,0,133262,5000,128262
18811,310000,248000,0,0,0,0,0,1,-1,-7,0,-7,-2,500,507,-7,-1,736,736,0,-1,739,3,736
18812,500000,400000,0,0,0,0,0,0,-2,62407,80389,-17982,-2,63706,50132,13574,-2,59452,22208,37244,-2,47868,30167,17701
18813,70000,56000,0,0,0,0,0,0,2,23275,0,23275,2,24584,2000,22584,2,24051,0,24051,2,26654,3000,23654
18814,130000,104000,0,0,0,0,0,0,-1,2898,2898,0,-1,4728,1900,2828,0,5149,500,4649,0,5561,500,5061
18815,420000,336000,0,0,0,0,0,0,-1,0,0,0,-1,0,0,0,-2,0,0,0,-2,0,0,0
18816,50000,40000,0,1,1,1,1,1,2,48981,0,48981,4,47897,0,47897,3,48811,2000,46811,2,48058,160,47898
18817,20000,16000,0,0,0,0,0,1,-1,2974,2974,0,-1,2376,0,2376,2,5262,5262,0,-1,4401,88,4313
18818,230000,184000,0,0,0,0,0,0,0,95155,5000,90155,0,72983,2624,70359,0,70329,2360,67969,0,69340,3100,66240
18819,160000,128000,0,0,0,0,0,0,-2,3613,3613,0,-1,2722,0,2722,2,0,0,0,2,0,0,0
18820,240000,192000,0,0,0,0,0,0,-1,3195,3195,0,-1,1932,0,1932,0,7363,7383,-20,-1,1546,1546,0
18821,280000,224000,0,1,0,0,0,0,0,240627,7071,233556,0,228230,6574,221656,0,209987,5938,204049,0,196997,5867,191130
18822,80000,64000,0,0,0,0,0,0,-2,1650,1650,0,-2,3176,3176,0,-2,3379,3379,0,-2,1807,1807,0
18823,120000,96000,0,0,0,0,0,1,-2,-2390,0,-2390,-2,-2390,0,-2390,-2,-2390,0,-2390,-2,-2390,0,-2390
18824,100000,80000,0,0,0,0,0,1,0,63145,2000,61145,0,56962,1476,55486,0,52385,4992,47393,0,22543,808,21735
18825,30000,24000,0,1,1,1,1,0,2,30226,2900,27326,2,29454,0,29454,2,31775,2787,28988,2,30743,0,30743
18826,80000,64000,0,0,0,0,0,0,-2,-2241,1846,-4087,-2,0,8759,-8759,-2,0,0,0,-2,0,0,0
18827,360000,288000,0,0,0,0,0,0,-1,5504,5536,-32,-1,-4,0,-4,-1,-4,0,-4,-2,881,885,-4
18828,20000,16000,0,0,0,0,0,1,2,1050,0,1050,2,1050,0,1050,3,1050,0,1050,3,1050,0,1050
18829,200000,160000,0,0,0,0,0,1,0,0,0,0,-2,0,0,0,-2,0,0,0,-2,0,0,0
18830,460000,368000,0,0,0,0,0,0,0,217909,7500,210409,0,195811,7100,188711,0,199712,7100,192612,0,203895,7342,196553
18831,70000,56000,0,0,0,0,0,1,0,51152,2000,49152,0,35122,4500,30622,0,28633,1200,27433,2,28039,0,28039
18832,100000,80000,0,0,0,0,0,1,0,73525,3000,70525,0,75303,3000,72303,0,79994,5900,74094,0,78550,0,78550
18833,150000,120000,0,1,1,1,1,1,0,148152,4957,143195,0,150781,4208,146573,0,146446,4201,142245,0,149658,4837,144821
18834,170000,136000,0,0,0,0,0,0,0,50255,3000,47255,0,51410,1990,49420,0,52429,2000,50429,0,53554,2000,51554
18835,250000,200000,0,0,0,0,0,0,0,174837,85756,89081,0,81376,35153,46223,0,61474,4236,57238,0,27864,6080,21784
18836,400000,320000,0,0,0,0,0,0,-2,33956,34229,-273,-2,44258,44258,0,-2,56526,56526,0,-2,776,776,0
18837,10000,8000,0,0,1,1,1,0,0,9694,3000,6694,0,9888,345,9543,0,10094,356,9738,0,9762,425,9337
18838,20000,16000,0,0,0,0,0,0,-1,200,0,200,2,0,0,0,2,28740,28740,0,-1,1295,1565,-270
18839,20000,16000,0,1,1,0,1,1,2,19530,3000,16530,2,18950,0,18950,2,16510,1000,15510,0,19386,3000,16386
18840,330000,264000,0,0,0,0,0,0,-2,0,0,0,-2,469,469,0,-1,150,150,0,-1,3661,3661,0
18841,30000,24000,0,0,0,0,0,1,0,13225,901,12324,2,12718,0,12718,2,12829,465,12364,0,13083,467,12616
18842,110000,88000,0,0,0,0,0,0,0,41240,2760,38480,0,42380,3000,39380,0,380,380,0,-1,96736,96736,0
18843,270000,216000,0,0,0,0,0,0,0,122249,6843,115406,0,123905,6284,117621,0,105064,3617,101447,0,105600,3716,101884
18844,240000,192000,0,0,0,0,0,1,-2,0,0,0,-2,0,0,0,-2,0,0,0,-2,0,0,0
18845,40000,32000,0,0,0,0,0,0,0,18688,1006,17682,0,-620,0,-620,0,32760,17000,15760,-1,12500,2000,10500
18846,100000,80000,0,0,0,0,0,0,-2,636,636,0,-2,2538,4001,-1463,-2,1735,1735,0,-2,2054,2054,0
18847,30000,24000,0,0,0,0,0,0,0,5068,1000,4068,0,2023,1002,1021,0,1163,23,1140,0,0,0,0
18848,110000,88000,0,0,0,0,0,1,0,27630,1402,26228,0,22017,1534,20483,0,20517,800,19717,0,18534,700,17834
18849,130000,104000,0,0,0,0,0,1,0,95053,4198,90855,0,96146,3490,92656,0,98310,3800,94510,0,95726,3920,91806
18850,80000,64000,0,0,0,0,0,0,0,14366,1500,12866,0,15369,1252,14117,0,14595,330,14265,0,14363,1829,12534
18851,50000,40000,0,0,1,0,0,0,-2,49024,52806,-3782,-1,49806,1872,47934,0,30212,1200,29012,0,30419,1100,29319
18852,90000,72000,0,0,0,0,0,0,-1,15459,10000,5459,0,43380,33000,10380,0,46632,5300,41332,0,14177,5000,9177
18853,80000,64000,0,1,1,1,1,0,3,72205,6000,66205,2,73116,2700,70416,2,74801,3000,71801,2,73444,0,73444
18854,140000,112000,0,0,0,0,0,0,-1,0,0,0,-2,0,0,0,-2,0,0,0,-2,840,840,0
18855,30000,24000,0,1,1,1,1,0,0,30061,1748,28313,0,29621,1003,28618,0,27956,1022,26934,0,29484,2000,27484
18856,150000,120000,0,0,0,0,0,0,0,42407,3016,39391,0,28265,1201,27064,0,25402,601,24801,0,21514,2002,19512
18857,450000,360000,0,0,0,0,0,0,-1,16895,16918,-23,-1,7312,7316,-4,-1,6213,6213,0,-1,5073,5073,0
18858,20000,16000,0,0,0,0,0,1,2,11207,700,10507,2,11227,500,10727,2,12042,1000,11042,0,12850,1000,11850
18859,60000,48000,0,0,0,0,0,0,0,29836,1812,28024,0,30818,1794,29024,0,31314,1290,30024,0,30852,1268,29584
18860,80000,64000,0,0,0,0,0,0,0,21529,5002,16527,0,29236,10662,18574,0,10662,2,10660,0,2408,2408,0
18861,90000,72000,0,0,0,0,0,1,0,66940,2431,64509,0,68332,2506,65826,0,70169,3000,67169,0,66709,2950,63759
18862,90000,72000,0,0,0,0,0,0,0,38704,2000,36704,0,37135,1800,35335,0,35141,1150,33991,0,33502,1200,32302
18863,220000,176000,0,0,0,0,0,1,2,19798,0,19798,2,21468,2000,19468,2,20986,0,20986,2,22469,2000,20469
18864,110000,88000,0,0,0,0,0,0,0,15424,1545,13879,0,15479,600,14879,0,15989,750,15239,0,16276,700,15576
18865,230000,184000,0,0,0,0,0,0,0,133263,6000,127263,0,114889,4500,110389,0,117139,4000,113139,0,120252,5000,115252
18866,360000,288000,0,0,0,0,0,0,0,0,0,0,0,18,18,0,-1,18,0,18,-1,18,0,18
18867,130000,104000,0,0,0,0,0,0,0,63951,2207,61744,0,57467,2000,55467,0,51614,1717,49897,0,46071,1770,44301
18868,120000,96000,0,0,0,0,0,1,-1,948,0,948,3,632,0,632,2,632,316,316,0,316,0,316
18869,130000,104000,0,0,0,0,0,0,2,54976,0,54976,2,-3518,1580,-5098,2,-1285,1580,-2865,-2,1601,3202,-1601
18870,160000,128000,0,0,0,0,0,1,2,1100,1100,0,-1,652,652,0,-1,326,0,326,0,5654,5654,0
18871,360000,288000,0,0,0,0,0,0,-1,2776,2776,0,-1,2386,7158,-4772,-1,3166,3166,0,-1,2983,2983,0
18872,180000,144000,0,0,0,0,0,0,-1,3439,3444,-5,-1,1193,1193,0,-1,381,381,0,-1,1516,1516,0
18873,210000,168000,0,0,0,0,0,0,-1,167125,5482,161643,0,139784,3493,136291,0,142662,3590,139072,0,145725,3815,141910
18874,20000,16000,0,0,1,1,1,1,0,20035,5000,15035,0,19435,0,19435,4,18835,0,18835,3,18395,0,18395
18875,160000,128000,0,0,0,0,0,0,-1,0,0,0,-1,0,0,0,-2,1817,1817,0,-1,1817,0,1817
18876,50000,40000,0,0,0,0,0,0,0,790,790,0,-1,3696,3696,0,-1,6696,3000,3696,-2,5724,5724,0
18877,120000,96000,0,0,0,0,0,0,2,0,0,0,-2,41150,41150,0,-1,0,0,0,-1,125,125,0
18878,360000,288000,0,0,0,0,0,0,-1,390,390,0,-1,390,390,0,-1,390,390,0,-1,690,690,0
18879,180000,144000,0,0,0,0,0,0,0,6801,2000,4801,0,6759,1000,5759,0,6918,3000,3918,0,9777,4000,5777
18880,120000,96000,0,0,0,0,0,0,-1,119558,100000,19558,0,93652,3500,90152,0,23862,1000,22862,0,0,0,0
18881,180000,144000,0,0,0,0,0,0,-1,398,398,0,-1,629,629,0,-1,0,0,0,-1,978,978,0
18882,290000,232000,0,0,0,0,0,0,0,193999,9008,184991,0,157500,6000,151500,0,147150,5000,142150,0,146936,5200,141736
18883,20000,16000,0,0,1,1,1,0,0,18418,19330,-912,-1,19297,2303,16994,0,19000,1000,18000,0,19683,1000,18683
18884,50000,40000,0,0,0,0,0,0,-2,37111,37111,0,-1,37516,1307,36209,2,36614,0,36614,2,37537,1509,36028
18885,50000,40000,0,0,0,0,0,0,0,29447,2438,27009,0,19980,1700,18280,0,10400,1000,9400,0,0,0,0
18886,160000,128000,0,0,0,0,0,0,-1,26325,5000,21325,0,29638,7000,22638,0,35474,8000,27474,0,38190,5000,33190
18887,220000,176000,0,0,0,0,0,1,0,172926,8000,164926,0,104747,6000,98747,0,180458,107000,73458,0,182435,13000,169435
18888,60000,48000,0,0,0,0,0,0,-1,1758,1758,0,-1,416,416,0,-1,416,416,0,-1,3640,3640,0
18889,50000,40000,0,1,1,0,0,0,0,49245,2070,47175,0,48657,1232,47425,0,20050,625,19425,0,17376,585,16791
18890,120000,96000,0,1,0,0,0,0,2,122250,5700,116550,0,70901,2964,67937,0,40860,1527,39333,0,39553,1407,38146
18891,100000,80000,1,1,1,1,0,1,3,132132,0,132132,2,114431,0,114431,0,116766,2335,114431,0,95961,102075,-6114
18892,160000,128000,0,0,0,0,0,0,0,124283,4370,119913,0,123733,4400,119333,0,123275,4470,118805,0,122624,4420,118204
18893,50000,40000,0,0,0,0,0,0,-1,226,226,0,-1,-1300,0,-1300,-1,-1300,0,-1300,-2,-1300,0,-1300
18894,240000,192000,0,0,0,0,0,0,0,121245,6000,115245,0,122736,5000,117736,0,125599,5000,120599,0,128506,5000,123506
18895,70000,56000,0,1,1,1,1,1,2,58008,2000,56008,2,58957,2500,56457,2,60367,2500,57867,2,61617,2400,59217
18896,260000,208000,0,1,1,1,1,0,0,260497,9501,250996,0,261593,9577,252016,0,264184,9584,254600,0,264598,10006,254592
18897,80000,64000,0,1,0,0,0,0,0,71663,3021,68642,0,57571,2300,55271,0,58485,2500,55985,0,59655,2300,57355
18898,150000,120000,0,0,0,0,0,0,-1,1351,1351,0,-1,2942,2942,0,-1,384,384,0,-1,504,504,0
18899,410000,328000,0,0,0,0,0,0,0,32233,2800,29433,0,34450,3000,31450,0,36954,3000,33954,0,39251,3000,36251
18900,500000,400000,0,0,0,0,0,0,0,4814,5025,-211,-1,18365,18571,-206,-1,8728,5000,3728,0,28521,20000,8521
18901,310000,248000,0,0,0,0,0,0,-2,2667,2681,-14,-2,0,0,0,-2,2654,2654,0,-2,0,0,0
18902,170000,136000,0,0,0,0,0,1,-1,9871,9871,0,-1,9739,0,9739,0,66,0,66,0,230,230,0
18903,610000,488000,0,0,0,0,0,0,-2,-255,1,-256,-2,-538,0,-538,-2,107592,108130,-538,-2,168966,30695,138271
18904,100000,80000,0,0,0,0,0,0,0,39982,2000,37982,0,40914,1600,39314,0,42053,1800,40253,0,43151,1800,41351
18905,30000,24000,0,0,0,1,1,0,2,200,0,200,2,29847,29847,0,-1,30089,340,29749,-1,27957,0,27957
18906,40000,32000,0,1,1,1,1,1,3,39620,7,39613,2,38464,2500,35964,0,38569,1500,37069,0,70659,1500,69159
18907,190000,152000,0,1,1,0,0,0,0,202868,15466,187402,0,198936,4700,194236,0,28950,47450,-18500,-1,28666,16666,12000
18908,70000,56000,0,0,0,0,0,0,0,12117,1210,10907,0,13125,1218,11907,0,13407,500,12907,0,13692,500,13192
18909,360000,288000,0,0,0,0,0,1,-1,751,1502,-751,-1,15369,15369,0,-1,7845,200,7645,0,6786,0,6786
18910,370000,296000,0,0,0,0,0,0,0,71825,2097,69728,0,69872,2000,67872,0,63656,1818,61838,0,46555,1044,45511
18911,310000,248000,0,0,0,0,0,0,0,49738,5000,44738,0,53602,5052,48550,0,40510,9950,30560,0,43742,5000,38742
18912,80000,64000,0,0,0,0,0,0,2,10512,10512,0,-1,19529,9529,10000,0,27167,8167,19000,0,30878,5000,25878
18913,50000,40000,0,0,0,0,0,0,-2,0,0,0,-2,0,0,0,-2,0,0,0,-2,0,0,0
18914,250000,200000,0,0,0,0,0,0,0,12462,12158,304,0,8977,8777,200,0,1503,1503,0,-1,96834,96834,0
18915,160000,128000,0,0,0,0,0,0,-2,0,0,0,-2,2039,2039,0,-1,1033,0,1033,0,0,0,0
18916,100000,80000,0,0,0,0,0,0,0,46899,5000,41899,0,47447,1554,45893,0,48035,1595,46440,0,40484,1686,38798
18917,160000,128000,0,0,0,0,0,0,0,54769,1487,53282,0,39137,958,38179,0,26971,539,26432,0,3426,1000,2426
18918,170000,136000,0,0,0,0,0,0,0,31050,2500,28550,0,0,0,0,0,0,0,0,-2,0,0,0
18919,200000,160000,0,0,0,0,0,0,-1,0,0,0,-2,680,680,0,-1,0,0,0,-1,0,0,0
18920,50000,40000,0,0,0,0,0,0,0,19849,2000,17849,0,20301,2000,18301,0,17951,1000,16951,0,17254,1000,16254
18921,70000,56000,0,0,0,0,0,1,2,52431,5100,47331,2,52479,2000,50479,2,53345,2000,51345,2,52333,0,52333
18922,60000,48000,0,0,0,0,0,1,2,28601,2500,26101,2,29819,2000,27819,2,30192,1000,29192,2,31045,1500,29545
18923,180000,144000,0,0,0,0,0,0,-2,5944,5944,0,-2,2102,2102,0,-2,10214,10214,0,-2,0,0,0
18924,50000,40000,0,0,0,0,0,1,0,35625,1750,33875,0,36754,2270,34484,0,16943,603,16340,0,16234,713,15521
18925,150000,120000,0,0,0,0,0,0,-1,2199,1208,991,0,2997,1006,1991,0,735,50000,-49265,-1,1104,1104,0
18926,50000,40000,0,1,0,0,0,0,0,50687,1703,48984,0,37200,1444,35756,0,29838,1027,28811,0,30062,1053,29009
18927,20000,16000,0,0,0,0,0,0,2,13307,486,12821,2,13633,545,13088,0,15054,1639,13415,0,16505,1700,14805
18928,130000,104000,0,0,0,0,0,0,-1,1984,3000,-1016,-1,4649,4649,0,-1,6727,6727,0,-1,473,473,0
18929,220000,176000,0,0,0,0,0,0,2,290,291,-1,-1,5134,5159,-25,-1,346,347,-1,-1,427,428,-1
18930,80000,64000,0,1,1,1,1,1,2,68247,3100,65147,2,68531,2000,66531,2,69808,3000,66808,2,70544,2000,68544
18931,30000,24000,0,0,0,0,0,1,0,16671,10038,6633,0,13353,8057,5296,0,13232,6000,7232,0,9601,4221,5380
18932,140000,112000,0,1,1,1,1,0,0,139418,7000,132418,0,140962,5300,135662,0,137819,5300,132519,0,137094,10100,126994
18933,160000,128000,0,0,0,0,0,0,0,96395,5000,91395,0,58773,5000,53773,0,60737,3000,57737,0,115158,60000,55158
18934,110000,88000,0,0,0,0,0,0,0,67536,1317,66219,0,77697,11380,66317,0,82888,6508,76380,0,88048,6540,81508
18935,20000,16000,0,1,1,1,1,0,0,18545,1400,17145,0,19405,1300,18105,0,19358,700,18658,0,19413,700,18713
18936,210000,168000,0,0,0,0,0,0,-2,212,212,0,-2,3066,3066,0,-2,13206,13206,0,-1,10583,212,10371
18937,380000,304000,0,1,1,1,0,1,0,371624,14152,357472,0,362191,12270,349921,0,322148,11031,311117,0,309689,10207,299482
18938,30000,24000,0,1,1,1,1,0,0,25768,1500,24268,0,26410,1000,25410,0,27960,1909,26051,0,46254,1000,45254
18939,120000,96000,0,0,0,0,0,0,-1,2158,2826,-668,-1,6968,7026,-58,-1,2552,2620,-68,-1,626,1000,-374
18940,80000,64000,0,0,0,0,0,0,-1,390,390,0,-1,390,390,0,-1,390,390,0,-1,390,390,0
18941,300000,240000,0,0,0,0,0,0,2,137637,6500,131137,2,138886,5000,133886,2,140116,5000,135116,2,147715,10000,137715
18942,420000,336000,0,0,0,0,0,0,-1,56611,10617,45994,0,77406,25000,52406,0,79316,3034,76282,0,73995,3012,70983
18943,280000,224000,0,0,0,0,0,0,-1,16387,16387,0,-1,2967,2981,-14,-1,1087,2644,-1557,-1,2644,2644,0
18944,50000,40000,0,1,1,1,1,1,2,47041,2200,44841,0,49180,3600,45580,0,47500,0,47500,2,48479,1763,46716
18945,50000,40000,0,1,0,0,0,1,0,47827,1521,46306,0,28935,1419,27516,0,28224,969,27255,0,27547,997,26550
18946,300000,240000,0,0,0,0,0,0,0,14290,7000,7290,0,7490,7490,0,-1,2962,2962,0,-1,0,0,0
18947,160000,128000,0,0,0,0,0,1,2,14634,1247,13387,0,16532,2145,14387,0,15969,0,15969,2,17701,2000,15701
18948,200000,160000,0,1,1,1,1,0,0,190977,7000,183977,0,193800,6000,187800,0,190936,6000,184936,0,186183,5400,180783
18949,130000,104000,0,0,0,0,0,0,-1,390,390,0,-1,540,540,0,-1,540,540,0,-1,636,636,0
18950,120000,96000,0,1,0,0,0,0,0,101417,4715,96702,0,89852,3200,86652,0,91503,3010,88493,0,89571,3772,85799
18951,20000,16000,0,0,0,0,0,1,2,8212,0,8212,3,7931,0,7931,2,8797,1000,7797,2,8514,0,8514
18952,150000,120000,0,0,0,0,0,0,0,6763,1101,5662,0,6581,1098,5483,0,6733,250,6483,0,6882,247,6635
18953,80000,64000,0,0,0,0,0,1,-2,-270,0,-270,-2,3697,3967,-270,-2,9455,9455,0,-2,4144,5000,-856
18954,210000,168000,0,0,0,0,0,1,-2,0,0,0,-2,0,0,0,-2,1290,1290,0,-1,990,0,990
18955,50000,40000,0,1,1,1,0,1,2,46097,3628,42469,2,44187,8,44179,2,43165,1500,41665,0,37967,1490,36477
18956,10000,8000,0,0,0,0,0,1,2,2400,0,2400,2,2400,0,2400,7,2400,0,2400,7,2400,0,2400
18957,10000,8000,0,0,0,0,1,1,2,7912,1517,6395,0,4838,194,4644,0,10096,6700,3396,0,10112,1000,9112
18958,50000,40000,0,0,0,0,0,1,0,33462,1563,31899,0,36199,3300,32899,0,36803,1500,35303,2,37566,1500,36066
18959,250000,200000,0,0,0,0,0,0,-1,390,390,0,-1,2855,2855,0,-1,390,0,390,0,2950,2950,0
18960,20000,16000,0,0,0,0,0,0,0,8570,1300,7270,0,10020,1600,8420,0,9715,0,9715,2,10153,600,9553
18961,30000,24000,0,0,0,0,0,1,2,1050,0,1050,3,1050,0,1050,3,1050,0,1050,3,1050,0,1050
18962,240000,192000,0,0,0,0,0,1,-1,6853,6853,0,-1,5673,113,5560,0,7588,7588,0,-1,2737,2737,0
18963,50000,40000,0,0,0,0,0,1,0,41544,1843,39701,0,13007,434,12573,0,16233,5000,11233,0,14952,582,14370
18964,380000,304000,0,0,0,0,0,1,0,132838,6000,126838,0,136616,6000,130616,0,140240,6000,134240,0,143914,6000,137914
18965,160000,128000,0,0,0,0,0,0,-2,-38,0,-38,-2,-38,0,-38,-2,-38,0,-38,-2,-38,0,-38
18966,330000,264000,0,0,0,0,0,0,0,149325,6600,142725,0,143242,4800,138442,0,138627,5000,133627,0,139977,5400,134577
18967,200000,160000,0,0,0,0,0,0,-2,291,291,0,-2,2515,2515,0,-2,1133,1133,0,-2,-363,0,-363
18968,320000,256000,0,0,0,0,0,0,0,101151,5000,96151,0,104203,5000,99203,0,108867,5364,103503,0,40411,5010,35401
18969,20000,16000,0,1,1,1,1,1,2,17457,1000,16457,2,17868,1000,16868,0,18428,1000,17428,0,19120,1000,18120
18970,220000,176000,0,0,0,0,0,0,0,48211,2000,46211,0,47418,2000,45418,0,48657,2000,46657,0,48129,2000,46129
18971,80000,64000,0,0,0,0,0,0,-2,909,909,0,-2,1740,1740,0,-2,2190,2190,0,-2,518,518,0
18972,50000,40000,0,0,0,0,0,0,0,18588,1309,17279,0,18958,679,18279,0,19355,703,18652,0,19788,755,19033
18973,280000,224000,0,0,0,0,0,0,2,-127,0,-127,2,1012,1548,-536,-1,536,0,536,2,982,982,0
18974,390000,312000,0,0,0,0,0,0,-1,55120,55120,0,-1,2011,2011,0,-1,380,380,0,-1,380,0,380
18975,70000,56000,0,0,0,0,0,0,0,208,0,208,2,4170,4170,0,-1,4563,1000,3563,0,5331,1000,4331
18976,130000,104000,0,0,0,0,0,0,-1,0,0,0,-1,1358,1358,0,-1,1039,1039,0,-1,164,164,0
18977,50000,40000,0,0,0,0,0,0,0,35703,5003,30700,0,22360,3000,19360,0,23659,3000,20659,0,27421,5000,22421
18978,110000,88000,0,0,0,0,0,0,0,85868,3706,82162,0,74198,3009,71189,0,69783,2400,67383,0,66132,2300,63832
18979,160000,128000,0,1,0,0,0,0,2,157661,6322,151339,0,73322,2275,71047,0,57835,2343,55492,0,41842,3069,38773
18980,40000,32000,0,0,0,0,0,0,0,30019,1399,28620,0,30426,806,29620,0,22867,862,22005,0,12900,258,12642
18981,60000,48000,0,1,0,0,0,0,0,54422,1385,53037,0,19843,1000,18843,0,19095,693,18402,0,19495,717,18778
18982,120000,96000,0,0,0,0,0,0,0,7982,1163,6819,0,6289,1000,5289,0,7319,2000,5319,0,6958,1000,5958
18983,390000,312000,0,0,0,0,0,0,0,4090,2010,2080,0,8342,6500,1842,0,7611,2000,5611,0,8018,1000,7018
18984,100000,80000,0,0,0,0,0,0,2,37706,0,37706,2,38148,1369,36779,0,40630,3100,37530,0,39827,0,39827
18985,50000,40000,0,0,0,0,0,0,-1,34539,34539,0,-1,7000,7000,0,-1,6000,6000,0,-1,0,0,0
18986,390000,312000,0,0,0,0,0,0,0,46201,2188,44013,0,38770,1000,37770,0,3914,8572,-4658,-1,6568,6568,0
18987,200000,160000,0,0,0,0,0,0,-1,5679,5679,0,-1,8855,8855,0,-1,49572,49572,0,-1,2684,2684,0
18988,90000,72000,0,0,0,0,0,0,0,57739,2690,55049,0,55499,3041,52458,0,48246,3790,44456,0,47850,2000,45850
18989,160000,128000,0,0,0,0,0,0,0,73233,5824,67409,0,72328,0,72328,-2,74234,2204,72030,-2,75500,2000,73500
18990,30000,24000,0,1,1,1,1,0,-1,26195,1437,24758,0,27209,1451,25758,0,27924,1166,26758,0,30204,2900,27304
18991,120000,96000,0,0,0,0,0,0,0,17936,1200,16736,2,18536,1200,17336,2,19091,1000,18091,2,19629,1000,18629
18992,310000,248000,0,0,0,0,0,0,-1,131107,18008,113099,0,97009,20000,77009,0,51757,12000,39757,0,50009,5000,45009
18993,260000,208000,0,0,0,0,0,0,0,92549,6000,86549,0,90038,5000,85038,0,88772,6500,82272,0,111287,25000,86287
18994,80000,64000,0,0,0,0,1,1,2,63827,3000,60827,2,64682,2500,62182,2,65614,2600,63014,2,67007,2600,64407
18995,10000,8000,0,0,0,0,0,1,2,2400,0,2400,2,2400,0,2400,7,2400,0,2400,7,2400,0,2400
18996,140000,112000,0,1,1,1,1,1,2,133567,19500,114067,2,129953,0,129953,2,136283,10000,126283,2,139961,6000,133961
18997,140000,112000,0,0,0,0,0,1,2,464,464,0,-1,337,337,0,-1,548,548,0,-1,395,395,0
18998,30000,24000,0,0,0,0,0,0,-1,24135,24135,0,-1,24745,1000,23745,0,22805,2000,20805,0,10745,10745,0
18999,30000,24000,0,0,0,0,0,1,0,14964,1600,13364,0,15428,1000,14428,0,15612,569,15043,0,16630,1280,15350
19000,210000,168000,0,0,0,0,0,1,0,4048,3923,125,0,1871,1723,148,0,1320,5,1315,2,257,257,0
19001,10000,8000,1,1,1,1,1,0,0,10626,0,10626,3,10160,0,10160,2,10052,357,9695,0,9635,400,9235
19002,150000,120000,0,0,0,0,0,0,-2,858,858,0,-2,0,0,0,-2,3600,3600,0,-2,0,0,0
19003,50000,40000,0,0,0,0,0,0,0,21414,4476,16938,0,20774,0,20774,2,21177,888,20289,0,21612,788,20824
19004,300000,240000,0,0,0,0,0,0,0,7655,1500,6155,0,7507,0,7507,0,7659,300,7359,0,-574,0,-574
19005,20000,16000,0,0,0,0,0,1,2,11998,0,11998,2,13795,2000,11795,2,13431,0,13431,2,16199,3000,13199
19006,150000,120000,0,0,0,0,0,0,-1,7937,7937,0,-1,3307,3307,0,-1,2894,2894,0,-1,0,0,0
19007,280000,224000,0,0,0,0,0,0,-2,1848,1857,-9,-2,-8,0,-8,-2,1601,1609,-8,-2,-3,3,-6
19008,50000,40000,0,0,0,0,0,1,2,16586,1280,15306,0,18696,2390,16306,0,18100,0,18100,2,18475,816,17659
19009,260000,208000,0,0,0,0,0,0,-1,274,274,0,-1,165,165,0,-1,333,333,0,-1,165,165,0
19010,360000,288000,0,0,0,0,0,0,-2,2500,2500,0,-2,0,0,0,-2,0,0,0,-2,0,0,0
19011,260000,208000,0,0,0,0,0,0,-1,0,0,0,-1,8839,8839,0,-1,62140,62140,0,-1,6647,6647,0
19012,200000,160000,0,0,0,0,0,1,-1,2877,2877,0,0,160944,160944,0,-1,156864,0,156864,2,160066,5900,154166
19013,360000,288000,0,1,1,1,1,1,0,351383,14000,337383,0,335323,12000,323323,0,332865,12000,320865,0,333404,12000,321404
19014,10000,8000,0,1,0,0,0,0,0,10034,1503,8531,0,6599,1000,5599,0,6713,2134,4579,0,3940,79,3861
19015,280000,224000,0,0,0,0,0,1,0,430,430,0,-1,2041,2041,0,-1,775,775,0,-1,580,580,0
19016,200000,160000,0,0,0,0,0,0,0,5378,3378,2000,0,5501,5501,0,-1,9402,9402,0,-1,9221,6000,3221
19017,20000,16000,0,0,0,0,0,1,2,17187,1202,15985,0,8585,1000,7585,0,8760,175,8585,0,12000,3240,8760
19018,50000,40000,0,0,0,0,0,1,0,10000,1000,9000,0,0,0,0,0,0,0,0,-2,0,0,0
19019,60000,48000,0,1,0,0,0,0,0,59968,2203,57765,0,40377,1500,38877,0,40679,1600,39079,0,40493,1500,38993
19020,360000,288000,0,0,0,0,0,0,-1,8570,8570,0,-1,5625,5625,0,-1,3684,0,3684,0,2804,2804,0
19021,240000,192000,0,1,1,1,1,0,0,223853,9000,214853,0,225623,10000,215623,0,221130,8301,212829,0,225446,9000,216446
19022,180000,144000,0,0,0,0,0,0,-1,47392,47822,-430,-1,0,0,0,-1,460,460,0,-1,0,0,0
19023,280000,224000,0,0,0,0,0,0,0,105082,105082,0,-1,105908,4172,101736,0,98380,3408,94972,0,93649,3489,90160
19024,160000,128000,0,0,0,0,0,0,-1,0,0,0,-1,8484,8484,0,-1,2060,2064,-4,-1,0,0,0
19025,200000,160000,0,0,0,0,0,0,-1,11846,11846,0,-1,25920,25924,-4,-1,8035,161,7874,0,8521,8521,0
19026,50000,40000,0,1,0,0,0,0,0,42248,2000,40248,0,33855,2500,31355,0,28064,2500,25564,0,29660,2000,27660
19027,140000,112000,0,0,0,0,0,0,-1,12830,5000,7830,0,13317,1000,12317,0,14936,2000,12936,0,18504,4000,14504
19028,30000,24000,0,1,1,1,1,0,0,29372,1504,27868,0,29514,2017,27497,0,27226,2000,25226,0,25408,1000,24408
19029,50000,40000,0,0,0,0,0,1,2,15831,2100,13731,0,16884,2000,14884,0,18070,2000,16070,0,19218,2000,17218
19030,30000,24000,0,1,1,1,1,0,0,28949,1731,27218,0,28218,1200,27018,0,27262,1000,26262,0,27434,1009,26425
19031,30000,24000,0,0,0,0,0,1,2,16197,1270,14927,0,16669,742,15927,0,16865,613,16252,0,17199,615,16584
19032,210000,168000,0,0,0,0,0,0,-1,2880,2880,0,-1,0,0,0,-1,0,0,0,-2,0,0,0
19033,20000,16000,0,0,0,0,0,0,0,1473,1473,0,-1,240,240,0,-1,390,540,-150,-1,1320,1320,0
19034,290000,232000,0,0,0,0,0,0,-1,2208,2604,-396,-1,105145,215917,-110772,-1,106511,3685,102826,0,108228,3700,104528
19035,110000,88000,0,1,1,1,0,0,0,103690,3920,99770,0,105447,4031,101416,0,97096,4000,93096,0,77197,3000,74197
19036,260000,208000,0,1,1,0,0,0,0,231156,7550,223606,0,223415,8080,215335,0,158739,4645,154094,0,159210,5047,154163
19037,140000,112000,0,0,0,0,0,0,0,24460,1000,23460,0,435,435,0,-1,435,435,0,-1,435,435,0
19038,280000,224000,0,0,0,0,0,0,-1,1415,2343,-928,-1,15251,15289,-38,-1,316,316,0,-1,316,316,0
19039,440000,352000,0,0,0,0,0,0,0,214092,7822,206270,0,201210,8000,193210,0,186455,6000,180455,0,169455,16000,153455
19040,100000,80000,0,0,0,0,0,0,-1,73689,70000,3689,0,76148,4000,72148,0,77254,3000,74254,0,78967,3000,75967
19041,190000,152000,0,0,0,0,0,0,-1,-2,0,-2,-1,6381,6383,-2,-1,6383,2,6381,0,817,0,817
19042,390000,312000,0,0,0,0,0,0,-1,199466,201925,-2459,-1,200701,6195,194506,0,210885,30000,180885,0,213137,8000,205137
19043,30000,24000,0,0,0,0,0,1,2,19998,1441,18557,0,15675,1000,14675,0,8240,165,8075,0,438,438,0
19044,140000,112000,0,0,0,0,0,0,0,78842,5,78837,2,67003,2007,64996,0,0,0,0,0,0,0,0
19045,300000,240000,0,0,0,0,0,1,-1,154,200,-46,-1,154,0,154,2,1626,1626,0,-1,976,0,976
19046,180000,144000,0,0,0,0,0,0,0,39120,7000,32120,0,38339,0,38339,2,42679,5000,37679,0,46953,5000,41953
19047,250000,200000,0,0,0,0,0,0,-1,4063,4063,0,-1,5589,6018,-429,-1,15895,15895,0,-1,9948,1000,8948
19048,40000,32000,0,1,1,1,0,0,0,36824,3000,33824,0,38764,3000,35764,0,36411,3029,33382,0,31931,1000,30931
19049,100000,80000,0,1,1,1,1,1,0,98571,8002,90569,0,99322,4003,95319,2,96661,2,96659,2,95951,4005,91946
19050,320000,256000,0,1,1,0,0,0,0,288726,11422,277304,0,293969,11006,282963,0,247873,10011,237862,0,250870,9091,241779
19051,50000,40000,0,0,0,0,0,0,-1,3505,3556,-51,-1,12931,14010,-1079,-1,2972,3000,-28,-1,1589,0,1589
19052,120000,96000,0,0,0,0,0,1,0,27065,1200,25865,0,25948,0,25948,0,11884,0,11884,0,3107,3107,0
19053,70000,56000,0,0,0,0,0,1,2,12695,3116,9579,2,11482,0,11482,2,8896,1000,7896,0,10074,2000,8074
19054,150000,120000,0,0,0,0,0,0,0,81194,2725,78469,0,70590,2505,68085,0,72040,3000,69040,0,73423,3000,70423
19055,280000,224000,0,0,0,0,0,0,0,28111,1800,26311,0,29138,1800,27338,0,29852,1500,28352,0,30717,1500,29217
19056,210000,168000,0,0,0,0,0,0,-2,0,0,0,-2,0,0,0,-2,0,0,0,-2,0,0,0
19057,240000,192000,0,0,0,0,0,0,-2,2999,2999,0,-2,0,0,0,-2,0,0,0,-2,0,0,0
19058,60000,48000,0,0,0,0,0,0,-2,29452,1675,27777,-2,1696,1696,0,-1,38585,38000,585,0,38884,1500,37384
19059,60000,48000,0,0,0,0,0,1,0,44653,5000,39653,0,44056,2000,42056,0,42210,1500,40710,0,41796,2000,39796
19060,50000,40000,0,1,0,0,0,1,2,49727,568,49159,2,21826,0,21826,2,10208,516,9692,0,10100,400,9700
19061,130000,104000,0,0,0,0,0,0,0,66103,3500,62603,0,61549,3000,58549,0,62389,2500,59889,0,58782,2000,56782
19062,370000,296000,0,0,0,0,0,0,0,243293,11000,232293,0,226471,9004,217467,0,217901,6930,210971,0,195244,6000,189244
19063,50000,40000,0,0,0,0,0,0,0,23610,1504,22106,0,18079,1000,17079,0,18668,1000,17668,0,17273,1000,16273
19064,150000,120000,0,0,0,0,0,0,0,33616,1203,32413,0,24519,41,24478,0,10656,2587,8069,0,30168,31382,-1214
19065,360000,288000,0,0,0,0,0,0,0,158098,6019,152079,0,153896,5315,148581,0,152053,4975,147078,0,128253,4701,123552
19066,150000,120000,0,0,0,0,0,0,0,89151,0,89151,2,90071,3300,86771,0,92565,4000,88565,0,98291,7400,90891
19067,70000,56000,0,0,0,0,0,0,-2,0,0,0,-2,398,398,0,-1,248,0,248,2,3408,3408,0
19068,70000,56000,0,1,0,0,0,0,2,65348,0,65348,2,58253,3000,55253,0,35943,5943,30000,0,27930,10000,17930
19069,220000,176000,0,1,1,1,1,1,6,215959,1000,214959,5,210438,0,210438,4,207114,0,207114,3,210491,6800,203691
19070,20000,16000,0,1,1,1,1,0,0,19637,3100,16537,0,18671,1000,17671,2,20116,2000,18116,0,17617,1000,16617
19071,160000,128000,0,0,0,0,0,0,0,73996,3831,70165,0,75065,2900,72165,0,82472,8800,73672,0,80984,0,80984
19072,50000,40000,0,0,0,0,0,1,2,25064,1210,23854,0,12927,1000,11927,0,18691,6000,12691,0,19291,1060,18231
19073,230000,184000,0,0,0,0,0,0,-1,363,363,0,-1,372,372,0,-1,1971,1971,0,-1,2566,1000,1566
19074,360000,288000,0,0,0,0,0,0,-1,5137,8537,-3400,-1,4912,4912,0,-1,1150,0,1150,0,0,0,0
19075,50000,40000,0,0,0,0,0,0,0,32533,1500,31033,0,23156,1000,22156,0,23782,1000,22782,0,24386,1000,23386
19076,200000,160000,0,0,0,0,0,0,0,94933,3500,91433,0,96554,5000,91554,0,65905,5000,60905,0,1528,1000,528
19077,50000,40000,0,0,0,1,1,0,0,39803,6000,33803,0,41790,3000,38790,0,44351,3500,40851,0,46194,3500,42694
19078,340000,272000,0,0,0,0,0,0,0,206832,9184,197648,0,1682,1682,0,-1,1352,1352,0,-1,1520,1520,0
19079,50000,40000,0,1,1,1,1,0,0,45546,2100,43446,0,46587,2100,44487,0,47519,2000,45519,0,51346,4600,46746
19080,30000,24000,0,0,0,0,0,0,-1,390,0,390,2,780,780,0,-1,390,0,390,0,390,390,0
19081,170000,136000,0,0,0,0,0,0,0,129544,5100,124444,0,131937,5000,126937,0,132958,4700,128258,0,134525,5000,129525
19082,260000,208000,0,0,0,0,0,0,-2,0,0,0,-2,0,0,0,-2,0,0,0,-2,0,0,0
19083,460000,368000,0,1,1,1,1,1,0,450047,17610,432437,0,453770,17500,436270,0,396600,13810,382790,0,392879,14100,378779
19084,320000,256000,1,1,1,0,0,1,0,348144,13006,335138,0,311004,11500,299504,0,254598,9000,245598,0,227869,10000,217869
19085,70000,56000,0,0,0,0,0,1,2,16892,0,16892,2,18013,1400,16613,0,19315,1600,17715,0,19859,1000,18859
19086,50000,40000,0,0,0,0,0,0,0,36372,2000,34372,0,30305,3342,26963,0,29742,0,29742,2,30556,1400,29156
19087,30000,24000,0,0,0,0,0,1,2,16087,0,16087,2,17317,1500,15817,2,16900,0,16900,2,17465,1000,16465
19088,230000,184000,0,0,0,0,0,0,0,66633,1050,65583,2,56055,1634,54421,0,22935,3000,19935,0,17354,3203,14151
19089,320000,256000,0,0,0,0,0,0,0,37762,2941,34821,0,16425,2013,14412,0,12177,270,11907,0,45648,42659,2989
19090,230000,184000,0,0,0,0,0,0,0,43532,3000,40532,0,44504,2011,42493,0,44267,1574,42693,0,45564,2000,43564
19091,150000,120000,0,1,1,1,1,0,0,145341,5500,139841,0,153833,11000,142833,0,151194,0,151194,2,145738,6000,139738
19092,200000,160000,0,0,0,0,0,0,0,141129,8000,133129,0,134295,4100,130195,0,135962,4200,131762,0,112870,4300,108570
19093,100000,80000,0,1,1,1,1,0,2,96662,4000,92662,2,94216,0,94216,2,99732,7400,92332,2,101737,3800,97937
19094,280000,224000,0,0,0,0,0,0,0,191493,208141,-16648,-1,136249,5003,131246,0,111454,5002,106452,0,96425,5000,91425
19095,80000,64000,0,0,0,0,0,0,-1,917,917,0,-1,917,0,917,0,702,702,0,-1,3099,3099,0
19096,50000,40000,0,0,0,0,0,0,0,7861,7861,0,-1,8984,1320,7664,0,10664,2000,8664,0,7292,6000,1292
19097,410000,328000,0,0,0,0,0,0,0,199348,9000,190348,0,201941,9000,192941,0,101962,5000,96962,0,104837,5000,99837
19098,270000,216000,0,0,0,0,0,0,0,3203,1000,2203,0,1144,1121,23,0,1144,0,1144,0,1144,0,1144
19099,180000,144000,0,0,0,0,0,0,0,71298,3200,68098,0,72729,3210,69519,0,73627,2700,70927,0,75086,2800,72286
19100,200000,160000,0,0,0,0,0,0,2,0,0,0,2,1500,2250,-750,-1,750,0,750,0,750,750,0
19101,50000,40000,0,0,0,0,0,0,0,17221,10600,6621,0,16738,0,16738,2,17106,700,16406,0,15415,3000,12415
19102,360000,288000,0,0,0,0,0,0,2,47887,1900,45987,0,49158,2100,47058,0,49834,1707,48127,0,46034,2000,44034
19103,50000,40000,0,1,0,0,0,1,0,49496,2510,46986,0,10353,10371,-18,-1,4337,16533,-12196,-1,15017,11017,4000
19104,380000,304000,0,0,0,0,0,0,-1,86617,86697,-80,-1,-3450,0,-3450,-1,-3450,0,-3450,-2,3502,7102,-3600
19105,140000,112000,0,0,0,0,0,1,2,34685,2000,32685,0,35399,1583,33816,0,36616,1800,34816,0,36893,1000,35893
19106,200000,160000,0,0,0,0,0,0,-1,4447,4447,0,-1,126476,126476,0,-1,700,700,0,-1,0,0,0
19107,20000,16000,0,0,0,0,0,0,2,17619,2000,15619,0,10688,4000,6688,0,11346,2033,9313,0,0,0,0
19108,180000,144000,0,0,0,0,0,0,-1,1968,1968,0,-1,1800,1800,0,-1,8198,8198,0,-1,511,0,511
19109,230000,184000,0,1,1,1,1,1,0,229250,11000,218250,0,229572,9000,220572,0,213420,9000,204420,0,218809,9000,209809
19110,280000,224000,0,0,0,0,0,0,2,416,416,0,-1,416,416,0,-1,59211,59211,0,-1,416,0,416
19111,20000,16000,0,0,0,0,0,0,-1,398,0,398,2,796,796,0,-1,398,0,398,0,716,716,0
19112,550000,440000,0,0,0,0,0,0,0,260932,10507,250425,0,267917,13035,254882,0,217738,9511,208227,0,167245,6114,161131
19113,70000,56000,0,0,0,0,0,0,0,56333,2702,53631,0,29288,1500,27788,0,29524,1100,28424,0,29764,1100,28664
19114,390000,312000,0,0,0,0,0,0,0,134282,7027,127255,0,128701,5000,123701,0,131529,5000,126529,0,135242,6000,129242
19115,460000,368000,0,0,0,0,0,0,-1,32838,32871,-33,-1,33203,21000,12203,0,3129,165,2964,0,5945,3551,2394
19116,160000,128000,0,0,0,0,0,0,-1,4436,4436,0,-1,1978,1978,0,-1,3781,3781,0,-1,1732,1732,0
19117,80000,64000,0,0,0,0,0,1,2,25832,2000,23832,0,27394,2000,25394,0,29922,3000,26922,0,31879,2600,29279
19118,240000,192000,0,0,0,0,0,0,-1,20517,20519,-2,-1,0,0,0,-1,11423,11423,0,-1,0,0,0
19119,220000,176000,0,0,0,0,0,1,-1,-344,0,-344,-1,-344,0,-344,-2,-601,0,-601,-2,-601,0,-601
19120,50000,40000,0,0,0,0,0,1,3,34370,2000,32370,2,34806,1300,33506,2,35433,1500,33933,2,36216,1500,34716
19121,120000,96000,0,0,0,0,0,0,-1,30607,30629,-22,-1,25005,0,25005,0,19771,0,19771,0,34315,27000,7315
19122,50000,40000,0,0,0,1,1,1,3,40796,1600,39196,2,41526,1700,39826,2,42209,1500,40709,2,44960,3600,41360
19123,130000,104000,0,0,0,0,0,1,0,96898,0,96898,2,97990,3600,94390,0,100160,3800,96360,0,102190,3800,98390
19124,350000,280000,0,0,0,0,0,0,0,64995,3312,61683,0,61464,4050,57414,0,44664,1165,43499,0,51550,20055,31495
19125,210000,168000,0,1,1,0,0,0,0,193694,9057,184637,0,178664,6507,172157,0,149612,9808,139804,0,151226,6000,145226
19126,100000,80000,0,0,0,0,0,1,0,39680,2000,37680,0,41687,2680,39007,0,43607,2600,41007,0,43739,1000,42739
19127,50000,40000,0,1,1,1,1,0,2,44316,1900,42416,2,45189,1900,43289,2,46214,1900,44314,2,48904,3600,45304
19128,420000,336000,0,0,0,0,0,0,0,78830,3019,75811,0,76521,2777,73744,0,78049,2800,75249,0,79792,3000,76792
19129,50000,40000,0,1,1,1,1,0,0,47342,3600,43742,0,46326,0,46326,2,46358,1666,44692,0,45283,1559,43724
19130,160000,128000,0,0,0,0,0,0,-1,715,715,0,-1,715,715,0,-1,715,715,0,-1,865,865,0
19131,80000,64000,0,0,1,1,1,1,0,66334,3014,63320,0,70312,5700,64612,0,68585,0,68585,2,70027,2700,67327
19132,50000,40000,0,1,1,0,0,1,2,50603,1500,49103,2,49788,39,49749,2,37353,1280,36073,0,0,0,0
19133,270000,216000,0,0,0,0,0,0,0,40546,1700,38846,0,36822,1500,35322,0,31700,1100,30600,0,29133,1200,27933
19134,80000,64000,0,0,0,0,0,0,-2,9452,9481,-29,-2,1584,1588,-4,-2,2200,2206,-6,-2,7042,7073,-31
19135,230000,184000,0,0,0,0,0,0,0,159,159,0,0,1772,1778,-6,-1,28704,28704,0,-1,19474,19474,0
19136,120000,96000,0,1,0,0,0,0,0,123294,5427,117867,0,81042,2830,78212,0,81225,3000,78225,0,79777,2900,76877
19137,240000,192000,0,0,0,0,0,0,0,7164,3000,4164,0,10041,3000,7041,0,9731,0,9731,2,13540,4000,9540
19138,230000,184000,0,0,0,0,0,0,-2,0,0,0,-2,0,0,0,-2,0,0,0,-2,0,0,0
19139,90000,72000,0,0,0,0,0,1,0,19177,1000,18177,2,18574,0,18574,2,19721,1600,18121,2,19254,0,19254
19140,110000,88000,0,0,0,0,0,0,0,37484,3900,33584,0,38935,3900,35035,0,40633,4000,36633,0,41393,3100,38293
19141,100000,80000,0,0,0,0,0,0,0,68566,5000,63566,0,65132,2436,62696,0,48738,3000,45738,0,51020,3000,48020
19142,50000,40000,0,0,0,0,0,0,0,19057,1500,17557,0,18788,2000,16788,0,18108,1000,17108,0,15256,2000,13256
19143,500000,400000,0,0,0,0,0,0,0,2601,2601,0,-1,112075,112212,-137,-1,163165,100000,63165,0,214575,64575,150000
19144,80000,64000,0,0,0,0,0,0,0,60005,2500,57505,0,53384,1900,51484,0,55060,2500,52560,0,54583,2500,52083
19145,30000,24000,0,0,0,0,0,1,0,20123,1522,18601,0,20222,621,19601,0,20796,795,20001,0,19844,715,19129
19146,100000,80000,0,0,0,0,0,0,-1,390,0,390,2,390,390,0,-1,3863,3863,0,-1,390,390,0
19147,60000,48000,0,0,0,0,0,0,0,36032,1601,34431,0,37431,2000,35431,0,37863,1354,36509,0,38954,1700,37254
19148,20000,16000,0,0,0,1,1,0,2,15090,0,15090,2,16859,2001,14858,2,16472,0,16472,2,21819,5782,16037
19149,260000,208000,0,0,0,1,1,0,0,209496,15000,194496,0,215317,15000,200317,0,220727,12000,208727,0,218750,10000,208750
19150,180000,144000,0,0,0,0,0,0,0,6482,5004,1478,0,3246,1000,2246,0,2016,1000,1016,0,2334,2300,34
19151,100000,80000,0,0,0,0,0,0,0,3461,1064,2397,0,4471,1074,3397,0,4560,163,4397,0,4656,169,4487
19152,170000,136000,0,0,0,0,0,0,0,134372,6026,128346,0,84558,3200,81358,0,86538,3500,83038,0,88299,3200,85099
19153,30000,24000,0,1,1,1,1,1,0,25650,1500,24150,0,26222,1000,25222,0,26800,1000,25800,0,27554,1200,26354
19154,60000,48000,0,0,0,0,0,0,0,26401,1454,24947,0,326,326,0,0,324,324,0,-2,1126,1130,-4
19155,30000,24000,0,0,0,0,0,1,-1,859,859,0,-1,755,755,0,-1,755,0,755,0,220,0,220
19156,120000,96000,0,0,0,0,0,0,-1,1021,1021,0,-2,2311,2321,-10,-1,3868,3868,0,-1,2980,2980,0
19157,50000,40000,0,0,0,0,0,0,0,13918,4031,9887,0,8239,3000,5239,0,6376,6376,0,-1,10077,5000,5077
19158,180000,144000,0,0,0,0,0,0,-2,0,0,0,-2,0,0,0,-2,0,0,0,-2,0,0,0
19159,170000,136000,0,0,0,0,0,0,-1,15360,15360,0,-1,891,891,0,-1,13460,13460,0,-1,32136,32136,0
19160,220000,176000,0,0,0,0,0,0,0,142295,5163,137132,0,145127,5196,139931,0,148159,5372,142787,0,151462,5761,145701
19161,200000,160000,0,0,0,0,0,1,0,132963,5001,127962,0,145115,15000,130115,0,153040,10800,142240,0,155636,5600,150036
19162,130000,104000,0,0,0,0,0,0,-2,0,0,0,-2,0,0,0,-2,0,0,0,-2,0,0,0
19163,170000,136000,0,1,0,0,0,0,0,165432,6196,159236,0,120084,4300,115784,0,123439,5000,118439,0,107682,4006,103676
19164,170000,136000,0,0,0,0,0,0,0,40096,2000,38096,0,41130,2000,39130,0,42144,2000,40144,0,43114,1800,41314
19165,20000,16000,0,1,1,1,0,1,3,19331,0,19331,2,19333,500,18833,0,17363,715,16648,0,16314,326,15988
19166,20000,16000,0,0,0,0,0,0,0,0,0,0,0,0,0,0,-2,0,0,0,-2,0,0,0
19167,340000,272000,0,0,0,0,0,0,0,241509,11060,230449,0,275045,50008,225037,0,268429,8400,260029,0,262575,10000,252575
19168,50000,40000,0,0,0,0,0,1,2,24587,3115,21472,2,14999,3,14996,2,13410,1000,12410,0,7378,415,6963
19169,360000,288000,0,0,0,0,0,0,-2,1650,1650,0,-1,0,0,0,-1,0,0,0,-2,1650,1650,0
19170,500000,400000,0,0,0,0,0,1,-2,2652,2652,0,-2,2835,2835,0,-2,8896,8896,0,-2,3850,3850,0
19171,280000,224000,0,0,0,0,0,0,0,177913,7000,170913,0,182942,8000,174942,0,186892,7000,179892,0,197661,14000,183661
19172,500000,400000,0,0,0,0,0,0,0,239479,9800,229679,0,200081,6610,193471,0,185130,6000,179130,0,168868,6000,162868
19173,100000,80000,0,0,0,0,0,1,-1,671,671,0,-1,1642,1642,0,-1,821,0,821,2,671,671,0
19174,180000,144000,0,0,0,0,0,0,-2,785,785,0,-1,1809,1809,0,-1,2067,2067,0,-1,0,0,0
19175,100000,80000,0,1,1,0,0,0,2,96592,0,96592,2,99801,5000,94801,0,27930,2000,25930,0,27377,1116,26261
19176,30000,24000,0,0,0,0,0,0,-1,2970,2970,0,-1,2587,2587,0,-1,0,0,0,-1,0,0,0
19177,150000,120000,0,0,0,0,0,0,0,54793,6000,48793,0,59244,6000,53244,0,64096,6000,58096,0,68837,6001,62836
19178,120000,96000,0,0,0,0,0,0,0,84797,5076,79721,0,66398,5000,61398,0,44428,3042,41386,0,31738,2110,29628
19179,150000,120000,1,1,1,1,1,0,0,165990,10000,155990,0,161285,6000,155285,0,156749,6000,150749,0,151863,5500,146363
19180,50000,40000,0,0,0,0,0,1,2,0,0,0,-2,0,0,0,-2,0,0,0,-2,74,74,0
19181,60000,48000,0,0,0,0,0,1,2,45020,2000,43020,2,45785,1800,43985,2,44750,0,44750,2,45578,1700,43878
19182,30000,24000,0,1,1,1,1,1,3,26729,0,26729,2,27291,1300,25991,2,28819,2123,26696,2,29201,1000,28201
19183,320000,256000,0,0,0,0,0,0,0,261698,11020,250678,0,265703,11000,254703,0,175925,9486,166439,0,188982,20000,168982
19184,180000,144000,0,0,0,0,0,0,0,102359,5024,97335,0,96462,4300,92162,0,96846,3500,93346,0,95549,4000,91549
19185,50000,40000,0,0,0,0,0,0,0,7288,1032,6256,0,6662,166,6496,0,4920,149,4771,0,6060,2000,4060
19186,340000,272000,0,0,0,0,0,0,0,41930,2000,39930,0,43397,2000,41397,0,44710,2000,42710,0,46143,2000,44143
19187,90000,72000,0,1,0,0,0,0,2,87428,2773,84655,0,61778,2402,59376,0,68248,7660,60588,0,66997,0,66997
19188,330000,264000,0,0,0,0,0,0,-1,2023,2023,0,-1,-22,0,-22,-1,2870,2892,-22,-1,860,1059,-199
19189,360000,288000,0,0,0,0,0,0,0,3299,3331,-32,-1,8786,8786,0,-1,6801,1000,5801,0,8488,8488,0
19190,280000,224000,0,0,0,0,0,0,0,111858,5000,106858,0,83428,10000,73428,0,73908,0,73908,0,81908,8000,73908
19191,340000,272000,0,0,0,0,0,1,-1,1684,1692,-8,-1,-15,0,-15,-1,-15,0,-15,-2,3016,3031,-15
19192,100000,80000,0,1,1,1,1,0,0,92244,4300,87944,0,93316,3500,89816,0,95158,3500,91658,0,97776,4200,93576
19193,80000,64000,0,1,0,0,0,0,0,69986,2800,67186,0,46965,2008,44957,0,46518,1700,44818,0,47330,2000,45330
19194,150000,120000,0,0,0,0,0,0,2,0,0,0,2,1980,1980,0,-1,0,0,0,-1,0,0,0
19195,180000,144000,0,0,0,0,0,0,-1,1110,1110,0,-1,1110,1110,0,-1,1110,1110,0,-1,1110,1110,0
19196,400000,320000,0,0,0,0,0,0,0,284624,9816,274808,0,237176,8000,229176,0,211342,7824,203518,0,208432,8700,199732
19197,270000,216000,0,0,0,0,0,0,0,104377,5000,99377,0,106651,3953,102698,0,109294,4500,104794,0,101151,4000,97151
19198,300000,240000,0,0,0,0,0,0,-1,9505,9565,-60,-1,91527,91559,-32,-1,80780,252,80528,0,2694,2694,0
19199,90000,72000,0,0,0,0,0,1,2,61388,0,61388,2,64376,4000,60376,0,67347,4000,63347,0,74960,8900,66060
19200,80000,64000,0,1,1,0,0,0,0,79286,3593,75693,0,69708,3006,66702,0,49743,1729,48014,0,48969,2000,46969
19201,350000,280000,0,0,0,0,0,0,-1,47631,27689,19942,0,51451,21451,30000,0,35104,2000,33104,0,0,0,0
19202,20000,16000,0,0,1,0,0,0,0,16299,1200,15099,0,16428,329,16099,0,0,0,0,0,0,0,0
19203,80000,64000,0,0,0,0,0,0,0,61001,2226,58775,0,58759,2004,56755,0,58212,2132,56080,0,56534,2030,54504
19204,80000,64000,0,0,0,0,0,0,2,890,893,-3,-1,382,382,0,-1,2786,2794,-8,-1,2557,2561,-4
19205,150000,120000,0,0,0,0,0,0,-2,0,0,0,-2,0,0,0,-2,0,0,0,-2,0,0,0
19206,60000,48000,0,1,0,0,0,1,2,60906,2400,58506,2,45734,12,45722,2,40629,3200,37429,2,41137,1619,39518
19207,20000,16000,0,0,0,0,0,0,0,15781,1609,14172,0,15939,717,15222,0,16271,738,15533,0,16590,740,15850
19208,160000,128000,0,0,0,0,0,0,2,1863,1863,0,-1,390,0,390,0,930,930,0,-1,390,0,390
19209,30000,24000,0,1,1,1,1,0,0,27534,2000,25534,0,27670,1500,26170,0,28717,1500,27217,0,28786,1100,27686
19210,250000,200000,0,0,0,0,0,1,0,38905,2205,36700,0,35356,2000,33356,0,34978,2000,32978,0,35822,1000,34822
19211,80000,64000,0,0,0,0,0,0,-1,68,0,68,2,232,1000,-768,-1,-604,0,-604,-1,-440,1000,-1440
19212,50000,40000,0,0,0,0,0,0,0,41688,3000,38688,0,32806,6000,26806,0,18609,1000,17609,0,19793,1500,18293
19213,230000,184000,0,0,0,0,0,0,-2,0,0,0,-2,0,0,0,-2,0,0,0,-2,0,0,0
19214,170000,136000,0,0,0,0,0,0,0,98505,5000,93505,0,99970,4000,95970,0,102303,4000,98303,0,104654,4000,100654
19215,450000,360000,0,0,0,0,0,0,-2,74,100,-26,-2,-73,0,-73,-2,14590,14663,-73,-2,-70,0,-70
19216,90000,72000,0,0,0,0,0,0,0,48575,2000,46575,0,49667,2000,47667,0,51119,2000,49119,0,23344,2000,21344
19217,500000,400000,0,0,0,0,0,0,-1,52858,52858,0,-1,151479,100756,50723,0,29343,29488,-145,-1,2355,2365,-10
19218,200000,160000,0,0,0,0,0,1,-1,1463,1463,0,-1,15550,15550,0,-1,5045,5045,0,-1,6709,6709,0
19219,510000,408000,0,0,0,0,0,0,-1,559712,1227082,-667370,-1,163628,164577,-949,-1,117475,510,116965,0,116656,6239,110417
19220,360000,288000,0,0,0,0,0,0,-2,0,0,0,-2,0,0,0,-2,0,0,0,-2,0,0,0
19221,240000,192000,0,0,0,0,0,0,0,69899,2263,67636,0,71946,2930,69016,0,75425,5000,70425,0,74377,0,74377
19222,180000,144000,0,0,0,0,0,1,0,22587,1380,21207,0,23599,1392,22207,0,24069,862,23207,0,24573,892,23681
19223,80000,64000,0,0,0,0,0,0,0,45126,2051,43075,0,45775,1700,44075,0,48033,3000,45033,0,56981,10000,46981
19224,30000,24000,0,1,1,1,1,1,0,30146,1500,28646,0,26371,933,25438,0,27567,2000,25567,0,30114,3000,27114
19225,50000,40000,1,1,1,0,0,1,0,55328,2000,53328,0,42511,2000,40511,0,31032,5000,26032,0,34510,4000,30510
19226,440000,352000,0,0,0,0,0,0,0,48337,3000,45337,0,49532,2000,47532,0,53714,5000,48714,0,56818,4000,52818
19227,30000,24000,0,0,0,0,1,1,2,23691,3100,20591,2,23012,0,23012,2,26105,3500,22605,0,30500,5000,25500
19228,20000,16000,0,1,1,1,1,1,2,21034,3292,17742,2,20419,0,20419,3,19289,0,19289,2,19600,781,18819
19229,20000,16000,0,0,0,0,0,1,-1,1669,1669,0,-1,0,0,0,-1,0,0,0,-2,0,0,0
19230,200000,160000,0,1,0,0,0,1,2,181932,261,181671,2,132127,6206,125921,0,132245,5006,127239,0,138104,9406,128698
19231,140000,112000,0,0,0,0,0,0,-1,6573,6573,0,-1,0,0,0,-1,770,770,0,-1,0,0,0
19232,50000,40000,0,0,0,0,0,0,0,-220,220,-440,0,-1000,780,-1780,-2,-1000,0,-1000,-2,0,1000,-1000
19233,310000,248000,0,0,0,0,0,0,-2,6864,6864,0,-2,0,0,0,-2,150,150,0,-2,150,150,0
19234,150000,120000,0,0,0,0,0,0,-1,34731,34733,-2,-1,18845,18857,-12,-1,25745,25752,-7,-1,13396,3396,10000
19235,80000,64000,0,0,0,0,0,0,-2,0,0,0,-2,0,0,0,-2,0,0,0,-2,0,0,0
19236,390000,312000,0,0,0,0,0,1,-2,1600,1600,0,-2,3815,3315,500,-2,8330,11645,-3315,-1,4765,4765,0
19237,50000,40000,0,0,0,0,0,0,-2,0,0,0,-2,0,0,0,-2,0,0,0,-2,0,0,0
19238,360000,288000,0,0,0,0,0,1,0,248969,9036,239933,0,253896,9066,244830,0,259403,9576,249827,0,264352,9426,254926
19239,700000,560000,0,0,0,0,0,0,0,9861,2015,7846,0,6384,1005,5379,0,5126,1009,4117,0,2680,1000,1680
19240,280000,224000,0,0,0,0,0,0,0,156387,6100,150287,0,159584,5600,153984,0,163009,5805,157204,0,161769,7007,154762
19241,10000,8000,0,1,1,1,1,1,0,8637,0,8637,2,10277,1800,8477,2,9736,0,9736,2,9704,500,9204
19242,150000,120000,0,1,1,0,0,0,0,148393,7600,140793,0,149709,6000,143709,0,107862,4000,103862,0,108623,4100,104523
19243,30000,24000,0,0,1,1,1,1,3,25344,2000,23344,2,25634,1000,24634,2,24924,0,24924,2,26546,2026,24520
19244,80000,64000,0,0,0,0,0,1,-2,0,0,0,-2,0,0,0,-2,0,0,0,-2,650,650,0
19245,50000,40000,0,0,0,0,0,0,2,8023,2600,5423,2,7748,0,7748,2,8269,800,7469,2,7992,0,7992
19246,340000,272000,0,0,0,0,0,0,-1,17716,17716,0,-1,12010,12636,-626,-1,14111,14111,0,-1,6995,0,6995
19247,80000,64000,0,0,0,0,0,0,0,36288,2100,34188,0,37630,2400,35230,0,26424,1100,25324,0,27342,1500,25842
19248,360000,288000,0,1,0,0,0,0,0,346416,11992,334424,0,261694,8581,253113,0,230654,7991,222663,0,201528,9083,192445
19249,340000,272000,0,1,1,1,1,1,0,306575,10302,296273,0,311784,10365,301419,0,318320,10750,307570,0,325028,11150,313878
19250,300000,240000,0,0,0,0,0,0,-1,0,0,0,-1,320,320,0,-1,0,0,0,-1,0,0,0
19251,160000,128000,0,0,0,0,0,0,-1,390,390,0,-1,390,390,0,-1,390,390,0,-1,390,390,0
19252,170000,136000,0,0,0,0,0,0,-1,29271,29271,0,-1,26511,0,26511,0,0,0,0,0,0,0,0
19253,220000,176000,0,0,0,0,0,0,0,41422,8000,33422,0,44738,4000,40738,0,51479,7500,43979,0,56653,6000,50653
19254,140000,112000,0,0,0,0,0,0,-1,390,390,0,-1,1434,1434,0,-1,1309,1309,0,-1,540,540,0
19255,30000,24000,0,0,0,0,0,1,2,15069,0,15069,2,15868,1000,14868,0,16657,1000,15657,0,13998,668,13330
19256,50000,40000,0,0,0,0,0,1,-2,0,0,0,-2,0,0,0,-2,0,0,0,-2,0,0,0
19257,50000,40000,0,1,1,1,1,0,0,46346,2500,43846,0,47273,2000,45273,0,48357,2000,46357,0,50393,3000,47393
19258,150000,120000,0,0,0,0,0,0,-2,-123,0,-123,-2,240,363,-123,-1,123,0,123,0,123,123,0
19259,50000,40000,0,0,0,0,0,0,-1,591,591,0,-1,441,441,0,-1,741,741,0,-1,441,441,0
19260,200000,160000,0,0,0,0,0,0,-1,586,586,0,-1,600,600,0,-1,485,485,0,-1,0,0,0
19261,110000,88000,0,0,0,0,0,1,0,34983,0,34983,2,-18,0,-18,2,-18,0,-18,-2,-18,0,-18
19262,30000,24000,0,1,1,1,0,1,0,28072,1579,26493,0,28885,1402,27483,0,29287,804,28483,0,23012,732,22280
19263,300000,240000,0,0,0,0,0,0,0,21689,5000,16689,0,12500,3500,9000,0,12500,12500,0,-1,12500,12500,0
19264,50000,40000,0,0,0,0,0,0,0,25239,2310,22929,0,10228,303,9925,0,10107,369,9738,0,9178,331,8847
19265,50000,40000,0,1,1,1,1,0,0,46649,1700,44949,0,48020,2000,46020,0,49439,2044,47395,0,45771,1319,44452
19266,180000,144000,0,0,0,0,0,0,0,148713,6000,142713,0,129518,5000,124518,0,125868,5000,120868,0,121823,4416,117407
19267,50000,40000,0,0,0,0,0,1,3,4284,0,4284,2,2946,0,2946,0,1473,0,1473,0,1473,1473,0
19268,290000,232000,0,0,0,0,0,0,-1,36918,36982,-64,-1,37063,37063,0,-1,11566,11566,0,-1,32057,32057,0
19269,210000,168000,0,0,0,0,0,0,-2,-81,0,-81,-2,-81,0,-81,-2,-81,0,-81,-2,-81,0,-81
19270,130000,104000,0,0,0,0,0,0,-1,99,99,0,-1,99,99,0,-1,99,99,0,-1,98,98,0
19271,140000,112000,0,0,0,0,0,0,-1,0,0,0,-2,2971,2971,0,-1,1607,0,1607,0,0,0,0
19272,20000,16000,0,0,0,0,0,1,0,11901,2000,9901,0,11901,0,11901,0,9336,0,9336,0,9054,9054,0
19273,20000,16000,0,1,1,1,1,1,0,20654,700,19954,2,19118,0,19118,2,18104,1000,17104,0,19846,2000,17846
19274,150000,120000,0,0,0,0,0,0,0,96940,4000,92940,0,46349,1482,44867,0,47360,1577,45783,0,48717,2000,46717
19275,400000,320000,0,0,0,0,0,0,-1,5300,5300,0,-1,6534,6534,0,-1,5222,0,5222,0,500,500,0
19276,50000,40000,0,0,0,0,0,0,0,45137,40693,4444,0,41168,3900,37268,0,5890,1000,4890,0,7000,1500,5500
19277,420000,336000,0,0,0,0,0,0,2,35097,3016,32081,0,33025,1846,31179,0,36945,5005,31940,0,37276,2005,35271
19278,180000,144000,0,0,0,0,0,1,2,1600,1600,0,-1,0,0,0,-1,22357,22357,0,-1,21541,1500,20041
19279,30000,24000,0,1,1,1,1,0,0,25745,1422,24323,0,27949,2626,25323,0,27216,0,27216,2,29138,2351,26787
19280,500000,400000,0,0,0,0,0,0,-1,7981,7993,-12,-1,695,695,0,-1,1130,1130,0,-1,41026,41026,0
19281,350000,280000,0,0,0,0,0,0,-1,0,0,0,-1,0,0,0,-2,0,0,0,-2,0,0,0
19282,500000,400000,0,0,0,0,0,0,-1,2914,2929,-15,-1,-341,0,-341,-1,38853,39194,-341,-1,0,0,0
19283,180000,144000,0,0,0,0,0,1,-1,5307,5347,-40,-1,28004,28004,0,-1,957,957,0,-1,0,0,0
19284,120000,96000,0,0,0,0,0,1,-1,1000,1000,0,-1,0,0,0,-1,19100,19100,0,-1,0,0,0
19285,70000,56000,0,1,1,1,1,0,0,66398,2600,63798,0,66282,2600,63682,0,67580,3000,64580,0,67273,2600,64673
19286,200000,160000,0,0,0,0,0,0,-1,780,780,0,-1,0,0,0,-1,0,0,0,-2,0,0,0
19287,80000,64000,0,0,0,0,0,0,-1,0,0,0,-2,0,0,0,-2,0,0,0,-2,0,0,0
19288,60000,48000,0,0,0,0,0,0,0,21712,2000,19712,0,23284,2000,21284,0,24945,2000,22945,0,25402,2000,23402
19289,80000,64000,0,0,0,0,0,0,-1,1533,1533,0,-1,722,0,722,0,811,900,-89,-1,337,337,0
19290,320000,256000,0,0,0,0,0,0,-1,316,316,0,-1,316,316,0,-1,316,316,0,-1,316,316,0
19291,100000,80000,0,0,0,0,0,1,2,48205,2031,46174,0,47324,1800,45524,0,45723,2000,43723,0,46708,1900,44808
19292,20000,16000,0,1,1,1,1,0,6,18235,0,18235,5,18654,1000,17654,4,18073,0,18073,4,17501,0,17501
19293,50000,40000,0,0,0,0,0,0,0,41132,2200,38932,0,31538,1917,29621,0,28896,1200,27696,0,28315,1030,27285
19294,380000,304000,0,1,1,1,1,0,0,375150,14219,360931,0,383319,15022,368297,0,385813,29000,356813,0,365587,0,365587
19295,300000,240000,0,1,1,1,1,0,0,262075,12000,250075,0,276110,20002,256108,0,279623,10002,269621,0,285719,11002,274717
19296,180000,144000,0,0,0,0,0,0,0,101255,5114,96141,0,101341,3238,98103,0,98419,3401,95018,0,85259,2980,82279
19297,10000,8000,0,0,0,0,0,0,0,780,780,0,-1,780,0,780,0,0,600,-600,0,0,0,0
19298,210000,168000,0,0,0,0,0,0,0,259323,130000,129323,-1,139861,10000,129861,0,1684,1684,0,0,826,826,0
19299,20000,16000,0,0,1,1,1,1,2,17140,1500,15640,0,18457,1600,16857,0,21381,1646,19735,0,18914,678,18236
19300,50000,40000,0,0,0,0,0,0,-1,748,748,0,-1,1693,1693,0,-1,1138,1138,0,-1,748,895,-147
19301,220000,176000,0,0,0,0,0,0,0,1369,6643,-5274,-1,5924,5924,0,-1,1759,1759,0,-2,1824,1824,0
19302,100000,80000,0,0,0,0,0,0,0,53779,1941,51838,0,54166,2000,52166,0,55265,2000,53265,0,56425,2049,54376
19303,180000,144000,0,0,0,0,0,0,-2,1290,1290,0,-2,0,0,0,-2,0,0,0,-2,1200,1200,0
19304,20000,16000,0,1,1,1,1,0,0,19123,1602,17521,0,19351,830,18521,0,20411,1512,18899,0,19947,0,19947
19305,70000,56000,0,0,0,0,0,0,0,20980,2000,18980,0,22320,2000,20320,0,22650,1000,21650,0,23136,1000,22136
19306,150000,120000,0,0,0,0,0,0,-1,6701,6701,0,-1,54574,54579,-5,-1,983,983,0,-1,25580,25580,0
19307,550000,440000,0,0,0,0,0,0,0,209720,7353,202367,0,214030,7534,206496,0,218096,7385,210711,0,210264,7253,203011
19308,180000,144000,0,0,0,0,0,0,0,40611,2600,38011,0,42641,2568,40073,0,45287,3214,42073,0,44577,0,44577
19309,30000,24000,0,1,1,0,0,0,0,27601,1545,26056,0,26921,1300,25621,0,15525,825,14700,0,0,0,0
19310,90000,72000,0,1,1,1,1,0,0,81812,3000,78812,0,76424,3100,73324,0,77086,3000,74086,0,77634,3000,74634
19311,200000,160000,0,0,0,0,0,0,0,38764,10007,28757,0,37618,2019,35599,0,35737,5027,30710,0,40710,15031,25679
19312,50000,40000,0,1,0,0,0,0,0,46505,2938,43567,0,6991,6996,-5,-1,4809,4809,0,-1,1890,1890,0
19313,100000,80000,0,0,0,0,0,0,0,0,0,0,-2,0,0,0,-2,0,0,0,-2,0,0,0
19314,200000,160000,0,0,0,0,0,1,-2,0,0,0,-2,0,0,0,-2,0,0,0,-2,0,0,0
19315,170000,136000,0,1,0,0,0,0,0,164509,6500,158009,0,128279,8000,120279,0,139968,15462,124506,0,127502,2163,125339
19316,180000,144000,0,0,0,0,0,1,-1,0,0,0,-1,0,0,0,-2,0,0,0,-2,0,0,0
19317,90000,72000,0,0,1,1,0,0,0,97541,27000,70541,0,90102,3000,87102,0,78285,2680,75605,0,70224,52930,17294
19318,10000,8000,0,0,1,1,1,1,2,8881,2035,6846,2,8594,0,8594,3,8312,0,8312,2,9241,1069,8172
19319,30000,24000,0,1,1,1,1,1,2,29693,2000,27693,2,30206,1500,28706,2,30309,1044,29265,2,28218,0,28218
19320,360000,288000,0,0,0,0,0,0,0,13739,14598,-859,-1,7995,1017,6978,0,9480,5022,4458,0,9952,5049,4903
19321,230000,184000,0,0,0,0,0,0,0,56484,5000,51484,0,38363,5000,33363,0,4867,4867,0,-1,2736,2736,0
19322,50000,40000,0,1,0,0,0,0,0,49891,1793,48098,0,20503,700,19803,0,20159,731,19428,0,20268,735,19533
19323,240000,192000,0,0,0,0,0,1,2,5411,5784,-373,-1,8513,8548,-35,-1,4626,4630,-4,-1,5329,5334,-5
19324,60000,48000,0,0,0,0,0,0,0,16150,2000,14150,0,17870,2000,15870,0,19571,2000,17571,0,21235,2000,19235
19325,70000,56000,0,1,0,0,0,0,0,70004,2220,67784,0,38102,28931,9171,0,28931,1000,27931,0,29143,1050,28093
19326,110000,88000,0,1,1,0,0,0,0,98236,4416,93820,0,92879,2972,89907,0,75216,2756,72460,0,76778,2839,73939
19327,210000,168000,0,0,0,0,0,0,-2,0,0,0,-2,0,0,0,-2,0,0,0,-2,0,0,0
19328,200000,160000,0,1,1,1,1,1,0,176523,6400,170123,0,180295,6700,173595,0,184104,6907,177197,0,195976,20163,175813
19329,130000,104000,0,0,0,0,0,0,2,0,0,0,2,632,948,-316,-1,316,0,316,0,316,316,0
19330,80000,64000,0,0,0,0,0,0,0,50100,6267,43833,0,0,0,0,0,0,0,0,-2,0,0,0
19331,90000,72000,1,1,1,1,1,0,0,97045,3580,93465,0,102372,13000,89372,0,100794,7000,93794,0,98277,6000,92277
19332,320000,256000,0,0,0,0,0,0,0,128832,15000,113832,0,133329,5000,128329,0,53870,5000,48870,0,13185,3000,10185
19333,500000,400000,0,0,0,0,0,0,0,19323,19623,-300,-1,33146,15000,18146,0,39741,7000,32741,0,53516,14122,39394
19334,200000,160000,0,0,0,0,0,0,-1,0,0,0,-2,0,0,0,-2,0,0,0,-2,1063,1063,0
19335,80000,64000,0,0,0,0,0,0,0,27591,1476,26115,0,28166,1441,26725,0,28330,995,27335,0,28524,1021,27503
19336,180000,144000,0,0,0,0,0,0,-2,3763,3763,0,-2,-3,3,-6,-2,3667,3670,-3,-1,1598,1799,-201
19337,290000,232000,0,0,0,0,0,0,-1,3268,3600,-332,-1,302,800,-498,-1,3586,5228,-1642,-1,2345,2345,0
19338,30000,24000,0,0,1,1,1,1,0,28318,4857,23461,0,28755,1200,27555,2,29442,1300,28142,2,30003,1200,28803
19339,100000,80000,0,0,0,0,0,0,0,20159,20159,0,-1,7053,500,6553,0,0,0,0,0,1120,1120,0
19340,280000,224000,0,0,0,0,0,1,0,75907,3000,72907,0,77723,3000,74723,0,79550,3000,76550,0,81801,3500,78301
19341,360000,288000,0,0,0,0,0,1,-2,3994,3998,-4,-2,0,0,0,-2,0,0,0,-2,7429,7429,0
19342,200000,160000,0,0,0,0,0,0,-2,1261,1261,0,-2,1261,1261,0,-2,1261,1261,0,-2,1256,1256,0
19343,350000,280000,0,0,0,0,0,0,-1,10723,10723,0,-1,1310,1310,0,-1,7796,7796,0,-1,5225,0,5225
19344,70000,56000,0,0,0,0,0,0,0,53099,1900,51199,2,51648,0,51648,2,55409,4600,50809,2,54366,0,54366
19345,140000,112000,0,1,0,0,0,0,0,139900,6120,133780,0,109665,4015,105650,0,108129,4042,104087,0,108067,4057,104010
19346,500000,400000,0,0,0,0,0,0,-1,12866,12930,-64,-2,162415,162434,-19,-1,122430,123042,-612,-1,188547,188715,-168
19347,220000,176000,0,0,0,0,0,1,-1,0,0,0,-1,780,780,0,-1,0,0,0,-1,780,780,0
19348,420000,336000,0,0,0,0,0,0,0,116385,5678,110707,0,106961,3577,103384,0,92331,3023,89308,0,89566,3026,86540
19349,50000,40000,0,0,0,0,0,0,0,16068,2000,14068,0,16387,582,15805,0,16882,754,16128,0,17350,893,16457
19350,100000,80000,0,0,0,0,0,0,0,54905,3000,51905,0,58133,4000,54133,0,60197,3000,57197,2,59226,0,59226
19351,20000,16000,1,1,1,1,1,0,0,25374,2024,23350,0,19075,2000,17075,0,18907,1005,17902,0,18507,1188,17319
19352,50000,40000,0,0,0,0,0,0,0,27589,1770,25819,0,27875,1446,26429,0,28539,1500,27039,0,29202,1500,27702
19353,230000,184000,0,0,0,0,0,1,-2,22925,22993,-68,-2,6120,6167,-47,-2,6519,6519,0,-2,12051,12086,-35
19354,220000,176000,0,1,0,0,0,0,0,194930,0,194930,2,130938,5000,125938,0,134664,6000,128664,0,140238,8000,132238
19355,60000,48000,0,0,0,0,0,1,2,0,0,0,-2,0,0,0,-2,0,0,0,-2,992,992,0
19356,200000,160000,0,0,0,0,0,0,-1,2180,2182,-2,-1,6605,6605,0,-1,970,970,0,-1,0,0,0
19357,240000,192000,0,0,0,0,0,0,-2,973,976,-3,-2,-110,110,-220,-2,-110,0,-110,-2,-110,0,-110
19358,140000,112000,0,0,0,0,0,0,0,100214,3800,96414,0,102496,3800,98696,0,108405,7600,100805,0,106649,0,106649
19359,20000,16000,0,1,1,1,1,0,5,19225,2000,17225,4,18644,0,18644,5,18063,0,18063,4,17491,0,17491
19360,310000,248000,0,0,0,0,0,0,-1,5329,5433,-104,-1,5724,5724,0,-1,1518,1336,182,-1,1336,0,1336
19361,490000,392000,0,1,1,1,1,0,0,477884,20000,457884,0,488808,19000,469808,0,427064,16000,411064,0,436172,16000,420172
19362,90000,72000,0,0,0,0,0,0,-2,0,0,0,-2,0,0,0,-2,0,0,0,-2,0,0,0
19363,30000,24000,0,0,0,0,0,0,2,7576,0,7576,2,5746,144,5602,0,3900,128,3772,0,1944,39,1905
19364,170000,136000,0,0,0,1,1,0,0,-157264,0,-157264,0,166969,332809,-165840,-1,164040,6000,158040,0,166416,6000,160416
19365,50000,40000,0,0,0,0,0,0,-2,580,580,0,-2,-200,0,-200,-2,300,500,-200,-2,0,0,0
19366,20000,16000,0,0,0,0,0,1,2,2400,0,2400,7,2400,0,2400,7,2400,0,2400,7,1800,0,1800
19367,50000,40000,0,1,1,1,1,1,2,50782,1900,48882,2,49335,0,49335,2,50133,1937,48196,0,51071,2224,48847
19368,330000,264000,0,0,0,0,0,1,-1,865,865,0,-1,15387,15500,-113,-1,5945,6000,-55,-1,896,896,0
19369,30000,24000,0,0,0,0,0,1,0,3280,2500,780,0,2890,2500,390,0,15839,15839,0,-1,13680,666,13014
19370,20000,16000,0,0,0,0,0,0,0,13844,0,13844,2,14614,1300,13314,2,14733,500,14233,2,14823,505,14318
19371,80000,64000,0,1,0,0,0,1,3,78715,5,78710,2,26681,1075,25606,0,0,0,0,0,0,0,0
19372,20000,16000,0,0,1,1,1,0,2,16715,1000,15715,2,18327,2200,16127,2,17735,0,17735,2,19446,2000,17446
19373,210000,168000,0,0,0,0,0,0,-2,0,0,0,-2,0,0,0,-2,0,0,0,-2,0,0,0
19374,110000,88000,0,0,0,0,0,0,0,45140,2000,43140,0,46885,2500,44385,0,48129,2000,46129,0,49327,2000,47327
19375,200000,160000,0,0,0,0,0,0,-2,0,0,0,-2,0,0,0,-2,0,0,0,-2,0,0,0
19376,50000,40000,0,1,1,1,0,1,0,50272,1928,48344,0,49293,1595,47698,0,47154,1526,45628,0,50069,13000,37069
19377,400000,320000,0,0,0,0,0,0,-2,-25,0,-25,-2,4895,4920,-25,-2,48976,49221,-245,-2,15319,15395,-76
19378,360000,288000,0,0,0,0,0,1,-2,0,0,0,-2,0,0,0,-2,0,0,0,-2,0,0,0
19379,120000,96000,0,0,0,0,0,1,2,744,444,300,2,744,444,300,2,1188,888,300,2,594,0,594
19380,150000,120000,0,0,0,0,0,0,-1,200,200,0,-1,200,200,0,-1,550,550,0,-1,550,200,350
19381,80000,64000,0,0,0,0,0,0,-1,0,0,0,-2,0,0,0,-2,0,0,0,-2,0,0,0
19382,230000,184000,0,0,0,0,0,0,-1,699,699,0,-1,999,999,0,-1,1149,1149,0,-1,849,849,0
19383,640000,512000,0,0,0,0,0,0,0,71564,4000,67564,0,32968,3000,29968,0,37541,5000,32541,0,42064,5000,37064
19384,100000,80000,0,1,0,0,0,0,0,100098,3919,96179,0,75296,3010,72286,0,73774,3000,70774,0,75603,6000,69603
19385,90000,72000,0,1,0,0,0,0,0,78767,3800,74967,0,74007,2406,71601,0,29480,595,28885,0,27941,570,27371
19386,30000,24000,0,1,0,0,0,0,0,28561,1000,27561,0,-229,1698,-1927,0,23930,24860,-930,-1,26655,3500,23155
19387,280000,224000,0,0,0,0,0,0,0,150666,12005,138661,0,133465,5000,128465,0,133536,8000,125536,0,132964,3000,129964
19388,100000,80000,0,1,0,0,0,1,2,95634,2924,92710,0,65828,5226,60602,0,61621,0,61621,2,62756,2278,60478
19389,50000,40000,0,0,0,0,0,0,0,0,0,0,0,1704,1704,0,-1,3715,2011,1704,0,-105,0,-105
19390,20000,16000,0,0,0,1,1,1,0,16035,1080,14955,0,16517,562,15955,0,16781,500,16281,0,17142,456,16686
19391,140000,112000,0,0,0,0,0,0,-1,1311,1311,0,-1,643,643,0,-1,2561,2561,0,-1,1440,1440,0
19392,170000,136000,0,1,0,0,0,0,0,171158,6316,164842,0,121399,3828,117571,0,118539,3569,114970,0,121276,3959,117317
19393,420000,336000,0,0,0,0,0,0,0,45983,2650,43333,0,41494,1043,40451,0,41065,42000,-935,-1,40666,40666,0
19394,270000,216000,0,0,0,0,0,0,0,39956,5000,34956,0,39827,5000,34827,0,9456,1000,8456,0,386,386,0
19395,20000,16000,0,1,1,0,0,0,0,19929,1369,18560,0,18775,1162,17613,0,13854,524,13330,0,10718,606,10112
19396,130000,104000,0,1,0,0,0,0,0,133400,9000,124400,0,0,0,0,0,0,0,0,-2,0,0,0
19397,50000,40000,0,0,0,0,0,0,0,19596,1300,18296,0,19194,675,18519,0,19201,694,18507,0,19199,704,18495
19398,60000,48000,0,0,0,0,0,0,-1,3496,3496,0,-1,11548,11548,0,-1,14519,3500,11019,0,5861,200,5661
19399,20000,16000,0,1,1,1,1,0,0,20141,1200,18941,2,19888,1300,18588,0,20318,1000,19318,0,20364,1000,19364
19400,50000,40000,0,0,0,0,0,0,0,26614,5000,21614,0,15571,1500,14071,0,14971,800,14171,0,15546,2000,13546
19401,40000,32000,0,0,0,0,0,0,2,400,400,0,-1,25289,25289,0,-1,24435,0,24435,0,2201,0,2201
19402,100000,80000,0,1,0,0,0,0,0,97664,4000,93664,0,70995,2700,68295,0,70183,2500,67683,0,71068,2800,68268
19403,390000,312000,0,0,0,0,0,0,-1,20868,20971,-103,-1,14411,14487,-76,-1,18969,19020,-51,-1,8637,43,8594
19404,130000,104000,0,0,0,0,0,0,0,18932,3000,15932,0,22001,4000,18001,0,3403,0,3403,0,3859,3860,-1
19405,130000,104000,0,0,0,0,0,0,0,47928,0,47928,2,45456,1500,43956,0,42704,0,42704,0,2552,2000,552
19406,390000,312000,0,0,0,0,0,0,0,177722,8000,169722,0,180132,6500,173632,0,184420,7000,177420,0,188329,7200,181129
19407,180000,144000,0,1,1,0,0,0,0,182492,8612,173880,0,180746,7534,173212,0,131166,5506,125660,0,114909,4850,110059
19408,230000,184000,0,0,0,0,0,0,0,11750,5000,6750,0,5194,15897,-10703,-1,15450,12000,3450,0,9368,9368,0
19409,280000,224000,0,1,1,0,0,0,0,268332,10001,258331,0,271904,8585,263319,0,157565,4761,152804,0,150665,5082,145583
19410,180000,144000,0,0,0,0,0,0,0,68877,10000,58877,0,48958,2000,46958,0,45255,1500,43755,0,41870,1500,40370
19411,240000,192000,0,0,0,0,0,0,-1,0,0,0,-1,0,0,0,-2,0,0,0,-2,0,0,0
19412,440000,352000,0,1,1,1,1,1,0,410821,14660,396161,0,403658,14500,389158,0,412248,15089,397159,0,456264,51000,405264
19413,50000,40000,0,0,0,0,0,0,0,13953,1528,12425,0,13924,499,13425,0,14399,700,13699,0,14610,600,14010
19414,150000,120000,0,0,0,0,0,0,0,32139,3000,29139,0,53639,40009,13630,0,51873,5000,46873,0,64675,20000,44675
19415,200000,160000,0,0,0,0,0,1,-1,-241,0,-241,-2,-241,0,-241,-2,-241,0,-241,-2,7817,8058,-241
19416,100000,80000,0,0,0,0,0,0,-2,0,0,0,-2,0,0,0,-2,4323,4323,0,-1,2000,2000,0
19417,100000,80000,0,0,0,0,0,1,2,48385,2000,46385,2,49285,2000,47285,2,50176,2000,48176,2,51228,2000,49228
19418,160000,128000,0,0,0,0,0,1,-2,1000,1000,0,-2,1000,1000,0,-2,12234,12234,0,-1,11960,1200,10760
19419,70000,56000,0,0,0,0,0,1,2,12109,1204,10905,0,12905,1000,11905,0,14683,2000,12683,0,15435,1000,14435
19420,140000,112000,0,0,0,0,0,1,-1,165,165,0,-1,1031,1031,0,-1,487,0,487,0,863,863,0
19421,500000,400000,0,0,0,0,0,0,-1,22963,22963,0,-1,7086,7086,0,-1,5453,0,5453,0,1486,1486,0
19422,50000,40000,0,0,0,0,0,0,0,20952,1392,19560,0,21873,1313,20560,0,22319,759,21560,0,24371,2371,22000
19423,20000,16000,0,0,0,0,0,1,0,390,390,0,-1,18280,18280,0,-1,2880,2880,0,-1,1600,1600,0
19424,50000,40000,0,1,1,1,1,0,2,50035,2160,47875,0,50495,2000,48495,0,52073,4300,47773,0,51120,0,51120
19425,230000,184000,0,0,0,0,0,0,0,7676,2000,5676,0,9877,2500,7377,0,10181,1000,9181,0,12472,2472,10000
19426,230000,184000,0,0,0,0,0,0,0,29127,1500,27627,0,25446,1000,24446,0,26141,1100,25041,0,26852,1300,25552
19427,290000,232000,0,0,0,0,0,0,0,7124,1507,5617,0,8038,2580,5458,0,4029,2050,1979,0,6059,2030,4029
19428,120000,96000,0,0,0,0,0,0,-1,380,380,0,-1,380,380,0,-1,2402,2402,0,-1,696,696,0
19429,400000,320000,0,0,0,0,0,0,-1,3328,3328,0,-1,3828,3828,0,-1,4893,4893,0,-1,4687,4687,0
19430,230000,184000,0,0,0,0,0,0,0,44005,1894,42111,0,35161,1466,33695,0,24985,1018,23967,0,25176,1136,24040
19431,150000,120000,0,0,0,0,0,1,0,12865,5064,7801,0,817,821,-4,-1,1095,1100,-5,-1,1393,1393,0
19432,20000,16000,0,0,0,0,0,1,3,9680,1200,8480,2,9376,0,9376,2,9720,500,9220,0,10962,1400,9562
19433,150000,120000,0,0,0,0,0,0,0,101886,4000,97886,0,101441,4032,97409,0,100829,3410,97419,0,101913,4000,97913
19434,210000,168000,0,0,0,0,0,1,-2,0,0,0,-2,29337,29337,0,-1,30362,1500,28862,0,31356,1500,29856
19435,50000,40000,0,0,0,0,0,1,2,31142,1833,29309,0,29391,1000,28391,0,30099,1000,29099,0,28041,10000,18041
19436,110000,88000,0,1,1,1,1,1,0,108884,4368,104516,0,112149,5500,106649,0,112507,3971,108536,0,114200,6280,107920
19437,290000,232000,0,0,0,0,0,0,-2,798,802,-4,-2,-2,0,-2,-2,494,496,-2,-2,-6,0,-6
19438,200000,160000,0,0,0,0,0,0,-1,396,396,0,-1,396,396,0,-1,396,396,0,-1,396,396,0
19439,200000,160000,0,0,0,0,0,0,0,67627,2485,65142,0,68085,2414,65671,0,69445,2434,67011,0,71242,2863,68379
19440,130000,104000,0,1,1,1,1,1,2,126524,4300,122224,2,127534,4400,123134,2,130524,5000,125524,2,132416,4000,128416
19441,370000,296000,0,0,0,0,0,0,-1,184429,192718,-8289,-1,180508,5000,175508,0,178220,5000,173220,0,72656,3000,69656
19442,60000,48000,0,1,1,1,1,0,0,56706,2000,54706,0,56452,2100,54352,0,58542,3000,55542,0,60273,3210,57063
19443,100000,80000,0,0,0,0,0,0,0,65132,2436,62696,0,48738,3000,45738,0,51020,3000,48020,0,51948,2000,49948
19444,240000,192000,0,0,0,0,0,0,-2,3496,3496,0,-2,4708,4708,0,-2,1522,1522,0,-2,2407,2407,0
19445,110000,88000,0,0,0,0,0,1,0,82627,10090,72537,0,57533,2100,55433,0,59289,3000,56289,0,60828,3000,57828
19446,20000,16000,0,0,0,0,1,0,0,15893,1563,14330,0,16330,1000,15330,0,16517,600,15917,0,16944,700,16244
19447,200000,160000,0,1,1,1,1,0,0,203017,7848,195169,0,203109,8957,194152,0,203494,8000,195494,0,203920,7775,196145
19448,50000,40000,0,0,0,0,0,0,-2,1756,1756,0,-1,2719,1000,1719,0,4049,1537,2512,0,5176,1200,3976
19449,50000,40000,0,1,1,0,0,1,0,50453,2433,48020,2,49037,0,49037,2,28589,1145,27444,0,29392,3167,26225
19450,30000,24000,0,0,0,0,0,1,0,21991,3000,18991,0,22544,2000,20544,0,24061,2000,22061,0,23428,1000,22428
19451,20000,16000,0,0,1,0,0,0,0,9547,1200,8347,0,20766,2000,18766,0,12197,3000,9197,0,12994,1000,11994
19452,120000,96000,0,0,0,0,0,0,-1,2439,2439,0,-1,2439,2439,0,-1,2439,2439,0,-1,2116,2116,0
19453,360000,288000,0,0,0,0,0,1,-2,0,0,0,-2,0,0,0,-2,0,0,0,-2,0,0,0
19454,500000,400000,0,0,0,0,0,0,-2,4074,4074,0,-2,116446,116446,0,-2,9335,9335,0,-2,3312,3312,0
19455,100000,80000,0,0,0,0,0,0,0,13142,2184,10958,0,12280,38500,-26220,-1,938,938,0,-1,796,796,0
19456,60000,48000,0,0,0,0,0,1,0,27046,1500,25546,0,27187,960,26227,0,27372,1000,26372,0,27549,1027,26522
19457,200000,160000,0,0,0,0,0,0,-1,326,326,0,-1,326,326,0,-1,326,326,0,-1,326,326,0
19458,40000,32000,0,1,0,0,0,0,0,36485,2002,34483,0,28152,1603,26549,0,22161,1000,21161,0,19789,2000,17789
19459,150000,120000,0,0,1,1,1,0,0,123914,5000,118914,0,126447,3583,122864,0,128773,3402,125371,0,134930,7226,127704
19460,360000,288000,0,0,0,0,0,1,-2,0,0,0,-2,0,0,0,-2,0,0,0,-2,0,0,0
19461,30000,24000,0,0,0,0,0,0,0,9286,1400,7886,0,9483,500,8983,0,9780,600,9180,0,10068,600,9468
19462,20000,16000,0,0,0,0,0,0,0,6467,1400,5067,0,7500,1300,6200,0,7497,270,7227,0,8170,795,7375
19463,450000,360000,0,0,0,0,0,0,-2,0,0,0,-2,0,0,0,-2,0,0,0,-2,0,0,0
19464,340000,272000,0,0,0,0,0,0,0,231178,7007,224171,0,201471,7865,193606,0,181740,5795,175945,0,140088,5000,135088
19465,320000,256000,0,0,0,0,0,0,0,112151,3137,109014,0,84218,52,84166,0,76058,2384,73674,0,24068,25094,-1026
19466,20000,16000,0,0,0,0,0,1,2,15436,1000,14436,2,16331,1200,15131,0,10229,900,9329,0,10250,700,9550
19467,50000,40000,0,0,0,0,0,1,2,22718,3200,19518,2,22057,0,22057,2,23044,1500,21544,0,24990,2340,22650
19468,60000,48000,0,0,0,0,0,0,0,27517,1760,25757,0,27506,1100,26406,0,28115,1052,27063,0,28815,1200,27615
19469,160000,128000,0,0,0,0,0,0,0,61589,3000,58589,0,58702,2000,56702,0,56853,2000,54853,0,56002,3000,53002
19470,20000,16000,0,0,0,0,0,0,0,12001,2500,9501,0,13978,2500,11478,2,15932,2500,13432,3,17572,2500,15072
19471,360000,288000,0,0,0,0,0,0,0,198245,25045,173200,0,217320,33124,184196,0,2500,5180,-2680,-1,0,0,0
19472,120000,96000,0,0,0,0,0,0,0,36607,4000,32607,0,38828,4017,34811,0,38325,3000,35325,0,39222,3000,36222
19473,360000,288000,0,0,0,0,0,1,-2,-301,0,-301,-2,-301,0,-301,-2,-301,0,-301,-2,-301,0,-301
19474,400000,320000,0,0,0,0,0,0,0,99832,99835,-3,-1,100967,3501,97466,0,101788,3641,98147,0,117818,17823,99995
19475,50000,40000,0,1,1,1,0,0,0,50480,2000,48480,0,50372,2000,48372,0,50993,2500,48493,0,7957,289,7668
19476,210000,168000,0,0,0,0,0,0,0,59594,5000,54594,0,51877,2000,49877,0,44293,2540,41753,0,38215,3000,35215
19477,230000,184000,0,0,0,0,0,1,2,119,1000,-881,-1,699,1000,-301,-1,383,0,383,2,32774,33500,-726
19478,180000,144000,0,0,0,0,0,0,-1,2500,2500,0,-1,0,0,0,-1,0,0,0,-2,3650,3650,0
19479,20000,16000,0,0,0,0,0,1,2,150,0,150,2,150,0,150,2,150,0,150,2,1150,1150,0
19480,50000,40000,0,1,1,1,1,0,0,45821,3805,42016,0,46767,2000,44767,2,45886,0,45886,2,48701,3581,45120
19481,190000,152000,0,1,0,0,0,0,0,192896,8000,184896,0,116537,4100,112437,0,112086,4000,108086,0,108660,5000,103660
19482,360000,288000,0,0,0,0,0,0,-1,26943,26943,0,-1,148307,148307,0,-1,71373,71373,0,-1,7406,7406,0
19483,100000,80000,0,0,0,0,0,0,0,60652,4800,55852,0,58338,2000,56338,0,56849,2000,54849,0,45744,2000,43744
19484,300000,240000,0,0,0,0,0,0,0,17036,1008,16028,0,12863,270,12593,0,9597,206,9391,0,2304,329,1975
19485,410000,328000,0,0,0,0,0,0,-1,13745,13745,0,-1,6033,121,5912,0,8326,8326,0,-1,8926,8926,0
19486,250000,200000,0,0,0,0,0,0,-1,17038,23744,-6706,-1,5169,5169,0,-1,12818,14008,-1190,-1,2328,2328,0
19487,60000,48000,0,0,0,0,0,0,0,27050,2678,24372,0,26317,0,26317,2,28200,2310,25890,2,28762,1173,27589
19488,330000,264000,0,0,0,0,0,0,0,36228,1640,34588,0,37833,3000,34833,0,37694,3000,34694,0,41269,4016,37253
19489,430000,344000,0,0,0,0,0,0,-2,325,325,0,-2,0,0,0,-2,325,325,0,-2,650,650,0
19490,80000,64000,0,0,0,0,0,0,0,50209,2031,48178,0,43323,2013,41310,0,40275,2016,38259,0,38690,2002,36688
19491,80000,64000,0,0,0,0,0,0,0,31106,1511,29595,0,28890,1415,27475,0,28613,1138,27475,0,49036,22000,27036
19492,50000,40000,0,0,0,0,0,0,0,49577,20103,29474,0,18666,667,17999,0,19058,692,18366,0,19450,709,18741
19493,360000,288000,0,0,0,0,0,0,-2,-1917,0,-1917,-2,-1917,0,-1917,-2,-1917,0,-1917,-2,18083,20000,-1917
19494,150000,120000,0,0,0,0,0,0,0,39934,1926,38008,0,8433,0,8433,2,6741,408,6333,0,7586,3000,4586
19495,100000,80000,0,0,0,0,0,0,0,53416,2545,50871,0,32422,1513,30909,0,33177,1268,31909,0,42560,10000,32560
19496,140000,112000,0,1,1,1,1,1,0,144072,7000,137072,0,142381,5300,137081,0,142807,6000,136807,0,141635,5500,136135
19497,170000,136000,1,1,1,1,1,0,0,179868,8000,171868,0,177952,7000,170952,0,176160,7000,169160,0,175304,8000,167304
19498,500000,400000,0,0,0,0,0,0,0,8544,4005,4539,0,15351,8048,7303,0,5839,131,5708,0,9192,9213,-21
19499,30000,24000,0,1,0,1,1,0,2,24453,0,24453,2,24849,1100,23749,0,25399,1100,24299,0,27020,2200,24820
19500,50000,40000,0,0,0,0,0,1,-1,4038,0,4038,2,5275,1500,3775,0,0,0,0,0,0,0,0
19501,390000,312000,0,0,0,0,0,0,2,-1690,1693,-3383,2,4240,6940,-2700,-1,3346,7,3339,2,2698,1230,1468
19502,20000,16000,0,1,0,0,0,0,2,19930,3000,16930,2,780,0,780,2,780,0,780,0,0,0,0
19503,290000,232000,0,0,0,0,0,0,0,218783,8600,210183,0,158215,6700,151515,0,69234,2600,66634,0,71560,3500,68060
19504,120000,96000,0,0,0,0,0,1,0,56542,2500,54042,0,58023,2800,55223,0,17421,1000,16421,0,105771,109000,-3229
19505,30000,24000,0,0,0,0,0,0,0,26168,3000,23168,0,23119,5000,18119,0,23268,3000,20268,0,29327,7000,22327
19506,340000,272000,0,0,0,0,0,0,0,24268,4322,19946,0,3210,3210,0,-1,3240,3240,0,-1,11095,11095,0
19507,150000,120000,0,1,1,1,1,0,0,143488,5200,138288,0,142419,5100,137319,0,145100,5300,139800,0,153229,10900,142329
19508,200000,160000,0,0,0,0,0,0,-1,610,610,0,-1,5130,5130,0,-1,12050,12050,0,-1,4970,4970,0
19509,300000,240000,0,0,0,0,0,0,-1,390,390,0,-1,390,390,0,-1,390,390,0,-1,390,390,0
19510,120000,96000,0,0,0,0,0,0,0,74853,4000,70853,0,78692,6300,72392,0,78456,3000,75456,2,76140,0,76140
19511,50000,40000,1,1,1,1,1,0,2,51051,0,51051,2,50959,2100,48859,0,51121,3500,47621,0,49344,0,49344
19512,150000,120000,0,0,0,0,0,0,0,5051,1093,3958,0,4408,1000,3408,0,1731,1731,0,-1,1960,2169,-209
19513,50000,40000,0,0,0,0,0,0,-1,0,0,0,-2,0,0,0,-2,4400,4400,0,-1,9318,5000,4318
19514,150000,120000,0,1,1,0,0,0,0,147296,3171,144125,0,144927,3699,141228,0,54116,69245,-15129,-1,6072,1030,5042
19515,20000,16000,0,0,0,0,0,1,-1,3551,3551,0,-1,6180,5000,1180,0,0,0,0,0,0,0,0
19516,220000,176000,0,0,0,0,0,1,-2,0,0,0,-2,0,0,0,-2,0,0,0,-2,0,0,0
19517,260000,208000,0,0,0,0,0,0,0,156296,8000,148296,0,156248,5028,151220,0,120518,5000,115518,0,122649,5000,117649
19518,200000,160000,0,0,0,0,0,0,0,439,439,0,-1,2257,2000,257,0,43720,42000,1720,0,43968,1700,42268
19519,200000,160000,0,0,0,0,0,0,0,19153,3007,16146,0,20606,3014,17592,0,21032,2007,19025,0,89162,70012,19150
19520,20000,16000,0,1,1,0,0,1,0,19787,1200,18587,0,19682,394,19288,0,7468,210,7258,0,2312,5546,-3234
19521,100000,80000,0,0,0,0,0,0,-1,64886,64886,0,-1,66202,2353,63849,0,72526,10000,62526,0,74323,3000,71323
19522,290000,232000,0,0,0,0,0,0,0,6282,3814,2468,0,2440,2452,-12,-1,0,0,0,-1,0,0,0
19523,30000,24000,0,0,0,0,0,1,0,11552,1200,10352,0,11933,573,11360,0,12092,500,11592,0,17884,6000,11884
19524,120000,96000,0,0,0,0,0,0,-2,0,0,0,-2,0,0,0,-2,0,0,0,-2,0,0,0
19525,500000,400000,0,0,0,0,0,0,-1,39,39,0,-1,44,44,0,-1,0,0,0,-1,0,0,0
19526,20000,16000,0,0,0,1,0,1,0,15417,1500,13917,0,16944,2000,14944,0,18992,2048,16944,0,15888,0,15888
19527,310000,248000,0,0,0,0,0,0,0,68612,6000,62612,0,73441,6000,67441,0,123966,52000,71966,0,127957,6000,121957
19528,300000,240000,0,0,0,0,0,0,0,91558,4500,87058,0,93741,5000,88741,0,99802,8000,91802,0,97711,0,97711
19529,130000,104000,0,0,0,0,0,1,2,70184,3000,67184,0,8518,2000,6518,0,11296,3000,8296,0,6514,2000,4514
19530,50000,40000,0,0,0,0,0,0,0,0,0,0,-2,0,0,0,-2,0,0,0,-2,0,0,0
19531,500000,400000,0,0,0,0,0,0,0,207026,10000,197026,0,203513,7000,196513,0,202853,7000,195853,0,202404,6799,195605
19532,50000,40000,0,0,0,0,0,1,-1,390,390,0,-1,390,390,0,-1,390,390,0,-1,390,390,0
19533,310000,248000,0,0,0,0,0,0,0,161002,5600,155402,0,139275,5000,134275,0,120762,4500,116262,0,102598,3500,99098
19534,60000,48000,0,1,1,1,1,0,0,51316,2470,48846,0,54046,4200,49846,0,55036,2000,53036,2,53985,0,53985
19535,30000,24000,0,1,1,0,0,0,0,29075,3000,26075,0,26011,1200,24811,0,13900,139,13761,0,0,0,0
19536,100000,80000,0,0,1,0,0,0,0,84401,5000,79401,0,85786,4200,81586,0,65345,3000,62345,0,67205,3000,64205
19537,50000,40000,0,0,0,0,0,1,0,10010,6135,3875,0,9357,308,9049,0,8714,316,8398,0,9733,2000,7733
19538,240000,192000,0,0,0,0,0,0,0,18977,2000,16977,0,12055,300,11755,0,7878,1000,6878,0,5531,2000,3531
19539,80000,64000,0,0,0,0,0,0,0,65470,3017,62453,0,57187,1557,55630,0,29058,1500,27558,0,26790,1000,25790
19540,90000,72000,0,1,0,0,0,0,0,87862,3258,84604,0,18889,1000,17889,0,-783,0,-783,0,73568,77500,-3932
19541,320000,256000,0,0,0,0,0,0,0,33619,9842,23777,0,23553,24709,-1156,-1,9398,6022,3376,-1,4296,4318,-22
19542,370000,296000,0,0,0,0,0,0,-2,10086,10136,-50,-2,804,808,-4,-2,4577,4599,-22,-2,-10,0,-10
19543,30000,24000,0,0,0,0,0,0,0,8185,1300,6885,0,9286,1400,7886,0,9483,500,8983,0,9780,600,9180
19544,90000,72000,0,0,0,0,0,0,0,62000,3188,58812,0,60673,2661,58012,0,22196,1000,21196,0,29809,8000,21809
19545,180000,144000,0,0,0,0,0,0,0,1537,1000,537,0,-43,0,-43,0,-43,0,-43,-2,-43,0,-43
19546,200000,160000,0,0,0,0,0,0,0,162208,8000,154208,0,162357,5800,156557,0,144236,5200,139036,0,127362,5000,122362
19547,180000,144000,0,0,0,0,0,0,-1,4312,4312,0,-1,2490,2490,0,-1,0,0,0,-1,0,0,0
19548,500000,400000,0,0,0,0,0,0,0,116402,15263,101139,0,95244,4672,90572,0,68182,0,68182,0,60153,1296,58857
19549,100000,80000,0,1,1,1,1,0,2,97997,0,97997,2,103384,8000,95384,2,97266,0,97266,2,101492,8600,92892
19550,260000,208000,0,0,0,0,0,0,0,7065,4150,2915,0,0,0,0,0,0,0,0,-2,0,0,0
19551,500000,400000,0,0,0,0,0,0,0,8471,7505,966,0,7234,145,7089,0,5828,33,5795,0,1906,1150,756
19552,420000,336000,0,0,0,0,0,1,0,312224,14000,298224,0,315822,11230,304592,0,275393,10000,265393,0,278745,8091,270654
19553,20000,16000,0,1,1,1,1,0,0,19985,1,19984,3,19702,651,19051,2,18395,0,18395,2,18763,655,18108
19554,120000,96000,0,0,0,0,0,0,0,62511,2347,60164,0,36996,5000,31996,0,30311,3000,27311,0,26414,2000,24414
19555,330000,264000,0,0,0,0,0,0,0,113296,5449,107847,0,35048,5000,30048,0,36491,2000,34491,0,37252,2000,35252
19556,70000,56000,0,0,0,0,0,1,2,46540,2000,44540,2,47378,1900,45478,2,46490,0,46490,2,47758,2200,45558
19557,180000,144000,0,0,0,0,0,0,-1,0,0,0,-2,0,0,0,-2,1030,1030,0,-1,440,0,440
19558,150000,120000,0,0,0,0,0,1,-1,1863,1863,0,-1,390,0,390,0,772,772,0,-1,382,0,382
19559,50000,40000,0,0,0,0,0,0,0,22581,1500,21081,0,20192,700,19492,0,18813,700,18113,0,17328,629,16699
19560,400000,320000,0,0,0,0,0,1,2,31379,3000,28379,2,27969,0,27969,2,9513,1000,8513,2,1346,0,1346
19561,300000,240000,0,0,0,0,0,0,0,19326,10000,9326,0,10662,1940,8722,0,10162,10200,-38,-1,10250,10500,-250
19562,50000,40000,0,0,0,0,0,0,0,13386,1500,11886,0,13663,500,13163,0,14440,1000,13440,0,15150,1000,14150
19563,230000,184000,0,1,1,1,1,1,2,195724,9300,186424,2,198707,7500,191207,2,201634,7500,194134,2,205949,7500,198449
19564,210000,168000,0,0,0,0,0,0,0,75602,3500,72102,0,76062,3300,72762,0,76287,3000,73287,0,76971,3000,73971
19565,20000,16000,0,0,0,1,1,1,0,16183,1574,14609,0,16893,1284,15609,0,18200,1591,16609,0,17769,0,17769
19566,230000,184000,0,0,0,0,0,0,0,116691,5000,111691,0,116220,5000,111220,0,112746,5000,107746,0,108653,5000,103653
19567,270000,216000,0,0,0,0,0,0,-1,6425,6425,0,-1,10116,6000,4116,0,15953,8000,7953,0,19556,6000,13556
19568,110000,88000,0,0,0,0,0,1,0,52113,0,52113,2,53317,2053,51264,0,54040,2500,51540,0,54805,2200,52605
19569,130000,104000,0,0,0,0,0,0,-1,396,0,396,2,792,792,0,-1,396,0,396,0,396,396,0
19570,30000,24000,0,0,0,0,0,0,0,23180,0,23180,2,22000,0,22000,0,22000,0,22000,0,0,0,0
19571,240000,192000,0,0,0,0,0,0,0,116710,10000,106710,0,93057,10000,83057,0,55419,5000,50419,0,59336,5000,54336
19572,60000,48000,0,0,0,0,0,0,0,6466,6466,0,-1,6469,3,6466,0,5364,5,5359,0,3664,10,3654
19573,180000,144000,0,0,0,0,0,0,-1,20726,20789,-63,-1,22111,22169,-58,-1,25560,25560,0,-1,2461,2461,0
19574,80000,64000,0,0,0,0,0,0,-2,0,0,0,-2,0,0,0,-2,0,0,0,-2,0,0,0
19575,360000,288000,0,0,0,0,0,0,-1,-34041,2,-34043,-1,-34503,38,-34541,-2,43013,85155,-42142,-1,11654,58,11596
19576,240000,192000,0,0,0,0,0,0,-1,871,0,871,2,871,0,871,0,-155,155,-310,0,-155,0,-155
19577,210000,168000,0,0,0,0,0,0,0,19689,1362,18327,0,20629,1302,19327,0,21193,866,20327,0,21484,742,20742
19578,300000,240000,0,0,0,0,0,1,-2,850,850,0,-2,850,850,0,-2,850,850,0,-2,3688,4384,-696
19579,50000,40000,0,1,1,1,1,1,2,46468,500,45968,2,47198,1800,45398,2,49634,3528,46106,2,48708,0,48708
19580,60000,48000,1,1,0,0,0,1,0,65508,2188,63320,0,17677,2501,15176,0,19481,2512,16969,0,19205,4005,15200
19581,70000,56000,1,1,1,0,0,1,0,80389,3815,76574,0,75854,3064,72790,0,33563,1000,32563,0,34563,1000,33563
19582,30000,24000,0,1,1,1,1,1,2,31090,4000,27090,2,31247,1000,30247,2,30493,0,30493,2,31148,1100,30048
19583,30000,24000,0,1,1,1,1,0,0,27710,1800,25910,0,27959,1007,26952,0,30002,2500,27502,0,29371,0,29371
19584,60000,48000,0,0,0,0,0,1,0,34312,2000,32312,0,17277,618,16659,0,17808,809,16999,0,19346,2000,17346
19585,230000,184000,1,1,1,0,0,0,0,303082,10978,292104,0,307038,10361,296677,0,116506,2507,113999,0,19085,490,18595
19586,210000,168000,0,0,0,0,0,1,0,51353,2000,49353,0,43485,1600,41885,0,44784,2000,42784,0,45685,1800,43885
19587,310000,248000,0,0,0,0,0,0,-1,21897,11139,10758,0,4316,15347,-11031,-1,771,793,-22,-1,2888,7390,-4502
19588,90000,72000,0,0,0,0,0,1,0,8152,1293,6859,0,9009,1150,7859,0,9359,500,8859,0,9460,400,9060
19589,180000,144000,0,0,0,0,0,0,-1,2331,5028,-2697,-1,3596,6411,-2815,-1,3125,3155,-30,-1,2702,2702,0
19590,50000,40000,1,1,1,1,1,1,2,56075,2500,53575,2,54515,0,54515,2,52250,2000,50250,0,52433,4000,48433
19591,50000,40000,0,0,0,0,0,0,0,0,0,0,-2,0,0,0,-2,0,0,0,-2,0,0,0
19592,500000,400000,0,0,0,0,0,0,-2,28148,4625,23523,-2,24377,24448,-71,-1,15421,2028,13393,0,11239,2009,9230
19593,350000,280000,0,1,1,1,1,1,3,322032,14000,308032,2,327193,12000,315193,2,333278,13000,320278,2,340791,13000,327791
19594,500000,400000,0,0,0,0,0,0,0,124836,10522,114314,0,37334,6133,31201,0,34944,24408,10536,0,24355,122,24233
19595,130000,104000,0,0,0,0,0,0,0,34975,2000,32975,0,35943,1850,34093,0,36447,1400,35047,0,37259,1400,35859
19596,80000,64000,0,0,0,0,0,0,2,40137,0,40137,2,40793,1603,39190,0,42990,3000,39990,0,42854,2000,40854
19597,360000,288000,0,0,0,0,0,0,-2,66458,72200,-5742,-2,0,0,0,-2,0,0,0,-2,0,0,0
19598,200000,160000,0,0,0,0,0,0,0,1513,1513,0,-1,0,0,0,-1,0,0,0,-2,0,0,0
19599,20000,16000,0,0,0,0,0,0,0,12359,1208,11151,0,13730,1579,12151,0,13371,0,13371,2,13491,608,12883
19600,230000,184000,0,0,0,0,0,0,-1,10834,15000,-4166,-1,28540,29000,-460,-1,56660,30000,26660,0,46213,0,46213
19601,100000,80000,0,0,0,0,0,0,0,51235,69370,-18135,-1,67368,20001,47367,0,68141,3000,65141,0,64167,3000,61167
19602,30000,24000,0,0,0,1,1,0,-1,0,0,0,-2,25919,25919,0,-1,26383,1000,25383,2,25691,0,25691
19603,100000,80000,0,0,0,0,0,0,0,24290,2000,22290,0,25080,1500,23580,0,25768,1093,24675,0,27407,2228,25179
19604,340000,272000,0,0,0,0,0,0,0,76022,3819,72203,0,76402,2823,73579,0,75356,2876,72480,0,76237,2853,73384
19605,140000,112000,0,1,0,0,0,0,0,143215,6110,137105,0,61586,5000,56586,0,70626,10014,60612,0,72723,5011,67712
19606,190000,152000,0,0,0,0,0,0,0,115639,5581,110058,0,115849,4237,111612,0,118313,4423,113890,0,119973,5000,114973
19607,20000,16000,0,1,1,1,1,0,0,19932,1405,18527,0,19904,1157,18747,0,19549,802,18747,0,19920,790,19130
19608,220000,176000,0,0,0,0,0,1,-1,200,0,200,2,200,200,0,-1,350,350,0,-1,350,350,0
19609,110000,88000,0,0,0,0,0,0,0,19563,5000,14563,0,21994,3000,18994,0,21994,3000,18994,0,8391,2000,6391
19610,160000,128000,0,0,0,0,0,1,-1,-660,0,-660,-2,-660,0,-660,-2,340,1000,-660,-1,596,596,0
19611,300000,240000,0,0,0,0,0,0,0,94524,3200,91324,0,86637,3500,83137,0,78939,3000,75939,0,70689,3000,67689
19612,220000,176000,0,0,0,0,0,1,-1,792,792,0,-1,396,0,396,0,396,396,0,-1,396,396,0
19613,20000,16000,0,0,0,0,0,1,3,11516,0,11516,2,11436,408,11028,0,12553,1300,11253,0,12501,300,12201
19614,50000,40000,0,0,0,0,0,1,0,15688,1210,14478,0,0,0,0,0,0,0,0,-2,0,0,0
19615,210000,168000,0,0,0,0,0,0,-2,0,0,0,-2,0,0,0,-2,0,0,0,-2,0,0,0
19616,260000,208000,0,0,0,0,0,0,0,18136,0,18136,2,24018,8000,16018,2,21490,0,21490,2,18196,2000,16196
19617,140000,112000,0,0,0,0,0,1,2,72924,2800,70124,2,72335,1200,71135,2,75508,4500,71008,2,77116,3000,74116
19618,360000,288000,0,0,0,0,0,0,0,22581,1000,21581,0,12936,1000,11936,0,7970,3000,4970,0,7970,0,7970
19619,170000,136000,0,0,0,0,0,0,-2,0,0,0,-2,0,0,0,-2,0,0,0,-2,0,0,0
19620,50000,40000,0,0,1,0,0,1,2,43733,5607,38126,2,85652,16,85636,2,29775,1167,28608,0,30243,1051,29192
19621,80000,64000,0,0,0,0,0,0,-2,0,0,0,-2,23374,23374,0,-1,24836,2000,22836,0,26412,2000,24412
19622,240000,192000,0,0,0,0,0,0,-1,390,780,-390,-1,390,390,0,-1,390,390,0,-1,390,390,0
19623,220000,176000,0,0,0,0,0,1,2,81229,450,80779,2,80175,2000,78175,2,79563,300,79263,0,82371,3310,79061
19624,160000,128000,0,0,0,0,0,1,2,70848,3000,67848,2,71739,2600,69139,2,73090,2600,70490,2,74490,2700,71790
19625,200000,160000,0,0,0,0,0,0,-1,392,392,0,-1,423,450,-27,-1,404,400,4,0,415,430,-15
19626,20000,16000,0,1,1,0,0,0,0,18798,1456,17342,0,19347,1005,18342,0,8007,160,7847,0,4890,98,4792
19627,30000,24000,1,1,1,1,1,0,7,33165,0,33165,6,32391,0,32391,5,31332,0,31332,4,30558,0,30558
19628,210000,168000,0,0,0,0,0,1,-2,0,0,0,-2,0,0,0,-2,0,0,0,-2,0,0,0
19629,70000,56000,0,0,0,0,0,0,0,68376,12496,55880,0,30163,3268,26895,0,14310,3000,11310,0,15085,3000,12085
19630,410000,328000,0,0,0,0,0,0,-2,31177,3041,28136,-2,27185,3096,24089,-2,13818,3845,9973,-2,8477,212,8265
19631,150000,120000,0,0,0,0,0,0,0,51547,1745,49802,0,44384,1566,42818,0,36900,1208,35692,0,29497,1077,28420
19632,210000,168000,0,0,0,0,0,0,0,108775,3939,104836,0,107090,3792,103298,0,104037,3657,100380,0,101337,3631,97706
19633,400000,320000,0,0,0,0,0,0,0,109278,3807,105471,0,94511,2403,92108,0,64995,1933,63062,0,28654,1014,27640
19634,500000,400000,0,0,0,0,0,0,-1,18008,18008,0,-1,29158,29248,-90,-1,11484,11484,0,-1,103340,103340,0
19635,130000,104000,0,0,0,0,0,0,0,10348,2753,7595,0,104698,110094,-5396,-1,88251,3002,85249,0,90189,3200,86989
19636,500000,400000,0,0,0,0,0,0,-1,60201,60207,-6,-1,45299,1000,44299,0,40940,838,40102,0,16923,4476,12447
19637,80000,64000,0,1,1,1,1,0,0,72172,3205,68967,0,73674,3300,70374,0,73532,3000,70532,0,75192,3000,72192
19638,20000,16000,0,1,1,1,1,0,0,18048,1600,16448,0,18102,650,17452,0,18491,681,17810,0,19173,1000,18173
19639,100000,80000,0,0,0,0,0,0,0,48799,2200,46599,0,49508,1822,47686,0,50686,2000,48686,0,51815,2100,49715
19640,140000,112000,0,0,0,0,0,0,-2,3930,3930,0,-2,3951,3951,0,-2,0,0,0,-2,12555,12555,0
19641,360000,288000,0,0,0,0,0,0,-1,0,0,0,-1,0,0,0,-2,0,0,0,-2,0,0,0
19642,200000,160000,0,0,0,0,0,0,2,54742,2200,52542,0,54401,1671,52730,0,42923,3000,39923,0,40365,0,40365
19643,130000,104000,0,0,0,0,0,0,-1,5275,4000,1275,0,198,198,0,-1,3992,3992,0,-1,8893,5000,3893
19644,230000,184000,0,0,0,0,0,0,0,136908,6246,130662,0,118358,8836,109522,0,115497,5955,109542,0,118539,8984,109555
19645,20000,16000,0,0,0,0,0,0,0,12542,1838,10704,0,13619,1300,12319,0,14415,1000,13415,0,15281,1074,14207
19646,80000,64000,0,0,0,0,0,1,2,33890,1000,32890,0,2065,2065,0,-1,5215,5215,0,-1,3745,3745,0
19647,300000,240000,0,0,0,0,0,1,2,160242,6000,154242,2,156171,0,156171,2,165556,12000,153556,2,169250,6500,162750
19648,50000,40000,0,0,0,0,0,0,-2,7321,10000,-2679,-1,2850,7867,-5017,-1,6340,6340,0,-1,3110,3000,110
19649,60000,48000,0,0,0,0,0,1,3,33041,0,33041,2,35284,2900,32384,2,31602,0,31602,2,32221,1200,31021
19650,130000,104000,0,0,0,0,0,1,-1,390,390,0,-1,390,390,0,-1,390,390,0,-1,0,0,0
19651,80000,64000,0,0,0,0,0,1,2,5326,1500,3826,2,5092,0,5092,2,6008,1000,5008,2,5618,0,5618
19652,80000,64000,0,1,1,1,1,0,0,70057,2600,67457,0,71886,3000,68886,0,73724,3000,70724,0,75498,3000,72498
19653,360000,288000,0,0,0,0,0,0,-2,0,0,0,-2,0,0,0,-2,0,0,0,-2,0,0,0
19654,250000,200000,0,0,0,0,0,0,0,1404,1000,404,0,5208,5208,0,-1,59006,54000,5006,0,12072,5000,7072
19655,30000,24000,0,0,0,0,0,0,0,20442,1800,18642,0,21592,1801,19791,0,23079,2001,21078,0,24529,2000,22529
19656,280000,224000,0,0,0,0,0,0,0,141996,7300,134696,0,131471,5000,126471,0,134963,6000,128963,0,139471,7000,132471
19657,360000,288000,0,0,0,0,0,0,-1,0,0,0,-2,0,0,0,-2,150,150,0,-2,137,137,0
19658,50000,40000,0,1,1,1,1,0,0,45684,1758,43926,0,46592,1666,44926,0,47568,1725,45843,0,48907,2128,46779
19659,110000,88000,0,0,0,0,0,1,0,8033,0,8033,2,7262,2000,5262,0,9612,5000,4612,0,6747,0,6747
19660,110000,88000,0,1,1,1,1,1,2,110565,4000,106565,0,216850,7000,209850,0,110952,7766,103186,0,109169,3982,105187
19661,400000,320000,0,0,0,0,0,0,-1,47213,20000,27213,0,121013,93000,28013,0,87332,30000,57332,0,106519,20000,86519
19662,20000,16000,0,1,1,1,0,1,0,19953,3200,16753,0,19183,0,19183,2,17703,0,17703,0,12100,1100,11000
19663,20000,16000,0,0,0,0,0,1,0,16432,1286,15146,0,16174,1204,14970,0,16499,529,15970,0,12882,467,12415
19664,320000,256000,0,0,0,0,0,0,-2,218,218,0,-2,0,0,0,-2,2355,2355,0,-2,0,0,0
19665,220000,176000,1,1,1,1,1,0,0,229896,8500,221396,0,226036,8000,218036,0,222487,7900,214587,0,210628,7800,202828
19666,90000,72000,0,0,0,0,0,1,-1,490,490,0,-1,850,850,0,-1,1000,1000,0,-1,1360,1360,0
19667,20000,16000,0,0,0,0,0,1,2,7254,1283,5971,0,8106,1135,6971,0,8418,447,7971,0,8440,306,8134
19668,360000,288000,0,0,0,0,0,0,-2,48179,48426,-247,-2,14702,14775,-73,-2,20444,20559,-115,-2,30833,30954,-121
19669,250000,200000,0,0,0,0,0,0,0,51547,1741,49806,0,48483,1824,46659,0,49553,1942,47611,0,49683,2100,47583
19670,50000,40000,0,1,1,1,0,0,0,51217,1804,49413,0,47919,1664,46255,0,44593,1560,43033,0,38475,1370,37105
19671,250000,200000,0,0,0,0,0,0,0,202346,7000,195346,0,203132,8975,194157,0,201230,7043,194187,0,199820,8000,191820
19672,240000,192000,0,1,0,0,0,0,0,232706,9257,223449,0,187325,8583,178742,0,129889,4292,125597,0,123680,5133,118547
19673,360000,288000,0,0,0,0,0,1,-2,-4,145,-149,-2,585,744,-159,-1,139,139,0,-1,0,0,0
19674,50000,40000,0,0,0,0,0,0,-1,170,170,0,-1,1261,1261,0,-1,390,390,0,-1,390,390,0
19675,230000,184000,0,1,0,0,0,1,2,199659,9264,190395,0,157434,6116,151318,0,160009,6128,153881,0,155825,5765,150060
19676,430000,344000,0,0,0,0,0,0,0,11153,2000,9153,0,11073,1030,10043,0,2853,2350,503,0,3177,2000,1177
19677,380000,304000,0,0,0,0,0,1,-1,0,0,0,-2,46350,46350,0,-1,0,0,0,-1,0,0,0
19678,80000,64000,0,0,0,0,0,0,0,7793,1306,6487,0,7433,512,6921,0,5962,1000,4962,0,4960,0,4960
19679,100000,80000,0,1,1,1,1,0,2,100978,5000,95978,2,96606,0,96606,2,92062,6040,86022,0,90228,4000,86228
19680,360000,288000,0,0,0,0,0,0,-1,175512,175539,-27,-1,74334,1372,72962,0,46985,0,46985,0,50276,50276,0
19681,50000,40000,0,0,0,0,0,1,0,35307,1405,33902,0,23096,1366,21730,0,18970,1000,17970,0,19514,1000,18514
19682,450000,360000,0,0,0,0,0,0,0,49606,10075,39531,0,43803,10000,33803,0,62914,20000,42914,0,81529,20000,61529
19683,30000,24000,0,1,1,0,0,0,0,29826,3000,26826,0,28572,1000,27572,0,9072,500,8572,0,0,0,0
19684,210000,168000,0,0,0,0,0,0,-1,660,660,0,-1,330,0,330,2,660,660,0,-1,330,0,330
19685,210000,168000,0,0,0,0,0,1,-1,396,396,0,-1,396,396,0,-1,396,396,0,-1,396,396,0
19686,180000,144000,0,0,0,0,0,0,0,121342,5000,116342,0,124337,5000,119337,0,127181,5000,122181,0,130147,6000,124147
19687,230000,184000,0,0,0,0,0,0,-2,4791,4791,0,-2,3516,3516,0,-2,7475,7475,0,-2,5352,5352,0
19688,60000,48000,0,0,0,0,0,0,-1,23011,23011,0,-1,9941,9941,0,-1,12688,12688,0,-1,8719,8958,-239
19689,420000,336000,0,0,0,0,0,0,0,85269,90499,-5230,-1,86388,3122,83266,0,87153,2915,84238,0,88957,3000,85957
19690,50000,40000,0,0,0,0,0,1,0,37093,2000,35093,0,32925,1547,31378,0,26640,2388,24252,0,22247,944,21303
19691,50000,40000,0,0,0,0,0,0,0,18537,1296,17241,0,19941,1700,18241,0,19500,2,19498,2,18921,800,18121
19692,90000,72000,0,0,0,0,0,0,-2,0,0,0,-2,0,0,0,-2,0,0,0,-2,0,0,0
19693,10000,8000,0,1,0,0,0,0,0,9669,1145,8524,0,7624,1000,6624,0,8049,1000,7049,0,6857,1000,5857
19694,40000,32000,0,0,0,0,0,0,0,0,0,0,-2,0,0,0,-2,0,0,0,-2,0,0,0
19695,160000,128000,0,0,0,0,0,0,-2,99500,99500,0,-2,-500,0,-500,-2,-500,0,-500,-2,-500,0,-500
19696,200000,160000,0,0,0,0,0,0,-2,-50,0,-50,-2,-50,0,-50,-2,-50,0,-50,-2,-50,0,-50
19697,200000,160000,0,0,0,0,0,0,0,122304,50000,72304,0,116674,6760,109914,0,89694,3486,86208,0,68256,2476,65780
19698,110000,88000,0,1,1,1,1,1,2,113676,5400,108276,2,114223,4000,110223,2,110876,0,110876,2,107710,4000,103710
19699,480000,384000,0,0,0,0,0,1,-1,6070,6083,-13,-1,5924,5924,0,-1,547,547,0,-1,1308,1308,0
19700,110000,88000,0,1,1,1,1,1,0,106805,3875,102930,0,107608,3830,103778,0,108643,4000,104643,0,109689,4000,105689
19701,300000,240000,0,0,0,0,0,0,0,15200,1200,14000,0,18000,3000,15000,0,0,0,0,0,0,0,0
19702,50000,40000,0,0,0,0,0,0,0,23553,1380,22173,2,22876,0,22876,2,23328,832,22496,0,24955,2000,22955
19703,140000,112000,1,1,1,1,1,0,2,143084,0,143084,2,142011,6000,136011,0,136431,5200,131231,0,128118,5000,123118
19704,120000,96000,0,1,1,0,0,0,0,117684,5179,112505,0,117344,2543,114801,0,58800,1176,57624,0,0,0,0
19705,20000,16000,0,0,0,1,1,0,2,14400,2000,12400,0,17000,3000,14000,0,17000,0,17000,0,20000,3000,17000
19706,20000,16000,0,0,1,0,0,0,0,13674,2000,11674,0,27524,2500,25024,0,13490,500,12990,2,15261,2000,13261
19707,110000,88000,0,0,1,0,0,0,0,90877,9563,81314,0,92986,4000,88986,0,49901,1800,48101,0,49649,2000,47649
19708,80000,64000,0,0,0,0,0,0,0,42832,3413,39419,0,23799,2000,21799,0,11723,5000,6723,0,27236,17236,10000
19709,60000,48000,0,0,0,0,0,0,0,25227,2000,23227,0,26039,1500,24539,0,27493,2000,25493,0,26416,1500,24916
19710,550000,440000,0,0,0,0,0,0,0,66328,2577,63751,0,26422,2169,24253,0,21386,1000,20386,0,17674,602,17072
19711,50000,40000,0,0,0,0,0,0,0,8799,5000,3799,0,8033,0,8033,2,8933,1000,7933,0,7995,1000,6995
19712,290000,232000,0,0,0,0,0,1,0,240049,10200,229849,0,107993,4000,103993,0,110691,4534,106157,0,50143,2670,47473
19713,360000,288000,0,0,0,0,0,0,-2,508,508,0,-2,0,0,0,-2,4861,4861,0,-2,2547,2547,0
19714,380000,304000,0,0,0,0,0,0,-2,0,0,0,-2,0,0,0,-2,0,0,0,-2,0,0,0
19715,130000,104000,0,0,0,0,0,0,0,-10,0,-10,-2,-10,0,-10,-2,-10,0,-10,-2,-10,0,-10
19716,280000,224000,0,0,0,0,0,0,-1,8689,8689,0,-1,41652,41652,0,-1,9031,9031,0,-1,14106,14106,0
19717,50000,40000,0,1,1,1,1,0,0,49073,2284,46789,0,47889,2100,45789,0,51139,4200,46939,0,49000,0,49000
19718,60000,48000,0,0,0,1,1,0,0,48337,1805,46532,0,49332,1800,47532,0,50536,2000,48536,0,51694,2000,49694
19719,20000,16000,0,0,0,0,0,0,2,13433,2200,11233,2,13398,480,12918,2,13040,0,13040,2,14518,1702,12816
19720,20000,16000,0,0,0,0,0,0,-1,2480,2480,0,-1,390,0,390,0,880,880,0,-1,1560,1070,490
19721,40000,32000,0,0,0,0,0,1,-1,776,776,0,-1,776,776,0,-1,1552,1552,0,-1,776,0,776
19722,230000,184000,0,0,0,0,0,0,-2,188,188,0,-1,6498,6498,0,-1,44938,40000,4938,0,56015,12000,44015
19723,120000,96000,0,0,0,0,0,1,-2,1471,1471,0,-1,3094,3103,-9,-1,12623,12623,0,-1,10446,0,10446
19724,20000,16000,0,0,0,0,0,0,2,12902,500,12402,2,12398,0,12398,2,13297,1100,12197,2,12934,0,12934
19725,310000,248000,0,0,0,0,0,0,2,400,0,400,2,20334,20334,0,-1,19050,0,19050,2,21573,21573,0
19726,50000,40000,0,0,0,0,0,0,0,8880,2000,6880,0,15088,6700,8388,0,-574,5000,-5574,0,27529,28103,-574
19727,30000,24000,1,1,1,0,0,0,2,30200,0,30200,2,30000,0,30000,0,0,0,0,0,0,0,0
19728,50000,40000,0,1,1,1,1,0,0,50383,3387,46996,0,48987,1637,47350,0,48793,1231,47562,0,48328,3356,44972
19729,200000,160000,0,0,0,0,0,0,2,63518,5000,58518,0,14607,2000,12607,0,16399,2000,14399,0,18026,2000,16026
19730,360000,288000,0,0,0,0,0,1,-1,9118,9118,0,-1,19183,11000,8183,0,36842,30000,6842,0,10621,428,10193
19731,20000,16000,0,0,0,0,0,1,3,10916,0,10916,2,12419,2000,10419,0,13904,2000,11904,0,13538,0,13538
19732,70000,56000,0,0,0,0,0,1,0,49271,0,49271,2,50449,2000,48449,0,51636,2000,49636,0,53666,3000,50666
19733,50000,40000,0,0,0,0,0,0,-1,4377,4377,0,-1,0,0,0,-1,0,0,0,-2,0,0,0
19734,210000,168000,0,0,0,0,0,0,-1,742,742,0,-1,742,742,0,-1,742,742,0,-1,316,316,0
19735,150000,120000,1,1,1,0,0,0,0,197085,6000,191085,0,202517,6000,196517,0,56898,5000,51898,0,58262,2000,56262
19736,60000,48000,0,1,1,1,1,0,-1,61284,4898,56386,-1,58698,0,58698,2,58033,2300,55733,0,57539,2200,55339
19737,40000,32000,0,1,1,1,1,1,0,39477,1200,38277,3,39924,1400,38524,2,39004,0,39004,2,41462,3069,38393
19738,20000,16000,0,0,0,0,0,0,0,17146,2080,15066,0,16319,2000,14319,0,15687,600,15087,0,16948,1500,15448
19739,50000,40000,0,0,0,0,0,0,0,27059,0,27059,2,29505,2900,26605,2,29824,1100,28724,2,29209,0,29209
19740,130000,104000,0,0,0,0,0,0,-1,396,396,0,-1,485,485,0,-1,46773,46684,89,0,47313,1700,45613
19741,120000,96000,0,0,0,0,0,0,0,51333,2000,49333,0,51174,2000,49174,0,44680,2000,42680,0,43760,2000,41760
19742,130000,104000,0,0,1,1,1,0,0,107691,5400,102291,0,108418,4000,104418,0,115638,9000,106638,0,117958,4400,113558
19743,160000,128000,0,1,0,0,0,1,0,153226,5045,148181,0,78511,2280,76231,0,9808,305,9503,0,8358,2000,6358
19744,50000,40000,0,0,0,0,0,1,-1,390,390,0,-1,780,780,0,-1,0,0,0,-1,0,0,0
19745,50000,40000,0,0,0,0,0,0,2,20583,10000,10583,2,19996,400,19596,2,19879,700,19179,0,18065,800,17265
19746,10000,8000,0,0,0,0,0,0,0,7313,1083,6230,0,6469,500,5969,0,6988,1000,5988,0,7489,1000,6489
19747,100000,80000,0,0,0,0,0,0,1,7571,9586,-2015,-1,5386,1014,4372,0,1133,500,633,0,4143,3010,1133
19748,360000,288000,0,0,0,0,0,0,-1,2635,2643,-8,-1,-227,227,-454,-1,-1763,1536,-3299,-2,-4303,12975,-17278
19749,170000,136000,0,0,0,0,0,0,2,0,0,0,2,0,0,0,-2,0,0,0,-2,0,0,0
19750,70000,56000,0,0,0,0,0,0,0,24100,1010,23090,0,0,0,0,0,0,0,0,-2,0,0,0
19751,80000,64000,0,0,0,0,0,0,0,51936,1687,50249,0,30165,1052,29113,0,30145,1076,29069,0,30085,1121,28964
19752,80000,64000,0,0,0,0,0,0,-2,0,0,0,-2,0,0,0,-2,0,0,0,-2,0,0,0
19753,130000,104000,0,0,0,0,0,0,-1,1214,1214,0,-1,1125,1125,0,-1,139,139,0,-1,0,0,0
19754,200000,160000,0,0,0,0,0,0,-2,547,547,0,-2,-2,2,-4,-2,2040,2042,-2,-1,0,0,0
19755,90000,72000,0,0,0,0,0,0,0,2408,1007,1401,0,57167,57113,54,0,57700,2092,55608,0,58817,2400,56417
19756,300000,240000,0,0,0,0,0,0,-1,197,197,0,-1,10767,10770,-3,-1,26117,15350,10767,0,15800,5000,10800
19757,30000,24000,0,0,0,0,0,0,0,14793,1300,13493,0,15566,1000,14566,0,15014,1000,14014,0,15413,800,14613
19758,120000,96000,0,0,0,0,0,1,-2,0,0,0,-2,0,0,0,-2,54683,54683,0,-1,2657,0,2657
19759,500000,400000,0,0,0,0,0,0,-1,12925,76146,-63221,-1,75667,67697,7970,0,67609,67609,0,-1,71946,71946,0
19760,80000,64000,0,0,0,0,0,1,-1,3587,0,3587,2,3332,267,3065,0,3400,68,3332,0,-300,0,-300
19761,150000,120000,0,0,0,0,0,0,0,86108,4031,82077,0,89006,10006,79000,0,89775,3266,86509,0,87725,4040,83685
19762,50000,40000,0,1,0,0,0,0,0,49400,0,49400,2,0,2000,-2000,2,0,0,0,-2,0,0,0
19763,220000,176000,0,0,0,0,0,0,-2,0,0,0,-2,0,0,0,-2,0,0,0,-2,0,0,0
19764,110000,88000,0,0,0,0,0,1,2,600,0,600,2,600,0,600,4,600,0,600,4,300,0,300
19765,210000,168000,0,0,0,0,0,0,-2,0,0,0,-2,6622,6622,0,-1,6506,298,6208,0,6511,1000,5511
19766,390000,312000,0,0,0,0,0,0,-2,1266,1266,0,-1,0,0,0,-1,0,0,0,-2,0,0,0
19767,300000,240000,0,1,1,0,0,0,0,282818,11001,271817,0,289012,12001,277011,0,123239,10001,113238,0,123812,5001,118811
19768,20000,16000,0,1,1,1,1,0,2,18359,2000,16359,0,19000,1400,17600,0,19600,1000,18600,0,19600,0,19600
19769,10000,8000,0,0,0,0,0,0,0,8162,1000,7162,0,6978,186,6792,0,2278,0,2278,0,0,0,0
19770,290000,232000,0,0,0,0,0,0,0,140607,10000,130607,0,131933,5000,126933,0,135606,6000,129606,0,132906,4700,128206
19771,200000,160000,0,0,0,0,0,0,-1,-61,0,-61,-2,-61,0,-61,-2,-61,0,-61,-2,-61,0,-61
19772,50000,40000,0,0,0,0,0,0,0,17494,1604,15890,0,18178,1288,16890,0,18541,651,17890,0,18929,674,18255
19773,10000,8000,0,0,0,0,0,0,4,2440,0,2440,3,2510,500,2010,2,2641,400,2241,2,2222,0,2222
19774,90000,72000,0,0,0,0,0,0,0,59492,2600,56892,0,68365,10000,58365,0,66832,0,66832,2,69248,3500,65748
19775,100000,80000,0,0,0,0,0,0,-1,1709,1709,0,-1,574,574,0,-1,556,556,0,-1,2306,2306,0
19776,170000,136000,0,0,0,0,0,0,-1,632,632,0,-1,416,200,216,0,416,416,0,-1,566,566,0
19777,50000,40000,0,0,0,0,0,0,-1,780,780,0,-1,216,216,0,-1,1080,864,216,-1,540,0,540
19778,50000,40000,0,0,0,0,0,0,0,10695,1297,9398,0,8841,448,8393,0,8140,449,7691,0,8267,419,7848
19779,60000,48000,0,1,0,0,0,0,0,59824,3572,56252,0,47655,2169,45486,0,27298,6000,21298,0,28303,4000,24303
19780,50000,40000,0,0,0,0,0,0,0,29550,1467,28083,0,29894,1201,28693,0,30125,1236,28889,0,30192,1103,29089
19781,280000,224000,0,0,0,0,0,0,-1,12261,12277,-16,-1,12610,12610,0,-1,3160,0,3160,0,9380,9380,0
19782,50000,40000,0,1,0,0,0,1,0,47434,1935,45499,0,20099,675,19424,0,18682,662,18020,0,18538,650,17888
19783,30000,24000,0,0,0,1,0,0,-1,0,0,0,-2,48514,48514,0,-1,49300,986,48314,0,691,691,0
19784,360000,288000,0,0,0,0,0,0,0,96288,6000,90288,0,100251,5000,95251,0,99983,4000,95983,0,122578,80000,42578
19785,50000,40000,0,0,0,0,0,0,-1,686,686,0,-1,527,527,0,-1,312,312,0,-1,442,442,0
19786,160000,128000,0,0,0,0,0,0,-2,390,390,0,-2,4080,4080,0,-2,3390,3390,0,-2,390,390,0
19787,100000,80000,0,0,0,0,0,0,-1,896,900,-4,-1,697,800,-103,-1,-302,0,-302,-1,999,2300,-1301
19788,450000,360000,0,0,0,0,0,1,-1,2218,2300,-82,-1,99,0,99,-1,99,0,99,-1,412,412,0
19789,100000,80000,0,0,0,0,0,0,0,59110,10047,49063,0,70052,20000,50052,0,84659,17000,67659,0,57648,5000,52648
19790,420000,336000,0,0,0,0,0,0,-2,34676,34682,-6,-2,48823,48919,-96,-2,74475,74481,-6,-2,47108,47108,0
19791,190000,152000,0,0,1,1,1,1,2,156765,15000,141765,2,159386,6600,152786,2,161870,6500,155370,2,165725,6500,159225
19792,20000,16000,0,0,0,0,0,1,-1,0,0,0,-1,2616,2616,0,-1,600,600,0,-1,0,780,-780
19793,160000,128000,0,0,0,0,0,0,-1,5117,5124,-7,-1,4730,4730,0,-1,6634,6635,-1,-1,3477,3477,0
19794,20000,16000,0,0,0,0,0,0,-2,-1400,0,-1400,-2,-1000,1000,-2000,-2,-1000,0,-1000,-2,0,1000,-1000
19795,150000,120000,0,0,0,0,0,1,-2,10268,10273,-5,-2,5872,5978,-106,-2,3068,3068,0,-2,2181,2181,0
19796,300000,240000,0,0,0,0,0,0,-1,14458,14458,0,-1,18061,18061,0,-1,8016,8016,0,-1,5768,5768,0
19797,220000,176000,0,0,0,0,0,1,-1,4688,4716,-28,-1,1621,1632,-11,-1,8522,8559,-37,-1,4149,4164,-15
19798,30000,24000,0,0,0,0,0,0,2,22120,1700,20420,2,21471,0,21471,2,21598,782,20816,0,23241,2000,21241
19799,60000,48000,0,0,0,0,0,0,0,18001,1500,16501,0,18048,500,17548,0,12583,700,11883,0,12754,500,12254
19800,200000,160000,0,0,0,0,0,0,-2,0,0,0,-2,0,0,0,-2,0,0,0,-2,0,0,0
19801,500000,400000,0,0,0,0,0,0,0,57052,3000,54052,0,62051,6000,56051,0,70198,10000,60198,0,72924,10000,62924
19802,450000,360000,0,0,0,0,0,0,0,2499,2499,0,-1,2499,2499,0,-1,0,0,0,-1,11071,11071,0
19803,50000,40000,0,0,0,0,0,0,0,34694,1662,33032,0,35503,1471,34032,0,2025,2125,-100,0,0,0,0
19804,130000,104000,0,1,1,1,0,0,2,115173,0,115173,2,108310,4000,104310,0,112083,5000,107083,0,81362,4000,77362
19805,430000,344000,0,0,0,0,0,0,-1,7566,7642,-76,-1,987,990,-3,-1,4870,4889,-19,-1,975,981,-6
19806,50000,40000,0,0,0,0,0,0,0,0,0,0,0,0,0,0,-2,0,0,0,-2,0,0,0
19807,30000,24000,1,1,1,1,0,0,0,38600,1400,37200,0,29400,1188,28212,0,30000,600,29400,0,0,0,0
19808,120000,96000,0,0,0,0,0,0,-1,389,389,0,-1,978,978,0,-1,0,0,0,-1,2358,2358,0
19809,200000,160000,0,0,0,0,0,0,0,110258,4001,106257,0,112451,4025,108426,0,115090,4451,110639,0,117064,4167,112897
19810,30000,24000,0,0,0,0,0,1,-1,5254,5280,-26,-2,15570,15587,-17,-1,10117,325,9792,0,1875,0,1875
19811,140000,112000,0,0,0,0,0,0,-1,330,330,0,-1,69,69,0,-1,-261,0,-261,-1,-591,0,-591
19812,20000,16000,0,0,0,0,0,0,0,13297,2852,10445,0,12418,0,12418,2,12581,500,12081,0,12305,700,11605
19813,500000,400000,0,0,0,0,0,0,-2,157,785,-628,-1,20697,20697,0,-1,23906,3766,20140,0,23906,0,23906
19814,80000,64000,0,0,0,0,0,0,0,1000,1000,0,-1,0,0,0,-1,0,0,0,-2,0,0,0
19815,110000,88000,0,0,0,0,0,1,0,38340,2000,36340,0,39018,1500,37518,0,40122,1500,38622,0,41069,1500,39569
19816,20000,16000,0,1,1,1,1,0,0,19844,3398,16446,2,19162,0,19162,3,18704,0,18704,2,19226,780,18446
19817,280000,224000,0,0,0,0,0,0,-2,5234,5234,0,-2,3316,3316,0,-2,2970,2970,0,-2,3978,3978,0
19818,70000,56000,0,0,0,0,0,0,2,31678,1200,30478,2,32255,1400,30855,2,32890,1300,31590,2,33595,1400,32195
19819,50000,40000,0,1,1,0,0,1,2,50148,1700,48448,2,48910,1500,47410,0,29848,1000,28848,0,26159,1000,25159
19820,190000,152000,0,1,0,0,0,1,0,192221,7171,185050,0,136916,5427,131489,0,99307,4000,95307,0,98753,3518,95235
19821,50000,40000,0,1,1,0,0,1,0,50021,2456,47565,0,49353,3288,46065,0,30439,1230,29209,0,29890,1085,28805
19822,290000,232000,0,1,0,0,0,0,0,275169,10490,264679,0,189354,6620,182734,0,193163,6700,186463,0,197303,7000,190303
19823,310000,248000,0,0,0,0,0,0,-2,1284,1000,284,-2,1088,1000,88,-2,892,1000,-108,-2,-304,304,-608
19824,50000,40000,0,0,0,0,0,0,2,29577,1000,28577,2,29529,1000,28529,0,28276,1000,27276,0,28768,1000,27768
19825,260000,208000,0,0,0,0,0,0,0,192782,10107,182675,0,189886,20000,169886,0,196398,10000,186398,0,194568,10000,184568
19826,290000,232000,0,1,0,0,0,1,2,288543,14000,274543,0,209443,9000,200443,0,132211,5000,127211,0,133946,5000,128946
19827,30000,24000,0,1,1,1,0,1,0,28638,1820,26818,0,28818,1000,27818,0,29439,621,28818,0,17685,354,17331
19828,200000,160000,0,0,0,0,0,0,0,147911,8000,139911,0,57903,5000,52903,0,60117,3000,57117,0,61828,3000,58828
19829,150000,120000,0,1,0,0,0,0,2,146001,6000,140001,0,113907,3937,109970,0,115578,4077,111501,0,111863,4504,107359
19830,30000,24000,0,0,0,0,0,1,2,23473,1300,22173,2,22798,0,22798,2,24420,2000,22420,2,23889,0,23889
19831,150000,120000,0,0,0,0,0,1,-2,1791,1791,0,-2,570,570,0,-2,0,0,0,-2,0,0,0
19832,310000,248000,0,1,0,0,0,0,0,279138,16800,262338,0,252703,11600,241103,0,248895,11000,237895,0,244026,10000,234026
19833,260000,208000,0,0,0,0,0,0,0,43986,10000,33986,0,45879,10390,35489,0,54264,10009,44255,0,59872,10000,49872
19834,50000,40000,0,1,1,1,1,1,0,48310,0,48310,2,50332,3000,47332,0,47492,3000,44492,0,50782,5000,45782
19835,50000,40000,0,0,0,0,0,1,-2,0,0,0,-2,0,0,0,-2,0,0,0,-2,0,0,0
19836,140000,112000,0,0,0,0,0,0,2,110174,5500,104674,0,111079,4900,106179,0,113439,5000,108439,0,114983,4112,110871
19837,360000,288000,0,0,0,0,0,0,-2,-1,0,-1,-2,-1,0,-1,-2,-1,0,-1,-2,-1,0,-1
19838,50000,40000,0,0,0,0,0,0,0,21482,1162,20320,0,18029,2184,15845,0,18705,871,17834,0,18698,500,18198
19839,50000,40000,0,0,0,0,0,0,-1,264,0,264,2,7300,7300,0,-1,0,0,0,-1,0,0,0
19840,180000,144000,0,0,0,0,0,1,0,0,0,0,-2,0,0,0,-2,0,0,0,-2,0,0,0
19841,120000,96000,0,0,0,0,0,0,-1,421,421,0,-1,4502,5000,-498,-1,6013,6013,0,-1,5094,0,5094
19842,400000,320000,0,0,0,0,0,0,0,186081,7000,179081,0,189987,7000,182987,0,193824,7000,186824,0,201699,11000,190699
19843,500000,400000,0,0,0,0,0,0,0,50783,5000,45783,0,53204,5012,48192,0,56946,10000,46946,0,58394,5000,53394
19844,500000,400000,0,0,0,0,0,0,-2,0,0,0,-2,0,0,0,-2,0,0,0,-2,0,0,0
19845,360000,288000,0,0,0,0,0,0,-1,7799,7799,0,-1,8506,8528,-22,-1,0,0,0,-1,4186,4186,0
19846,200000,160000,0,0,0,0,0,0,0,7357,3000,4357,0,9471,3000,6471,0,8538,0,8538,2,7685,1000,6685
19847,230000,184000,0,0,0,0,0,0,0,133281,4845,128436,0,123958,4291,119667,0,124474,4115,120359,0,120570,4274,116296
19848,20000,16000,0,1,1,1,1,1,3,18335,0,18335,2,19530,1500,18030,2,19076,0,19076,2,20444,1700,18744
19849,140000,112000,0,0,0,0,0,0,0,48149,3000,45149,0,50341,3000,47341,0,51897,3000,48897,0,53058,2000,51058
19850,10000,8000,1,1,1,1,1,0,0,10844,0,10844,2,10468,507,9961,0,10101,365,9736,0,9911,404,9507
19851,120000,96000,0,0,0,0,0,0,-1,-155,0,-155,-1,-155,0,-155,-2,745,2530,-1785,-1,542,542,0
19852,50000,40000,0,0,0,0,0,0,0,32563,1400,31163,0,27823,3000,24823,0,29130,3130,26000,0,28309,1062,27247
19853,100000,80000,0,0,0,0,0,0,0,42604,5000,37604,0,44607,3000,41607,2,45576,2000,43576,2,46495,1800,44695
19854,180000,144000,0,0,0,0,0,0,-1,5382,5393,-11,-1,3155,3159,-4,-1,1877,1881,-4,-1,4673,4678,-5
19855,60000,48000,0,0,0,0,0,0,0,23837,1600,22237,0,23078,1000,22078,0,22618,1000,21618,0,23950,2500,21450
19856,360000,288000,0,0,0,0,0,0,0,39017,5000,34017,0,0,0,0,0,6835,6835,0,-1,5562,0,5562
19857,160000,128000,0,0,0,0,0,0,2,0,0,0,-2,0,0,0,-2,0,0,0,-2,0,0,0
19858,30000,24000,0,0,0,0,0,1,2,15410,0,15410,2,17149,2000,15149,0,18362,1500,16862,0,18919,1000,17919
19859,210000,168000,0,0,0,0,0,0,-1,4231,4231,0,-1,4221,4221,0,-1,4221,4221,0,-1,4483,4483,0
19860,20000,16000,0,0,0,1,1,0,0,18781,3000,15781,0,20632,6668,13964,0,20042,468,19574,0,20090,507,19583
19861,290000,232000,0,1,0,0,0,0,0,296084,12447,283637,0,218399,8973,209426,0,200461,6761,193700,0,204637,6983,197654
19862,310000,248000,0,0,0,0,0,0,-1,29935,20146,9789,0,20339,3000,17339,0,12924,512,12412,0,839,839,0
19863,20000,16000,0,0,1,1,1,0,-1,18884,14000,4884,0,18059,137,17922,0,18163,500,17663,0,16990,0,16990
19864,370000,296000,0,1,0,1,0,1,3,365461,0,365461,2,304436,10019,294417,0,311426,11000,300426,0,275628,10000,265628
19865,360000,288000,0,0,0,0,0,0,-1,0,0,0,-2,0,0,0,-2,0,0,0,-2,0,0,0
19866,50000,40000,0,0,0,0,0,0,0,29341,1393,27948,0,29928,980,28948,0,29533,994,28539,0,28538,1024,27514
19867,70000,56000,0,0,0,0,0,0,0,20685,1500,19185,0,22142,1800,20342,0,23340,1700,21640,2,22817,0,22817
19868,290000,232000,0,0,0,0,0,0,0,103299,3500,99799,0,104583,3500,101083,0,106447,4000,102447,0,104045,4000,100045
19869,80000,64000,0,0,0,0,0,0,-2,2676,22670,-19994,-2,-4,0,-4,-2,-4,0,-4,-2,-4,0,-4
19870,30000,24000,0,1,1,1,1,0,0,26829,1600,25229,0,26839,1000,25839,0,27449,1000,26449,0,25125,1000,24125
19871,90000,72000,0,0,0,0,0,0,0,23539,3539,20000,0,28986,9000,19986,0,27079,650,26429,0,21966,584,21382
19872,20000,16000,1,1,1,1,1,0,3,22922,1500,21422,2,22140,18,22122,2,19170,2383,16787,0,17170,0,17170
19873,330000,264000,0,0,0,0,0,0,0,32912,10000,22912,0,36710,5000,31710,0,40442,5000,35442,0,42283,5000,37283
19874,140000,112000,0,0,0,0,0,0,2,47722,0,47722,2,50411,3800,46611,2,49473,0,49473,2,50649,2000,48649
19875,50000,40000,0,0,0,0,0,0,2,0,0,0,2,0,0,0,-2,0,0,0,-2,0,0,0
19876,310000,248000,0,1,1,1,1,1,2,264482,0,264482,2,280240,20000,260240,2,285805,10000,275805,2,272059,0,272059
19877,20000,16000,0,0,0,1,1,0,0,16153,1500,14653,0,18175,2300,15875,0,19876,2000,17876,0,19419,0,19419
19878,180000,144000,0,0,0,0,0,1,0,0,0,0,0,0,0,0,-2,0,0,0,-2,0,0,0
19879,70000,56000,0,0,0,0,0,0,0,36620,1626,34994,0,32163,1760,30403,0,29620,841,28779,0,23384,1000,22384
19880,390000,312000,0,0,0,0,0,1,0,95039,3950,91089,0,85806,2627,83179,0,76981,2044,74937,0,69641,2344,67297
19881,240000,192000,0,0,0,0,0,0,-1,3001,3001,0,-1,6861,6866,-5,-1,4681,4681,0,-1,2729,2729,0
19882,230000,184000,0,1,0,0,0,0,0,214585,10000,204585,0,170063,10000,160063,0,176893,10000,166893,0,183699,10000,173699
19883,240000,192000,0,1,0,0,1,1,0,227281,8800,218481,0,195027,7000,188027,0,199186,7200,191986,0,203475,7500,195975
19884,50000,40000,1,1,1,1,1,1,0,77330,2671,74659,0,70579,2396,68183,0,63751,2177,61574,0,56977,2146,54831
19885,500000,400000,0,0,0,0,0,0,0,359940,15773,344167,0,345238,10393,334845,0,274743,10580,264163,0,250930,120081,130849
19886,50000,40000,0,0,0,0,0,1,0,33311,1800,31511,0,18033,3000,15033,0,18740,1000,17740,0,19408,1000,18408
19887,350000,280000,0,0,0,0,0,0,0,280478,200000,80478,0,143142,0,143142,0,160442,135000,25442,0,98479,0,98479
19888,200000,160000,0,0,0,0,0,0,0,80592,3000,77592,0,86216,7000,79216,0,88071,3400,84671,0,90842,4400,86442
19889,130000,104000,0,0,0,0,0,1,0,9883,1164,8719,0,10079,360,9719,0,10289,372,9917,0,10495,376,10119
19890,60000,48000,0,0,0,0,0,0,2,28736,8000,20736,0,42733,15000,27733,0,46404,9000,37404,0,37993,10000,27993
19891,80000,64000,0,1,0,0,0,0,0,77025,4000,73025,0,66725,2784,63941,0,21604,1882,19722,0,9352,1000,8352
19892,200000,160000,0,0,0,0,0,0,-1,0,0,0,-2,2989,2989,0,-1,9059,9059,0,-1,52248,52546,-298
19893,500000,400000,0,0,0,0,0,0,0,96888,3417,93471,0,16476,3000,13476,0,12534,1276,11258,0,394163,388071,6092
19894,20000,16000,0,0,1,1,1,0,0,20498,4500,15998,0,19509,0,19509,2,20038,1600,18438,2,18982,0,18982
19895,50000,40000,0,0,0,0,0,0,0,8234,1200,7034,0,8595,500,8095,0,8955,500,8455,0,9305,500,8805
19896,50000,40000,0,0,0,0,0,0,0,11204,1192,10012,0,12214,1202,11012,0,12458,446,12012,0,12719,462,12257
19897,360000,288000,0,0,0,0,0,0,-2,0,0,0,-2,0,0,0,-2,0,0,0,-2,0,0,0
19898,20000,16000,0,0,0,1,1,1,0,16176,1300,14876,0,18204,2300,15904,0,17614,0,17614,2,18826,1500,17326
19899,200000,160000,0,0,0,0,0,1,-1,0,0,0,-1,148,148,0,-1,148,0,148,0,198,198,0
19900,200000,160000,0,0,0,0,0,0,0,91499,3000,88499,0,93317,3000,90317,0,96110,4000,92110,0,98906,4000,94906
19901,500000,400000,0,0,0,0,0,0,2,11000,2000,9000,0,13000,2000,11000,0,0,0,0,0,0,0,0
19902,120000,96000,0,0,0,0,0,1,2,91057,4100,86957,2,91981,3300,88681,2,89605,0,89605,2,95245,7100,88145
19903,50000,40000,0,0,0,0,0,0,-1,1134,1134,0,-1,3067,3067,0,-1,5496,5496,0,-1,1194,1194,0
19904,130000,104000,0,0,0,0,0,0,0,37927,1950,35977,0,38993,2000,36993,0,39628,1580,38048,0,42136,3310,38826
19905,200000,160000,0,0,0,0,0,0,-1,200,200,0,-1,959,959,0,-1,759,0,759,0,1317,931,386
19906,100000,80000,0,0,0,0,0,0,-2,0,0,0,-2,0,0,0,-2,79679,79679,0,-1,79691,3300,76391
19907,50000,40000,0,0,0,0,0,0,-2,0,0,0,-2,0,0,0,-2,0,0,0,-2,0,0,0
19908,200000,160000,0,0,0,0,0,0,-2,3538,3555,-17,-2,17091,17175,-84,-2,2413,2435,-22,-2,1301,1307,-6
19909,50000,40000,1,1,0,0,0,0,2,50024,0,50024,2,29381,800,28581,0,28957,808,28149,0,28435,1200,27235
19910,140000,112000,0,0,0,0,0,1,-2,1824,3000,-1176,-1,1508,0,1508,0,300,0,300,0,-206,0,-206
19911,280000,224000,0,0,0,0,0,0,-1,13454,13488,-34,-1,5549,5572,-23,0,1260,1263,-3,-1,26271,26398,-127
19912,180000,144000,0,0,0,0,0,1,-2,98458,4207,94251,-2,89384,3500,85884,-2,88315,4000,84315,-2,84320,5000,79320
19913,30000,24000,0,1,1,1,1,0,4,29367,0,29367,4,28605,0,28605,3,27855,0,27855,2,29649,2400,27249
19914,200000,160000,0,0,0,0,0,0,0,65728,3042,62686,0,64490,2100,62390,0,53186,2008,51178,0,52136,2508,49628
19915,110000,88000,0,1,0,0,0,0,0,108831,5000,103831,0,79455,3043,76412,0,54971,2000,52971,0,57257,3000,54257
19916,180000,144000,0,0,0,0,1,1,0,51686,7000,44686,0,2594,0,2594,2,171716,171716,0,-1,181693,13400,168293
19917,180000,144000,0,0,0,0,0,0,-1,30418,30418,0,-1,31370,31370,0,-1,13496,13496,0,-1,23943,12000,11943
19918,150000,120000,0,0,0,0,0,0,-1,3087,3087,0,-1,2887,2887,0,-1,2887,2887,0,-1,2887,2887,0
19919,50000,40000,0,0,0,0,0,0,0,2865,1056,1809,0,3878,1069,2809,0,4809,1000,3809,0,5726,1000,4726
19920,720000,576000,0,0,0,0,0,0,0,105582,8043,97539,0,104501,10092,94409,0,83504,3020,80484,0,79411,2591,76820
19921,140000,112000,0,0,0,0,0,1,2,450,0,450,2,450,0,450,3,1450,1000,450,3,1150,0,1150
19922,80000,64000,0,0,0,0,0,0,-2,0,0,0,-2,16638,16638,0,-1,18367,2000,16367,0,33081,15081,18000
19923,50000,40000,0,0,0,0,0,0,0,34941,1700,33241,0,34243,1502,32741,0,28014,1000,27014,0,28528,1200,27328
19924,170000,136000,0,0,0,0,0,0,-1,2446,2446,0,-1,720,720,0,-1,236,236,0,-1,210,210,0
19925,50000,40000,0,0,0,0,0,1,2,32700,3304,29396,2,28768,4,28764,2,29639,2230,27409,2,28629,0,28629
19926,90000,72000,0,0,0,0,0,1,2,16846,0,16846,2,20559,4000,16559,2,19933,0,19933,2,21454,2000,19454
19927,420000,336000,0,0,0,0,0,0,0,134188,10000,124188,0,121983,10000,111983,0,111256,11256,100000,0,103481,13841,89640
19928,100000,80000,0,0,0,0,0,0,0,74239,2515,71724,0,75704,2516,73188,0,55704,4022,51682,0,56810,2032,54778
19929,200000,160000,0,0,0,0,0,0,-1,10190,10190,0,-1,10190,10190,0,-1,10594,10594,0,-1,11193,11193,0
19930,360000,288000,0,0,0,0,0,0,-1,1090,1096,-6,-1,780,780,0,-1,390,0,390,0,388,388,0
19931,30000,24000,0,0,0,0,1,1,0,13375,1210,12165,0,2592,1000,1592,0,30094,30000,94,0,29147,1046,28101
19932,20000,16000,0,0,0,0,0,0,0,7215,1060,6155,0,1520,30,1490,0,0,0,0,0,0,0,0
19933,10000,8000,0,0,0,0,0,0,2,2735,2735,0,-1,4564,4564,0,-1,0,0,0,-1,0,0,0
19934,50000,40000,0,0,0,0,0,0,0,30580,1600,28980,0,15365,1000,14365,0,15587,1000,14587,0,15940,1000,14940
19935,30000,24000,0,0,0,0,0,0,0,6214,2259,3955,0,3311,0,3311,2,4430,1500,2930,0,906,425,481
19936,200000,160000,0,0,0,0,0,0,-1,10,15,-5,0,1010,1000,10,0,2230,2000,230,-1,1191,1191,0
19937,420000,336000,0,0,0,0,0,0,0,24524,10026,14498,0,21318,1606,19712,0,21496,2006,19490,0,19704,707,18997
19938,230000,184000,0,0,0,0,0,0,-1,8888,8888,0,-1,4932,4932,0,-1,10986,10986,0,-1,5081,5081,0
19939,50000,40000,0,1,0,0,0,0,0,49381,2000,47381,0,9999,324,9675,0,8793,1000,7793,0,9138,1000,8138
19940,110000,88000,0,0,0,0,0,0,-2,0,0,0,-2,0,0,0,-2,0,0,0,-2,0,0,0
19941,30000,24000,0,0,0,0,0,0,0,27835,5000,22835,0,24743,1000,23743,0,28020,20000,8020,0,25607,3000,22607
19942,240000,192000,0,0,0,0,0,1,-2,0,0,0,-2,0,0,0,-2,0,0,0,-2,0,0,0
19943,230000,184000,0,0,0,0,0,1,-1,0,0,0,-1,780,780,0,-1,0,0,0,-1,0,0,0
19944,20000,16000,0,0,0,0,0,1,2,5685,1095,4590,0,6490,900,5590,0,6837,596,6241,2,6435,0,6435
19945,60000,48000,0,0,0,1,1,0,-2,4028,4028,0,-1,59334,56626,2708,0,54526,2100,52426,0,58575,5000,53575
19946,230000,184000,0,0,0,0,0,0,-1,59835,2300,57535,0,60963,2200,58763,0,59337,2200,57137,0,71089,25000,46089
19947,270000,216000,0,0,0,0,0,0,0,12273,2273,10000,0,12014,2014,10000,0,10597,597,10000,0,31182,31182,0
19948,300000,240000,0,0,0,0,0,0,0,7198,7217,-19,0,6975,7023,-48,-1,9356,9383,-27,-1,3697,3714,-17
19949,150000,120000,0,0,0,0,0,0,-1,360,360,0,-1,16133,16133,0,-1,22309,7000,15309,0,22377,796,21581
19950,20000,16000,0,0,0,1,1,1,-1,724,724,0,-1,18589,18589,0,-1,18985,1000,17985,0,19531,1000,18531
19951,110000,88000,0,0,0,0,0,0,0,82828,3300,79528,0,47978,1700,46278,0,47276,1900,45376,0,48109,1770,46339
19952,60000,48000,0,0,0,0,0,1,-1,0,0,0,-1,0,0,0,-2,0,0,0,-2,0,0,0
19953,200000,160000,0,0,0,0,0,0,-2,348,348,0,-2,359,359,0,-2,672,672,0,-2,1620,1620,0
19954,50000,40000,0,0,0,0,0,0,0,33757,5008,28749,0,23332,3013,20319,0,23782,5035,18747,0,16816,5001,11815
19955,20000,16000,0,0,0,1,1,1,0,14740,0,14740,3,18188,4000,14188,2,17630,0,17630,5,16780,0,16780
19956,310000,248000,0,0,0,0,0,0,-2,5781,1000,4781,-2,7754,4000,3754,-2,12315,5000,7315,-2,14099,5000,9099
19957,250000,200000,0,0,0,0,0,0,-1,45964,46224,-260,-1,6496,6496,0,-1,11108,11108,0,-1,3321,3321,0
19958,180000,144000,0,0,0,0,0,1,0,28958,1526,27432,0,29864,1432,28432,0,30632,1200,29432,0,31274,1072,30202
19959,50000,40000,0,1,0,0,0,0,2,50733,2504,48229,0,30363,1200,29163,0,30444,1500,28944,0,30482,1100,29382
19960,300000,240000,0,0,0,0,0,0,-1,3050,3331,-281,-1,1760,1760,0,-1,0,0,0,-1,0,0,0
19961,200000,160000,0,0,0,0,0,0,-2,5738,5738,0,-2,0,1626,-1626,-2,2244,2244,0,-2,66000,66000,0
19962,110000,88000,0,0,0,0,0,0,0,37745,2000,35745,0,34519,2000,32519,0,29541,2000,27541,0,42400,16468,25932
19963,50000,40000,0,0,0,0,0,1,0,27762,1243,26519,0,19238,3991,15247,0,15585,712,14873,0,15892,715,15177
19964,150000,120000,0,0,0,0,0,0,-1,12870,12884,-14,-1,11173,251,10922,0,1719,39,1680,0,413,414,-1
19965,50000,40000,0,1,1,1,1,0,2,46320,1700,44620,2,45290,0,45290,2,48322,3760,44562,2,49094,1700,47394
19966,100000,80000,0,0,0,0,0,1,0,61574,7500,54074,0,62470,2500,59970,3,61198,0,61198,3,62524,2500,60024
19967,120000,96000,0,0,0,0,0,0,-1,0,0,0,-1,680,680,0,-1,0,0,0,-1,0,0,0
19968,230000,184000,0,1,1,0,0,0,0,216287,8502,207785,0,215927,8350,207577,0,174259,6200,168059,0,174486,6500,167986
19969,70000,56000,0,0,0,0,0,1,0,43514,0,43514,2,44489,2000,42489,0,45617,2000,43617,0,46702,2000,44702
19970,360000,288000,0,0,0,0,0,0,-2,15390,10048,5342,-2,7090,35,7055,-2,2115,2126,-11,-2,20075,21220,-1145
19971,80000,64000,0,0,0,0,0,0,-2,0,0,0,-2,0,0,0,-2,0,0,0,-2,0,0,0
19972,150000,120000,0,0,0,0,0,0,0,106500,4648,101852,0,104670,2000,102670,0,55442,2889,52553,0,55936,2700,53236
19973,20000,16000,0,0,0,0,0,1,-2,0,0,0,-2,0,0,0,-2,0,0,0,-2,0,0,0
19974,150000,120000,0,0,0,0,0,1,-2,6731,6731,0,-2,0,0,0,-2,1800,1800,0,-2,0,0,0
19975,130000,104000,0,0,0,0,0,0,-2,7569,22271,-14702,-2,8130,8526,-396,-2,544,544,0,-2,148,148,0
19976,210000,168000,0,0,0,0,0,0,0,53107,4000,49107,0,53717,2350,51367,0,53255,2000,51255,0,55160,3000,52160
19977,270000,216000,0,0,0,0,0,1,2,63082,0,63082,2,73568,20000,53568,0,77642,5000,72642,0,73452,10000,63452
19978,30000,24000,0,1,1,1,1,0,0,25499,0,25499,2,25778,1000,24778,0,28708,3352,25356,0,30520,2300,28220
19979,360000,288000,0,0,0,0,0,0,-2,3118,3133,-15,-2,0,0,0,-2,162,162,0,-2,4857,4881,-24
19980,140000,112000,0,0,0,0,0,1,-1,4739,0,4739,2,4739,0,4739,0,0,0,0,0,0,0,0
19981,150000,120000,0,0,0,0,0,0,-2,12029,12040,-11,-2,13821,13821,0,-1,1493,1493,0,-1,2229,2229,0
19982,150000,120000,0,0,0,0,0,0,-1,117140,117146,-6,-1,89524,1793,87731,0,36772,959,35813,0,16157,343,15814
19983,130000,104000,0,0,0,0,0,0,0,37528,37559,-31,-1,2793,2805,-12,-1,28865,28865,0,-1,14986,300,14686
19984,110000,88000,0,1,0,0,0,1,0,108207,4380,103827,0,75808,3000,72808,0,78490,5000,73490,0,81238,10000,71238
19985,80000,64000,0,0,0,0,0,1,2,22231,2500,19731,2,21576,0,21576,2,23229,2000,21229,2,22708,0,22708
19986,200000,160000,0,0,0,0,0,0,0,156489,5382,151107,0,152357,5279,147078,0,150829,5389,145440,0,149851,7026,142825
19987,510000,408000,0,0,0,0,0,0,-1,200,200,0,-1,22397,22397,0,-1,28782,18000,10782,0,18617,1000,17617
19988,80000,64000,0,0,0,0,0,1,2,50372,2000,48372,2,51246,2000,49246,2,52279,2000,50279,2,53069,1800,51269
19989,350000,280000,0,0,0,0,0,0,-2,5170,6033,-863,-1,-1496,1500,-2996,-1,-2366,4,-2370,-2,-2366,0,-2366
19990,180000,144000,0,0,0,0,0,0,-1,4390,4390,0,-1,1016,1016,0,-1,4745,4745,0,-1,0,0,0
19991,50000,40000,0,1,0,0,0,0,0,46338,3105,43233,0,14234,3119,11115,0,19545,11000,8545,0,20173,909,19264
19992,240000,192000,0,0,0,0,0,0,-1,10690,11728,-1038,-1,4772,7738,-2966,-1,1294,1297,-3,-1,2147,2153,-6
19993,230000,184000,0,0,0,0,0,0,0,177733,6418,171315,0,182106,8000,174106,0,183965,7000,176965,0,186979,6618,180361
19994,120000,96000,0,0,0,0,0,1,0,16743,1551,15192,0,17185,2000,15185,0,18281,1500,16781,0,17312,457,16855
19995,30000,24000,0,1,1,0,0,0,2,29214,0,29214,2,29478,910,28568,0,23384,1000,22384,0,22428,1000,21428
19996,500000,400000,0,0,0,0,0,0,0,96781,5000,91781,0,98274,4000,94274,0,100528,4000,96528,0,102748,4091,98657
19997,130000,104000,0,0,0,0,0,0,-1,7671,7671,0,-1,12088,5000,7088,0,74088,65000,9088,0,63593,3000,60593
19998,380000,304000,0,0,0,0,0,0,-1,0,0,0,-2,12500,12500,0,-1,37811,25311,12500,0,1500,1500,0
19999,300000,240000,0,0,0,0,0,0,0,110751,4500,106251,0,99222,3500,95722,0,83859,3000,80859,0,72220,3000,69220
20000,140000,112000,0,0,0,0,0,0,0,82163,2900,79263,0,83238,2950,80288,0,85383,4000,81383,0,86615,3576,83039
20001,80000,64000,0,0,0,0,0,0,0,59863,2200,57663,0,62860,4000,58860,0,63976,1777,62199,2,63293,0,63293
20002,80000,64000,0,0,0,0,0,0,0,23346,1482,21864,0,18361,1011,17350,0,10434,8,10426,0,7387,111,7276
20003,50000,40000,0,1,1,0,0,0,0,47500,2045,45455,0,47921,1466,46455,0,17125,600,16525,0,16686,604,16082
20004,30000,24000,0,0,0,0,1,1,2,23057,1082,21975,2,24506,2131,22375,2,24711,900,23811,3,24178,0,24178
20005,250000,200000,0,1,0,0,0,0,0,214629,9700,204929,0,204093,8960,195133,0,150752,5630,145122,0,150863,5777,145086
20006,50000,40000,0,0,0,0,0,1,0,16366,0,16366,2,17380,1289,16091,0,17876,785,17091,0,18097,657,17440
20007,160000,128000,0,0,0,0,0,1,0,2623,2473,150,0,2457,0,2457,2,4912,2500,2412,2,3669,0,3669
20008,30000,24000,0,1,1,1,0,0,0,28883,1655,27228,0,29411,1513,27898,0,24602,499,24103,0,22760,688,22072
20009,150000,120000,0,0,0,0,0,0,0,77002,2381,74621,0,45340,1579,43761,0,36352,1265,35087,0,36499,1584,34915
20010,330000,264000,0,0,0,0,0,0,0,17413,1200,16213,0,17769,510,17259,0,18138,524,17614,0,13788,668,13120
20011,320000,256000,0,0,0,0,0,0,0,165530,10000,155530,0,161152,10000,151152,0,158468,10000,148468,0,145399,20000,125399
20012,10000,8000,0,0,0,0,0,0,0,1352,676,676,-1,13352,6000,7352,0,0,120,-120,0,0,0,0
20013,120000,96000,0,0,0,0,0,1,-1,360,360,0,-1,150,150,0,-1,870,870,0,-1,510,510,0
20014,20000,16000,0,0,0,0,0,0,-1,18286,19352,-1066,-1,-200,0,-200,-1,0,200,-200,-2,18486,18486,0
20015,10000,8000,0,0,0,0,0,0,-1,7264,5000,2264,0,9084,5019,4065,0,4422,1009,3413,0,1735,1000,735
20016,500000,400000,0,0,0,0,0,1,-1,3719,3723,-4,-1,-200,1319,-1519,-1,-200,0,-200,-2,-200,0,-200
20017,160000,128000,0,0,0,0,0,0,-1,1058,1058,0,-1,2146,2146,0,-1,2534,2534,0,-1,2242,2242,0
20018,390000,312000,0,0,0,0,0,1,-2,0,0,0,-2,0,0,0,-2,0,0,0,-2,8668,8668,0
20019,20000,16000,0,1,1,1,1,0,0,18342,2200,16142,2,17755,0,17755,3,17967,800,17167,2,17538,0,17538
20020,50000,40000,0,1,0,0,0,0,2,42652,2176,40476,0,9965,334,9631,0,9720,336,9384,0,9951,375,9576
20021,210000,168000,0,1,0,0,0,0,0,181870,6601,175269,0,159975,5085,154890,0,138349,4087,134262,0,112371,4220,108151
20022,50000,40000,0,0,0,0,0,0,0,-144,0,-144,-2,-144,0,-144,-2,-144,144,-288,-2,6,150,-144
20023,400000,320000,0,0,0,0,0,0,0,0,0,0,0,0,0,0,-2,0,0,0,-2,91057,91057,0
20024,50000,40000,0,0,0,0,0,0,0,0,402,-402,0,0,0,0,-2,0,0,0,-2,402,402,0
20025,130000,104000,0,0,0,0,0,0,-1,15383,10007,5376,0,9189,184,9005,0,8499,170,8329,0,1738,1738,0
20026,480000,384000,0,0,0,0,0,0,-2,7169,7169,0,-2,6749,6749,0,-2,2436,2436,0,-2,14155,14155,0
20027,60000,48000,0,1,1,1,1,0,0,59624,2530,57094,0,58124,1865,56259,0,58852,1445,57407,0,58872,293,58579
20028,120000,96000,0,0,0,0,0,0,0,96298,4400,91898,0,90570,4040,86530,0,89442,3100,86342,0,92756,6600,86156
20029,50000,40000,0,0,0,0,0,1,2,19909,0,19909,2,22096,2531,19565,2,22438,1000,21438,2,21941,0,21941
20030,30000,24000,0,1,1,1,1,0,0,30298,2000,28298,0,30046,900,29146,0,29880,1000,28880,0,27039,2000,25039
20031,110000,88000,0,0,0,0,0,0,0,76793,3275,73518,0,13062,3028,10034,0,12609,3000,9609,0,12638,2000,10638
20032,200000,160000,0,0,0,0,0,1,-2,4460,4460,0,-2,3190,3190,0,-2,5238,5238,0,-2,950,950,0
20033,80000,64000,0,0,0,0,0,0,0,4560,2000,2560,0,5450,1000,4450,0,0,0,0,0,0,0,0
20034,180000,144000,0,1,1,1,1,0,0,167293,14300,152993,0,168074,5000,163074,2,167235,3400,163835,2,179461,15000,164461
20035,120000,96000,0,0,0,0,0,0,-1,0,0,0,-2,1187,1187,0,-1,1187,0,1187,0,1187,0,1187
20036,450000,360000,0,0,0,0,0,0,-2,0,0,0,-2,0,0,0,-2,0,0,0,-2,0,0,0
20037,200000,160000,0,1,0,0,0,0,0,179350,7578,171772,0,152525,5700,146825,0,152765,5882,146883,0,152680,5799,146881
20038,200000,160000,0,0,0,0,0,0,2,0,0,0,2,0,0,0,-2,0,0,0,-2,0,0,0
20039,280000,224000,0,0,0,0,0,0,-1,53669,53934,-265,-1,4707,4726,-19,-1,22014,22102,-88,-1,3415,12,3403
20040,160000,128000,0,0,0,0,0,0,-1,3720,3722,-2,-1,3465,4300,-835,-1,4218,5000,-782,-1,2913,2500,413
20041,130000,104000,0,0,0,0,0,0,-1,670,670,0,-1,670,0,670,2,670,0,670,0,670,0,670
20042,210000,168000,0,0,0,0,0,1,-1,0,0,0,-1,582,582,0,-1,291,291,0,-1,1027,1027,0
20043,40000,32000,0,0,0,0,0,0,-1,8374,8382,-8,-1,7505,7505,0,-1,7515,7515,0,-1,9120,9120,0
20044,130000,104000,0,0,0,0,0,0,0,23167,1000,22167,0,0,0,0,0,0,0,0,-2,0,0,0
20045,380000,304000,0,1,0,0,0,0,0,373512,14100,359412,0,304594,11000,293594,0,305275,11000,294275,0,303402,11100,292302
20046,180000,144000,0,1,1,0,0,0,0,174667,7000,167667,0,176618,7000,169618,0,141697,5010,136687,0,143738,5200,138538
20047,60000,48000,0,0,0,0,0,1,0,49802,2262,47540,0,50965,3000,47965,0,19275,1500,17775,0,17976,1000,16976
20048,230000,184000,0,1,1,1,1,1,2,200300,8000,192300,2,203018,7500,195518,2,199689,0,199689,2,202833,6622,196211
20049,260000,208000,0,0,0,0,0,0,0,122956,6000,116956,0,123709,4500,119209,0,120603,4500,116103,0,122674,4546,118128
20050,80000,64000,0,0,0,0,0,0,-1,0,0,0,-1,2303,2303,0,-1,71637,71637,0,-1,7893,1796,6097
20051,300000,240000,0,0,0,0,0,0,0,14291,1093,13198,0,7331,1000,6331,0,10018,5014,5004,0,6213,2000,4213
20052,240000,192000,0,0,0,0,0,0,0,167934,6003,161931,0,169133,5504,163629,0,175175,10158,165017,0,146093,6000,140093
20053,330000,264000,0,0,0,0,0,0,0,82293,5000,77293,0,86458,6458,80000,0,91512,6512,85000,0,100433,10433,90000
20054,150000,120000,0,1,1,1,1,1,0,137279,1000,136279,2,143848,10400,133448,2,146986,5600,141386,2,149805,5400,144405
20055,230000,184000,0,0,0,0,0,0,-2,1470,1470,0,-2,735,735,0,-2,419,419,0,-2,316,316,0
20056,200000,160000,0,1,0,0,0,0,0,194464,5105,189359,0,76223,3000,73223,0,77822,2828,74994,0,80598,4073,76525
20057,230000,184000,0,0,0,0,0,1,-2,380,380,0,-2,380,380,0,-2,380,380,0,-2,380,380,0
20058,80000,64000,0,0,0,0,0,0,-1,5256,5256,0,-1,4451,4451,0,-1,9937,9937,0,-1,13102,9000,4102
20059,140000,112000,0,0,0,0,0,0,-2,0,0,0,-2,0,0,0,-2,825,825,0,-1,675,0,675
20060,230000,184000,0,0,0,0,0,0,-2,1611,1611,0,-2,1498,1498,0,-2,1301,1301,0,-2,309,309,0
20061,80000,64000,0,1,0,0,0,0,2,75688,0,75688,2,46378,1806,44572,0,46175,2124,44051,0,41118,1599,39519
20062,30000,24000,0,0,0,0,0,1,0,15626,2000,13626,0,9330,0,9330,0,4372,0,4372,0,1419,1419,0
20063,30000,24000,0,0,0,0,0,0,0,16453,1000,15453,2,15891,0,15891,2,16224,589,15635,0,16710,756,15954
20064,30000,24000,0,0,0,0,0,0,-1,11306,1101,10205,0,3562,1,3561,0,1621,1724,-103,-1,1307,1408,-101
20065,210000,168000,0,0,0,0,0,0,-2,0,0,0,-2,0,0,0,-2,0,0,0,-2,484,484,0
20066,70000,56000,0,1,1,1,0,1,0,66932,3100,63832,0,69043,3900,65143,0,70252,2500,67752,2,55732,2500,53232
20067,20000,16000,0,0,0,0,0,0,0,10944,1500,9444,0,11280,757,10523,0,11011,0,11011,2,7755,430,7325
20068,360000,288000,0,0,0,0,0,0,0,139310,13360,125950,0,143215,6123,137092,0,168839,28002,140837,0,171153,6116,165037
20069,480000,384000,0,0,0,0,0,1,0,0,0,0,-2,0,0,0,-2,0,0,0,-2,330982,330982,0
20070,340000,272000,0,0,0,0,0,1,0,285399,14000,271399,0,248984,11000,237984,0,251047,9200,241847,0,255303,10000,245303
20071,90000,72000,0,0,0,0,0,0,0,75576,4007,71569,0,75266,5006,70260,0,74431,4003,70428,0,68399,3014,65385
20072,260000,208000,0,0,0,0,0,1,-2,0,0,0,-2,0,0,0,-2,0,0,0,-2,0,0,0
20073,80000,64000,0,0,0,0,0,0,0,9701,2005,7696,0,8969,1013,7956,0,8529,1000,7529,0,8737,350,8387
20074,20000,16000,0,0,0,0,0,0,0,9792,1500,8292,0,10990,1500,9490,0,13990,3000,10990,0,10000,2000,8000
20075,50000,40000,0,0,0,0,0,0,-2,0,0,0,-2,2025,2025,0,-2,0,0,0,-2,1924,1924,0
20076,100000,80000,0,0,0,0,0,0,0,32689,1686,31003,0,17246,1043,16203,0,3175,409,2766,0,35311,62380,-27069
20077,100000,80000,0,0,0,0,0,1,-2,0,0,0,-2,0,0,0,-2,0,0,0,-2,0,0,0
20078,440000,352000,0,0,0,0,0,0,0,16540,3024,13516,0,13247,1043,12204,0,7577,3037,4540,0,1652,1660,-8
20079,50000,40000,0,0,0,0,0,0,2,18256,3000,15256,0,19896,2000,17896,0,19874,1000,18874,0,19248,2000,17248
20080,270000,216000,0,0,0,0,0,1,0,196747,8119,188628,0,108242,4500,103742,0,72480,3000,69480,0,36440,2000,34440
20081,50000,40000,0,0,0,0,0,1,-1,780,780,0,-1,390,0,390,0,390,390,0,-1,500,500,0
20082,360000,288000,0,0,0,0,0,0,-1,5562,5588,-26,-1,3906,3924,-18,-1,8413,8454,-41,-1,3079,3093,-14
20083,30000,24000,0,0,0,0,0,0,2,37,0,37,4,37,0,37,4,37,0,37,4,37,0,37
20084,500000,400000,0,0,0,0,0,0,-1,28854,0,28854,2,92952,70000,22952,0,50089,32000,18089,0,2165,2165,0
20085,190000,152000,0,0,0,0,0,0,-1,83701,3017,80684,0,85035,3029,82006,0,86482,3127,83355,0,88164,3433,84731
20086,50000,40000,0,0,0,0,0,1,2,200,0,200,2,200,0,200,2,-200,0,-200,2,0,200,-200
20087,150000,120000,0,0,0,0,0,0,-1,0,0,0,-1,234,234,0,-1,0,0,0,-1,0,0,0
20088,260000,208000,0,1,0,0,0,0,0,220219,7893,212326,0,206666,9241,197425,0,185282,7106,178176,0,167161,6506,160655
20089,120000,96000,0,0,0,0,0,0,-2,1706,1711,-5,-2,-4,0,-4,-2,-4,0,-4,-2,-4,0,-4
20090,100000,80000,0,0,0,0,0,0,-2,389,10389,-10000,-2,10049,10051,-2,-2,1049,1051,-2,-2,1049,1051,-2
20091,360000,288000,0,0,0,0,0,1,-2,-9,0,-9,-2,-9,0,-9,-2,1943,1952,-9,-2,2500,2500,0
20092,50000,40000,0,0,0,0,0,0,0,34057,5000,29057,0,34611,1417,33194,0,38359,4488,33871,0,37592,0,37592
20093,170000,136000,0,0,0,0,0,0,0,56537,20121,36416,0,113576,100071,13505,0,138419,50122,88297,0,101452,6468,94984
20094,340000,272000,0,0,0,0,0,0,-1,10780,10780,0,-1,8201,0,8201,0,7675,2000,5675,0,5653,5653,0
20095,10000,8000,0,1,0,0,0,0,0,9180,1000,8180,0,8300,1166,7134,0,0,0,0,0,0,0,0
20096,360000,288000,0,0,0,0,0,1,-2,0,0,0,-2,0,0,0,-2,-5,0,-5,-2,-5,0,-5
20097,110000,88000,0,0,0,0,0,0,0,25349,1500,23849,0,26265,1400,24865,0,27045,1100,25945,0,27572,1000,26572
20098,50000,40000,0,0,0,0,0,0,0,43927,3927,40000,0,19234,1234,18000,0,18799,1000,17799,0,16412,1450,14962
20099,500000,400000,0,0,0,0,0,0,0,197284,8001,189283,0,199489,6701,192788,0,201484,6321,195163,0,204017,6401,197616
20100,60000,48000,0,0,0,0,0,1,2,25079,1100,23979,2,24380,0,24380,2,26022,2200,23822,2,26542,1100,25442
20101,40000,32000,0,0,0,0,0,0,-1,0,0,0,-1,0,0,0,-2,247,247,0,-1,0,0,0
20102,80000,64000,0,0,0,0,0,0,-2,2988,2988,0,-2,273,273,0,-2,0,0,0,-2,1542,1542,0
20103,80000,64000,0,0,0,0,0,1,-1,0,0,0,-1,0,0,0,-2,0,0,0,-2,7685,7685,0
20104,200000,160000,0,0,0,0,0,0,2,4629,1215,3414,0,14915,12000,2915,0,8523,4000,4523,0,5586,4978,608
20105,140000,112000,0,0,0,0,0,0,-1,487,487,0,-1,1011,1011,0,-1,524,0,524,0,1037,1000,37
20106,50000,40000,0,0,0,0,0,0,0,7545,1300,6245,0,8560,1300,7260,0,8730,460,8270,0,8791,350,8441
20107,140000,112000,0,0,0,0,0,0,0,28746,7000,21746,0,36395,8395,28000,0,46358,10546,35812,0,49946,4400,45546
20108,30000,24000,0,1,0,0,0,0,0,25373,1365,24008,0,23231,1663,21568,0,23913,5106,18807,0,21120,1050,20070
20109,260000,208000,0,0,0,0,0,0,2,60969,2800,58169,2,59400,0,59400,2,60315,2500,57815,0,63230,4000,59230
20110,50000,40000,0,1,0,0,0,0,0,42190,1613,40577,0,30683,1504,29179,0,29140,1200,27940,0,28986,1100,27886
20111,360000,288000,0,0,0,0,0,0,-1,22648,22674,-26,-1,19433,95,19338,0,16708,16790,-82,-1,24047,24283,-236
20112,340000,272000,0,0,0,0,0,0,0,169911,115000,54911,0,130718,5000,125718,0,131684,6000,125684,0,126223,10000,116223
20113,50000,40000,0,0,0,0,0,0,0,34617,2000,32617,0,35735,2000,33735,0,37154,2000,35154,0,38380,2000,36380
20114,20000,16000,0,0,0,1,1,0,0,0,0,0,-2,19132,19132,0,-1,19533,709,18824,0,20235,1027,19208
20115,60000,48000,0,1,0,0,0,0,2,60398,1744,58654,0,31194,1100,30094,0,30343,1074,29269,0,30427,1200,29227
20116,370000,296000,0,0,0,0,0,1,-2,0,0,0,-2,0,0,0,-2,0,0,0,-2,0,0,0
20117,190000,152000,0,0,0,0,0,0,0,110884,5000,105884,0,111200,12028,99172,0,87619,5000,82619,0,92418,10418,82000
20118,50000,40000,0,1,0,0,0,0,0,49388,1192,48196,0,10275,1000,9275,0,9598,2000,7598,0,8382,1000,7382
20119,200000,160000,0,1,1,1,1,1,2,185410,8600,176810,0,189069,8300,180769,0,197736,13257,184479,0,183299,917,182382
20120,360000,288000,0,0,0,0,0,1,-2,0,0,0,-2,0,0,0,-2,0,0,0,-2,0,0,0
20121,40000,32000,0,0,1,1,1,1,2,34021,4514,29507,2,33177,0,33177,2,33870,1378,32492,0,34537,1382,33155
20122,380000,304000,0,0,0,0,0,0,-1,10472,10472,0,-1,39993,39993,0,-1,25356,25356,0,-1,39772,39772,0
20123,360000,288000,0,0,0,0,0,0,2,3821,3828,-7,-1,2404,2000,404,0,319,319,0,-1,0,0,0
20124,420000,336000,0,0,0,0,0,0,-1,0,0,0,-1,11511,11511,0,-1,14916,14916,0,-1,15564,15564,0
20125,100000,80000,0,0,0,0,0,1,0,70844,3003,67841,0,63924,1910,62014,0,57326,2400,54926,0,59654,3300,56354
20126,20000,16000,0,0,0,0,0,1,2,1050,0,1050,2,1050,0,1050,3,1050,0,1050,3,1050,0,1050
20127,130000,104000,0,1,1,1,1,0,0,127622,5000,122622,0,129795,5000,124795,0,122416,5000,117416,0,124653,5000,119653
20128,100000,80000,0,0,0,0,0,1,2,58643,1500,57143,2,58589,1500,57089,2,62586,5600,56986,2,64519,3100,61419
20129,50000,40000,0,0,0,0,0,0,0,23203,1500,21703,0,18983,1100,17883,0,13466,1466,12000,0,18878,5556,13322
20130,50000,40000,0,0,0,0,0,1,0,12990,1202,11788,0,12793,452,12341,0,12686,460,12226,0,12980,504,12476
20131,170000,136000,0,0,0,0,0,0,-2,2698,2706,-8,-1,6951,6954,-3,-1,12753,7002,5751,0,12023,241,11782
20132,20000,16000,0,1,1,1,1,0,0,17594,1442,16152,0,18552,1400,17152,0,18522,370,18152,0,18900,378,18522
20133,230000,184000,0,0,0,0,0,0,0,172204,7726,164478,0,173045,5601,167444,0,176163,6100,170063,0,179625,6427,173198
20134,50000,40000,0,0,0,0,0,0,-1,1382,1382,0,-1,-118,0,-118,-1,13656,13925,-269,-1,13927,498,13429
20135,10000,8000,0,1,1,1,1,1,2,9212,1201,8011,0,9633,1062,8571,0,9550,254,9296,0,9334,288,9046
20136,150000,120000,0,0,0,0,0,1,-2,0,0,0,-2,0,0,0,-2,0,0,0,-2,0,0,0
20137,500000,400000,0,0,0,0,0,0,-1,19502,19522,-20,-1,128406,128406,0,-1,-200,0,-200,-1,-200,0,-200
20138,70000,56000,0,0,0,0,0,0,-2,-25,0,-25,-2,-50,0,-50,-2,-25,0,-25,-2,475,500,-25
20139,280000,224000,0,0,0,0,0,0,-2,-10,0,-10,-2,-10,0,-10,-2,-10,0,-10,-2,-10,0,-10
20140,190000,152000,0,0,0,0,0,0,0,22117,2000,20117,0,23433,2010,21423,0,22173,1003,21170,0,22598,2007,20591
20141,150000,120000,0,1,1,1,1,0,0,145132,4875,140257,0,148054,4085,143969,0,146358,4113,142245,0,145253,4074,141179
20142,20000,16000,0,1,1,1,1,0,0,18051,1603,16448,0,18759,1311,17448,0,19132,684,18448,0,19684,860,18824
20143,180000,144000,0,0,0,0,0,0,0,137261,6382,130879,0,135904,5000,130904,0,127905,4649,123256,0,129465,5084,124381
20144,280000,224000,0,0,0,0,0,0,0,199490,10123,189367,0,181857,10001,171856,0,183324,6244,177080,0,177920,6315,171605
20145,290000,232000,0,0,0,0,0,0,-1,21036,11068,9968,0,17391,7600,9791,0,16348,3352,12996,0,-209051,6104,-215155
20146,200000,160000,0,0,0,0,0,0,2,1312,1312,0,-1,2404,2404,0,-1,3786,3786,0,-1,1916,1916,0
20147,250000,200000,0,0,0,0,0,0,-1,5354,5354,0,-1,167,167,0,-1,908,908,0,-1,0,0,0
20148,170000,136000,0,0,0,0,0,0,-2,0,0,0,-2,0,0,0,-2,1015,1015,0,-1,0,0,0
20149,20000,16000,0,1,0,0,0,0,0,19117,1286,17831,0,11983,1000,10983,0,11626,987,10639,0,1970,39,1931
20150,20000,16000,0,0,0,0,0,1,2,4016,1000,3016,0,3282,100,3182,0,1814,1814,0,-1,2232,1000,1232
20151,210000,168000,0,0,0,0,0,1,0,173236,10007,163229,0,84302,5609,78693,0,25876,2000,23876,0,140066,151139,-11073
20152,130000,104000,0,0,0,0,0,1,0,59335,2140,57195,0,54668,1093,53575,0,22780,13706,9074,0,13417,500,12917
20153,100000,80000,0,0,0,0,0,0,0,42636,1028,41608,0,44728,3120,41608,0,49192,6218,42974,0,51391,4016,47375
20154,280000,224000,0,0,0,0,0,1,-1,6455,11,6444,2,544,5,539,0,0,0,0,0,4694,4694,0
20155,400000,320000,0,0,0,0,0,0,0,138235,10007,128228,0,136102,3601,132501,0,33340,22000,11340,0,63684,35802,27882
20156,130000,104000,0,0,0,0,0,0,0,37414,15430,21984,0,42816,12015,30801,0,43089,8020,35069,0,37101,1060,36041
20157,40000,32000,0,1,1,1,0,0,0,38224,1890,36334,0,37764,2000,35764,0,38029,1104,36925,0,32179,948,31231
20158,50000,40000,0,1,1,0,0,0,0,44016,2016,42000,0,43396,1796,41600,0,41470,1570,39900,0,48676,10000,38676
20159,240000,192000,0,0,0,0,0,0,-2,0,0,0,-2,0,0,0,-2,0,0,0,-2,690,690,0
20160,230000,184000,0,0,0,0,0,0,-2,1052,1052,0,-2,0,0,0,-2,1931,1931,0,-2,0,0,0
20161,190000,152000,0,0,0,0,0,0,-1,0,0,0,-1,0,0,0,-2,418,418,0,-1,964,964,0
20162,50000,40000,0,1,1,1,1,0,0,51402,2600,48802,0,49020,2500,46520,0,50679,3800,46879,0,51568,2200,49368
20163,110000,88000,0,1,1,1,1,0,0,100272,4800,95472,0,92615,4300,88315,0,92657,3600,89057,0,93364,3500,89864
20164,120000,96000,0,0,0,0,0,0,0,0,0,0,0,0,0,0,-2,0,0,0,-2,0,0,0
20165,160000,128000,0,0,0,0,0,1,3,836,0,836,2,836,836,0,-1,836,836,0,-1,836,836,0
20166,290000,232000,0,0,0,0,0,0,0,211610,7697,203913,0,214300,7657,206643,0,213834,7771,206063,0,217758,7870,209888
20167,350000,280000,0,0,0,0,0,0,-1,34034,34034,0,-1,1157,1157,0,-1,8584,8584,0,-1,2076,2076,0
20168,150000,120000,0,0,0,0,0,0,-2,0,0,0,-2,0,0,0,-2,0,0,0,-2,0,0,0
20169,190000,152000,0,0,0,0,0,0,-2,0,0,0,-2,0,0,0,-2,0,0,0,-2,0,0,0
20170,400000,320000,0,0,0,0,0,0,-1,96868,97353,-485,-1,33745,33913,-168,-1,5143,5168,-25,-1,1601,1611,-10
20171,640000,512000,0,0,0,0,0,0,-1,32110,32120,-10,-1,62649,34000,28649,0,63218,5037,58181,0,53151,0,53151
20172,60000,48000,0,0,0,0,0,0,-1,19453,19435,18,0,17912,1000,16912,0,18480,1000,17480,0,18848,1000,17848
20173,130000,104000,0,0,0,0,0,0,-1,6263,6279,-16,-1,24571,24516,55,0,18817,16,18801,0,13481,34,13447
20174,30000,24000,0,0,0,1,0,0,0,23114,23150,-36,-1,24727,2000,22727,-1,24192,0,24192,2,25905,2119,23786
20175,80000,64000,0,1,1,1,1,0,0,81619,3300,78319,0,80030,3100,76930,0,79434,2900,76534,0,81348,3200,78148
20176,200000,160000,0,0,0,0,0,0,0,32801,1306,31495,0,14664,3400,11264,0,17092,3000,14092,0,18820,2000,16820
20177,200000,160000,0,0,0,0,0,0,-1,0,0,0,-2,367,367,0,-1,-150,150,-300,-1,-150,0,-150
20178,30000,24000,0,0,0,0,0,0,0,9237,1361,7876,0,5881,5921,-40,-1,29083,23665,5418,0,23795,566,23229
20179,470000,376000,0,0,0,0,0,0,0,153743,9001,144742,0,146971,8001,138970,0,127546,5001,122545,0,129998,5001,124997
20180,230000,184000,0,0,0,0,0,0,0,52698,30000,22698,0,101007,50000,51007,0,103598,4691,98907,0,150430,50000,100430
20181,100000,80000,0,0,0,0,0,0,0,29798,3000,26798,0,31028,2028,29000,0,33544,3354,30190,0,35328,2328,33000
20182,30000,24000,0,1,1,1,1,0,0,28870,1774,27096,0,27806,1710,26096,0,25142,1046,24096,0,25667,1079,24588
20183,220000,176000,0,0,0,0,0,0,0,30415,13500,16915,0,28038,14000,14038,0,25669,13500,12169,0,16003,13500,2503
20184,200000,160000,0,0,0,0,0,0,2,1863,2253,-390,-1,390,0,390,2,390,390,0,-1,390,390,0
20185,50000,40000,0,1,0,0,0,1,0,50510,3700,46810,0,32177,0,32177,2,29530,1072,28458,0,29789,1500,28289
20186,20000,16000,0,0,0,0,0,1,0,13513,2743,10770,0,12999,0,12999,2,14456,1686,12770,0,16313,2089,14224
20187,100000,80000,0,1,1,1,1,0,0,90147,4101,86046,0,94425,6623,87802,0,92853,0,92853,2,93816,3503,90313
20188,50000,40000,0,1,1,1,1,1,2,44313,2200,42113,2,45286,2000,43286,2,44256,0,44256,2,47549,4000,43549
20189,90000,72000,0,0,0,0,0,0,0,16404,1600,14804,0,17424,1600,15824,0,18925,2100,16825,0,18483,0,18483
20190,60000,48000,0,0,0,0,0,1,2,35284,2900,32384,2,31602,0,31602,2,32221,1200,31021,0,30208,1409,28799
20191,310000,248000,0,0,0,0,0,0,0,40136,21890,18246,0,31242,15000,16242,0,18962,9481,9481,-1,9950,19900,-9950
20192,50000,40000,0,0,0,0,0,1,0,15057,13609,1448,0,19825,13327,6498,0,4264,250,4014,0,3690,1000,2690
20193,340000,272000,0,0,0,0,0,0,-2,353,359,-6,-2,5674,5674,0,-2,3344,3692,-348,-2,3406,3406,0
20194,170000,136000,0,0,0,0,0,0,-1,1362,1362,0,-1,1591,1591,0,-1,3524,3524,0,-1,8545,8545,0
20195,440000,352000,0,0,0,0,0,0,0,23713,29748,-6035,-1,25427,25448,-21,-1,21187,10015,11172,0,26486,14501,11985
20196,20000,16000,0,1,1,1,1,0,0,18506,0,18506,2,18802,900,17902,0,20199,1700,18499,0,19394,0,19394
20197,150000,120000,0,0,0,0,0,1,2,64813,7628,57185,2,63048,0,63048,2,120660,61923,58737,2,122762,4500,118262
20198,230000,184000,0,0,0,0,0,0,-2,0,0,0,-2,0,0,0,-2,0,0,0,-2,0,0,0
20199,50000,40000,0,1,0,0,0,0,0,50095,1979,48116,0,34120,1495,32625,0,33235,1144,32091,0,32377,1165,31212
20200,150000,120000,0,0,0,0,0,0,0,17443,2,17441,2,21649,5000,16649,0,22045,2000,20045,0,18814,1500,17314
20201,340000,272000,0,0,0,0,0,0,-1,4881,4881,0,-1,717,717,0,-1,3785,3785,0,-1,10911,10911,0
20202,450000,360000,0,0,0,0,0,0,-1,2312,2328,-16,-1,192,192,0,-1,1630,1638,-8,-1,14099,14169,-70
20203,360000,288000,0,0,0,0,0,0,-1,836,836,0,-1,836,836,0,-1,986,986,0,-1,986,986,0
20204,360000,288000,0,0,0,0,0,0,-1,6989,7021,-32,-1,2729,6,2723,0,1436,7,1429,0,-14,0,-14
20205,230000,184000,0,0,0,0,0,0,-2,-1,0,-1,-2,-1,0,-1,-2,-1,0,-1,-2,-1,0,-1
20206,280000,224000,0,0,0,0,0,0,-1,8413,16830,-8417,-1,19825,19862,-37,-1,22085,12098,9987,0,12316,19,12297
20207,120000,96000,0,0,0,0,0,0,0,54401,5000,49401,0,57873,5000,52873,0,61917,5000,56917,0,63880,3000,60880
20208,220000,176000,0,0,0,0,0,0,-1,16838,16876,-38,-1,22237,22237,0,-1,10684,10684,0,-1,4262,4262,0
20209,150000,120000,0,0,0,0,0,0,-2,1512,1512,0,-1,0,0,0,-1,0,0,0,-2,0,0,0
20210,300000,240000,0,0,0,0,0,0,-1,331,332,-1,-1,331,332,-1,-1,-1,0,-1,-1,199,200,-1
20211,170000,136000,0,0,0,0,0,0,-2,0,0,0,-2,0,0,0,-2,0,0,0,-2,0,0,0
20212,10000,8000,0,0,0,1,0,1,2,8337,1201,7136,0,8356,1000,7356,0,8527,171,8356,0,4694,94,4600
20213,290000,232000,0,1,1,1,1,0,0,244535,10000,234535,0,244518,10000,234518,0,243689,9009,234680,0,241125,9031,232094
20214,80000,64000,0,1,1,1,1,0,0,73027,3500,69527,0,74215,3000,71215,0,75865,3000,72865,0,77448,3000,74448
20215,470000,376000,0,0,0,0,0,0,-2,0,0,0,-2,200,200,0,-1,34325,34325,0,-1,37325,3000,34325
20216,80000,64000,0,0,0,0,0,0,-2,1000,1006,-6,-1,2525,2525,0,-1,1498,1504,-6,-1,499,1,498
20217,20000,16000,0,0,0,0,0,1,0,5514,1500,4014,0,5277,0,5277,2,5791,600,5191,2,5550,0,5550
20218,290000,232000,0,0,0,0,0,0,-2,390,800,-410,-2,3184,3184,0,-2,390,390,0,-2,390,390,0
20219,40000,32000,0,0,0,0,1,0,0,24735,4000,20735,0,24050,0,24050,2,43317,20000,23317,2,44059,2000,42059
20220,160000,128000,0,0,0,0,0,1,-2,0,0,0,-2,0,0,0,-2,0,0,0,-2,0,0,0
20221,360000,288000,0,0,0,0,0,0,0,9034,1501,7533,0,8340,1000,7340,0,3144,900,2244,0,0,0,0
20222,10000,8000,0,0,0,0,0,0,-2,-58,0,-58,-2,7242,7300,-58,-1,8123,1000,7123,0,8993,1000,7993
20223,200000,160000,0,0,0,0,0,1,-2,0,0,0,-2,0,0,0,-2,0,0,0,-2,0,0,0
20224,50000,40000,0,0,0,0,0,0,-1,-88,0,-88,-1,2912,3000,-88,-1,390,0,390,0,390,0,390
20225,50000,40000,0,0,0,0,0,0,0,16285,1000,15285,2,17009,1300,15709,0,18223,1500,16723,0,18778,1000,17778
20226,150000,120000,0,0,0,0,0,0,0,8770,3014,5756,0,8740,3086,5654,0,2323,2000,323,0,5307,3003,2304
20227,110000,88000,0,1,1,1,1,1,2,104407,5200,99207,0,108689,7700,100989,0,106342,0,106342,2,111575,7800,103775
20228,210000,168000,0,0,0,0,0,0,0,0,0,0,-2,1008,1008,0,-1,0,0,0,-1,0,0,0
20229,160000,128000,0,0,0,1,1,0,0,110538,5731,104807,0,130873,24677,106196,0,134524,5753,128771,0,135264,5325,129939
20230,200000,160000,0,0,0,0,0,0,-2,8640,8683,-43,-2,433,436,-3,-2,14398,14595,-197,-2,3475,3516,-41
20231,200000,160000,0,0,0,0,0,0,0,67223,0,67223,2,69167,2943,66224,0,69289,2301,66988,0,70333,2374,67959
20232,20000,16000,0,0,1,1,1,1,0,17041,1400,15641,0,18239,1500,16739,0,17919,1000,16919,0,17398,1000,16398
20233,200000,160000,0,0,0,0,0,0,-2,880,880,0,-2,0,0,0,-2,0,0,0,-2,0,0,0
20234,200000,160000,0,0,0,0,0,0,0,52672,2672,50000,0,53682,2492,51190,0,51841,2006,49835,0,52921,2069,50852
20235,140000,112000,0,1,1,1,0,0,0,142140,6150,135990,0,142111,5900,136211,0,194934,4000,190934,0,95484,4000,91484
20236,100000,80000,0,0,0,0,0,0,-2,0,0,0,-2,0,0,0,-2,1639,1639,0,-2,923,923,0
20237,200000,160000,0,0,0,0,0,0,0,0,0,0,-2,0,0,0,-2,0,0,0,-2,2842,2842,0
20238,100000,80000,0,0,0,0,0,0,0,7886,4000,3886,0,5578,5578,0,-1,8608,11756,-3148,-1,11756,10000,1756
20239,160000,128000,0,0,0,0,0,0,-2,-200,0,-200,-2,0,200,-200,-2,10199,10199,0,-1,0,303,-303
20240,10000,8000,0,1,1,1,1,1,2,11163,2000,9163,2,10852,0,10852,4,10396,0,10396,3,10085,0,10085
20241,150000,120000,0,0,0,0,0,0,-2,0,0,0,-2,1522,1522,0,-2,5014,5014,0,-1,1000,1406,-406
20242,230000,184000,0,0,0,0,0,0,-2,0,0,0,-2,0,0,0,-2,0,0,0,-2,0,0,0
20243,50000,40000,0,0,0,0,0,1,0,20107,2400,17707,2,19496,0,19496,3,18885,0,18885,2,20581,2000,18581
20244,80000,64000,0,0,0,0,0,0,0,20407,2000,18407,0,18839,1014,17825,0,3810,0,3810,0,23836,23836,0
20245,20000,16000,0,1,1,1,1,1,2,17862,0,17862,2,19756,2500,17256,2,19143,0,19143,2,21671,3000,18671
20246,30000,24000,0,1,0,0,0,0,2,28987,2027,26960,0,24960,2000,22960,0,14358,1000,13358,0,16123,2000,14123
20247,20000,16000,0,0,0,0,0,0,2,12326,3317,9009,2,10621,0,10621,2,10400,1000,9400,0,0,0,0
20248,70000,56000,0,0,0,0,0,0,0,24926,3160,21766,0,10681,3000,7681,0,7431,3000,4431,0,4705,5060,-355
20249,90000,72000,0,0,0,0,0,0,-1,3396,3396,0,-1,1457,1464,-7,-1,750,750,0,-1,3091,3091,0
20250,320000,256000,0,0,0,0,0,0,0,117678,5000,112678,2,119245,5000,114245,2,120794,5000,115794,2,123796,5100,118696
20251,130000,104000,0,0,0,0,0,0,0,66258,3000,63258,0,62697,6000,56697,0,48210,2000,46210,0,46255,2000,44255
20252,230000,184000,0,0,0,0,0,0,-1,86813,10000,76813,0,35695,5170,30525,0,5555,5000,555,0,15165,15165,0
20253,50000,40000,0,0,1,1,1,0,0,41220,1700,39520,0,42332,1800,40532,0,43227,1600,41627,0,44530,2000,42530
20254,80000,64000,0,0,0,0,0,0,0,35476,35476,0,-1,24657,1000,23657,0,12139,243,11896,0,9038,9038,0
20255,110000,88000,0,0,0,0,0,0,0,45907,1102,44805,0,5130,1014,4116,0,2889,2889,0,0,78834,82718,-3884
20256,140000,112000,0,1,1,0,0,0,0,132730,10000,122730,0,124689,5000,119689,0,105447,5000,100447,0,106704,5000,101704
20257,140000,112000,0,0,0,0,0,0,-2,0,0,0,-2,0,0,0,-2,0,0,0,-2,0,0,0
20258,260000,208000,0,0,0,0,0,0,0,48663,4000,44663,0,50998,4000,46998,0,53835,3835,50000,0,56728,3805,52923
20259,180000,144000,0,0,0,0,0,0,-2,1352,1352,0,-2,960,960,0,-2,4921,4921,0,-2,3031,3031,0
20260,180000,144000,0,0,0,0,0,0,-2,8479,8875,-396,-2,792,792,0,-2,3826,3826,0,-2,1997,1997,0
20261,280000,224000,0,0,0,0,0,0,-1,7444,8069,-625,-1,4858,5005,-147,-1,2309,2400,-91,-1,8925,9000,-75
20262,20000,16000,0,1,1,1,1,1,2,19830,3000,16830,2,19240,0,19240,3,18419,0,18419,2,20126,2000,18126
20263,600000,480000,0,0,0,0,0,1,2,458862,0,458862,2,469703,18000,451703,0,447130,16000,431130,0,440982,16000,424982
20264,130000,104000,0,0,0,0,0,1,2,78652,6000,72652,2,76790,0,76790,2,78400,3001,75399,0,79996,3058,76938
20265,410000,328000,0,0,0,0,0,0,-2,7022,7022,0,-2,3321,3326,-5,-2,2745,2745,0,-2,500,500,0
20266,80000,64000,0,0,0,0,0,0,-1,3318,3324,-6,-1,1278,1278,0,-1,2541,2003,538,0,15452,15000,452
20267,390000,312000,0,0,0,0,0,0,0,60313,35127,25186,0,55769,20000,35769,0,65835,12000,53835,0,72177,7500,64677
20268,30000,24000,0,0,0,0,0,1,2,17272,0,17272,2,18131,1434,16697,2,17711,0,17711,2,19007,1581,17426
20269,320000,256000,0,0,0,0,0,0,-2,16615,16654,-39,-2,2914,2914,0,-2,696,696,0,-2,740,740,0
20270,130000,104000,0,0,0,0,0,1,0,94067,4500,89567,0,96604,5000,91604,0,97706,3600,94106,0,121027,25000,96027
20271,270000,216000,0,0,0,0,0,0,-1,-348,0,-348,-2,326,1000,-674,-1,326,326,0,-1,304,304,0
20272,200000,160000,0,1,1,0,0,0,0,197824,8857,188967,0,201940,9117,192823,0,98496,29420,69076,0,3480,3484,-4
20273,200000,160000,0,0,0,0,0,0,-1,1306,1306,0,-1,1623,1679,-56,-1,620,620,0,-1,849,849,0
20274,100000,80000,0,0,0,0,0,1,2,74555,9557,64998,2,72759,0,72759,2,74131,2700,71431,0,75603,2707,72896
20275,60000,48000,0,1,1,0,0,0,0,58147,0,58147,2,59399,2500,56899,0,37746,1316,36430,0,37794,1401,36393
20276,20000,16000,0,0,0,1,0,0,0,14155,2000,12155,0,19975,7000,12975,0,19975,0,19975,0,0,0,0
20277,20000,16000,0,0,0,0,0,1,0,14506,0,14506,2,15516,1555,13961,0,15561,600,14961,0,15910,600,15310
20278,510000,408000,0,0,0,0,0,0,-1,739,739,0,-1,1939,1939,0,-1,739,739,0,-1,2739,2739,0
20279,140000,112000,0,0,0,0,0,0,0,90424,5000,85424,0,92022,4000,88022,0,95377,5000,90377,0,98237,5000,93237
20280,200000,160000,0,0,0,0,0,0,-1,1689,1200,489,0,1851,1893,-42,0,34808,42804,-7996,-1,-30895,10,-30905
20281,280000,224000,0,0,0,0,0,0,-1,7819,7819,0,-1,7831,12,7819,0,5428,27,5401,0,2295,2309,-14
20282,500000,400000,0,0,0,0,0,0,-1,2971,2971,0,-1,184,200,-16,-1,64356,38144,26212,-1,33348,0,33348
20283,270000,216000,0,0,0,0,0,1,0,92217,3349,88868,0,94082,3400,90682,0,96367,3800,92567,0,97793,3300,94493
20284,500000,400000,0,0,0,0,0,0,-1,23338,6112,17226,0,7896,10014,-2118,-1,8970,9018,-48,-1,215305,215518,-213
20285,50000,40000,0,0,0,0,0,0,-1,8290,1398,6892,0,7838,1000,6838,0,7998,160,7838,0,8161,163,7998
20286,280000,224000,0,0,0,0,0,0,0,24910,1910,23000,0,20133,1133,19000,0,5821,821,5000,0,143866,155681,-11815
20287,120000,96000,0,0,0,0,0,1,-2,326,652,-326,-2,326,326,0,-2,326,326,0,-2,476,476,0
20288,80000,64000,0,0,0,0,0,0,0,15816,1210,14606,0,12710,1000,11710,0,0,0,0,0,0,0,0
20289,50000,40000,0,0,0,0,0,1,-1,26372,26479,-107,-1,7490,7490,0,-1,5155,5155,0,-1,0,0,0
20290,360000,288000,0,0,0,0,0,0,0,49018,48833,185,0,32760,32928,-168,-1,31489,31646,-157,-1,22316,22428,-112
20291,20000,16000,0,0,0,0,0,0,0,7859,0,7859,2,9518,1800,7718,2,9216,0,9216,2,10067,1000,9067
20292,20000,16000,0,1,0,0,1,0,0,19065,1032,18033,0,8332,541,7791,0,18868,20000,-1132,-1,19247,693,18554
20293,300000,240000,0,0,0,0,0,0,0,57390,18340,39050,0,36766,1000,35766,0,38586,3000,35586,0,84950,57543,27407
20294,140000,112000,0,1,1,1,1,0,0,141347,6500,134847,0,134503,5000,129503,0,137015,5200,131815,0,136581,5100,131481
20295,280000,224000,0,0,0,1,0,0,0,239059,80004,159055,0,282518,68410,214108,0,248238,7767,240471,0,210267,6308,203959
20296,250000,200000,0,0,0,0,0,0,0,18016,1000,17016,0,15353,20000,-4647,-1,325,325,0,-1,325,325,0
20297,100000,80000,0,1,1,1,0,1,2,85594,0,85594,2,87095,3300,83795,0,88357,2839,85518,0,77155,3000,74155
20298,230000,184000,0,0,0,0,0,0,-1,36163,3010,33153,0,32653,20000,12653,0,30821,1200,29621,0,29827,2000,27827
20299,90000,72000,0,0,0,0,0,0,0,1940,4200,-2260,-1,1940,0,1940,0,0,0,0,0,23101,23101,0
20300,50000,40000,0,1,0,0,0,0,0,48760,2313,46447,0,22967,813,22154,0,39687,875,38812,0,23755,1008,22747
20301,140000,112000,0,0,0,0,0,0,-2,0,0,0,-2,0,0,0,-2,0,0,0,-2,0,0,0
20302,130000,104000,0,0,0,0,0,0,0,81221,3500,77721,0,34289,5000,29289,0,38550,5000,33550,0,40600,3000,37600
20303,140000,112000,0,0,0,0,0,0,0,7262,1000,6262,0,7410,148,7262,0,1545,1545,0,-1,0,0,0
20304,100000,80000,0,0,0,0,0,0,0,8564,1123,7441,0,7241,1000,6241,0,7364,223,7141,0,7542,1500,6042
20305,240000,192000,0,0,0,0,0,0,0,97395,7255,90140,0,83314,3035,80279,0,73292,3030,70262,0,59270,3018,56252
20306,170000,136000,0,0,0,0,0,0,-2,1156,1156,0,-2,316,316,0,-2,316,316,0,-2,316,316,0
20307,280000,224000,0,0,0,0,0,0,0,51436,1795,49641,0,34260,1372,32888,0,36564,3931,32633,0,33331,3047,30284
20308,170000,136000,0,0,0,0,0,0,-1,400,400,0,-1,1000,1000,0,-1,0,0,0,-1,1243,1243,0
20309,80000,64000,0,0,0,0,0,0,0,0,0,0,0,0,0,0,-2,0,0,0,-2,0,0,0
20310,360000,288000,0,0,0,0,0,0,-2,-447,26,-473,-2,-6146,0,-6146,-2,13461,25461,-12000,-2,0,0,0
20311,180000,144000,0,0,0,0,0,0,-2,0,0,0,-2,0,0,0,-2,0,0,0,-2,0,0,0
20312,230000,184000,0,0,0,0,0,0,-1,1947,1950,-3,-1,11674,11692,-18,-1,16160,10000,6160,0,32519,20000,12519
20313,320000,256000,0,0,0,0,0,0,0,5591,2016,3575,0,2371,0,2371,0,4754,12,4742,0,4932,5036,-104
20314,200000,160000,0,0,0,0,0,0,-1,8235,8511,-276,-1,0,0,0,-1,0,0,0,-2,0,0,0
20315,60000,48000,0,1,1,1,1,0,0,56616,2083,54533,0,56749,1983,54766,0,57504,2200,55304,0,58296,2500,55796
20316,250000,200000,0,0,0,0,0,0,-1,5579,5607,-28,-1,8537,8634,-97,-1,2500,2500,0,-1,2500,0,2500
20317,50000,40000,0,1,1,1,1,1,2,51967,4156,47811,2,50794,0,50794,2,51911,4100,47811,2,50976,0,50976
20318,60000,48000,0,0,0,0,0,1,0,36991,1915,35076,0,37701,1625,36076,0,38452,1376,37076,0,39255,1422,37833
20319,220000,176000,0,0,0,0,0,0,-1,5516,5549,-33,-1,47619,50019,-2400,-1,28800,28800,0,-1,8561,8561,0
20320,300000,240000,0,0,0,0,0,0,0,38177,6028,32149,0,54867,25030,29837,0,66276,20023,46253,0,78169,20000,58169
20321,400000,320000,0,0,0,0,0,1,-1,0,0,0,-1,550,550,0,-1,0,0,0,-1,0,0,0
20322,470000,376000,0,0,0,0,0,0,0,5660,3500,2160,0,42003,38007,3996,0,39994,3000,36994,0,41816,3507,38309
20323,70000,56000,0,0,0,0,0,0,0,50890,2047,48843,0,50981,1861,49120,0,54122,4000,50122,0,58227,5000,53227
20324,180000,144000,0,0,0,0,0,0,0,78400,40129,38271,0,3000,3000,0,-1,0,0,0,-1,0,0,0
20325,110000,88000,0,0,0,0,0,0,0,33202,2000,31202,0,34656,2000,32656,0,38596,4500,34096,0,40970,4000,36970
20326,80000,64000,0,0,0,0,0,0,-1,1890,1890,0,-1,1712,0,1712,2,4180,2523,1657,2,3820,0,3820
20327,30000,24000,0,1,1,1,1,0,0,29038,3500,25538,0,28289,0,28289,2,28543,1011,27532,0,30544,2450,28094
20328,280000,224000,0,0,0,0,0,0,0,63225,3463,59762,0,29701,1300,28401,0,30172,1100,29072,0,30771,1100,29671
20329,210000,168000,0,0,0,0,0,0,-1,6273,6975,-702,-1,5651,5661,-10,-1,9103,9109,-6,-1,8660,8664,-4
20330,50000,40000,0,0,0,0,0,0,-1,1780,1780,0,-1,5808,5808,0,-1,390,390,0,-1,780,780,0
20331,400000,320000,0,0,0,0,0,0,0,14486,2002,12484,0,13419,2000,11419,0,14313,2000,12313,0,14524,3000,11524
20332,300000,240000,0,0,0,0,0,0,0,108659,5800,102859,0,110781,6000,104781,0,107833,7000,100833,0,104466,5000,99466
20333,360000,288000,0,0,0,0,0,1,2,115468,12000,103468,2,112157,0,112157,2,114690,5900,108790,0,117845,5000,112845
20334,280000,224000,0,0,0,0,0,0,-1,1906,1913,-7,-1,837,841,-4,-1,360,360,0,-1,350,350,0
20335,30000,24000,0,1,1,0,0,1,2,28322,0,28322,2,29251,1800,27451,0,15525,3925,11600,0,0,0,0
20336,50000,40000,0,0,0,0,0,1,-2,0,0,0,-2,0,0,0,-2,0,0,0,-2,0,0,0
20337,100000,80000,0,0,0,0,0,0,0,21255,1049,20206,0,0,0,0,0,0,0,0,-2,0,0,0
20338,100000,80000,0,0,0,0,0,1,2,8095,1500,6595,0,9296,1500,7796,0,10241,1100,9141,0,9936,0,9936
20339,30000,24000,0,0,0,0,0,0,2,390,390,0,-1,390,390,0,-1,390,390,0,-1,390,390,0
20340,180000,144000,0,0,0,0,0,0,0,97338,3700,93638,0,99694,4100,95594,0,65977,2360,63617,0,67415,2500,64915
20341,360000,288000,0,0,0,0,0,0,-2,0,0,0,-2,0,0,0,-2,0,0,0,-2,0,0,0
20342,90000,72000,0,0,0,0,0,1,2,65212,2368,62844,0,66627,2500,64127,0,70652,5140,65512,0,69397,0,69397
20343,300000,240000,0,0,0,0,0,0,-1,9737,9800,-63,-1,367,0,367,0,-23,0,-23,0,-413,0,-413
20344,120000,96000,0,0,0,1,1,0,0,99131,4500,94631,0,100464,4500,95964,0,100380,3700,96680,0,101445,3679,97766
20345,150000,120000,0,0,0,0,0,0,0,0,0,0,-2,0,0,0,-2,1000,1000,0,-1,0,0,0
20346,500000,400000,0,0,0,0,0,0,0,20700,2009,18691,0,19805,5000,14805,0,23802,5000,18802,0,23085,2000,21085
20347,50000,40000,0,0,0,0,0,1,0,6184,1110,5074,0,7194,1120,6074,0,7336,262,7074,0,7490,272,7218
20348,500000,400000,0,0,0,0,0,0,-2,18993,18997,-4,-2,50199,50933,-734,-2,22879,24652,-1773,-2,16070,18060,-1990
20349,160000,128000,0,0,0,0,0,0,-1,0,0,0,-2,0,0,0,-2,0,0,0,-2,0,0,0
20350,140000,112000,0,1,1,1,1,1,2,139070,1003,138067,2,134168,4854,129314,0,135678,5500,130178,0,136494,5200,131294
20351,190000,152000,0,1,0,0,0,0,0,162437,6000,156437,0,117364,30000,87364,0,100765,5000,95765,0,112095,13000,99095
20352,300000,240000,0,0,0,0,0,0,-1,12351,12300,51,0,12351,0,12351,0,12363,12,12351,0,9974,49,9925
20353,210000,168000,0,0,0,0,0,0,-1,2148,2148,0,-1,0,0,0,-1,0,0,0,-2,0,0,0
20354,170000,136000,0,0,0,0,0,0,-1,16835,16835,0,-1,2200,2200,0,-1,7510,5510,2000,0,12510,5000,7510
20355,290000,232000,0,0,0,0,0,0,-1,11859,11886,-27,-1,2483,2485,-2,-1,1170,1170,0,-1,20328,20328,0
20356,200000,160000,0,0,0,0,0,0,-1,94,94,0,-1,1712,1712,0,-1,9549,9549,0,-1,1060,1060,0
20357,170000,136000,0,0,0,0,0,1,0,60649,3003,57646,0,61408,3009,58399,0,59390,2013,57377,0,57037,3041,53996
20358,140000,112000,0,0,0,0,0,0,0,48437,5000,43437,0,50667,3000,47667,0,52888,3000,49888,0,54060,2000,52060
20359,30000,24000,0,0,0,0,0,1,-1,78,78,0,-1,135,135,0,-1,68,68,0,-1,193,423,-230
20360,170000,136000,0,0,0,0,0,0,-1,7360,7373,-13,-1,6380,6380,0,-1,11937,11937,0,-1,6378,1000,5378
20361,90000,72000,0,1,0,0,0,1,0,85301,3325,81976,0,65463,2300,63163,0,65923,2400,63523,0,67269,2400,64869
20362,30000,24000,0,0,0,0,0,0,-1,1775,1034,741,0,3040,1299,1741,0,2843,0,2843,2,3052,255,2797
20363,240000,192000,0,0,0,0,0,1,-1,1900,1900,0,-1,0,0,0,-1,0,0,0,-2,5435,5435,0
20364,40000,32000,0,0,0,0,0,0,0,200,200,0,-1,2601,2601,0,-1,1759,100,1659,0,-125,0,-125
20365,290000,232000,0,0,0,0,0,0,-2,531,531,0,-2,22058,22058,0,-2,468,468,0,-2,681,681,0
20366,330000,264000,0,0,0,0,0,0,-2,0,0,0,-2,0,0,0,-2,0,0,0,-2,0,0,0
20367,50000,40000,0,0,0,0,0,1,0,28077,1636,26441,0,18291,1000,17291,0,16886,1000,15886,0,27476,1000,26476
20368,80000,64000,0,1,1,1,1,0,0,78311,3100,75211,0,80777,7000,73777,0,79306,3200,76106,0,79195,3500,75695
20369,500000,400000,0,0,0,0,0,0,0,32556,3000,29556,0,36642,5080,31562,0,-8,8,-16,0,-8,0,-8
20370,150000,120000,0,0,0,0,0,0,0,40832,1417,39415,0,33843,1256,32587,0,37015,4429,32586,0,30074,1000,29074
20371,210000,168000,0,1,1,0,0,0,0,206043,10120,195923,0,181945,8256,173689,0,52712,5000,47712,0,3574,4036,-462
20372,350000,280000,0,0,0,0,0,0,-2,0,0,0,-2,0,0,0,-2,590,590,0,-2,0,0,0
20373,80000,64000,0,0,0,0,0,0,-1,1580,1044,536,0,2338,1000,1338,0,3140,2000,1140,0,3907,1500,2407
20374,300000,240000,0,0,0,0,0,0,-1,3523,2000,1523,0,6355,3000,3355,0,5055,0,5055,0,-445,0,-445
20375,10000,8000,0,0,0,0,0,1,2,6066,300,5766,2,5820,0,5820,2,6026,300,5726,0,7680,1774,5906
20376,160000,128000,0,0,0,0,0,1,0,127815,5500,122315,0,130023,5000,125023,0,98604,3000,95604,0,101650,4000,97650
20377,240000,192000,0,0,0,0,0,0,0,76248,30646,45602,0,79684,70204,9480,0,58231,10000,48231,0,7100,7100,0
20378,60000,48000,0,0,0,0,0,0,0,18124,2500,15624,0,28644,1000,27644,0,18656,1688,16968,0,15952,1000,14952
20379,300000,240000,0,0,0,0,0,1,-2,4247,4285,-38,-2,5484,5500,-16,-2,5125,5151,-26,-2,1752,1757,-5
20380,160000,128000,0,0,0,0,0,0,-1,824,824,0,-1,948,948,0,-1,632,0,632,0,316,0,316
20381,110000,88000,0,0,0,0,0,0,0,79044,2900,76144,0,80631,2900,77731,0,82333,3000,79333,0,84462,3500,80962
20382,430000,344000,0,0,0,0,0,0,-2,5999,6008,-9,-2,38845,48845,-10000,-2,0,0,0,-2,1111,1111,0
20383,50000,40000,0,0,0,0,0,1,0,8106,1500,6606,0,9962,2000,7962,0,9656,0,9656,2,11328,2000,9328
20384,180000,144000,0,0,0,0,0,0,0,96043,5015,91028,0,85554,4000,81554,0,77007,3000,74007,0,72461,3000,69461
20385,120000,96000,0,0,0,0,0,0,-1,45802,45812,-10,-1,53231,10000,43231,0,25888,900,24988,0,27114,3000,24114
20386,50000,40000,0,1,1,0,0,0,0,49405,2013,47392,0,47522,1863,45659,0,28711,1006,27705,0,28060,1300,26760
20387,50000,40000,0,1,0,0,0,0,0,50544,2442,48102,0,25381,1669,23712,0,9652,330,9322,0,9464,1342,8122
20388,60000,48000,0,0,1,1,1,0,0,59129,12000,47129,2,57663,0,57663,6,56225,0,56225,5,54759,0,54759
20389,20000,16000,0,1,1,1,1,0,0,19077,1689,17388,0,19467,1469,17998,0,19155,547,18608,0,19098,500,18598
20390,290000,232000,0,0,0,0,0,0,-1,700,700,0,-2,5055,5077,-22,-1,694,694,0,-1,3207,3207,0
20391,20000,16000,0,1,1,1,1,0,2,17750,0,17750,2,18102,647,17455,0,18485,674,17811,0,19175,1000,18175
20392,220000,176000,0,0,0,0,0,0,-1,942,942,0,-1,608,608,0,-1,1738,1738,0,-1,277,277,0
20393,180000,144000,0,1,1,1,1,0,0,172288,8000,164288,0,175557,8000,167557,0,178010,7001,171009,0,178976,6600,172376
20394,200000,160000,0,0,0,0,0,0,-1,21699,21699,0,-1,2914,3003,-89,-1,3392,3392,0,-1,4343,4343,0
20395,180000,144000,0,0,0,0,0,0,0,6428,1000,5428,0,4618,0,4618,0,2708,2708,0,-1,54024,54024,0
20396,60000,48000,0,1,1,1,1,0,0,59007,4800,54207,0,56492,0,56492,2,57565,2100,55465,0,56569,2200,54369
20397,360000,288000,0,0,0,0,0,0,-2,398,398,0,-2,0,0,0,-2,418,418,0,-2,1840,1840,0
20398,130000,104000,0,0,0,0,0,0,0,62441,2741,59700,0,48175,2175,46000,0,29874,1874,28000,0,15525,1525,14000
20399,80000,64000,0,1,1,1,1,0,0,74807,3000,71807,0,76363,2800,73563,0,78091,3000,75091,0,79829,3000,76829
20400,30000,24000,0,1,1,1,1,0,-1,30642,4000,26642,-1,29361,0,29361,2,29022,1000,28022,0,28409,900,27509
20401,130000,104000,0,0,0,0,0,0,0,87518,4500,83018,0,89360,4190,85170,0,90481,3500,86981,0,92858,4000,88858
20402,260000,208000,0,0,0,0,0,0,0,31654,6781,24873,0,35784,5000,30784,0,40726,6452,34274,0,45923,6696,39227
20403,20000,16000,0,1,1,1,1,0,2,16580,0,16580,2,18366,2067,16299,2,18766,1000,17766,2,18324,0,18324
20404,320000,256000,0,0,0,0,0,0,0,35119,5000,30119,0,36886,5000,31886,0,38756,5000,33756,0,40543,5000,35543
20405,240000,192000,0,0,0,0,0,0,-2,402,402,0,-1,14350,14350,0,-1,14129,1129,13000,0,10222,1222,9000
20406,90000,72000,0,1,0,0,0,0,1,73960,1000,72960,1,2442,770,1672,0,48063,48012,51,0,48186,1756,46430
20407,280000,224000,0,0,0,0,0,0,-1,6183,6213,-30,-1,261,262,-1,-1,-91,0,-91,-1,-91,0,-91
20408,170000,136000,0,0,0,0,0,0,-2,0,0,0,-2,582,582,0,-2,291,291,0,-2,90,90,0
20409,400000,320000,0,0,0,0,0,0,0,6651,4020,2631,0,6542,4066,2476,0,7093,4009,3084,0,9134,4021,5113
20410,130000,104000,0,0,0,0,0,0,-1,99235,99235,0,-1,98080,4368,93712,0,97224,3449,93775,0,97940,3713,94227
20411,100000,80000,0,1,0,0,0,0,0,94028,2620,91408,0,14578,408,14170,0,33254,26130,7124,0,16723,653,16070
20412,30000,24000,0,0,0,0,0,0,0,21638,2617,19021,0,25392,5710,19682,0,24428,1000,23428,0,26410,3342,23068
20413,90000,72000,0,0,0,0,0,0,0,72707,3168,69539,0,74101,3143,70958,0,72818,2700,70118,2,73940,3600,70340
20414,490000,392000,0,0,0,0,0,0,0,85703,5000,80703,0,87725,4000,83725,0,88727,3000,85727,0,91483,4000,87483
20415,90000,72000,0,0,0,0,0,1,0,24443,1408,23035,0,26695,2660,24035,0,25967,0,25967,2,26946,1400,25546
20416,50000,40000,0,1,1,0,0,0,0,48669,2343,46326,0,42360,1611,40749,0,19840,200,19640,0,19840,0,19840
20417,240000,192000,0,0,0,0,0,0,0,7117,7117,0,-1,2898,2905,-7,-1,5530,5530,0,-1,67010,46275,20735
20418,450000,360000,0,0,0,0,0,0,-2,-30,0,-30,-2,3332,3362,-30,-2,873,873,0,-2,1110,1110,0
20419,500000,400000,0,0,0,0,0,0,0,146487,5015,141472,0,139155,5000,134155,0,142337,5000,137337,0,145411,5000,140411
20420,420000,336000,0,0,0,0,0,0,0,24612,2000,22612,0,25400,1500,23900,0,26333,1500,24833,0,27887,2000,25887
20421,200000,160000,0,0,0,0,0,1,0,96867,4262,92605,0,77140,2645,74495,0,81849,5834,76015,0,78046,2771,75275
20422,20000,16000,0,0,0,0,0,0,0,9249,3000,6249,0,9438,189,9249,0,5700,0,5700,0,1140,1140,0
20423,180000,144000,0,1,1,1,1,1,0,179878,8000,171878,0,182005,7000,175005,0,175016,6565,168451,0,178293,6800,171493
20424,50000,40000,0,0,0,0,0,0,2,34651,1600,33051,0,35677,1600,34077,0,36485,1400,35085,0,37300,1400,35900
20425,400000,320000,0,0,0,0,0,1,-2,0,0,0,-2,0,0,0,-2,0,0,0,-2,0,0,0
20426,360000,288000,0,0,0,0,0,0,-1,-15,0,-15,-2,12588,12603,-15,-1,1243,1250,-7,-1,-6,0,-6
20427,30000,24000,0,0,1,1,1,0,2,30042,7300,22742,2,28276,0,28276,2,30483,2666,27817,2,29848,0,29848
20428,250000,200000,0,0,0,0,0,0,0,12947,5000,7947,0,16095,4000,12095,0,23343,10000,13343,0,26028,4000,22028
20429,50000,40000,0,0,0,0,0,0,-2,0,0,0,-2,0,0,0,-2,0,0,0,-2,0,0,0
20430,180000,144000,0,0,0,0,0,0,0,62201,2400,59801,0,81859,23500,58359,0,78566,3800,74766,0,77491,3700,73791
20431,360000,288000,0,0,0,0,0,0,-1,741,741,0,-1,-659,659,-1318,-2,-659,0,-659,-2,-659,0,-659
20432,310000,248000,0,0,0,0,0,0,0,16393,1300,15093,0,14855,1461,13394,0,12662,1000,11662,0,9628,2000,7628
20433,280000,224000,0,0,0,0,0,1,0,168543,7000,161543,0,172083,6762,165321,0,173850,4880,168970,0,177469,5050,172419
20434,170000,136000,0,0,0,0,0,1,-2,740,740,0,-2,740,740,0,-2,740,740,0,-2,740,740,0
20435,150000,120000,0,0,0,0,0,1,2,103978,3500,100478,2,105272,4500,100772,2,106437,3000,103437,2,109108,4600,104508
20436,170000,136000,0,0,0,0,0,0,-2,5425,5425,0,-1,5223,1000,4223,0,1084,2172,-1088,0,1084,1084,0
20437,90000,72000,0,1,1,0,0,1,0,89052,4200,84852,0,85807,3000,82807,0,68186,3000,65186,0,69011,3000,66011
20438,440000,352000,0,0,0,0,0,0,0,649,499,150,0,1108,959,149,-1,150,0,150,2,1075,925,150
20439,260000,208000,0,0,0,0,0,0,-1,1757,1770,-13,-1,31741,31744,-3,-1,3842,1,3841,0,2450,2606,-156
20440,180000,144000,0,0,0,0,0,0,0,14688,3500,11188,0,14040,0,14040,2,13440,0,13440,0,13440,0,13440
20441,200000,160000,0,0,0,0,0,0,-2,2740,2753,-13,-2,2044,2054,-10,-2,1614,1622,-8,-2,2066,2076,-10
20442,180000,144000,0,0,0,0,0,0,-1,7609,7609,0,-1,825,825,0,-1,1650,1650,0,-1,825,0,825
20443,70000,56000,0,0,0,0,0,0,0,52953,10000,42953,0,53696,2446,51250,0,11790,11790,0,0,12045,430,11615
20444,330000,264000,0,0,0,0,0,0,-1,2599,2599,0,-1,17064,17064,0,-1,70464,70464,0,-1,-6053,0,-6053
20445,200000,160000,0,0,0,0,0,0,0,103861,10000,93861,0,75480,6000,69480,0,70042,0,70042,2,72157,5000,67157
20446,30000,24000,0,0,0,0,0,0,-1,7480,7480,0,-1,0,0,0,-1,1803,1803,0,-1,1023,0,1023
20447,80000,64000,0,0,0,0,0,0,0,0,0,0,-2,0,0,0,-2,0,0,0,-2,0,0,0
20448,50000,40000,0,1,0,0,0,0,0,51400,2400,49000,0,0,0,0,0,0,0,0,-2,0,0,0
20449,360000,288000,0,0,0,0,0,0,0,1330,1341,-11,-1,2255,2255,0,-1,4164,4164,0,-1,0,0,0
20450,80000,64000,0,0,0,0,0,0,-1,0,0,0,-1,0,0,0,-2,0,0,0,-2,0,0,0
20451,60000,48000,0,0,0,0,0,0,0,30586,2867,27719,0,30885,1080,29805,2,30268,0,30268,2,30103,1319,28784
20452,150000,120000,0,0,0,0,0,0,0,0,0,0,0,0,0,0,-2,0,0,0,-2,0,0,0
20453,50000,40000,0,1,1,1,1,0,2,42368,150,42218,2,44553,3200,41353,2,45679,2000,43679,2,46275,1500,44775
20454,20000,16000,0,0,0,1,1,0,0,14137,2560,11577,0,16283,2426,13857,0,17108,1038,16070,0,18005,1116,16889
20455,120000,96000,0,0,0,0,0,0,0,33018,0,33018,2,19172,10076,9096,0,14938,10000,4938,0,21290,10000,11290
20456,50000,40000,0,0,0,0,0,0,0,4166,1000,3166,0,0,0,0,0,0,0,0,-2,318,318,0
20457,200000,160000,0,0,0,0,0,0,-2,11533,11533,0,-1,9463,189,9274,0,3884,1000,2884,0,3033,2050,983
20458,110000,88000,0,1,1,1,1,0,2,101930,0,101930,2,102111,4000,98111,0,101521,4000,97521,0,100240,3600,96640
20459,260000,208000,0,0,0,0,0,0,0,19556,2934,16622,0,18136,0,18136,2,24018,8000,16018,2,21490,0,21490
20460,50000,40000,0,0,0,0,0,0,0,21697,1650,20047,0,20683,850,19833,0,19283,700,18583,0,19965,1000,18965
20461,350000,280000,0,0,0,0,0,0,-1,1667,1667,0,-1,9737,9839,-102,-1,363,363,0,-1,1112,1112,0
20462,30000,24000,0,1,1,1,1,1,2,27826,3200,24626,2,27080,0,27080,2,30525,3900,26625,2,29764,0,29764
20463,340000,272000,0,0,0,0,0,0,0,20035,2000,18035,0,24238,5000,19238,0,20315,1000,19315,0,16378,723,15655
20464,360000,288000,0,0,0,0,0,0,0,51722,13092,38630,0,-8,0,-8,0,-8,0,-8,-2,-16,0,-16
20465,90000,72000,0,0,0,0,0,0,-1,2748,4448,-1700,-1,1048,6980,-5932,-1,450,0,450,0,450,0,450
20466,30000,24000,0,0,0,0,1,1,2,20089,0,20089,2,22717,3000,19717,0,26073,5000,21073,0,25583,0,25583
20467,70000,56000,0,1,1,0,0,0,0,70177,2511,67666,0,65735,2254,63481,0,55468,2000,53468,0,53266,2000,51266
20468,20000,16000,0,1,1,1,1,0,0,17359,1300,16059,0,17776,700,17076,0,19293,1800,17493,0,18844,0,18844
20469,360000,288000,0,0,0,0,0,0,-1,2500,2500,0,-1,0,0,0,-1,0,0,0,-2,0,0,0
20470,500000,400000,0,0,0,0,0,0,0,3823,1077,2746,0,4444,3023,1421,0,-232,54,-286,0,-2701,13,-2714
20471,220000,176000,0,0,0,0,0,0,0,76832,3000,73832,0,66879,2271,64608,0,55495,2009,53486,0,43369,1469,41900
20472,250000,200000,0,0,0,0,0,0,-1,-33,0,-33,-2,-33,0,-33,-2,267,300,-33,-1,144,144,0
20473,160000,128000,0,0,0,0,0,0,0,102650,5000,97650,0,0,0,0,0,0,0,0,-2,0,0,0
20474,50000,40000,0,0,0,0,0,0,0,29220,1491,27729,0,30547,1818,28729,0,32329,2600,29729,0,31677,0,31677
20475,170000,136000,0,0,1,0,0,0,-1,116189,5000,111189,0,192082,6000,186082,0,120077,7125,112952,0,92593,5000,87593
20476,180000,144000,0,0,0,0,0,0,-1,5198,5217,-19,-1,13263,13263,0,-1,6817,6000,817,0,4188,1000,3188
20477,140000,112000,0,0,0,0,0,0,0,65536,4000,61536,0,67645,8000,59645,0,62839,0,62839,2,53457,5000,48457
20478,200000,160000,0,1,0,0,0,1,2,194396,13,194383,2,166515,8684,157831,0,163673,5500,158173,0,145683,7437,138246
20479,210000,168000,0,0,0,0,0,0,-2,1008,1008,0,-1,0,0,0,-1,0,0,0,-2,0,0,0
20480,30000,24000,0,1,1,1,0,0,0,30611,3391,27220,0,30647,949,29698,2,28245,0,28245,2,24357,745,23612
20481,100000,80000,0,1,1,1,1,1,0,102237,5000,97237,0,98452,4500,93952,0,99423,3800,95623,0,101548,3900,97648
20482,70000,56000,0,1,1,0,0,0,0,68091,7500,60591,0,69028,3182,65846,0,-61372,25200,-86572,0,79256,102000,-22744
20483,340000,272000,0,0,0,0,0,0,0,138933,7000,131933,0,139824,5000,134824,0,142461,5200,137261,0,145269,5500,139769
20484,20000,16000,0,0,0,0,0,1,2,0,0,0,2,0,0,0,-2,0,0,0,-2,0,0,0
20485,50000,40000,0,0,0,0,0,1,0,8562,1200,7362,2,8276,0,8276,2,8638,500,8138,0,8851,500,8351
20486,240000,192000,0,1,1,0,0,0,0,220514,10038,210476,0,217068,10029,207039,0,5886,1038,4848,0,11841,7000,4841
20487,230000,184000,0,0,0,0,0,0,0,165978,10281,155697,0,170563,8866,161697,0,173697,6000,167697,0,179697,6000,173697
20488,100000,80000,0,0,0,0,0,0,0,25138,2000,23138,0,26499,2000,24499,0,26799,500,26299,0,1150,1150,0
20489,50000,40000,0,0,0,0,0,1,0,39949,2200,37749,0,40225,1400,38825,0,25517,1000,24517,0,20655,1000,19655
20490,50000,40000,0,0,0,0,0,1,0,10000,1000,9000,0,0,0,0,0,0,0,0,-2,0,0,0
20491,20000,16000,0,0,0,0,0,1,0,7415,1000,6415,0,0,0,0,0,0,0,0,-2,0,0,0
20492,140000,112000,0,1,0,0,0,0,0,131491,4000,127491,0,94362,3500,90862,0,85863,3000,82863,0,83974,13000,70974
20493,80000,64000,0,0,0,0,0,0,0,17405,441,16964,2,20207,3450,16757,0,23308,3541,19767,0,26406,3545,22861
20494,100000,80000,0,0,0,0,0,0,-1,96251,100044,-3793,-1,36221,2000,34221,0,36424,2000,34424,0,37791,2000,35791
20495,30000,24000,0,1,1,0,0,0,0,28618,1638,26980,0,28833,1053,27780,0,9895,2000,7895,0,12155,5155,7000
20496,300000,240000,0,0,0,0,0,0,0,54615,3011,51604,0,47146,582,46564,0,47486,602,46884,0,16937,627,16310
20497,120000,96000,0,0,0,0,0,1,0,70830,3800,67030,0,71557,2500,69057,2,73052,2804,70248,0,74502,2820,71682
20498,270000,216000,0,0,0,0,0,0,-2,1593,1593,0,-2,913,913,0,-2,1471,1471,0,-2,1302,1302,0
20499,210000,168000,0,0,0,0,0,0,-1,4909,1909,3000,0,6588,2588,4000,0,9074,3074,6000,0,8651,3651,5000
20500,80000,64000,0,0,0,0,0,1,2,7246,300,6946,2,8073,1100,6973,2,8349,700,7649,3,8420,500,7920
20501,50000,40000,0,0,0,0,0,0,0,20691,1306,19385,0,17081,1206,15875,0,16234,1000,15234,0,16330,697,15633
20502,80000,64000,0,1,0,0,0,0,0,77977,3112,74865,0,58469,2076,56393,0,58722,2279,56443,0,59770,2175,57595
20503,200000,160000,0,0,0,0,0,0,0,124075,5000,119075,0,99440,5000,94440,0,104685,6000,98685,0,54038,5000,49038
20504,480000,384000,0,1,1,0,0,0,0,476680,17000,459680,0,402695,12638,390057,0,362128,12058,350070,0,347271,11101,336170
20505,160000,128000,0,0,0,0,0,0,-2,207,207,0,-2,207,207,0,-2,207,207,0,-2,207,207,0
20506,150000,120000,0,0,0,0,0,0,0,30356,2000,28356,0,30545,2000,28545,0,31257,1200,30057,0,33762,3000,30762
20507,210000,168000,0,0,0,0,0,0,-1,0,0,0,-1,0,0,0,-2,0,0,0,-2,0,0,0
20508,100000,80000,0,0,0,0,0,0,-1,-1813,0,-1813,-2,-2011,0,-2011,-2,1751,3989,-2238,-2,2238,946,1292
20509,470000,376000,0,0,0,0,0,0,0,230011,8000,222011,0,234639,6671,227968,0,239502,6882,232620,0,244328,6960,237368
20510,30000,24000,0,1,0,0,1,0,0,26249,1889,24360,0,22721,1400,21321,0,17650,384,17266,0,25602,1000,24602
20511,50000,40000,0,1,0,0,0,0,0,48491,3537,44954,0,29157,5700,23457,0,29097,1102,27995,0,29039,1200,27839
20512,390000,312000,0,0,0,0,0,0,0,67503,5000,62503,0,68566,5007,63559,0,65411,5000,60411,0,66597,5000,61597
20513,210000,168000,0,0,0,0,0,0,0,14109,1613,12496,0,10955,1000,9955,0,11217,552,10665,0,11367,607,10760
20514,120000,96000,0,0,0,0,0,0,-1,768,768,0,-1,3096,3146,-50,-1,2677,2677,0,-1,2592,0,2592
20515,150000,120000,0,1,1,1,1,0,2,148066,6130,141936,2,142163,27,142136,2,135075,4610,130465,0,135309,5000,130309
20516,80000,64000,0,0,0,0,0,0,0,855086,1024516,-169430,-2,632,632,0,-2,632,632,0,-2,124542,124542,0
20517,220000,176000,0,0,0,0,0,0,0,36314,1600,34714,0,32320,1600,30720,0,27803,1000,26803,0,25370,3000,22370
20518,320000,256000,0,1,1,1,1,1,3,299382,0,299382,2,316898,24100,292798,2,310361,0,310361,2,312581,11700,300881
20519,60000,48000,0,0,0,0,0,0,0,48220,5348,42872,0,39595,4035,35560,0,29899,8804,21095,0,28722,3000,25722
20520,20000,16000,0,1,1,1,0,0,0,18677,2000,16677,0,18503,2000,16503,0,17231,1100,16131,0,15410,1586,13824
20521,50000,40000,0,1,1,0,0,0,0,43096,3000,40096,0,44151,2350,41801,0,3361,1000,2361,0,3593,286,3307
20522,160000,128000,0,0,0,0,0,0,-1,735,735,0,-1,735,735,0,-1,735,735,0,-1,735,735,0
20523,550000,440000,0,0,0,0,0,1,0,45392,3004,42388,0,48244,4010,44234,0,36206,3002,33204,0,38021,3000,35021
20524,240000,192000,0,0,0,0,0,0,0,16704,4000,12704,0,13934,3506,10428,0,2020,0,2020,0,4520,2500,2020
20525,20000,16000,0,0,0,0,0,1,0,1179,1179,0,-1,1536,1536,0,-1,-301,0,-301,-1,-301,0,-301
20526,80000,64000,0,0,0,0,0,0,-2,0,0,0,-2,0,0,0,-2,0,0,0,-2,0,0,0
20527,280000,224000,0,0,0,0,0,0,-1,25482,25489,-7,-1,24942,1348,23594,0,23944,816,23128,0,23068,934,22134
20528,160000,128000,0,0,0,0,0,0,0,132051,5500,126551,0,93367,4200,89167,0,84622,3032,81590,0,87255,4000,83255
20529,340000,272000,0,0,0,0,0,0,-1,1256,1256,0,-1,845,845,0,-1,2149,2000,149,0,696,696,0
20530,60000,48000,0,0,0,0,0,0,0,13265,1600,11665,0,13645,1300,12345,0,14538,1500,13038,0,14923,1000,13923
20531,70000,56000,0,0,0,0,0,0,0,22460,1500,20960,0,20345,3000,17345,0,42123,721,41402,0,19852,1200,18652
20532,320000,256000,0,0,0,0,0,0,-2,12664,12850,-186,-2,1316,1316,0,-2,326,326,0,-2,598,598,0
20533,310000,248000,0,0,0,0,0,0,-1,16799,16818,-19,-1,32372,20313,12059,0,6680,1006,5674,0,4732,4739,-7
20534,440000,352000,0,0,0,0,0,0,-1,981,982,-1,-1,873,874,-1,-1,873,874,-1,-1,840,841,-1
20535,260000,208000,0,1,1,0,0,0,0,243167,6310,236857,0,231463,5871,225592,0,105518,3130,102388,0,93193,2966,90227
20536,500000,400000,0,0,0,0,0,0,0,366475,13000,353475,0,248288,7029,241259,0,253283,7100,246183,0,258707,7500,251207
20537,50000,40000,0,1,1,0,0,0,0,51105,1680,49425,0,47494,1860,45634,0,31375,1061,30314,0,30781,1392,29389
20538,180000,144000,0,1,1,0,0,0,0,151651,5657,145994,0,159019,10372,148647,0,123022,5000,118022,0,126075,5000,121075
20539,370000,296000,0,0,0,0,0,0,0,297700,10015,287685,0,298224,16502,281722,0,338565,60003,278562,0,288924,15008,273916
20540,340000,272000,0,0,0,0,0,0,0,53490,3819,49671,0,104477,2073,102404,0,54351,5264,49087,0,25346,2571,22775
20541,50000,40000,0,1,0,0,1,0,0,47893,2021,45872,0,30707,1562,29145,0,50741,26004,24737,0,49663,1800,47863
20542,20000,16000,0,1,0,1,1,1,4,16334,0,16334,3,17270,1500,15770,2,16713,0,16713,3,16297,0,16297
20543,150000,120000,0,0,1,0,0,0,0,146685,31280,115405,0,137993,5979,132014,0,90715,7760,82955,0,92759,6000,86759
20544,130000,104000,0,0,0,0,0,1,2,51960,0,51960,3,49723,0,49723,2,47120,4500,42620,2,46188,0,46188
20545,110000,88000,0,0,0,0,0,1,0,63142,10000,53142,0,39854,5048,34806,0,9293,2000,7293,0,-1288,39958,-41246
20546,60000,48000,0,0,0,0,0,0,0,28509,1452,27057,0,28628,1009,27619,0,28785,1040,27745,0,28921,1048,27873
20547,60000,48000,0,1,0,0,0,0,0,61117,1900,59217,0,25254,1100,24154,0,26237,3000,23237,0,26752,1011,25741
20548,360000,288000,0,0,0,0,0,0,0,23816,1152,22664,0,13800,1000,12800,0,11000,1000,10000,0,0,0,0
20549,70000,56000,0,0,0,0,0,0,0,40934,1700,39234,0,34685,1446,33239,0,30166,1000,29166,0,29299,1044,28255
20550,40000,32000,0,0,0,0,0,0,-1,4167,4167,0,-1,1979,0,1979,2,1979,1979,0,-1,1979,1979,0
20551,30000,24000,0,1,1,1,1,0,0,29588,2000,27588,0,30687,2200,28487,0,25637,0,25637,2,26468,1800,24668
20552,20000,16000,0,1,1,1,0,1,0,18559,1344,17215,0,19068,1243,17825,0,19053,618,18435,0,16500,579,15921
20553,60000,48000,0,0,0,0,0,0,2,0,0,0,2,0,0,0,-2,0,0,0,-2,2285,2285,0
20554,20000,16000,0,0,0,0,0,0,-1,2500,2500,0,-1,1000,0,1000,0,0,0,0,0,0,0,0
20555,200000,160000,0,0,0,0,0,1,2,0,16550,-16550,2,665,665,0,-1,2846,2846,0,-1,6586,6586,0
20556,320000,256000,0,0,0,0,0,0,0,164694,6100,158594,0,148160,6094,142066,0,132230,5035,127195,0,121191,4446,116745
20557,210000,168000,0,0,0,0,0,0,-2,101912,5000,96912,-2,62959,2500,60459,-2,60767,2800,57967,-2,41150,2000,39150
20558,360000,288000,0,1,0,0,0,1,0,362900,14061,348839,0,293597,11028,282569,0,249345,8813,240532,0,228470,7900,220570
20559,140000,112000,0,0,0,0,0,1,0,63729,2000,61729,0,63751,2000,61751,0,65421,2000,63421,0,68070,3000,65070
20560,160000,128000,0,0,0,0,0,0,-1,9385,0,9385,2,2260,4560,-2300,-1,1313,2626,-1313,-1,947,1894,-947
20561,400000,320000,0,0,0,0,0,1,-2,0,0,0,-2,0,0,0,-2,18014,18014,0,-2,0,3710,-3710
20562,120000,96000,0,0,0,0,0,0,-2,-936,0,-936,-2,-1262,0,-1262,-2,-1588,0,-1588,-2,-1914,0,-1914
20563,10000,8000,0,0,0,1,1,1,0,7851,1292,6559,0,8704,1145,7559,0,8877,318,8559,0,9063,329,8734
20564,350000,280000,0,0,0,0,0,0,2,54554,54554,0,-1,92400,83288,9112,0,3520,3520,0,-1,3330,3330,0
20565,200000,160000,0,0,0,0,0,0,-2,2400,2400,0,-2,2185,2185,0,-2,6718,6718,0,-2,2298,2298,0
20566,80000,64000,0,1,1,1,1,1,2,68782,2600,66182,0,73955,6332,67623,0,79128,7000,72128,2,82275,5000,77275
20567,220000,176000,0,0,0,0,0,0,0,54167,1965,52202,0,55267,2000,53267,0,56586,2210,54376,0,57993,2500,55493
20568,50000,40000,0,0,0,0,0,0,-2,0,0,0,-2,0,0,0,-2,0,0,0,-2,429,429,0
20569,20000,16000,0,0,0,0,0,0,0,11127,1300,9827,0,12928,2000,10928,0,13721,1000,12721,0,14492,1000,13492
20570,440000,352000,0,1,1,0,0,0,0,423621,20341,403280,0,385873,13005,372868,0,364175,15410,348765,0,376228,72000,304228
20571,80000,64000,0,0,0,0,0,0,0,46099,3000,43099,0,47039,2000,45039,0,48286,2000,46286,0,48974,2000,46974
20572,10000,8000,0,0,1,1,1,1,2,9629,4000,5629,2,9328,0,9328,2,11411,2395,9016,2,10652,0,10652
20573,290000,232000,0,0,0,0,0,0,0,0,0,0,0,0,0,0,-2,0,0,0,-2,0,0,0
20574,30000,24000,0,0,0,0,0,0,0,10064,199,9865,2,150,0,150,2,1150,1150,0,-1,1000,0,1000
20575,120000,96000,0,0,0,0,0,0,-2,0,0,0,-2,0,0,0,-2,915,915,0,-1,0,0,0
20576,200000,160000,0,1,1,0,1,0,0,196120,8993,187127,0,168814,7503,161311,0,163509,6000,157509,0,172037,11300,160737
20577,130000,104000,0,0,0,0,0,0,-2,0,0,0,-2,0,0,0,-2,0,0,0,-2,0,0,0
20578,70000,56000,0,1,1,1,1,1,0,71267,2800,68467,0,69813,2900,66913,0,71324,2800,68524,0,71268,2800,68468
20579,270000,216000,0,0,0,0,0,0,-1,1277,1004,273,0,42402,42522,-120,-1,33855,1026,32829,0,32349,10000,22349
20580,200000,160000,0,1,1,1,1,0,0,172074,8000,164074,0,173907,6500,167407,0,184067,13500,170567,0,180612,0,180612
20581,160000,128000,0,0,0,0,0,1,0,6999,1200,5799,0,8109,2000,6109,0,8596,1000,7596,0,9455,1000,8455
20582,130000,104000,0,0,0,0,0,1,0,98083,4700,93383,0,92317,4433,87884,0,87375,3100,84275,0,87634,3300,84334
20583,370000,296000,0,0,0,0,0,0,0,192231,8500,183731,0,187486,6983,180503,0,191019,6500,184519,0,186529,7150,179379
20584,50000,40000,0,1,0,0,0,1,0,49691,2500,47191,0,49308,28400,20908,0,30284,1100,29184,0,30554,2000,28554
20585,190000,152000,0,0,0,0,0,0,0,140664,6000,134664,0,144395,6000,138395,0,147642,5500,142142,0,151410,6000,145410
20586,200000,160000,0,0,0,0,0,0,0,7763,2000,5763,0,8525,1000,7525,0,6843,518,6325,0,2865,1000,1865
20587,160000,128000,0,0,0,0,0,0,-1,2480,2480,0,-1,1920,1920,0,-1,2192,2192,0,-1,8187,8187,0
20588,200000,160000,0,0,0,0,0,0,0,44318,6032,38286,0,32010,0,32010,2,33271,3000,30271,0,34297,3000,31297
20589,140000,112000,0,1,0,0,1,0,0,122762,6614,116148,0,76564,2198,74366,0,139508,140000,-492,-1,142253,5413,136840
20590,230000,184000,0,0,0,0,0,0,2,23266,1200,22066,0,13565,1027,12538,0,80,80,0,-1,0,0,0
20591,100000,80000,0,0,0,0,0,0,-2,0,0,0,-2,0,0,0,-2,0,0,0,-2,1505,1505,0
20592,450000,360000,0,0,0,0,0,0,0,74835,3703,71132,0,87584,15000,72584,0,95161,10000,85161,0,103398,10000,93398
20593,180000,144000,0,0,0,0,0,0,-2,-10,0,-10,-2,3844,3854,-10,-1,0,0,0,-1,0,0,0
20594,300000,240000,0,0,0,0,0,0,-1,4043,4045,-2,-1,683,685,-2,-1,172,172,0,-1,402,402,0
20595,170000,136000,0,1,1,1,1,0,0,166894,6894,160000,0,170102,6102,164000,0,165015,5807,159208,0,165571,6241,159330
20596,360000,288000,0,0,0,0,0,0,-1,15369,15369,0,-1,7845,200,7645,0,6786,0,6786,0,0,0,0
20597,250000,200000,0,0,0,0,0,0,0,177946,6243,171703,0,159849,5446,154403,0,145461,4721,140740,0,141487,4385,137102
20598,50000,40000,0,0,0,0,0,0,2,28379,6200,22179,0,15988,2000,13988,0,16718,1000,15718,0,17446,1000,16446
20599,260000,208000,0,0,0,0,0,0,-1,248,1,247,2,-15,1,-16,2,3526,3805,-279,-1,263,1,262
20600,30000,24000,0,0,0,0,0,0,-1,3897,3897,0,-1,6978,4081,2897,-1,4081,0,4081,2,3686,155,3531
20601,340000,272000,0,0,0,0,0,0,0,111704,4117,107587,0,110578,4199,106379,0,109932,4103,105829,0,111127,3900,107227
20602,110000,88000,1,1,1,1,0,0,0,133490,4300,129190,0,135888,3500,132388,0,137708,3500,134208,0,78581,2564,76017
20603,30000,24000,0,1,1,0,0,1,0,26568,2000,24568,0,29872,4000,25872,0,23504,0,23504,0,25724,3000,22724
20604,360000,288000,0,0,0,0,0,1,2,6491,2000,4491,0,8422,2000,6422,0,8665,243,8422,0,0,0,0
20605,360000,288000,0,0,0,0,0,0,-2,668,668,0,-2,0,0,0,-2,686,686,0,-2,7149,7149,0
20606,100000,80000,0,0,0,0,0,0,-1,0,0,0,-1,0,0,0,-2,0,0,0,-2,0,0,0
20607,200000,160000,0,0,0,0,0,1,-1,2343,2343,0,-1,23834,23834,0,-1,11000,11000,0,-1,1315,1315,0
20608,260000,208000,0,1,1,1,1,1,0,244860,9021,235839,0,245165,8767,236398,0,236120,8317,227803,0,237705,8736,228969
20609,360000,288000,0,0,0,0,0,0,-2,0,0,0,-2,0,0,0,-2,0,0,0,-2,0,0,0
20610,70000,56000,0,1,1,0,0,0,0,68790,3248,65542,0,68523,2661,65862,0,29163,1135,28028,0,29247,1160,28087
20611,150000,120000,0,0,0,0,0,0,0,103317,3306,100011,0,96140,3412,92728,0,87455,3500,83955,0,87601,3500,84101
20612,100000,80000,0,0,0,0,0,0,0,8975,1462,7513,0,11032,2519,8513,0,10561,0,10561,2,10779,537,10242
20613,130000,104000,0,0,0,0,0,1,0,46413,4900,41513,0,45000,0,45000,2,45800,1000,44800,0,0,0,0
20614,130000,104000,0,1,1,1,0,0,0,126408,5000,121408,0,119174,4200,114974,0,111339,4000,107339,0,103492,3600,99892
20615,360000,288000,0,0,0,0,0,0,-1,31532,30000,1532,0,46342,20000,26342,0,56571,15000,41571,0,65268,10000,55268
20616,180000,144000,0,0,0,0,0,0,0,129909,6000,123909,0,133043,6000,127043,0,133835,6000,127835,0,132587,5000,127587
20617,20000,16000,0,0,0,0,0,0,0,8811,6074,2737,0,9638,9000,638,0,11740,5000,6740,0,11047,6047,5000
20618,30000,24000,0,0,0,0,0,0,-2,0,0,0,-2,0,0,0,-2,0,0,0,-2,4443,4443,0
20619,60000,48000,0,0,0,0,0,0,0,15069,1308,13761,0,15761,1000,14761,0,5879,118,5761,0,-2879,1329,-4208
20620,70000,56000,0,1,1,0,0,0,0,68448,3600,64848,0,69316,3075,66241,0,29083,1204,27879,0,28140,1200,26940
20621,120000,96000,0,0,0,0,0,0,-1,3007,3012,-5,-1,1927,1927,0,-1,1838,1838,0,-1,2472,2472,0
20622,520000,416000,0,0,0,0,0,1,2,330211,12620,317591,0,251920,8758,243162,0,256512,9047,247465,0,262474,9959,252515
20623,460000,368000,0,0,0,0,0,1,-1,0,0,0,-1,650,650,0,-1,0,0,0,-1,2232,2232,0
20624,330000,264000,0,0,0,0,0,0,-2,2006,2014,-8,-2,-2,0,-2,-2,1683,1685,-2,-2,1382,1388,-6
20625,50000,40000,0,1,1,0,0,0,0,50921,2200,48721,0,49415,2000,47415,0,8862,500,8362,0,9711,9000,711
20626,150000,120000,0,0,0,0,0,1,0,92345,5000,87345,0,82866,5000,77866,0,76412,5000,71412,0,80259,5000,75259
20627,50000,40000,0,1,0,0,0,0,0,50287,1293,48994,0,20406,839,19567,0,20206,870,19336,0,19690,940,18750
20628,10000,8000,0,1,1,1,1,0,0,9919,1200,8719,0,10400,1137,9263,0,10123,335,9788,0,19813,351,19462
20629,360000,288000,0,0,0,0,0,0,0,26374,13021,13353,0,9781,9781,0,-1,8719,0,8719,0,18076,10000,8076
20630,220000,176000,0,0,0,0,0,0,-2,11202,11202,0,-2,21683,21778,-95,-2,10860,10860,0,-2,12534,12534,0
20631,70000,56000,0,1,1,1,1,0,0,65636,0,65636,2,66114,3000,63114,0,66142,2500,63642,0,68380,4100,64280
20632,50000,40000,0,1,0,0,0,0,0,44211,1539,42672,0,27415,633,26782,0,26630,634,25996,0,8551,433,8118
20633,390000,312000,0,0,0,0,0,1,0,300426,10612,289814,0,292869,10041,282828,0,292885,11000,281885,0,281826,10512,271314
20634,10000,8000,0,0,0,0,0,0,0,3764,1200,2564,0,4001,300,3701,0,5134,1200,3934,0,4762,0,4762
20635,80000,64000,0,0,0,0,0,0,-2,-10922,4666,-15588,-2,-15588,4666,-20254,-2,-20254,4666,-24920,-2,-24920,266,-25186
20636,30000,24000,0,1,1,1,1,0,2,29856,0,29856,2,30584,2304,28280,2,27883,0,27883,2,29334,2400,26934
20637,80000,64000,0,0,0,0,0,1,-1,4545,4545,0,-1,2886,0,2886,2,1443,0,1443,0,3743,3743,0
20638,10000,8000,1,1,1,1,1,0,4,10092,0,10092,3,9700,0,9700,2,10000,302,9698,0,9900,0,9900
20639,180000,144000,0,0,0,0,0,0,1,0,0,0,-2,0,0,0,-2,0,0,0,-2,0,0,0
20640,50000,40000,0,0,0,0,0,0,0,17626,1300,16326,0,10078,500,9578,0,9654,500,9154,0,9648,300,9348
20641,70000,56000,0,1,0,0,0,0,0,71078,3200,67878,0,50777,1950,48827,0,50841,2000,48841,0,50682,1828,48854
20642,80000,64000,1,1,0,0,0,0,0,206390,12290,194100,-1,0,0,0,-1,1257,1257,0,-1,33592,35238,-1646
20643,20000,16000,0,1,1,1,1,0,0,17199,1000,16199,2,17548,504,17044,0,17992,600,17392,0,31150,4000,27150
20644,160000,128000,0,0,0,0,0,0,0,12741,12841,-100,-1,10023,1000,9023,0,11023,1000,10023,0,8922,178,8744
20645,120000,96000,0,0,0,0,0,1,2,1010,0,1010,2,0,0,0,2,0,0,0,-2,0,0,0
20646,130000,104000,0,0,0,0,0,0,0,38680,1521,37159,0,5654,3100,2554,0,1938,0,1938,0,522,10,512
20647,20000,16000,0,0,0,0,0,1,0,11176,1006,10170,0,6934,144,6790,0,11203,10000,1203,0,7737,308,7429
20648,340000,272000,0,0,0,0,0,0,-2,2532,2544,-12,-2,-36,2,-38,-2,105668,106196,-528,-2,5490,5517,-27
20649,180000,144000,0,0,0,0,0,0,0,49108,10000,39108,0,50016,3000,47016,0,45956,5000,40956,0,52926,15000,37926
20650,200000,160000,0,0,0,0,0,0,0,40400,2684,37716,0,25570,5625,19945,0,10060,1020,9040,0,8619,3044,5575
20651,280000,224000,0,0,0,0,0,1,0,146106,4422,141684,0,97334,3138,94196,0,91671,2817,88854,0,81030,2927,78103
20652,50000,40000,0,1,0,0,0,0,0,43193,2349,40844,0,18768,800,17968,0,19182,835,18347,0,19447,726,18721
20653,340000,272000,0,0,0,0,0,0,-1,44852,30000,14852,0,41971,20000,21971,0,81011,50000,31011,0,38472,20000,18472
20654,140000,112000,0,0,0,0,0,0,-1,0,0,0,-2,0,0,0,-2,0,0,0,-2,0,0,0
20655,360000,288000,0,0,0,0,0,0,-1,442,444,-2,-1,442,444,-2,-1,434,436,-2,-1,442,452,-10
20656,140000,112000,0,0,0,0,0,0,-2,-18,0,-18,-2,-18,0,-18,-2,-18,0,-18,-2,-18,0,-18
20657,370000,296000,0,0,0,0,0,0,0,149128,13000,136128,0,48907,5000,43907,0,53025,10000,43025,0,51434,4000,47434
20658,430000,344000,0,0,0,0,0,0,-1,13247,13298,-51,-1,27555,27570,-15,-1,17389,0,17389,0,2919,2919,0
20659,70000,56000,0,1,1,0,0,1,2,65701,0,65701,2,66782,3000,63782,0,36137,3000,33137,0,36894,1500,35394
20660,350000,280000,0,0,0,0,0,0,-1,6574,6636,-62,-1,3543,3559,-16,-1,1654,1659,-5,-1,6186,6215,-29
20661,10000,8000,0,0,0,0,0,0,0,6021,1200,4821,0,6763,1000,5763,0,7648,1000,6648,0,8367,1000,7367
20662,50000,40000,0,0,0,0,0,0,0,19111,2000,17111,0,20784,2000,18784,0,23428,3000,20428,0,25040,2000,23040
20663,120000,96000,0,0,0,0,0,0,-1,2541,2557,-16,-1,5648,5667,-19,-1,4122,4144,-22,-1,0,0,0
20664,400000,320000,0,0,0,0,0,0,0,21089,1539,19550,0,22943,3013,19930,0,22994,3003,19991,0,25172,3003,22169
20665,70000,56000,0,1,0,0,0,1,0,70935,3500,67435,0,52943,5450,47493,0,50971,5900,45071,0,50681,3100,47581
20666,200000,160000,0,0,0,0,0,1,0,145044,8080,136964,0,137480,6000,131480,0,6320,0,6320,0,780,0,780
20667,20000,16000,0,1,1,1,1,0,0,19308,0,19308,2,20296,1318,18978,0,20302,714,19588,0,20189,981,19208
20668,380000,304000,0,0,0,0,0,0,-2,1175,1180,-5,-2,576,578,-2,-2,576,578,-2,-2,-2,0,-2
20669,270000,216000,0,0,0,0,0,0,-2,1443,1443,0,-2,1443,1443,0,-2,9629,9629,0,-2,1773,1773,0
20670,280000,224000,0,0,0,0,0,1,-2,0,0,0,-2,787,787,0,-2,1233,1233,0,-2,0,0,0
20671,110000,88000,0,0,0,0,0,1,2,57156,0,57156,3,54984,0,54984,2,57437,4000,53437,0,59204,3500,55704
20672,50000,40000,0,0,0,0,0,0,-1,4216,4216,0,-1,4166,4116,50,0,4166,4166,0,-1,4166,4166,0
20673,70000,56000,0,1,1,1,1,0,0,59158,2500,56658,0,60675,2500,58175,0,62047,2500,59547,0,65298,4300,60998
20674,50000,40000,0,0,0,0,0,0,0,26621,1500,25121,0,27178,1000,26178,0,28038,1300,26738,0,28871,1300,27571
20675,150000,120000,0,0,0,0,0,0,-1,390,390,0,-1,15080,15080,0,-1,780,0,780,0,0,0,0
20676,10000,8000,0,0,0,0,0,1,2,1050,0,1050,2,1050,0,1050,3,1050,0,1050,3,1050,0,1050
20677,200000,160000,0,0,0,0,0,0,-2,0,0,0,-2,0,0,0,-2,0,0,0,-2,0,0,0
20678,190000,152000,0,0,0,0,0,1,-1,390,390,0,-1,390,390,0,-1,6026,6026,0,-1,7410,7410,0
20679,120000,96000,0,1,1,1,1,0,2,119044,5600,113444,2,120086,4500,115586,2,120662,4300,116362,2,118345,0,118345
20680,30000,24000,0,0,0,0,0,1,4,10225,0,10225,3,9912,0,9912,2,11444,1700,9744,2,10975,0,10975
20681,130000,104000,0,0,0,0,0,0,-1,0,0,0,-2,0,0,0,-2,0,0,0,-2,0,0,0
20682,500000,400000,0,0,0,0,0,0,-2,1742,1742,0,-2,27291,27291,0,-2,0,0,0,-2,0,0,0
20683,500000,400000,0,0,0,0,0,0,-2,0,0,0,-2,0,0,0,-2,177,177,0,-1,4716,4716,0
20684,250000,200000,0,0,0,0,0,0,0,186020,6959,179061,0,186465,110000,76465,0,113336,0,113336,0,0,0,0
20685,220000,176000,0,1,1,0,0,0,0,211233,23007,188226,0,194579,7991,186588,0,96213,4191,92022,0,27540,719,26821
20686,340000,272000,0,0,0,0,0,0,-1,66633,66652,-19,-1,182856,123267,59589,0,166943,26207,140736,0,126445,948,125497
20687,160000,128000,0,0,0,0,0,0,-1,-2,0,-2,-1,2319,2321,-2,-1,1523,4,1519,0,-2,0,-2
20688,170000,136000,0,0,0,0,0,0,0,308,308,0,-1,0,0,0,-1,0,0,0,-2,0,0,0
20689,280000,224000,0,0,0,0,0,0,-1,3861,3861,0,-1,316,316,0,-1,10800,10800,0,-1,9099,382,8717
20690,400000,320000,0,0,0,0,0,0,0,355718,263106,92612,0,298654,10900,287754,0,263190,10063,253127,0,202907,7708,195199
20691,80000,64000,0,1,1,0,0,0,0,73875,4000,69875,0,75949,3900,72049,0,44167,2000,42167,0,45362,2000,43362
20692,30000,24000,0,0,0,0,0,1,0,23343,1696,21647,0,24336,1689,22647,0,24475,1016,23459,0,24643,893,23750
20693,270000,216000,0,1,1,1,1,0,3,271951,18112,253839,4,278509,15405,263104,4,283545,10000,273545,4,278436,0,278436
20694,180000,144000,0,0,0,0,0,0,-1,906,908,-2,-1,6101,6101,0,-1,50372,48251,2121,0,1203,1207,-4
20695,230000,184000,0,0,0,0,0,0,0,28774,2000,26774,0,29202,1100,28102,0,29683,1000,28683,0,30277,980,29297
20696,30000,24000,0,1,1,1,1,0,0,28561,2048,26513,0,29684,2000,27684,0,32650,3769,28881,0,34299,5007,29292
20697,20000,16000,0,0,0,0,0,1,3,14020,5,14015,2,13345,1925,11420,0,0,0,0,0,0,0,0
20698,160000,128000,0,0,0,0,0,0,0,42889,1716,41173,0,43904,1731,42173,0,44777,1604,43173,0,45866,1812,44054
20699,220000,176000,0,0,0,0,0,0,0,91191,4006,87185,0,86139,3000,83139,0,83743,3000,80743,0,78555,3000,75555
20700,50000,40000,0,0,0,0,0,1,2,0,0,0,2,0,0,0,-2,0,0,0,-2,0,0,0
20701,50000,40000,0,0,0,0,0,1,4,30575,0,30575,3,29784,0,29784,2,31288,2000,29288,2,32634,2000,30634
20702,380000,304000,0,0,0,0,0,0,-1,65201,1628,63573,0,39281,196,39085,0,80561,80962,-401,-1,19302,19395,-93
20703,310000,248000,0,0,0,0,0,0,-2,0,0,0,-2,110,110,0,-2,0,0,0,-2,0,0,0
20704,80000,64000,0,0,0,0,0,0,-1,1096,1096,0,-1,162,163,-1,-1,6600,6600,0,-1,1780,1780,0
20705,50000,40000,0,0,0,0,0,0,0,0,0,0,0,3400,3400,0,-1,2769,2769,0,-1,0,1700,-1700
20706,180000,144000,0,0,0,0,0,0,-1,390,780,-390,-1,780,780,0,-1,0,0,0,-1,0,0,0
20707,80000,64000,0,0,0,0,0,1,0,39559,6000,33559,2,38640,0,38640,4,37721,0,37721,3,39965,3000,36965
20708,170000,136000,0,0,0,0,0,0,0,39872,1671,38201,0,40693,1657,39036,0,41334,1463,39871,0,42118,1666,40452
20709,130000,104000,0,0,0,0,0,1,2,73892,3572,70320,0,74400,2645,71755,0,62134,1813,60321,0,63430,1878,61552
20710,320000,256000,1,1,0,0,0,0,2,320622,450,320172,2,252323,7025,245298,0,253557,7161,246396,0,256525,8000,248525
20711,230000,184000,0,1,1,1,1,0,-1,226596,11621,214975,0,225791,9027,216764,0,226638,9015,217623,0,226265,9000,217265
20712,170000,136000,0,0,0,0,0,1,-2,0,0,0,-2,0,0,0,-2,0,0,0,-2,0,0,0
20713,20000,16000,0,1,1,1,1,1,2,19820,2832,16988,2,19104,0,19104,2,19646,658,18988,0,20527,1151,19376
20714,380000,304000,0,0,0,0,0,0,-2,8796,8863,-67,-1,7991,8007,-16,-1,5310,5362,-52,-2,14655,14695,-40
20715,30000,24000,0,0,0,0,0,0,2,14310,1560,12750,0,16059,2300,13759,0,15506,0,15506,2,15687,580,15107
20716,20000,16000,0,0,0,0,0,0,0,9470,2360,7110,0,9640,500,9140,2,6110,1000,5110,0,5775,3200,2575
20717,30000,24000,0,1,1,1,1,0,0,29752,1505,28247,0,28627,1500,27127,0,29467,2200,27267,0,29634,2300,27334
20718,170000,136000,0,0,0,0,0,0,-2,0,0,0,-2,0,0,0,-2,0,0,0,-2,0,0,0
20719,260000,208000,0,0,0,0,0,0,0,208756,8065,200691,0,168828,7000,161828,0,155644,10000,145644,0,159135,10000,149135
20720,240000,192000,0,0,0,0,0,0,0,92900,5000,87900,0,93876,3511,90365,0,91678,4000,87678,0,94280,4000,90280
20721,50000,40000,0,0,0,0,0,0,0,0,0,0,-2,0,0,0,-2,0,0,0,-2,0,0,0
20722,370000,296000,0,0,0,0,0,0,0,169132,14045,155087,0,128553,8553,120000,0,88817,8817,80000,0,83763,10763,73000
20723,190000,152000,0,1,1,1,1,1,2,166163,6500,159663,2,168592,6500,162092,2,171923,6000,165923,2,169165,0,169165
20724,90000,72000,0,0,0,0,0,0,0,21231,0,21231,2,22071,1500,20571,0,23211,1500,21711,0,23773,1100,22673
20725,300000,240000,0,0,0,0,0,0,0,1616,1000,616,0,3658,2700,958,0,658,658,0,-1,662,662,0
20726,160000,128000,0,0,0,0,0,0,0,90348,6353,83995,0,8274,1200,7074,0,75286,70000,5286,0,76618,3000,73618
20727,10000,8000,0,0,0,0,0,1,2,1050,0,1050,2,1050,0,1050,3,1050,0,1050,3,1050,0,1050
20728,30000,24000,0,0,0,0,0,0,-2,4342,4342,0,-2,690,690,0,-2,0,0,0,-2,99,99,0
20729,320000,256000,0,0,0,0,0,0,0,112393,4000,108393,0,111541,5000,106541,0,114934,5000,109934,0,118228,5000,113228
20730,40000,32000,0,0,0,0,0,0,0,18519,3000,15519,0,21058,3000,18058,0,8204,6000,2204,0,9899,2000,7899
20731,210000,168000,0,0,0,0,0,0,-1,11755,11800,-45,-1,5808,5818,-10,-1,3974,4015,-41,-1,0,0,0
20732,30000,24000,0,1,1,1,1,1,2,31034,2000,29034,2,28071,0,28071,2,29978,2500,27478,2,29365,0,29365
20733,10000,8000,0,0,0,0,0,1,2,600,0,600,2,600,0,600,2,600,0,600,2,2050,1450,600
20734,80000,64000,0,0,0,0,0,0,0,20694,5694,15000,0,25435,5435,20000,0,30510,5510,25000,0,36101,6101,30000
20735,50000,40000,0,0,0,0,0,0,0,26866,1717,25149,0,26673,914,25759,0,26871,1000,25871,0,27009,963,26046
20736,290000,232000,0,0,0,0,0,0,0,85735,20000,65735,0,79698,0,79698,2,71981,5500,66481,2,63168,0,63168
20737,290000,232000,0,0,0,0,0,0,0,176099,8000,168099,0,170282,6500,163782,0,166869,7000,159869,0,173273,10000,163273
20738,40000,32000,0,0,0,0,1,1,2,28912,1500,27412,0,29495,1064,28431,0,33011,4000,29011,0,32194,0,32194
20739,50000,40000,0,0,0,0,0,0,0,39094,0,39094,2,19476,680,18796,0,19483,693,18790,0,19634,851,18783
20740,500000,400000,0,0,0,0,0,0,0,152365,20154,132211,0,139757,20019,119738,0,153348,20151,133197,0,127391,20037,107354
20741,80000,64000,0,0,0,0,0,0,0,47918,2210,45708,0,47620,1700,45920,0,48571,1614,46957,0,48525,1600,46925
20742,280000,224000,0,1,1,0,0,1,0,284041,10261,273780,0,283396,17003,266393,0,213294,7657,205637,0,213384,7750,205634
20743,100000,80000,0,1,1,1,1,1,2,88624,4000,84624,2,89576,3300,86276,2,90614,3400,87214,2,89046,0,89046
20744,100000,80000,0,0,0,0,0,0,0,63794,3000,60794,0,60651,2700,57951,0,54664,2000,52664,0,51776,2000,49776
20745,20000,16000,0,1,1,1,1,0,0,18854,2382,16472,0,19972,1500,18472,0,18090,605,17485,0,19842,2000,17842
20746,200000,160000,0,0,0,0,0,0,-1,12000,12000,0,-1,0,0,0,-1,0,0,0,-2,0,0,0
20747,60000,48000,0,0,0,0,0,0,-1,13421,10000,3421,0,9900,900,9000,0,310,310,0,-1,160,0,160
20748,110000,88000,0,0,0,0,0,0,0,84960,4000,80960,0,86045,3400,82645,0,88060,3400,84660,0,93394,7000,86394
20749,500000,400000,0,0,0,0,0,1,0,250186,6242,243944,0,276579,231888,44691,0,239874,7945,231929,0,226502,7840,218662
20750,200000,160000,0,0,0,0,0,0,-2,6737,6737,0,-2,6012,6031,-19,-2,5167,5167,0,-2,3132,3132,0
20751,110000,88000,0,0,0,0,0,0,0,85136,3050,82086,0,80491,2765,77726,0,78967,2304,76663,0,80628,2400,78228
20752,330000,264000,0,0,0,0,0,1,0,176396,5496,170900,0,171553,4721,166832,0,162251,4132,158119,0,145931,3916,142015
20753,20000,16000,0,0,0,0,1,1,0,14890,1248,13642,0,15642,1000,14642,0,16387,1000,15387,0,17113,1000,16113
20754,500000,400000,0,0,0,0,0,0,-2,162,162,0,-2,0,0,0,-2,151,151,0,-2,2530,2530,0
20755,260000,208000,0,0,0,0,0,0,0,0,0,0,0,0,0,0,-2,0,0,0,-2,0,0,0
20756,130000,104000,0,0,0,0,0,0,-2,8072,8141,-69,-2,5723,5744,-21,-2,6232,6232,0,-2,8873,8873,0
20757,60000,48000,0,0,0,0,0,0,2,36530,3200,33330,2,37133,1500,35633,2,37893,1500,36393,2,37131,0,37131
20758,210000,168000,0,0,0,0,0,0,-2,0,0,0,-2,0,0,0,-2,0,0,0,-2,0,0,0
20759,200000,160000,0,0,0,0,0,0,0,23382,2000,21382,0,21522,1128,20394,0,8815,4280,4535,0,4280,0,4280
20760,70000,56000,0,0,0,0,0,0,-2,17571,18862,-1291,-1,17920,640,17280,0,18296,663,17633,0,18659,666,17993
20761,360000,288000,0,1,1,0,0,1,2,350214,30,350184,2,319960,12302,307658,0,260944,10004,250940,0,202686,7506,195180
20762,80000,64000,0,0,0,0,0,0,0,11244,5000,6244,0,13444,3000,10444,0,6782,2000,4782,0,226,226,0
20763,30000,24000,0,1,1,1,1,0,0,26186,2000,24186,0,27698,2000,25698,0,28987,2000,26987,0,29568,2500,27068
20764,20000,16000,0,0,0,0,0,1,2,2400,0,2400,2,2400,0,2400,7,2400,0,2400,7,2400,0,2400
20765,230000,184000,0,0,0,0,0,0,-1,6163,6191,-28,-1,2765,2782,-17,-1,2050,2055,-5,-1,1197,1200,-3
20766,340000,272000,0,1,0,0,0,0,0,335012,12693,322319,0,197797,6100,191697,0,201935,6300,195635,0,140812,5100,135712
20767,420000,336000,0,0,0,0,0,0,-1,19725,21417,-1692,-1,23933,23941,-8,-1,24648,8000,16648,0,18610,18610,0
20768,450000,360000,0,0,0,0,0,0,0,74354,1879,72475,0,57628,20000,37628,0,57381,20000,37381,0,14870,5000,9870
20769,90000,72000,0,0,0,0,0,0,0,62725,4000,58725,0,57716,3000,54716,0,43970,2000,41970,0,36415,3480,32935
20770,130000,104000,0,0,0,0,0,1,3,9533,1000,8533,2,10220,1000,9220,2,10353,600,9753,0,10636,600,10036
20771,200000,160000,0,0,0,0,0,1,-1,2080,2080,0,-1,3567,3567,0,-1,0,0,0,-1,1731,1731,0
20772,50000,40000,0,0,0,0,0,0,-1,291,291,0,-1,291,291,0,-1,291,291,0,-1,0,0,0
20773,200000,160000,0,0,0,0,0,1,-2,0,0,0,-2,0,0,0,-2,0,0,0,-2,0,0,0
20774,80000,64000,0,0,0,0,0,1,3,11281,0,11281,2,12785,2000,10785,2,12283,0,12283,2,13184,1100,12084
20775,110000,88000,0,0,0,0,0,0,2,23920,2000,21920,0,25217,2000,23217,0,25600,1100,24500,0,26036,1000,25036
20776,50000,40000,0,0,0,0,0,0,0,24418,2000,22418,0,25938,2000,23938,0,27067,1500,25567,0,28193,1500,26693
20777,180000,144000,0,0,0,0,0,0,0,53358,3071,50287,0,41379,3042,38337,0,32620,1161,31459,0,19061,3023,16038
20778,240000,192000,0,0,0,0,0,0,0,63864,2400,61464,0,65130,2329,62801,0,66494,2411,64083,0,67441,2050,65391
20779,90000,72000,0,0,0,0,0,0,0,6470,5000,1470,0,9882,5000,4882,0,28283,25000,3283,0,27893,22000,5893
20780,310000,248000,0,0,0,0,0,0,-2,1572,1572,0,-2,240,240,0,-2,-1226,970,-2196,-2,-2074,0,-2074
20781,180000,144000,0,0,0,0,0,0,-1,-18,0,-18,-1,-18,0,-18,-2,-18,0,-18,-2,-18,0,-18
20782,20000,16000,0,0,0,0,0,0,-2,390,390,0,-2,390,390,0,-2,780,780,0,-2,0,0,0
20783,200000,160000,0,0,0,0,0,0,-2,0,0,0,-2,0,0,0,-2,0,0,0,-2,0,0,0
20784,170000,136000,0,0,0,0,0,1,-1,396,3396,-3000,-1,792,792,0,-1,396,0,396,0,396,396,0
20785,20000,16000,0,0,0,0,0,1,0,9331,1023,8308,0,6927,0,6927,0,12457,12469,-12,-1,8900,598,8302
20786,100000,80000,0,1,0,0,0,1,2,99176,128,99048,2,80358,3011,77347,0,75007,3000,72007,0,76805,3200,73605
20787,130000,104000,0,0,0,0,0,1,-2,-2000,0,-2000,-2,-2000,0,-2000,-2,-2000,0,-2000,-2,-2000,0,-2000
20788,30000,24000,0,0,0,0,0,0,0,0,1000,-1000,0,0,0,0,-2,0,0,0,-2,0,0,0
20789,360000,288000,0,0,0,0,0,0,-2,-17,0,-17,-2,1815,1832,-17,-2,1035,1035,0,-2,460,460,0
20790,50000,40000,0,1,1,1,1,0,0,47612,2440,45172,0,48713,2396,46317,0,49295,1368,47927,0,49916,1401,48515
20791,220000,176000,0,0,0,0,0,0,2,136020,6824,129196,0,115942,2726,113216,0,54611,1239,53372,0,42363,2953,39410
20792,30000,24000,0,0,0,0,0,0,0,780,0,780,2,0,0,0,2,0,0,0,-2,0,0,0
20793,50000,40000,0,0,0,0,0,0,-2,0,0,0,-2,0,0,0,-2,0,0,0,-2,0,0,0
20794,170000,136000,0,0,0,0,0,1,2,86004,0,86004,2,64363,3957,60406,2,55912,0,55912,2,54500,2200,52300
20795,30000,24000,0,1,1,1,1,1,2,29703,3500,26203,2,28700,0,28700,2,28300,0,28300,0,25520,1000,24520
20796,50000,40000,0,0,0,0,0,1,2,28565,0,28565,2,26601,1500,25101,0,26391,1000,25391,0,27165,1200,25965
20797,220000,176000,0,0,0,0,0,0,0,24998,1417,23581,0,23965,1333,22632,0,23865,731,23134,0,23667,1019,22648
20798,130000,104000,0,1,0,0,0,1,2,126862,5000,121862,0,97925,3500,94425,0,100484,4055,96429,0,54125,10000,44125
20799,280000,224000,0,0,0,0,0,0,0,182099,6445,175654,0,185925,15934,169991,0,188224,7016,181208,0,186529,6753,179776
20800,50000,40000,0,0,0,0,0,0,0,20476,1700,18776,0,21781,2000,19781,0,17792,1000,16792,0,16657,702,15955
20801,530000,424000,0,0,0,0,0,0,0,235392,10000,225392,0,232640,10000,222640,0,239004,10000,229004,0,236657,9000,227657
20802,340000,272000,0,0,0,0,0,0,-2,11550,11554,-4,-2,11058,11058,0,-2,6912,6917,-5,-2,4125,4125,0
20803,20000,16000,0,0,0,1,1,0,0,15162,1271,13891,0,17891,3000,14891,0,18590,1000,17590,0,19286,1000,18286
20804,280000,224000,0,0,0,0,0,0,0,105492,4000,101492,0,104061,4000,100061,0,105202,4000,101202,0,107143,4368,102775
20805,140000,112000,0,1,1,1,1,0,0,144194,6600,137594,0,144802,5100,139702,0,147311,5460,141851,0,150207,5460,144747
20806,340000,272000,0,0,0,0,0,0,0,18921,2000,16921,0,21205,10000,11205,0,19810,5000,14810,0,13586,3000,10586
20807,100000,80000,0,0,0,0,0,0,-1,3611,3611,0,-1,631,631,0,-1,631,631,0,-1,0,0,0
20808,50000,40000,0,0,0,0,0,0,0,11524,1162,10362,0,10812,1000,9812,0,11643,1000,10643,0,12458,1000,11458
20809,20000,16000,0,0,0,0,0,0,0,6440,1300,5140,0,7373,1200,6173,0,8246,1000,7246,0,11095,3000,8095
20810,400000,320000,0,0,0,0,0,0,0,240244,241366,-1122,-1,287499,278006,9493,0,86684,425,86259,0,6796,34,6762
20811,50000,40000,0,0,0,0,0,0,0,36086,3011,33075,0,32945,1019,31926,0,29348,1019,28329,0,23570,2015,21555
20812,50000,40000,1,1,1,0,0,1,4,51847,0,51847,3,50307,0,50307,2,27707,0,27707,0,28479,974,27505
20813,140000,112000,0,1,0,0,0,1,0,128069,8000,120069,0,103319,5000,98319,0,105702,4000,101702,0,108619,4520,104099
20814,80000,64000,0,0,0,0,0,0,0,3537,1000,2537,0,0,0,0,0,0,0,0,-2,0,0,0
20815,30000,24000,0,1,0,0,0,0,0,26702,1278,25424,0,20115,671,19444,0,18426,870,17556,0,18013,879,17134
20816,50000,40000,0,0,0,0,0,0,2,28858,1200,27658,2,29289,1200,28089,2,28685,0,28685,2,30847,2800,28047
20817,100000,80000,0,0,0,0,0,1,0,96414,20000,76414,0,74161,5150,69011,0,45585,5000,40585,0,40178,10000,30178
20818,120000,96000,0,0,0,0,0,1,2,63937,150,63787,2,67290,5000,62290,2,68565,2500,66065,2,69784,2500,67284
20819,120000,96000,0,0,0,0,0,0,0,12027,5000,7027,0,5870,1000,4870,0,2994,2994,0,-1,-175,0,-175
20820,60000,48000,0,1,0,0,0,0,0,54439,0,54439,2,-561,0,-561,2,20115,20907,-792,-1,20000,400,19600
20821,240000,192000,0,0,0,0,0,0,-1,2223,2223,0,-1,31136,31136,0,-1,4367,100,4267,0,3632,0,3632
20822,60000,48000,0,0,0,0,0,0,0,13801,2245,11556,0,8038,161,7877,0,7340,7340,0,-1,-153,0,-153
20823,120000,96000,0,0,0,0,0,0,2,1210,1179,31,0,1799,1799,0,-1,1594,1594,0,-1,1255,1255,0
20824,300000,240000,0,0,0,0,0,0,0,26700,2000,24700,0,22554,2552,20002,0,11858,2000,9858,0,13838,3000,10838
20825,100000,80000,0,0,0,0,0,0,0,51644,5138,46506,0,45920,75,45845,2,21659,1032,20627,0,10861,32,10829
20826,20000,16000,0,0,0,0,0,1,4,14449,0,14449,3,15116,1200,13916,2,14582,0,14582,3,14206,0,14206
20827,340000,272000,0,0,0,0,0,0,0,71707,5104,66603,0,92695,92695,0,-1,86244,3114,83130,0,71538,2613,68925
20828,500000,400000,0,0,0,0,0,0,-2,31130,31178,-48,-2,3180,3180,0,-2,0,0,0,-2,5293,5293,0
20829,170000,136000,0,0,0,0,0,0,0,125864,20000,105864,0,112300,6000,106300,0,110371,5000,105371,0,113685,5000,108685
20830,100000,80000,0,0,0,0,0,0,-2,0,0,0,-2,960,960,0,-2,960,0,960,-2,1185,1185,0
20831,200000,160000,0,0,0,0,0,0,-1,8736,0,8736,2,26383,20000,6383,0,27959,10000,17959,0,20360,5000,15360
20832,60000,48000,0,0,0,0,0,0,0,44412,1847,42565,0,45402,1837,43565,0,35704,1139,34565,0,36524,1254,35270
20833,210000,168000,0,0,0,0,0,0,0,18885,1700,17185,0,20258,2000,18258,0,21610,2000,19610,0,23025,2000,21025
20834,290000,232000,0,0,0,0,0,0,0,29312,2000,27312,0,31404,3000,28404,0,31004,0,31004,0,29124,0,29124
20835,360000,288000,0,0,0,0,0,0,0,1145,1150,-5,-1,1169,1174,-5,-1,-1,0,-1,-1,-1,0,-1
20836,380000,304000,0,0,0,0,0,0,-1,1395,1395,0,-1,3261,3261,0,-1,0,0,0,-1,0,0,0
20837,50000,40000,0,0,0,0,0,0,0,39408,3000,36408,0,29689,947,28742,0,23879,1000,22879,0,23355,837,22518
20838,20000,16000,0,0,0,0,0,1,2,15865,1595,14270,2,16062,750,15312,2,15509,0,15509,2,16558,1452,15106
20839,110000,88000,0,0,0,0,0,1,0,38026,2000,36026,0,40332,3000,37332,0,41772,2000,39772,0,43052,2000,41052
20840,440000,352000,0,0,0,0,0,0,0,29098,5052,24046,0,21447,3163,18284,0,13547,5010,8537,0,16008,5000,11008
20841,30000,24000,0,0,0,0,0,1,2,0,0,0,2,0,0,0,-2,0,0,0,-2,0,0,0
20842,100000,80000,0,0,0,0,0,1,2,33543,0,33543,2,34260,1580,32680,0,36580,2900,33680,0,37347,1500,35847
20843,200000,160000,0,0,0,0,0,1,-1,326,326,0,-1,326,326,0,-1,326,326,0,-1,326,326,0
20844,320000,256000,0,0,0,0,0,0,-2,0,0,0,-2,0,0,0,-2,12974,12974,0,-2,0,0,0
20845,20000,16000,0,1,1,1,1,0,0,18586,1285,17301,0,18957,656,18301,0,19374,699,18675,0,19583,2000,17583
20846,50000,40000,0,1,1,1,1,0,0,45880,0,45880,2,48697,3900,44797,2,49504,1900,47604,2,50577,2000,48577
20847,30000,24000,0,1,1,0,0,0,0,30077,1900,28177,0,29841,1019,28822,0,20075,26,20049,0,12250,1131,11119
20848,50000,40000,0,0,0,0,0,0,2,38222,0,38222,2,13026,580,12446,0,13268,600,12668,0,13497,600,12897
20849,30000,24000,0,0,0,0,0,0,-1,390,390,0,-1,390,390,0,-1,390,390,0,-1,1320,1320,0
20850,390000,312000,0,0,0,0,0,0,0,-349,0,-349,-2,-675,0,-675,-2,-1001,0,-1001,-2,-1327,0,-1327
20851,20000,16000,0,0,0,0,0,0,-1,0,0,0,-1,780,780,0,-1,0,0,0,-1,780,780,0
20852,100000,80000,0,0,0,0,0,0,-2,740,2220,-1480,-1,1480,1480,0,-1,1480,740,740,0,740,0,740
20853,210000,168000,0,0,0,0,0,1,-1,325,325,0,-1,325,325,0,-1,325,325,0,-1,325,325,0
20854,120000,96000,1,1,1,1,1,0,0,160796,5700,155096,0,160168,5815,154353,0,156165,5500,150665,0,158850,5522,153328
20855,320000,256000,0,0,0,0,0,0,-1,22381,10162,12219,0,14685,14702,-17,-1,7511,7511,0,-1,6722,6722,0
20856,20000,16000,0,1,1,1,1,0,0,18488,1400,17088,0,19179,1000,18179,0,19720,1000,18720,0,19822,626,19196
20857,120000,96000,0,0,0,0,0,1,2,59760,3000,56760,0,60990,3000,57990,0,61960,3000,58960,0,65233,5000,60233
20858,20000,16000,0,0,0,0,0,1,0,16912,1321,15591,0,12698,1500,11198,0,11939,500,11439,0,12346,600,11746
20859,260000,208000,0,0,0,0,0,1,-1,6675,6818,-143,-1,1175,1180,-5,-1,888,892,-4,-1,4186,4207,-21
20860,50000,40000,0,0,0,0,0,0,0,28585,1585,27000,0,29736,1736,28000,0,21356,2356,19000,0,23403,2403,21000
20861,100000,80000,0,0,0,0,0,0,-1,1953,1953,0,-1,3053,3100,-47,-1,853,0,853,2,48280,48280,0
20862,80000,64000,0,0,0,0,0,0,2,390,390,0,-1,390,390,0,-1,390,390,0,-1,1320,1320,0
20863,20000,16000,0,0,0,0,1,0,0,15958,2200,13758,0,16168,900,15268,2,16268,500,15768,0,16600,332,16268
20864,240000,192000,0,0,0,0,0,0,0,22081,2000,20081,0,3428,5000,-1572,-1,67,0,67,-1,1832,3332,-1500
20865,50000,40000,0,1,1,0,0,0,0,49180,2000,47180,0,44941,2005,42936,0,20056,700,19356,0,19783,856,18927
20866,240000,192000,0,0,0,0,0,0,-2,24671,24685,-14,-2,2249,3535,-1286,-2,4505,4505,0,-2,11859,11859,0
20867,290000,232000,0,1,0,0,0,0,0,280510,40504,240006,0,198869,20000,178869,0,222558,30003,192555,0,134187,15004,119183
20868,110000,88000,0,0,0,0,0,0,0,9316,2500,6816,0,7681,1000,6681,0,8897,1500,7397,0,11729,3000,8729
20869,50000,40000,1,1,1,0,0,0,0,56250,2257,53993,0,57603,2000,55603,0,19336,2000,17336,0,18964,700,18264
20870,150000,120000,0,0,0,0,0,0,-1,18600,18600,0,-1,18400,0,18400,0,1527,1527,0,-1,1527,0,1527
20871,340000,272000,0,1,1,1,0,1,0,334316,10126,324190,0,307974,1000,306974,0,318240,10521,307719,0,289763,279000,10763
20872,250000,200000,0,0,0,0,0,0,0,92934,5000,87934,0,94002,3500,90502,0,92826,4000,88826,0,88001,4000,84001
20873,20000,16000,0,0,0,1,1,0,0,16263,2600,13663,0,17287,1300,15987,0,17699,700,16999,0,18413,1000,17413
20874,100000,80000,0,0,0,0,0,1,0,210,780,-570,-1,780,1930,-1150,-1,390,0,390,0,930,930,0
20875,130000,104000,0,0,0,0,0,0,-1,390,300,90,0,11,11,0,-1,1011,1000,11,0,381,300,81
20876,170000,136000,0,1,1,1,1,1,0,171794,7100,164694,0,166637,6100,160537,0,169021,6000,163021,0,164531,5600,158931
20877,300000,240000,0,0,0,0,0,0,-2,-158,0,-158,-2,-158,0,-158,-2,142,300,-158,-1,92,100,-8
20878,300000,240000,0,0,0,0,0,0,-2,6221,6252,-31,-1,33999,34042,-43,-1,24985,66,24919,0,25743,14062,11681
20879,100000,80000,0,1,0,0,0,1,2,100349,3927,96422,0,72391,2700,69691,0,72396,2800,69596,0,72668,3000,69668
20880,430000,344000,0,0,0,0,0,0,-2,1198,1198,0,-2,0,0,0,-2,538,538,0,-2,77543,77543,0
20881,30000,24000,0,0,0,0,0,1,0,12380,3222,9158,0,15158,3000,12158,0,15760,1000,14760,0,18985,3500,15485
20882,80000,64000,0,0,0,0,0,0,0,23466,3000,20466,0,25689,3000,22689,0,29820,4500,25320,0,22082,830,21252
20883,20000,16000,0,0,0,0,0,0,-1,174,174,0,-1,1200,1200,0,-1,1434,1434,0,-1,0,0,0
20884,80000,64000,0,0,0,0,0,1,-1,12261,0,12261,2,2393,2403,-10,-1,407,407,0,-1,2888,3176,-288
20885,310000,248000,0,0,0,0,0,0,0,215686,8054,207632,0,186680,7037,179643,0,82775,2010,80765,0,107595,50186,57409
20886,180000,144000,0,0,0,0,0,1,0,6894,1200,5694,0,8292,2000,6292,0,21866,21866,0,-1,0,0,0
20887,180000,144000,0,0,0,0,0,0,2,17657,1590,16067,0,17705,638,17067,0,19043,1628,17415,0,18589,0,18589
20888,190000,152000,0,1,1,1,0,0,0,179458,5902,173556,0,162482,7061,155421,0,158137,4902,153235,0,157956,6057,151899
20889,400000,320000,0,0,0,0,0,1,0,70557,0,70557,2,71867,3200,68667,0,72137,2750,69387,0,72955,3000,69955
20890,140000,112000,0,1,1,1,1,0,0,137440,11000,126440,0,126342,0,126342,2,130295,6000,124295,0,132945,5000,127945
20891,350000,280000,0,0,0,0,0,0,0,164481,20000,144481,0,198545,100048,98497,0,232543,60000,172543,0,165288,0,165288
20892,50000,40000,0,0,0,0,0,0,0,8474,1289,7185,0,8488,303,8185,0,8665,313,8352,0,8843,321,8522
20893,50000,40000,0,1,1,1,1,1,2,45741,3900,41841,2,45694,1000,44694,2,45645,1000,44645,2,46457,1700,44757
20894,50000,40000,0,1,1,1,1,1,0,45916,2500,43416,2,46566,1700,44866,2,45516,0,45516,2,46484,1700,44784
20895,130000,104000,0,0,0,0,0,0,0,78524,3916,74608,0,63421,3000,60421,0,60269,3000,57269,0,59984,3000,56984
20896,200000,160000,0,0,0,0,0,0,0,1341,1025,316,0,25068,32994,-7926,-1,52486,37042,15444,0,45047,2004,43043
20897,80000,64000,0,0,0,0,0,0,-1,0,0,0,-1,0,0,0,-2,7240,7240,0,-1,0,0,0
20898,230000,184000,0,1,1,1,1,0,2,224753,8500,216253,2,228022,8500,219522,2,232724,8500,224224,2,260472,32000,228472
20899,290000,232000,0,0,0,0,0,0,0,113434,6000,107434,0,115273,5000,110273,0,97040,5000,92040,0,89942,4000,85942
20900,50000,40000,0,0,0,0,0,0,0,37636,2075,35561,0,32034,1294,30740,0,28133,999,27134,0,23860,934,22926
20901,180000,144000,0,1,1,1,1,1,0,156282,8000,148282,0,161163,9000,152163,0,172190,14000,158190,0,148963,0,148963
20902,330000,264000,0,0,0,0,0,0,0,148420,3926,144494,0,152341,3966,148375,0,149998,3000,146998,0,-2,2,-4
20903,230000,184000,0,0,0,0,0,0,-1,1894,1894,0,-1,2528,2532,-4,-1,1865,1865,0,-1,1496,1496,0
20904,210000,168000,0,0,0,0,0,0,0,60713,2500,58213,0,61949,6259,55690,0,61908,5000,56908,0,59914,3000,56914
20905,70000,56000,0,0,0,0,0,0,0,12262,1500,10762,0,17046,5000,12046,0,17618,1000,16618,0,18321,1000,17321
20906,330000,264000,0,0,0,0,0,0,-1,0,0,0,-2,0,0,0,-2,0,0,0,-2,324,324,0
20907,80000,64000,0,1,1,1,1,0,0,73744,5012,68732,0,73572,3119,70453,0,73025,3007,70018,0,73087,3110,69977
20908,80000,64000,0,0,0,0,0,0,0,43134,3204,39930,0,38010,2017,35993,0,38510,3515,34995,0,38427,2506,35921
20909,200000,160000,0,0,0,0,0,0,-2,0,0,0,-2,0,0,0,-2,0,0,0,-2,0,0,0
20910,140000,112000,0,0,0,0,0,0,0,42823,2000,40823,0,25224,900,24324,0,26855,2000,24855,0,23783,10000,13783
20911,50000,40000,0,0,0,0,0,1,0,30508,1509,28999,0,31599,1600,29999,0,32262,1170,31092,0,32904,1177,31727
20912,30000,24000,0,0,0,0,0,0,0,13358,13358,0,-1,19332,18154,1178,0,18149,796,17353,0,11743,484,11259
20913,150000,120000,0,0,0,0,0,0,-1,2651,2659,-8,-1,2465,2472,-7,-1,4108,4116,-8,-1,4703,4703,0
20914,100000,80000,0,0,0,0,0,0,0,1494,1504,-10,-1,2200,2506,-306,-1,0,0,0,-1,0,0,0
20915,70000,56000,0,1,1,1,1,0,0,64801,3400,61401,0,64863,2200,62663,0,123234,2500,120734,0,60733,2500,58233
20916,200000,160000,0,1,0,0,1,1,0,190282,7527,182755,0,164492,4900,159592,0,165076,5100,159976,0,166008,5300,160708
20917,110000,88000,0,1,1,0,0,0,0,111851,4400,107451,0,153551,2683,150868,0,75749,5466,70283,0,77217,5000,72217
20918,50000,40000,0,0,0,0,0,0,0,40850,3000,37850,0,0,0,0,0,800,400,400,-1,400,20000,-19600
20919,340000,272000,0,0,0,0,0,0,0,0,0,0,-2,495,495,0,-1,495,495,0,-1,1528,1528,0
20920,150000,120000,0,0,0,0,0,0,0,73323,2614,70709,0,74783,2631,72152,0,76360,2735,73625,0,77868,2740,75128
20921,70000,56000,0,0,0,0,0,1,3,52927,3,52924,2,30432,2214,28218,2,16546,0,16546,2,16722,600,16122
20922,140000,112000,0,0,0,0,0,0,0,20880,3000,17880,0,23515,3000,20515,0,25122,2000,23122,0,24581,0,24581
20923,200000,160000,0,0,0,0,0,0,-1,17560,17560,0,-1,3300,3300,0,-1,1920,1920,0,-1,2731,2731,0
20924,30000,24000,0,1,0,1,1,0,2,24293,0,24293,2,25896,2010,23886,2,26435,1100,25335,2,25859,0,25859
20925,50000,40000,0,0,0,0,0,0,0,5177,5191,-14,-1,2071,6,2065,2,0,0,0,2,0,0,0
20926,50000,40000,0,0,0,0,0,0,-2,19766,20509,-743,-1,19661,1513,18148,-1,16740,1515,15225,-1,13272,1539,11733
20927,240000,192000,0,0,0,0,0,1,-1,3619,4099,-480,-1,3262,3500,-238,-1,3228,3228,0,-1,3127,3127,0
20928,50000,40000,0,0,0,0,0,0,0,26660,1500,25160,0,27416,1200,26216,0,27836,1010,26826,0,28473,1100,27373
20929,260000,208000,0,0,0,0,0,0,-2,1027,1027,0,-2,-103,103,-206,-2,-103,0,-103,-2,1047,1150,-103
20930,10000,8000,0,1,1,1,0,0,0,8869,800,8069,2,8901,240,8661,0,9838,1000,8838,0,6771,771,6000
20931,180000,144000,0,0,0,0,0,1,-2,0,0,0,-2,0,0,0,-2,0,0,0,-2,2150,2150,0
20932,150000,120000,0,0,0,0,0,0,-1,618,618,0,-1,150,150,0,-1,150,150,0,-1,377,227,150
20933,190000,152000,0,0,0,0,0,0,0,95406,5148,90258,0,95313,5313,90000,0,48731,3000,45731,0,87197,40000,47197
20934,80000,64000,0,0,0,0,0,0,0,30640,3000,27640,0,15917,3000,12917,0,35608,20000,15608,0,23470,767,22703
20935,200000,160000,0,0,0,0,0,1,-2,0,0,0,-2,0,0,0,-2,0,0,0,-2,0,0,0
20936,130000,104000,0,1,1,1,1,1,0,114413,5700,108713,0,116721,5692,111029,0,117795,4500,113295,0,120511,4850,115661
20937,50000,40000,0,0,0,0,0,0,0,20356,1303,19053,0,20241,698,19543,0,20304,719,19585,0,20119,716,19403
20938,110000,88000,0,0,0,0,0,0,0,18426,1500,16926,0,19117,1000,18117,0,19655,1000,18655,0,20329,1000,19329
20939,60000,48000,0,1,0,0,0,0,2,59182,1478,57704,0,27882,2000,25882,0,24574,1000,23574,0,22330,3000,19330
20940,200000,160000,0,0,0,0,0,0,-1,4078,4092,-14,-1,3000,3000,0,-1,3849,3849,0,-1,4479,4479,0
20941,240000,192000,0,0,0,0,0,0,2,626,626,0,2,626,626,0,-2,776,776,0,-2,783,783,0
20942,210000,168000,0,1,1,0,0,0,0,214545,9100,205445,0,215635,9900,205735,0,163741,6100,157641,0,162253,6100,156153
20943,20000,16000,0,1,1,0,0,0,0,19324,1200,18124,0,18692,559,18133,0,16035,532,15503,0,12262,424,11838
20944,220000,176000,0,0,0,0,0,0,-1,2900,2907,-7,-1,3392,3397,-5,-1,1421,1421,0,-1,915,915,0
20945,180000,144000,0,0,0,0,0,0,0,37895,2000,35895,0,36002,5000,31002,0,31173,1500,29673,0,30832,1500,29332
20946,200000,160000,0,0,0,0,0,0,0,0,0,0,0,0,0,0,-2,2621,2621,0,-1,-72,0,-72
20947,200000,160000,0,0,0,0,0,0,-1,1281,1281,0,-1,1328,1328,0,-1,1114,1114,0,-1,1205,1205,0
20948,60000,48000,0,0,0,0,0,0,-1,390,390,0,-1,0,0,0,-1,15666,16056,-390,-1,15915,1000,14915
20949,80000,64000,0,0,0,0,0,0,0,0,0,0,-2,2883,2883,0,-1,1856,1856,0,-1,2856,1000,1856
20950,20000,16000,0,0,0,0,0,0,0,16567,3100,13467,0,10411,0,10411,2,13057,3000,10057,0,14340,1500,12840
20951,80000,64000,0,0,0,0,0,0,0,64956,3000,61956,0,65183,3000,62183,0,65455,3000,62455,0,65683,2500,63183
20952,320000,256000,0,0,0,0,0,0,0,108597,18832,89765,0,65913,2117,63796,0,43805,2076,41729,0,33263,5045,28218
20953,360000,288000,0,0,0,0,0,0,-1,165,165,0,-1,300,300,0,-1,0,0,0,-1,1790,1790,0
20954,50000,40000,0,1,1,1,0,0,0,50073,2005,48068,0,49130,1367,47763,0,48658,1700,46958,0,0,0,0
20955,70000,56000,0,0,0,0,0,0,0,54571,2230,52341,0,42413,2004,40409,0,42946,1537,41409,0,43843,1589,42254
20956,200000,160000,0,0,0,0,0,0,-2,-390,0,-390,-2,-391,0,-391,-2,710,1101,-391,-1,321,1,320
20957,170000,136000,0,0,0,0,0,0,-2,113019,2672,110347,-2,60868,10,60858,-2,19458,0,19458,-2,90,90,0
20958,200000,160000,0,0,0,0,0,0,-2,0,0,0,-2,0,0,0,-2,7637,7637,0,-2,21186,21186,0
20959,20000,16000,0,0,1,1,1,1,0,16375,1270,15105,0,18905,2800,16105,0,19462,1000,18462,2,18967,0,18967
20960,30000,24000,0,0,0,0,0,1,0,13591,1300,12291,0,14530,1166,13364,0,14154,0,14154,2,15320,1400,13920
20961,360000,288000,0,0,0,0,0,0,-1,325,1000,-675,-1,765,765,0,-1,24851,24851,0,-1,414,414,0
20962,100000,80000,0,1,1,0,0,1,0,92686,3900,88786,0,94122,3854,90268,0,53720,2000,51720,0,54866,2000,52866
20963,230000,184000,0,0,0,0,0,0,0,32358,2713,29645,0,114443,106028,8415,0,111520,3827,107693,0,105779,5060,100719
20964,90000,72000,0,0,0,0,0,0,-1,200,200,0,-1,100,0,100,-1,9894,9894,0,-1,20699,20000,699
20965,30000,24000,0,0,0,0,0,1,2,1200,0,1200,2,1200,0,1200,5,1200,0,1200,5,600,0,600
20966,260000,208000,0,0,0,0,0,0,0,113462,5744,107718,0,98146,3756,94390,0,86452,2600,83852,0,58846,2500,56346
20967,10000,8000,0,0,0,0,0,0,-2,0,0,0,-2,0,0,0,-2,0,0,0,-2,0,0,0
20968,130000,104000,0,0,0,0,0,0,2,58917,3000,55917,2,60352,3000,57352,2,61167,2400,58767,2,63042,3000,60042
20969,200000,160000,0,0,0,0,0,0,-1,6015,6144,-129,-2,34314,34418,-104,-1,23403,230,23173,0,-1839,1839,-3678
20970,150000,120000,0,0,0,0,0,0,0,10000,1000,9000,0,8000,8000,0,-1,0,2000,-2000,-1,10000,10000,0
20971,180000,144000,0,0,0,0,0,0,0,145248,5044,140204,0,58142,6506,51636,0,22312,500,21812,0,7340,500,6840
20972,30000,24000,0,0,0,1,1,1,2,24182,1000,23182,2,26022,2550,23472,2,27462,2013,25449,2,27531,1108,26423
20973,30000,24000,0,0,0,0,0,1,0,19108,2272,16836,0,18503,0,18503,2,20100,1900,18200,2,19629,0,19629
20974,90000,72000,0,1,1,1,1,0,2,91442,7300,84142,2,89804,1144,88660,2,87213,3265,83948,0,90441,6788,83653
20975,130000,104000,0,0,0,0,0,0,-1,596,596,0,-1,1520,1520,0,-1,700,700,0,-1,3688,3688,0
20976,20000,16000,0,0,0,0,0,0,-1,5529,0,5529,2,4482,0,4482,0,0,1449,-1449,0,2030,2030,0
20977,50000,40000,0,0,0,0,0,0,2,25440,1925,23515,0,26191,28293,-2102,-1,25193,0,25193,2,25742,1100,24642
20978,50000,40000,0,0,0,0,0,0,0,29476,1500,27976,0,4011,1000,3011,0,1000,1000,0,-1,0,0,0
20979,70000,56000,0,0,0,0,0,0,0,55018,7000,48018,0,27430,5505,21925,0,25498,3000,22498,0,27678,4000,23678
20980,120000,96000,0,0,1,1,0,1,0,118675,125000,-6325,-1,120047,4065,115982,0,100637,4000,96637,0,79613,3000,76613
20981,140000,112000,0,0,0,0,0,0,-1,4876,4876,0,-1,4666,4666,0,-1,4884,4884,0,-1,4666,4666,0
20982,50000,40000,0,0,0,0,0,0,0,26945,1500,25445,0,27541,3038,24503,0,27689,976,26713,0,28868,2000,26868
20983,450000,360000,0,0,0,0,0,0,-1,112841,62841,50000,0,112603,2000,110603,0,90202,0,90202,0,39564,1000,38564
20984,120000,96000,0,0,0,0,0,0,-2,0,0,0,-2,3663,3663,0,-1,3663,0,3663,0,0,0,0
20985,430000,344000,0,0,0,0,0,0,-2,4353,4391,-38,-2,471,473,-2,-2,5779,5808,-29,-2,4468,4489,-21
20986,140000,112000,0,0,0,0,0,0,-1,7146,7146,0,-1,5930,5930,0,-1,5280,5280,0,-1,5930,5930,0
20987,310000,248000,0,0,0,0,0,0,0,144855,6000,138855,0,149146,7000,142146,0,198027,75593,122434,0,202293,7000,195293
20988,170000,136000,0,0,1,0,0,0,0,139639,5300,134339,0,146931,10000,136931,0,98827,3500,95327,0,100833,3500,97333
20989,360000,288000,0,0,0,0,0,0,0,102837,7837,95000,0,110891,10185,100706,0,53827,5126,48701,0,14589,2898,11691
20990,200000,160000,0,0,1,1,1,0,2,193777,56100,137677,2,189225,5,189220,3,192304,7269,185035,2,188695,28,188667
20991,130000,104000,0,1,0,0,0,0,0,119008,3941,115067,0,46659,1742,44917,0,47588,1671,45917,0,47698,1712,45986
20992,130000,104000,0,0,0,0,0,0,0,81231,4000,77231,0,81983,3000,78983,0,83773,3146,80627,0,85532,3260,82272
20993,180000,144000,0,1,0,0,0,0,2,164619,7100,157519,0,133372,5500,127872,0,92101,3500,88601,0,60389,3000,57389
20994,160000,128000,0,0,0,0,0,0,-1,1560,1560,0,-1,1170,0,1170,0,780,0,780,0,390,0,390
20995,500000,400000,0,0,0,0,0,0,-1,1416,1416,0,-1,1416,1416,0,-1,1416,1416,0,-1,1416,1416,0
20996,500000,400000,0,0,0,0,0,0,0,47403,47221,182,0,36067,5026,31041,0,46054,16005,30049,0,34290,2000,32290
20997,330000,264000,0,0,0,0,0,0,-2,10756,10776,-20,-2,0,0,0,-2,442,442,0,-2,0,0,0
20998,20000,16000,0,0,0,1,1,1,2,13124,1200,11924,0,18859,7500,11359,0,19828,1015,18813,0,36666,15000,21666
20999,360000,288000,0,0,0,0,0,1,-1,64644,75720,-11076,-1,125984,62520,63464,0,106584,17000,89584,0,125557,132200,-6643
21000,80000,64000,0,0,0,0,0,0,0,26605,1500,25105,0,27920,1762,26158,0,28358,1200,27158,0,29000,1250,27750
21001,120000,96000,0,0,0,0,0,1,0,90834,4203,86631,0,95499,7100,88399,0,93857,0,93857,2,99504,7396,92108
21002,150000,120000,0,0,0,0,0,0,0,78940,3073,75867,0,73785,2584,71201,0,70787,1260,69527,0,59526,1357,58169
21003,80000,64000,0,0,0,0,0,0,0,59692,3000,56692,0,58055,1844,56211,0,44578,1567,43011,0,45889,2000,43889
21004,640000,512000,0,0,0,0,0,0,-2,22238,22243,-5,-2,9877,9877,0,-2,10110,10110,0,-2,23910,24616,-706
21005,30000,24000,0,0,0,0,0,0,2,23217,1600,21617,0,21295,1500,19795,0,19076,1000,18076,0,9292,1720,7572
21006,80000,64000,0,0,0,0,0,0,-2,0,0,0,-2,0,0,0,-2,0,0,0,-2,0,0,0
21007,90000,72000,0,1,1,0,0,1,0,87343,3500,83843,0,89786,4200,85586,0,67803,2426,65377,0,69324,2613,66711
21008,260000,208000,0,0,0,0,0,0,0,2786,2786,0,-2,-14,14,-28,-2,-14,0,-14,-2,12074,12088,-14
21009,30000,24000,0,0,0,0,0,1,2,18089,2300,15789,2,17504,0,17504,2,18727,1500,17227,2,18279,0,18279
21010,130000,104000,0,0,0,0,0,0,0,84906,4012,80894,0,85690,3885,81805,0,85892,3158,82734,0,87996,4704,83292
21011,150000,120000,0,0,0,0,0,0,0,59684,2812,56872,0,59501,2599,56902,0,59075,2143,56932,0,59171,2208,56963
21012,50000,40000,0,1,1,1,1,0,0,50711,3082,47629,0,50389,1760,48629,0,49030,1926,47104,0,50045,1980,48065
21013,130000,104000,0,0,0,0,0,1,0,58860,2000,56860,0,45207,2000,43207,0,41556,2000,39556,0,42455,1590,40865
21014,190000,152000,0,0,0,0,0,0,-1,7517,7523,-6,-1,2168,2168,0,-1,4918,5300,-382,-1,5300,3000,2300
21015,130000,104000,0,0,0,0,0,0,0,22386,2386,20000,0,24296,2296,22000,0,25436,1536,23900,0,27451,2451,25000
21016,70000,56000,0,0,0,0,0,1,0,45020,3582,41438,0,44006,0,44006,2,46905,3601,43304,2,46012,0,46012
21017,280000,224000,0,0,0,0,0,0,0,107293,4743,102550,0,6283,1640,4643,0,5783,0,5783,0,5283,0,5283
21018,60000,48000,0,0,0,0,0,0,0,46956,1650,45306,0,40671,3200,37471,0,38188,1500,36688,0,38652,1500,37152
21019,400000,320000,0,0,0,0,0,0,-1,49415,49415,0,-1,0,0,0,-1,0,0,0,-2,0,0,0
21020,110000,88000,0,1,1,1,0,0,0,106637,4000,102637,2,106665,4000,102665,0,92417,3500,88917,0,90730,9500,81230
21021,180000,144000,0,0,0,0,0,0,2,4722,31,4691,2,8643,5000,3643,0,7783,1000,6783,0,12398,5000,7398
21022,30000,24000,0,1,1,1,1,1,2,27536,1600,25936,2,28203,1400,26803,2,29048,1600,27448,4,29903,1600,28303
21023,290000,232000,0,0,0,0,0,1,0,230891,10000,220891,0,232778,8000,224778,0,235004,10000,225004,0,226959,8000,218959
21024,300000,240000,0,0,0,0,0,0,-1,0,0,0,-2,0,0,0,-2,0,0,0,-2,0,0,0
21025,60000,48000,0,0,0,0,0,0,-1,780,0,780,3,390,0,390,2,390,390,0,-1,390,390,0
21026,30000,24000,0,0,0,0,0,1,2,17141,0,17141,2,20730,4200,16530,2,20116,0,20116,4,19512,0,19512
21027,490000,392000,0,0,0,0,0,0,0,144853,7415,137438,0,132268,7025,125243,0,118899,44324,74575,0,79223,3119,76104
21028,150000,120000,0,0,0,0,0,0,0,97642,5000,92642,0,70371,2499,67872,0,72257,3000,69257,0,72536,2789,69747
21029,330000,264000,0,0,0,0,0,0,0,187820,12000,175820,0,190202,7000,183202,0,194964,8000,186964,0,199008,7287,191721
21030,180000,144000,0,0,0,0,0,0,0,72560,5000,67560,0,76169,5000,71169,0,77988,3000,74988,0,69293,5000,64293
21031,80000,64000,0,0,0,0,0,0,-2,3459,3459,0,-2,528,528,0,-2,6918,6918,0,-2,0,0,0
21032,110000,88000,0,0,0,0,0,0,0,46002,1800,44202,0,44701,1700,43001,0,42706,1500,41206,0,43513,1600,41913
21033,30000,24000,0,0,0,0,0,1,2,14188,1230,12958,0,7058,1000,6058,0,7976,1000,6976,0,7734,0,7734
21034,110000,88000,0,1,1,1,1,0,0,112974,5900,107074,0,108390,5500,102890,0,107180,5000,102180,0,107309,5000,102309
21035,80000,64000,0,1,1,1,1,0,0,74792,4000,70792,0,75825,3400,72425,0,77454,4000,73454,0,78862,3349,75513
21036,500000,400000,0,0,0,0,0,0,0,29717,5000,24717,0,36485,8006,28479,0,6174,2,6172,0,7148,2021,5127
21037,360000,288000,0,0,0,0,0,0,-1,-150,0,-150,-1,1692,2538,-846,-1,846,0,846,2,846,846,0
21038,300000,240000,0,0,0,0,0,0,-1,236,236,0,-1,766,800,-34,-1,227,227,0,-1,0,0,0
21039,140000,112000,0,0,0,0,0,0,-2,310,310,0,-1,2361,2361,0,-1,854,854,0,-1,565,565,0
21040,210000,168000,0,0,0,0,0,0,-2,0,0,0,-2,0,0,0,-2,0,0,0,-2,0,0,0
21041,50000,40000,0,0,0,0,0,0,-1,390,390,0,-1,390,390,0,-1,390,390,0,-1,390,390,0
21042,130000,104000,0,0,0,0,0,0,0,14849,3000,11849,0,17585,3000,14585,0,17990,1000,16990,0,20682,3000,17682
21043,160000,128000,0,0,0,0,0,0,0,45856,0,45856,2,48818,4000,44818,2,49640,1700,47940,2,48737,0,48737
21044,360000,288000,0,0,0,0,0,0,-1,0,0,0,-2,0,0,0,-2,0,0,0,-2,0,0,0
21045,290000,232000,0,0,0,0,0,0,-1,2154,2154,0,-1,1492,1518,-26,-1,229,229,0,-2,943,943,0
21046,20000,16000,0,1,1,1,1,1,0,17705,1277,16428,0,19228,1800,17428,0,18804,0,18804,2,19316,1000,18316
21047,260000,208000,0,0,0,0,0,1,2,12117,12117,0,-1,9620,2,9618,0,8690,0,8690,0,11744,3054,8690
21048,80000,64000,0,0,0,0,0,0,0,47620,1700,45920,0,48571,1614,46957,0,48525,1600,46925,0,43987,1600,42387
21049,280000,224000,0,0,0,0,0,0,0,140466,5195,135271,0,142417,5098,137319,0,126321,4319,122002,0,117613,4209,113404
21050,500000,400000,0,0,0,0,0,0,-1,17481,17512,-31,-1,12021,12021,0,-1,132906,132906,0,-1,122256,0,122256
21051,200000,160000,0,0,0,0,0,0,0,3559,2018,1541,0,22458,22491,-33,-1,20888,7521,13367,0,17875,2000,15875
21052,310000,248000,0,0,0,0,0,0,-1,0,0,0,-1,942,942,0,-1,1645,1645,0,-1,1287,1287,0
21053,240000,192000,0,0,0,0,0,0,0,0,0,0,-2,0,0,0,-2,0,0,0,-2,0,0,0
21054,440000,352000,0,0,0,0,0,1,-1,417,1937,-1520,-1,2217,1800,417,3,1321,0,1321,2,8879,8480,399
21055,200000,160000,0,0,0,0,0,0,-2,517,517,0,-2,11212,11214,-2,-2,19090,19116,-26,-2,24949,24949,0
21056,80000,64000,0,0,0,0,0,1,-2,0,0,0,-2,0,0,0,-2,0,0,0,-2,0,0,0
21057,120000,96000,0,0,0,0,0,0,-1,6389,6389,0,-1,4520,4520,0,-1,8708,8708,0,-1,1520,1520,0
21058,140000,112000,0,0,0,0,0,0,-1,4233,4233,0,-1,857,857,0,-1,325,325,0,-1,325,325,0
21059,90000,72000,0,0,0,0,0,0,-2,188,188,0,-2,1708,1708,0,-2,1783,1783,0,-2,3933,3933,0
21060,300000,240000,0,0,0,0,0,1,-1,780,0,780,3,390,0,390,2,390,390,0,-1,390,390,0
21061,200000,160000,0,0,0,0,0,0,-1,5300,5300,0,-1,5300,0,5300,0,0,0,0,0,0,0,0
21062,230000,184000,0,0,0,0,0,0,-2,1257,1257,0,-2,0,0,0,-2,1169,1169,0,-2,641,641,0
21063,230000,184000,0,0,0,0,0,0,0,142049,10000,132049,0,106677,10000,96677,0,88091,3000,85091,0,60929,2000,58929
21064,90000,72000,0,0,0,0,0,0,0,2290,1005,1285,0,1764,1764,0,-1,1728,1728,0,-1,1954,1954,0
21065,470000,376000,0,0,0,0,0,0,-1,22816,22816,0,-1,2360,2360,0,-1,4206,4356,-150,-1,5527,5527,0
21066,150000,120000,0,1,1,1,1,0,0,133616,3800,129816,0,136378,3900,132478,0,139219,4000,135219,0,142172,4100,138072
21067,30000,24000,0,1,1,1,1,0,0,27167,0,27167,2,27440,3000,24440,0,30117,6000,24117,0,29523,0,29523
21068,90000,72000,0,0,1,1,1,0,0,73798,3158,70640,0,74682,2600,72082,0,79586,6000,73586,0,78261,0,78261
21069,240000,192000,1,1,0,0,0,1,0,355496,9500,345996,0,176402,12448,163954,0,174440,6155,168285,0,172806,6453,166353
21070,470000,376000,0,0,0,0,0,0,-2,0,0,0,-2,1632,1632,0,-1,141186,141190,-4,-1,143916,6000,137916
21071,240000,192000,0,1,0,0,0,0,0,213580,7866,205714,0,191771,5602,186169,0,166239,6118,160121,0,146584,6023,140561
21072,20000,16000,0,1,1,1,0,0,0,18298,1737,16561,0,18761,1200,17561,0,17781,0,17781,0,10674,0,10674
21073,150000,120000,0,0,0,0,0,1,0,43045,3000,40045,0,40813,1452,39361,0,42164,5000,37164,0,43465,5000,38465
21074,500000,400000,0,0,0,0,0,0,0,337816,15022,322794,0,316739,20121,296618,0,167616,5925,161691,0,364940,35069,329871
21075,20000,16000,0,0,0,0,0,0,-1,1769,1769,0,-1,2582,1000,1582,0,3184,800,2384,0,3974,1000,2974
21076,380000,304000,0,0,0,0,0,0,0,105800,6068,99732,0,52296,2462,49834,0,196448,168159,28289,0,168405,5248,163157
21077,20000,16000,0,1,1,1,1,0,2,19309,816,18493,2,18703,0,18703,2,18937,685,18252,0,20724,2100,18624
21078,120000,96000,0,0,0,0,0,0,-1,788,788,0,-1,0,0,0,-1,0,0,0,-2,495,495,0
21079,230000,184000,0,0,0,0,0,0,-2,2652,2652,0,-2,12097,12097,0,-2,30096,30096,0,-2,8961,8961,0
21080,360000,288000,0,0,0,0,0,0,-2,0,0,0,-2,0,0,0,-2,0,0,0,-2,3078,3078,0
21081,210000,168000,0,0,0,0,0,1,-2,0,0,0,-2,0,0,0,-2,0,0,0,-2,0,0,0
21082,130000,104000,0,1,1,1,1,0,0,119728,15107,104621,0,121140,5000,116140,3,117767,0,117767,3,115640,0,115640
21083,150000,120000,0,1,1,0,0,0,0,151864,6012,145852,0,147485,5012,142473,0,106607,5000,101607,0,98109,4000,94109
21084,10000,8000,0,0,1,0,0,1,2,8630,1400,7230,0,8630,0,8630,0,7850,0,7850,0,8150,1600,6550
21085,70000,56000,0,0,0,0,0,1,2,51809,4000,47809,2,50675,0,50675,2,54839,5000,49839,2,53803,0,53803
21086,90000,72000,0,0,0,0,0,0,0,37433,0,37433,2,38507,1700,36807,0,39468,1600,37868,0,40183,1500,38683
21087,240000,192000,0,0,0,0,0,0,-2,4234,4234,0,-2,7118,7118,0,-2,8187,8187,0,-2,8708,8708,0
21088,110000,88000,0,0,0,0,0,0,0,49104,2000,47104,0,51202,3000,48202,0,50289,2000,48289,0,50528,2000,48528
21089,410000,328000,0,0,0,0,0,0,-2,333,333,0,-2,1019,1019,0,-1,2218,2218,0,-1,1216,1216,0
21090,140000,112000,0,0,0,0,0,0,-1,2010,2010,0,-1,0,0,0,-1,0,0,0,-2,0,0,0
21091,80000,64000,0,0,0,0,0,1,2,29060,13,29047,2,31133,4000,27133,2,24135,5,24130,2,22970,2005,20965
21092,360000,288000,0,0,0,0,0,0,-1,3278,3278,0,-1,580,580,0,-1,580,0,580,0,0,0,0
21093,80000,64000,0,0,0,0,0,0,-1,264,264,0,-1,264,264,0,-1,264,264,0,-1,414,414,0
21094,360000,288000,0,0,0,0,0,0,-2,0,0,0,-2,733,733,0,-1,0,0,0,-1,1307,1307,0
21095,150000,120000,0,0,0,0,0,0,0,46505,2500,44005,0,49103,3000,46103,0,51698,3000,48698,0,52549,1546,51003
21096,290000,232000,0,1,0,0,0,0,0,261236,29000,232236,0,223092,10000,213092,0,185522,8000,177522,0,170190,30000,140190
21097,140000,112000,1,1,1,1,1,1,3,189659,6500,183159,3,185477,0,185477,2,189351,6497,182854,0,193122,6536,186586
21098,10000,8000,0,0,1,1,1,0,0,8751,1146,7605,0,8925,320,8605,0,9111,330,8781,0,9360,400,8960
21099,20000,16000,0,0,0,0,0,1,-2,0,0,0,-2,0,0,0,-2,0,0,0,-2,0,0,0
21100,210000,168000,0,0,0,0,0,0,-1,33658,33658,0,-1,42551,10551,32000,0,51800,10000,41800,0,2295,2295,0
21101,80000,64000,0,1,0,0,0,1,0,79761,3500,76261,0,30286,1100,29186,0,29898,1100,28798,0,30364,1200,29164
21102,30000,24000,0,1,0,0,0,0,0,31237,1676,29561,0,13511,1223,12288,0,13781,493,13288,0,14070,511,13559
21103,50000,40000,0,0,0,0,0,0,0,9922,1200,8722,0,8633,1800,6833,0,8385,0,8385,2,7862,1600,6262
21104,300000,240000,0,0,0,0,0,0,-2,0,0,0,-2,0,0,0,-2,0,0,0,-2,0,0,0
21105,210000,168000,0,0,0,0,0,0,-1,59367,20176,39191,0,29583,6793,22790,0,26756,20112,6644,0,29553,29676,-123
21106,320000,256000,0,0,0,0,0,0,0,97996,2000,95996,0,27996,2000,25996,0,1712,2000,-288,-1,-216,0,-216
21107,150000,120000,0,0,0,0,0,0,0,31434,1718,29716,0,26518,1049,25469,0,21042,1500,19542,0,16540,2000,14540
21108,240000,192000,0,0,0,0,0,0,0,1425,1467,-42,-1,10591,10594,-3,-1,1793,1802,-9,-2,1509,1516,-7
21109,230000,184000,0,1,1,1,1,0,0,231272,10500,220772,0,228653,10000,218653,0,225471,9000,216471,0,224853,8200,216653
21110,200000,160000,0,0,0,0,0,0,-2,0,0,0,-2,0,0,0,-2,0,0,0,-2,0,0,0
21111,220000,176000,0,0,0,0,0,0,2,156531,7000,149531,2,154721,2300,152421,3,150627,0,150627,2,154034,5600,148434
21112,150000,120000,0,0,0,0,0,0,-1,1106,1106,0,-1,1323,1323,0,-1,2098,2098,0,-1,0,0,0
21113,220000,176000,0,0,0,0,0,0,0,96750,18720,78030,0,71616,37800,33816,0,65415,7096,58319,0,57914,12000,45914
21114,60000,48000,0,1,0,0,0,0,0,58160,3016,55144,0,51237,5011,46226,0,29999,1005,28994,0,28972,1000,27972
21115,20000,16000,0,0,0,0,0,1,2,0,0,0,2,390,390,0,-1,1170,1170,0,-1,780,0,780
21116,170000,136000,0,0,0,0,0,0,-1,416,0,416,2,2304,2304,0,-1,323,0,323,-1,-1092,0,-1092
21117,280000,224000,0,0,0,0,0,1,0,123909,4700,119209,0,124078,4210,119868,0,124489,4455,120034,0,114110,4109,110001
21118,390000,312000,0,0,0,0,0,1,-2,0,0,0,-2,0,0,0,-2,0,0,0,-2,0,0,0
21119,80000,64000,0,1,0,0,0,0,0,78707,4000,74707,0,38084,2000,36084,0,38910,2000,36910,0,39691,2000,37691
21120,200000,160000,0,0,0,0,0,0,-1,988,991,-3,-1,1805,1817,-12,-1,72551,72836,-285,-1,90988,30300,60688
21121,200000,160000,0,0,0,0,0,0,-1,326,326,0,-1,326,326,0,-1,326,326,0,-1,802,802,0
21122,160000,128000,1,1,0,0,0,1,0,170142,5289,164853,0,119529,4022,115507,0,122059,4195,117864,0,111378,3986,107392
21123,20000,16000,0,0,0,0,0,0,-1,9849,9849,0,-1,3870,3870,0,-1,6630,6700,-70,-1,1170,4780,-3610
21124,50000,40000,0,0,0,0,0,0,0,17354,2000,15354,0,18157,1000,17157,0,18952,1000,17952,0,14036,1000,13036
21125,80000,64000,0,1,1,0,0,1,0,73783,2000,71783,2,68909,0,68909,2,66308,5065,61243,0,60687,6235,54452
21126,50000,40000,0,1,0,0,0,0,0,47963,1703,46260,0,33499,1304,32195,0,19227,680,18547,0,19334,696,18638
21127,200000,160000,0,0,0,0,0,0,-1,1099,1099,0,-1,1099,1099,0,-1,1099,1099,0,-1,1099,1099,0
21128,20000,16000,0,0,1,1,1,1,0,16623,1282,15341,0,17634,1293,16341,0,17985,644,17341,0,18362,667,17695
21129,80000,64000,0,0,0,0,0,1,0,25919,25919,0,-1,18449,18449,0,-1,2655,2655,0,-1,20808,20808,0
21130,30000,24000,0,1,1,1,1,1,0,27435,2000,25435,0,28270,2000,26270,0,28632,1500,27132,0,30193,2400,27793
21131,380000,304000,0,0,0,0,0,0,-1,32510,32789,-279,-1,474,474,0,-1,25877,25877,0,-1,45038,20000,25038
21132,170000,136000,0,0,0,0,0,0,-2,996,996,0,-2,35490,35490,0,-1,6000,6000,0,-1,5350,5350,0
21133,180000,144000,0,0,0,0,0,0,-1,2727,2727,0,-1,5507,5507,0,-1,1382,0,1382,0,538,538,0
21134,30000,24000,0,0,0,0,0,0,-1,390,390,0,-1,390,390,0,-1,1438,1438,0,-1,719,0,719
21135,180000,144000,0,0,0,0,0,0,0,82849,5006,77843,0,78064,5000,73064,0,73437,5005,68432,0,108072,42500,65572
21136,400000,320000,0,0,0,0,0,1,0,246475,8000,238475,0,252429,9000,243429,0,257510,8200,249310,0,262931,8500,254431
21137,80000,64000,0,0,0,0,0,0,-1,64047,2051,61996,0,48107,2002,46105,0,48620,2013,46607,0,45280,2004,43276
21138,410000,328000,0,0,0,0,0,0,0,44596,3015,41581,0,44016,3549,40467,0,38728,5029,33699,0,36540,4325,32215
21139,70000,56000,0,0,0,0,0,0,0,25971,1229,24742,0,14859,519,14340,0,14930,687,14243,0,15091,557,14534
21140,200000,160000,0,0,0,0,0,0,2,103019,9000,94019,2,100464,0,100464,2,102844,4000,98844,0,105505,4500,101005
21141,240000,192000,0,0,0,0,0,0,0,11138,5015,6123,0,11481,5000,6481,0,18265,10000,8265,0,4365,2000,2365
21142,110000,88000,0,1,1,1,1,0,0,108567,5500,103067,0,110772,5500,105272,0,111946,4500,107446,0,111853,4400,107453
21143,120000,96000,0,0,0,0,0,1,2,53582,3500,50082,2,58310,6200,52110,2,57150,358,56792,4,55961,0,55961
21144,30000,24000,0,0,0,0,0,1,2,14635,0,14635,2,15318,1226,14092,2,14930,0,14930,2,16562,1882,14680
21145,70000,56000,0,0,0,0,0,1,2,28650,2708,25942,2,27590,0,27590,2,27850,1010,26840,0,28085,1013,27072
21146,320000,256000,0,0,0,0,0,0,-1,2197,2203,-6,-1,3934,3957,-23,-1,5541,5557,-16,-1,3141,3150,-9
21147,160000,128000,0,0,0,0,0,0,-1,-2697,0,-2697,-2,2303,5000,-2697,-1,6182,5000,1182,0,1654,1500,154
21148,60000,48000,0,0,0,0,0,1,-1,326,326,0,-1,326,326,0,-1,476,476,0,-1,326,326,0
21149,50000,40000,0,1,0,0,0,0,0,48833,5000,43833,0,31769,2500,29269,0,9713,500,9213,0,9521,317,9204
21150,260000,208000,0,0,0,0,0,0,-2,-20320,2631,-22951,-2,-20320,0,-20320,-2,-20320,0,-20320,-2,-20320,0,-20320
21151,80000,64000,0,0,0,0,0,0,-1,0,390,-390,-1,780,780,0,-1,0,0,0,-1,0,0,0
21152,10000,8000,0,0,1,1,1,1,2,8950,2500,6450,2,8658,0,8658,2,9413,900,8513,2,9117,0,9117
21153,360000,288000,0,0,0,0,0,1,-2,0,0,0,-2,0,0,0,-2,0,0,0,-2,0,0,0
21154,10000,8000,0,0,0,0,0,0,-1,7929,4000,3929,0,7693,207,7486,0,6838,229,6609,0,3486,70,3416
21155,210000,168000,0,0,0,0,0,0,0,31202,5000,26202,0,36968,8000,28968,0,32141,0,32141,2,35018,5000,30018
21156,210000,168000,0,0,0,0,0,0,-1,1443,1443,0,-1,1443,1443,0,-1,1443,1443,0,-1,1443,1443,0
21157,50000,40000,0,0,0,0,0,0,0,5918,1000,4918,0,6918,1000,5918,0,6941,1500,5441,0,4756,2150,2606
21158,30000,24000,0,1,1,1,0,1,0,29717,2595,27122,0,28812,1200,27612,0,28762,1020,27742,0,10404,10404,0
21159,90000,72000,0,0,0,0,0,0,0,74030,3471,70559,0,70198,3199,66999,0,71330,2964,68366,0,65479,2718,62761
21160,110000,88000,0,1,1,1,1,0,0,111954,4300,107654,0,111771,4164,107607,0,111703,4500,107203,0,111864,4200,107664
21161,180000,144000,0,0,0,0,0,0,0,0,0,0,0,0,0,0,-2,0,0,0,-2,0,0,0
21162,150000,120000,0,0,0,0,0,0,0,52807,10116,42691,0,34199,5000,29199,0,32061,6000,26061,0,23682,3000,20682
21163,50000,40000,0,0,0,0,0,0,-2,0,0,0,-2,0,0,0,-2,0,0,0,-2,0,0,0
21164,210000,168000,0,0,0,0,0,1,0,2753,1000,1753,0,291,0,291,0,582,582,0,-1,291,0,291
21165,140000,112000,0,0,0,0,0,0,0,83421,4251,79170,0,79088,4500,74588,0,73360,3000,70360,0,67700,2500,65200
21166,180000,144000,0,0,0,0,0,0,-2,-2,0,-2,-2,-2,0,-2,-2,-2,0,-2,-2,-2,0,-2
21167,150000,120000,0,1,1,1,1,0,0,153103,7000,146103,0,152060,5200,146860,0,151470,5500,145970,0,151974,6300,145674
21168,110000,88000,0,0,0,0,0,0,-2,0,0,0,-2,0,0,0,-2,0,0,0,-2,0,0,0
21169,150000,120000,0,0,0,0,0,0,-2,0,0,0,-2,0,0,0,-2,0,0,0,-2,300,300,0
21170,20000,16000,0,0,0,0,0,0,0,4298,1032,3266,0,3882,1000,2882,0,3563,72,3491,0,3242,369,2873
21171,50000,40000,0,1,0,0,0,0,0,45210,1251,43959,0,29917,848,29069,0,17859,872,16987,0,0,0,0
21172,120000,96000,0,0,0,0,0,0,0,16721,0,16721,2,17400,7313,10087,0,26087,15000,11087,0,19577,0,19577
21173,350000,280000,0,0,0,0,0,0,0,23489,6000,17489,0,29037,6000,23037,0,36213,8027,28186,0,38163,8000,30163
21174,230000,184000,0,0,0,0,0,0,0,713,720,-7,-1,1344,1344,0,-1,3786,4674,-888,-1,6571,6571,0
21175,260000,208000,0,0,0,0,0,0,0,85346,3712,81634,0,87620,3800,83820,0,89566,3500,86066,0,91502,3400,88102
21176,200000,160000,0,0,0,0,0,0,2,6769,2491,4278,2,2487,0,2487,2,1857,0,1857,0,0,0,0
21177,20000,16000,0,1,1,1,1,1,2,19384,0,19384,2,19405,600,18805,0,19978,847,19131,0,19791,670,19121
21178,260000,208000,0,0,0,0,0,0,0,17902,1279,16623,0,18258,635,17623,0,18640,657,17983,0,18956,669,18287
21179,280000,224000,0,0,0,0,0,1,2,2482,0,2482,2,2482,0,2482,2,2482,0,2482,2,2482,0,2482
21180,200000,160000,0,0,0,0,0,1,-1,8720,8860,-140,-1,4410,4410,0,-1,1186,1186,0,-1,28679,28679,0
21181,20000,16000,0,0,0,0,0,1,2,2400,0,2400,2,2400,0,2400,7,2400,0,2400,7,2400,0,2400
21182,300000,240000,0,0,0,0,0,0,-2,0,0,0,-2,0,0,0,-2,0,0,0,-2,0,0,0
21183,140000,112000,0,0,0,0,0,0,0,92775,4270,88505,0,93606,3500,90106,0,95301,3606,91695,0,96653,3500,93153
21184,50000,40000,0,0,0,0,0,0,2,38954,1500,37454,2,39618,1600,38018,2,38852,0,38852,2,39553,1500,38053
21185,250000,200000,0,0,0,0,0,0,-2,268,268,0,-2,0,0,0,-2,0,0,0,-2,0,0,0
21186,160000,128000,0,1,1,1,1,0,0,140745,5211,135534,0,139923,5000,134923,0,140815,5000,135815,0,139935,5000,134935
21187,210000,168000,0,0,0,0,0,1,-1,5536,5536,0,-1,2768,0,2768,0,1075,1075,0,-1,2006,2006,0
21188,100000,80000,0,0,0,0,0,0,0,25669,1016,24653,0,881,2007,-1126,-1,57540,57500,40,-1,55038,2000,53038
21189,20000,16000,0,0,0,0,0,1,0,5867,1700,4167,0,5495,0,5495,3,5126,0,5126,2,5899,1000,4899
21190,90000,72000,0,1,0,0,0,1,0,84963,2600,82363,0,56089,2037,54052,0,57355,2200,55155,0,58394,2110,56284
21191,210000,168000,0,0,0,0,0,0,0,47363,3018,44345,0,45810,2000,43810,0,42093,1500,40593,0,36587,1500,35087
21192,170000,136000,0,0,0,0,0,0,0,120267,6000,114267,0,117453,4500,112953,0,115778,4500,111278,0,117411,4500,112911
21193,140000,112000,0,0,0,0,0,0,0,97395,6812,90583,0,99249,5036,94213,0,77188,3000,74188,0,71675,15000,56675
21194,180000,144000,0,0,0,0,0,0,-1,390,390,0,-1,17475,17475,0,-1,17425,611,16814,0,17396,629,16767
21195,150000,120000,1,1,0,0,0,1,0,206221,8000,198221,0,69995,2500,67495,0,60000,1500,58500,0,0,0,0
21196,130000,104000,0,0,0,0,0,0,0,18885,7005,11880,0,19057,6013,13044,0,2511,2511,0,-1,10358,10358,0
21197,290000,232000,0,0,0,0,0,0,-2,0,0,0,-2,24756,24756,0,-1,25147,899,24248,0,25685,942,24743
21198,500000,400000,0,0,0,0,0,0,-1,1409,1422,-13,-1,16200,16281,-81,-1,19880,20062,-182,-1,9110,500,8610
21199,30000,24000,0,1,1,1,0,0,0,28278,1700,26578,0,28770,2008,26762,0,29432,2000,27432,0,28949,7600,21349
21200,10000,8000,0,1,0,0,1,1,4,8128,0,8128,3,7841,0,7841,2,8579,1000,7579,2,8317,0,8317
21201,80000,64000,0,0,0,0,0,1,2,600,0,600,2,600,0,600,4,600,0,600,4,300,0,300
21202,200000,160000,0,0,0,0,0,0,-2,2750,2750,0,-2,0,0,0,-2,1060,1060,0,-2,2000,2000,0
21203,220000,176000,0,1,1,1,1,0,0,214117,10000,204117,0,216712,8255,208457,0,194521,7200,187321,0,198246,7500,190746
21204,500000,400000,0,0,0,0,0,0,-1,385228,385228,0,-1,391047,7821,383226,0,0,0,0,0,150,150,0
21205,20000,16000,0,0,0,0,0,0,0,13375,2000,11375,0,14205,1000,13205,0,15869,2000,13869,0,16666,1000,15666
21206,60000,48000,0,0,0,0,0,1,-2,0,0,0,-2,0,0,0,-2,0,0,0,-2,0,0,0
21207,100000,80000,0,0,0,0,0,0,0,15807,3688,12119,0,18901,3288,15613,0,21794,3288,18506,0,25051,3688,21363
21208,50000,40000,0,1,1,0,0,0,2,48478,3518,44960,0,48173,3000,45173,0,21134,2352,18782,0,20403,2000,18403
21209,10000,8000,0,1,0,0,1,1,-1,9797,1000,8797,-1,-10433,0,-10433,-1,9767,20200,-10433,-1,9067,200,8867
21210,460000,368000,1,1,1,1,1,1,0,523423,19141,504282,0,493548,20141,473407,0,429966,14642,415324,0,427216,31549,395667
21211,170000,136000,0,0,0,0,0,0,-1,416,5,411,2,7509,7509,0,-1,6387,6387,0,-1,1516,1666,-150
21212,50000,40000,0,0,0,0,0,0,0,-306,0,-306,0,18394,18700,-306,-1,18760,663,18097,0,19166,700,18466
21213,50000,40000,0,0,0,0,0,0,-1,2866,2866,0,-1,1961,1961,0,-1,1261,1261,0,-1,2681,2681,0
21214,270000,216000,0,0,0,0,0,0,0,47846,1952,45894,0,39772,1418,38354,0,35143,5000,30143,0,44371,14000,30371
21215,180000,144000,0,1,1,1,0,1,2,177477,5022,172455,2,176197,5000,171197,0,170173,6000,164173,0,139649,7000,132649
21216,20000,16000,0,1,0,0,0,1,0,20960,1000,19960,0,6914,0,6914,0,1017,1017,0,0,780,780,0
21217,170000,136000,0,0,0,0,0,0,-1,326,326,0,-1,326,326,0,-1,652,652,0,-1,326,0,326
21218,200000,160000,0,0,0,0,0,1,0,3221,1000,2221,0,3287,66,3221,-2,63687,65437,-1750,-1,65034,2422,62612
21219,200000,160000,0,0,0,0,0,1,-2,0,0,0,-2,0,0,0,-2,0,0,0,-2,0,0,0
21220,50000,40000,0,0,0,0,0,0,0,19275,3000,16275,0,18829,1000,17829,0,15913,1000,14913,0,7561,1000,6561
21221,180000,144000,0,1,0,0,0,0,0,159019,10372,148647,0,123022,5000,118022,0,126075,5000,121075,0,126219,5000,121219
21222,300000,240000,0,0,0,0,0,0,-1,916,916,0,-1,316,316,0,-1,898,898,0,-1,748,748,0
21223,110000,88000,0,1,1,1,1,1,2,94652,3150,91502,2,97097,4900,92197,2,98097,3500,94597,2,100361,4000,96361
21224,220000,176000,0,0,0,0,0,0,0,111520,5050,106470,0,8303,8303,0,-1,0,0,0,-1,85632,85632,0
21225,120000,96000,0,0,0,0,0,0,-1,1280,0,1280,2,3783,3822,-39,-1,2522,0,2522,0,1261,0,1261
21226,70000,56000,0,0,0,0,0,0,0,6703,1123,5580,0,7853,1273,6580,0,7316,407,6909,0,7350,300,7050
21227,340000,272000,0,0,0,0,0,0,-1,16971,17025,-54,-1,10734,10734,0,-1,9200,9200,0,-1,23818,23818,0
21228,150000,120000,0,0,0,0,0,0,0,15429,1243,14186,0,15094,688,14406,0,15525,825,14700,0,0,0,0
21229,180000,144000,0,0,0,0,0,0,0,138313,6500,131813,0,137274,5000,132274,0,147314,12042,135272,0,129870,32,129838
21230,100000,80000,0,0,0,0,0,0,0,19587,2000,17587,0,21256,2000,19256,0,22895,2000,20895,0,24514,2000,22514
21231,80000,64000,1,1,1,1,1,0,0,80296,0,80296,3,77848,0,77848,2,76508,2788,73720,0,78396,3171,75225
21232,310000,248000,0,0,0,0,0,0,0,241092,9012,232080,0,242850,8549,234301,0,237818,8324,229494,0,237762,8524,229238
21233,80000,64000,0,0,0,0,0,0,-1,390,390,0,-1,390,390,0,-1,390,390,0,-1,540,540,0
21234,20000,16000,0,1,1,1,0,0,0,20199,1200,18999,0,19609,0,19609,0,19957,348,19609,0,2361,0,2361
21235,160000,128000,0,0,0,0,0,0,-1,0,0,0,-1,2773,2773,0,-1,215,215,0,-1,2026,2026,0
21236,280000,224000,0,0,0,0,0,0,0,198808,6497,192311,0,187425,5555,181870,0,177340,5027,172313,0,180506,5065,175441
21237,120000,96000,0,0,0,0,0,0,0,36850,1700,35150,0,37739,1500,36239,0,38381,1400,36981,0,39142,1400,37742
21238,20000,16000,0,0,0,0,0,0,-1,184,184,0,-1,184,0,184,2,5932,5924,8,0,7725,2000,5725
21239,300000,240000,0,1,1,0,0,0,0,297425,12039,285386,0,296884,13000,283884,0,241037,9000,232037,0,247383,10059,237324
21240,200000,160000,0,0,0,0,0,1,-1,1519,0,1519,2,0,0,0,2,0,0,0,-2,600,600,0
21241,110000,88000,0,1,0,0,0,0,0,97005,3409,93596,0,83998,2905,81093,0,79376,2778,76598,0,79816,2862,76954
21242,150000,120000,0,0,0,0,0,1,2,46007,5000,41007,0,47978,3000,44978,0,49100,2000,47100,0,50181,2000,48181
21243,100000,80000,0,0,0,0,0,1,2,64930,2000,62930,2,58433,4500,53933,0,50859,3300,47559,0,40005,0,40005
21244,50000,40000,0,0,0,0,0,0,0,40893,5023,35870,0,-45,0,-45,0,-45,0,-45,-2,0,5250,-5250
21245,270000,216000,0,0,0,0,0,0,0,57856,5000,52856,0,49804,5000,44804,0,47310,5000,42310,0,42812,5240,37572
21246,240000,192000,0,0,0,1,1,0,0,179549,7000,172549,0,225556,50000,175556,0,219642,0,219642,2,232652,16302,216350
21247,350000,280000,0,0,0,0,0,0,0,142695,5577,137118,0,98404,3488,94916,0,100367,3417,96950,0,102465,3536,98929
21248,20000,16000,0,0,0,0,0,1,0,13662,0,13662,2,15518,2088,13430,2,14972,0,14972,2,16925,2200,14725
21249,40000,32000,0,0,0,0,0,0,-2,960,960,0,-2,960,960,0,-2,960,960,0,-2,1383,1383,0
21250,180000,144000,0,0,0,0,0,0,-2,432,432,0,-2,0,0,0,-2,0,0,0,-2,0,0,0
21251,380000,304000,0,0,0,0,0,1,-1,0,0,0,-2,0,0,0,-2,0,0,0,-2,0,0,0
21252,210000,168000,0,0,0,0,0,0,0,139411,6450,132961,0,138991,5103,133888,0,140886,5500,135386,0,143721,5307,138414
21253,70000,56000,0,0,0,0,1,0,0,57417,5015,52402,0,54558,4000,50558,0,58968,5950,53018,0,63456,6000,57456
21254,240000,192000,0,0,0,0,0,0,-2,92,92,0,-2,0,0,0,-2,92,92,0,-2,0,0,0
21255,420000,336000,0,0,0,0,0,0,0,67083,10083,57000,0,69424,10094,59330,0,63523,10000,53523,0,60630,2500,58130
21256,260000,208000,0,0,0,0,0,0,-1,3780,3780,0,-1,3202,3202,0,-1,3754,4000,-246,-1,848,848,0
21257,360000,288000,0,0,0,0,0,0,-1,238,0,238,2,3730,3730,0,-1,3930,200,3730,0,3930,0,3930
21258,330000,264000,0,0,0,0,0,0,-1,119340,119356,-16,-1,134194,20062,114132,0,76865,10189,66676,0,78760,30032,48728
21259,100000,80000,0,0,0,0,0,1,0,12460,1040,11420,0,0,0,0,0,0,0,0,-2,0,0,0
21260,170000,136000,0,1,1,0,0,0,0,156688,7067,149621,0,151405,6443,144962,0,127090,4617,122473,0,126388,4711,121677
21261,180000,144000,0,0,0,0,0,1,-1,326,326,0,-1,480,480,0,-1,1011,1011,0,-1,2685,2000,685
21262,360000,288000,0,0,0,0,0,0,-2,0,0,0,-2,425,425,0,-2,1529,1529,0,-2,0,0,0
21263,50000,40000,0,0,0,0,0,0,0,37269,1900,35369,0,27880,1478,26402,0,27935,1172,26763,0,26314,2005,24309
21264,500000,400000,0,0,0,0,0,0,0,234316,10009,224307,0,199360,20071,179289,0,163408,20000,143408,0,186618,35565,151053
21265,410000,328000,0,0,0,0,0,0,-1,-281,0,-281,-1,-281,0,-281,-2,-281,0,-281,-2,-281,0,-281
21266,230000,184000,0,0,0,0,0,0,2,7226,3742,3484,0,1469,1546,-77,-1,690,0,690,0,388,388,0
21267,200000,160000,0,0,0,0,0,0,-2,3000,3000,0,-2,3000,3000,0,-2,3000,3000,0,-2,3000,3000,0
21268,110000,88000,0,0,0,0,0,0,-1,11801,11801,0,-1,11312,11312,0,-1,11312,0,11312,0,11312,0,11312
21269,30000,24000,0,0,0,0,0,1,2,18547,0,18547,2,18645,1511,17134,0,17847,609,17238,0,15465,500,14965
21270,60000,48000,0,0,0,0,0,1,0,17708,1000,16708,0,10148,203,9945,0,9284,186,9098,0,2241,347,1894
21271,200000,160000,0,0,0,0,0,0,-2,0,0,0,-2,522,522,0,-1,0,0,0,-1,1073,1073,0
21272,300000,240000,0,0,0,0,0,0,2,242518,10000,232518,0,224580,8000,216580,0,179060,8000,171060,0,154320,10000,144320
21273,230000,184000,0,0,0,0,0,0,-1,5167,3167,2000,0,8552,3552,5000,0,12552,5000,7552,0,10596,3000,7596
21274,240000,192000,0,0,0,0,0,1,-1,325,0,325,2,2250,2250,0,-1,1925,0,1925,0,1925,1925,0
21275,50000,40000,0,1,1,0,0,0,0,49551,2221,47330,0,49800,1470,48330,0,20000,400,19600,0,0,0,0
21276,50000,40000,0,0,0,0,0,0,0,20109,1902,18207,0,19932,1200,18732,0,19762,30,19732,0,10708,1031,9677
21277,80000,64000,0,0,0,0,0,0,0,46137,2200,43937,0,48218,3207,45011,0,48286,2000,46286,0,48207,2000,46207
21278,450000,360000,0,0,0,0,0,0,-2,8528,8528,0,-2,0,0,0,-2,6368,6368,0,-2,3000,3000,0
21279,170000,136000,0,1,1,0,0,0,0,159863,6500,153363,0,159700,5000,154700,0,77043,3000,74043,0,77047,3000,74047
21280,30000,24000,0,0,0,0,0,1,-2,4952,4972,-20,-2,6693,7629,-936,-2,22761,22817,-56,-2,10044,10056,-12
21281,310000,248000,0,0,0,0,0,0,-1,6464,6464,0,-1,7016,1000,6016,0,4351,4351,0,-1,17016,17016,0
21282,360000,288000,0,0,0,0,0,0,-2,2394,2406,-12,-2,2441,2453,-12,-2,2441,2453,-12,-2,2441,2453,-12
21283,50000,40000,0,1,0,0,0,0,0,46716,1400,45316,0,29744,984,28760,0,30060,1013,29047,0,29449,1006,28443
21284,80000,64000,0,1,0,0,0,0,0,79835,3344,76491,0,40499,1447,39052,0,41346,1497,39849,0,42348,1686,40662
21285,710000,568000,0,0,0,0,0,1,-2,0,0,0,-2,1004,1004,0,-1,854,0,854,2,8626,8000,626
21286,500000,400000,0,0,0,0,0,1,-2,0,0,0,-2,0,0,0,-2,0,0,0,-2,0,0,0
21287,530000,424000,0,0,0,0,0,0,0,206593,10000,196593,0,275847,10000,265847,0,163157,7000,156157,0,164838,7000,157838
21288,30000,24000,0,1,1,0,0,0,0,28138,1719,26419,0,27074,1613,25461,0,13275,271,13004,0,12500,2250,10250
21289,200000,160000,0,0,0,0,0,0,-1,2662,12,2650,2,6023,6053,-30,-1,8303,8337,-34,-1,171059,171074,-15
21290,50000,40000,0,0,0,0,0,1,0,7251,1125,6126,0,8326,1200,7126,0,9184,1000,8184,0,10031,1000,9031
21291,70000,56000,0,1,1,1,1,0,0,63695,3095,60600,0,63926,2000,61926,0,67361,4600,62761,0,59480,0,59480
21292,280000,224000,0,0,0,0,0,0,0,151000,5100,145900,0,152538,4300,148238,0,154291,4500,149791,0,155955,4500,151455
21293,310000,248000,0,0,0,0,0,0,-1,6500,6565,-65,-1,0,0,0,-1,0,0,0,-2,0,0,0
21294,110000,88000,0,0,0,0,0,0,0,74340,3152,71188,0,47152,1687,45465,0,48138,1745,46393,0,49171,1831,47340
21295,130000,104000,0,0,0,0,0,0,0,5476,1189,4287,0,6931,2646,4285,0,99416,104590,-5174,-1,99702,3358,96344
21296,140000,112000,0,0,0,0,0,0,0,35065,1601,33464,0,35668,1564,34104,0,36143,1399,34744,0,37064,2000,35064
21297,220000,176000,0,0,0,0,0,1,2,121910,0,121910,2,89608,6000,83608,2,53535,2500,51035,2,36312,0,36312
21298,50000,40000,0,0,0,0,0,0,0,34656,0,34656,2,35004,1200,33804,0,35514,710,34804,0,2582,52,2530
21299,330000,264000,0,0,0,0,0,0,0,89421,3285,86136,0,91115,3221,87894,0,92935,3247,89688,0,91584,3317,88267
21300,50000,40000,0,0,0,0,0,0,0,34440,2500,31940,0,30889,2000,28889,0,30182,1500,28682,0,29912,5000,24912
21301,20000,16000,0,1,1,1,1,1,0,19121,1700,17421,2,18521,0,18521,2,18615,700,17915,0,19015,700,18315
21302,280000,224000,0,0,0,0,0,0,0,193994,28869,165125,0,195250,13000,182250,0,204850,10000,194850,0,86279,5279,81000
21303,20000,16000,0,0,0,0,0,1,0,12130,2980,9150,0,11644,0,11644,2,12250,1100,11150,2,11910,0,11910
21304,500000,400000,0,0,0,0,0,0,-2,15183,15259,-76,-2,3399,3416,-17,-2,8311,8353,-42,-2,-2,0,-2
21305,500000,400000,0,0,0,0,0,0,0,277636,15000,262636,0,287998,15000,272998,0,298343,15000,283343,0,308378,15000,293378
21306,110000,88000,0,0,0,0,0,0,0,76296,2529,73767,0,77260,2348,74912,0,72907,2308,70599,0,63104,2180,60924
21307,130000,104000,0,0,0,0,0,0,0,9811,10363,-552,-1,5136,5177,-41,-1,19040,19040,0,-1,2940,2940,0
21308,130000,104000,0,0,0,0,0,1,0,30891,3300,27591,0,30096,0,30096,2,32169,2578,29591,2,31520,0,31520
21309,100000,80000,0,0,0,0,0,0,2,-8,8,-16,2,2562,2570,-8,-1,0,0,0,-1,0,0,0
21310,480000,384000,0,0,0,0,0,0,-1,5785,5785,0,-1,9233,9233,0,-1,4893,4893,0,-1,2168,2168,0
21311,70000,56000,0,0,0,0,0,0,0,14000,14000,0,-1,0,0,0,-1,0,0,0,-2,0,0,0
21312,200000,160000,0,1,1,1,1,0,0,190447,7000,183447,0,187224,7000,180224,0,183641,6510,177131,0,178239,6550,171689
21313,200000,160000,0,0,0,0,0,0,-1,1050,1050,0,-1,0,0,0,-1,400,400,0,-1,976,976,0
21314,50000,40000,0,0,0,0,0,0,2,31623,3500,28123,2,33393,2589,30804,2,32587,0,32587,3,31914,0,31914
21315,50000,40000,0,0,1,1,1,0,0,41945,2381,39564,0,44064,2500,41564,0,45182,1500,43682,0,47408,3000,44408
21316,380000,304000,0,0,0,0,0,0,0,135167,90527,44640,0,95527,5000,90527,0,91541,3000,88541,0,92808,4000,88808
21317,260000,208000,0,0,0,0,0,0,-2,9571,9576,-5,-1,7235,29,7206,0,0,0,0,0,197,197,0
21318,10000,8000,0,1,1,1,1,1,0,9560,0,9560,2,9901,500,9401,0,9963,370,9593,0,10182,393,9789
21319,20000,16000,1,1,0,0,0,0,0,35036,2110,32926,0,14694,4000,10694,0,16914,6000,10914,0,14074,4000,10074
21320,100000,80000,0,0,0,0,0,1,-2,0,0,0,-2,300,300,0,-1,150,0,150,2,780,630,150
21321,360000,288000,0,0,0,0,0,0,-2,0,0,0,-2,3666,3666,0,-2,2749,2878,-129,-2,2921,2921,0
21322,50000,40000,0,1,1,1,1,0,0,45390,2000,43390,0,46310,1113,45197,0,47262,1143,46119,0,48219,1159,47060
21323,200000,160000,0,0,0,0,0,0,-2,69084,69084,0,-1,71857,3450,68407,0,72755,2348,70407,0,34125,1486,32639
21324,170000,136000,0,0,0,0,0,0,-1,2908,2908,0,-1,9283,9283,0,-1,2908,0,2908,0,2908,2908,0
21325,500000,400000,0,0,0,0,0,0,0,134908,8048,126860,0,141358,20141,121217,0,121262,10000,111262,0,131147,12000,119147
21326,300000,240000,0,0,0,0,0,0,-1,-27,0,-27,-2,-27,0,-27,-2,-27,0,-27,-2,-27,0,-27
21327,400000,320000,0,0,0,0,0,1,2,186539,11500,175039,2,196029,14100,181929,2,192680,4,192676,3,195226,6804,188422
21328,140000,112000,0,0,0,0,0,0,0,45351,1755,43596,0,46317,1721,44596,0,55506,10000,45506,0,56609,2028,54581
21329,50000,40000,0,0,0,0,0,0,0,39490,1770,37720,0,38801,1148,37653,0,36087,1174,34913,0,25189,949,24240
21330,180000,144000,0,0,0,0,0,0,-2,910,910,0,-2,0,0,0,-2,0,0,0,-2,0,0,0
21331,140000,112000,0,1,1,1,1,0,0,118713,6000,112713,0,121248,6000,115248,0,123232,5500,117732,0,126242,5000,121242
21332,160000,128000,0,0,0,0,0,0,-2,0,0,0,-2,780,780,0,-2,390,390,0,-2,930,930,0
21333,50000,40000,0,0,0,0,0,0,-1,1861,1861,0,-1,0,0,0,-1,1780,1780,0,-1,2581,2581,0
21334,30000,24000,0,1,1,1,0,0,0,28734,1400,27334,0,27551,1300,26251,0,28836,3000,25836,0,11718,0,11718
21335,170000,136000,0,0,0,0,0,0,0,124103,5921,118182,0,115638,5700,109938,0,116430,4200,112230,0,118950,4400,114550
21336,80000,64000,0,1,1,1,1,0,0,77106,6100,71006,0,74420,0,74420,2,76220,3000,73220,0,77877,3000,74877
21337,80000,64000,0,1,1,1,0,0,2,80070,7000,73070,2,74172,4007,70165,2,68002,0,68002,2,58032,3000,55032
21338,110000,88000,0,1,0,0,0,0,0,103834,3256,100578,0,76491,2696,73795,0,77245,2780,74465,0,78049,2900,75149
21339,120000,96000,0,1,1,1,1,0,0,111987,10000,101987,0,112652,4000,108652,0,114337,5000,109337,0,115105,4200,110905
21340,150000,120000,0,0,0,0,0,1,0,94995,4221,90774,0,52874,3094,49780,0,64269,30454,33815,0,73351,100049,-26698
21341,340000,272000,0,0,0,0,0,0,0,73004,3035,69969,0,72338,1958,70380,0,58935,2819,56116,0,123936,100000,23936
21342,50000,40000,0,0,0,0,0,1,-1,0,0,0,-2,0,0,0,-2,0,0,0,-2,0,0,0
21343,500000,400000,0,0,0,0,0,0,-1,4775,4775,0,-1,31188,31188,0,-1,5827,0,5827,0,3637,4119,-482
21344,130000,104000,0,0,0,0,0,0,0,47313,5000,42313,0,44568,5000,39568,0,48560,5000,43560,0,51529,5000,46529
21345,100000,80000,0,0,0,0,0,0,0,22577,3000,19577,0,21037,1000,20037,0,22373,2000,20373,0,23352,1500,21852
21346,300000,240000,0,0,0,0,0,0,2,264,264,0,-1,264,264,0,-1,517,517,0,-1,528,11,517
21347,120000,96000,0,0,0,0,0,0,-1,14940,15928,-988,-1,41990,43000,-1010,-1,1493,1493,0,-1,36186,36200,-14
21348,170000,136000,0,0,0,0,0,0,0,136176,4742,131434,0,61000,2022,58978,0,59477,2076,57401,0,44218,1776,42442
21349,380000,304000,0,0,0,0,0,0,-2,10933,10933,0,-2,62602,62602,0,-2,6408,150000,-143592,-2,16791,16791,0
21350,230000,184000,0,1,1,1,1,0,0,227807,8366,219441,0,218047,6012,212035,0,223370,9474,213896,0,206937,6962,199975
21351,80000,64000,0,0,0,0,0,0,0,78716,79239,-523,-1,53109,2516,50593,0,28973,1023,27950,0,24705,2000,22705
21352,300000,240000,0,0,0,0,0,0,0,-3699,0,-3699,0,4142,10005,-5863,-1,1700,0,1700,0,0,0,0
21353,180000,144000,0,0,0,0,0,0,-1,735,735,0,-1,2414,2414,0,-1,256,256,0,-1,3858,3858,0
21354,50000,40000,0,0,0,0,0,0,0,28027,3000,25027,0,28007,1200,26807,0,28770,1200,27570,0,28929,1162,27767
21355,210000,168000,0,0,0,0,0,1,0,93234,7500,85734,0,90571,0,90571,2,94653,6000,88653,0,142549,50000,92549
21356,50000,40000,0,0,0,0,0,0,-2,0,0,0,-2,0,0,0,-2,2900,2900,0,-2,0,0,0
21357,20000,16000,0,0,0,0,0,0,2,-780,0,-780,2,1170,1950,-780,-1,780,0,780,0,0,0,0
21358,110000,88000,0,0,0,0,0,0,2,16401,6000,10401,0,18670,7000,11670,0,19670,1200,18470,0,1187,0,1187
21359,220000,176000,0,0,0,0,0,0,-1,3874,3000,874,0,264,264,0,-1,3105,3105,0,-1,2074,0,2074
21360,50000,40000,0,0,0,0,0,0,0,20972,1527,19445,0,16359,16408,-49,-1,1340,1444,-104,-1,0,0,0
21361,400000,320000,0,0,0,0,0,0,0,186905,8214,178691,0,188959,6621,182338,0,183659,3400,180259,0,96385,3541,92844
21362,170000,136000,0,0,0,0,0,0,-1,18070,4000,14070,0,910,910,0,-1,9080,9080,0,-1,4839,4839,0
21363,20000,16000,0,0,0,1,0,0,0,15926,5000,10926,0,16668,1300,15368,2,16109,0,16109,3,15709,0,15709
21364,50000,40000,0,1,0,0,0,1,2,49741,1379,48362,0,28442,945,27497,0,28597,2002,26595,0,29375,2008,27367
21365,100000,80000,0,0,0,0,0,0,0,46628,3805,42823,0,45578,0,45578,2,46486,1663,44823,0,47457,1719,45738
21366,450000,360000,0,0,0,0,0,1,2,949,949,0,-1,575,575,0,-1,3489,4929,-1440,-1,0,0,0
21367,170000,136000,0,0,1,1,1,0,0,145050,13314,131736,2,146641,5801,140840,2,149603,5800,143803,2,157601,11000,146601
21368,50000,40000,0,0,0,0,0,0,-1,1554,1554,0,-1,390,390,0,-1,780,780,0,-1,390,0,390
21369,50000,40000,0,0,0,0,0,1,3,36822,1200,35622,2,37421,1500,35921,2,38424,1750,36674,2,39035,1390,37645
21370,290000,232000,0,0,0,0,0,0,0,19130,3001,16129,0,14793,2000,12793,0,15442,1502,13940,0,14381,1000,13381
21371,500000,400000,0,0,0,0,0,0,-1,3834,4024,-190,-1,-754,754,-1508,-1,6276,7030,-754,-1,16871,17050,-179
21372,20000,16000,0,1,1,1,1,0,0,18872,0,18872,2,21178,3000,18178,2,20329,0,20329,2,20853,1000,19853
21373,100000,80000,0,0,0,0,0,0,-2,52262,52282,-20,-2,9920,9920,0,-2,8633,8633,0,-2,53312,53312,0
21374,300000,240000,0,1,1,1,0,0,0,275061,9000,266061,0,250488,10000,240488,0,250357,9000,241357,0,249990,10000,239990
21375,50000,40000,0,1,1,1,1,1,0,48099,1888,46211,0,50021,3464,46557,0,50352,1717,48635,0,50740,1766,48974
21376,50000,40000,0,0,0,0,0,0,0,16544,2000,14544,0,14787,3000,11787,0,15975,3000,12975,0,17098,3000,14098
21377,390000,312000,0,0,0,0,0,0,0,240876,13163,227713,0,190709,8349,182360,0,191162,6840,184322,0,195336,7252,188084
21378,260000,208000,0,1,1,0,0,0,0,233426,12007,221419,0,230319,9170,221149,0,127897,4853,123044,0,118868,4531,114337
21379,300000,240000,0,0,0,0,0,0,0,26324,1800,24524,0,27249,2000,25249,0,46007,20000,26007,0,46764,2160,44604
21380,500000,400000,0,0,0,0,0,0,0,39032,2383,36649,0,29092,1126,27966,0,22725,782,21943,0,11590,596,10994
21381,170000,136000,0,0,0,0,0,0,0,6494,2000,4494,0,1264,1264,0,-1,948,0,948,0,632,0,632
21382,10000,8000,0,0,0,0,1,0,0,5561,0,5561,2,8455,3000,5455,2,9730,2000,7730,4,8999,0,8999
21383,170000,136000,0,0,0,0,0,0,-2,0,0,0,-2,0,0,0,-2,0,0,0,-2,0,0,0
21384,70000,56000,0,0,0,0,0,0,0,33481,1500,31981,0,33683,1138,32545,0,34227,1806,32421,0,34327,1383,32944
21385,230000,184000,0,0,0,0,0,0,-1,8100,8100,0,-1,-2900,0,-2900,-1,-2900,0,-2900,-2,-2900,0,-2900
21386,70000,56000,0,0,0,0,0,1,3,35839,3000,32839,4,37954,3000,34954,4,39787,3000,36787,5,41601,3000,38601
21387,150000,120000,0,0,0,0,0,0,-1,140230,140951,-721,-1,98674,10000,88674,0,107664,10000,97664,0,111561,5219,106342
21388,50000,40000,0,0,0,0,0,1,-1,390,390,0,-1,390,390,0,-1,0,0,0,-1,780,780,0
21389,500000,400000,0,0,0,0,0,0,-1,6324,5000,1324,0,7353,1224,6129,0,5536,3003,2533,0,8321,3506,4815
21390,30000,24000,0,0,0,0,1,0,2,23502,0,23502,2,24603,1800,22803,0,24996,1100,23896,0,26426,2000,24426
21391,10000,8000,0,0,0,0,0,0,-1,1777,1500,277,0,780,780,0,-1,780,0,780,0,0,0,0
21392,150000,120000,0,0,0,0,0,0,0,56523,2549,53974,0,56737,2406,54331,0,51005,2000,49005,0,47471,1655,45816
21393,330000,264000,0,0,0,0,0,0,0,50531,2500,48031,0,50595,1309,49286,0,40491,1243,39248,0,31020,2027,28993
21394,330000,264000,0,0,0,0,0,0,-2,3775,3775,0,-2,1590,1590,0,-2,0,0,0,-2,2130,2130,0
21395,30000,24000,0,0,0,0,0,0,0,8642,3000,5642,0,11492,3000,8492,0,14285,3000,11285,0,17056,3000,14056
21396,40000,32000,0,0,0,0,0,1,3,9331,1642,7689,2,9729,700,9029,2,9424,0,9424,2,9621,349,9272
21397,50000,40000,0,0,0,0,0,1,-1,0,0,0,-2,0,0,0,-2,0,0,0,-2,0,0,0
21398,200000,160000,0,0,0,0,0,0,-1,3423,3475,-52,-1,7403,7417,-14,-1,4896,108,4788,0,3185,18,3167
21399,70000,56000,0,0,0,0,0,0,-1,157,157,0,-1,157,157,0,-1,157,157,0,-1,307,307,0
21400,50000,40000,0,1,0,0,0,1,0,50391,1600,48791,0,19867,1000,18867,0,20154,1000,19154,0,18732,1000,17732
21401,130000,104000,0,0,0,0,0,0,-2,734,734,0,-2,0,0,0,-2,390,390,0,-2,988,988,0
21402,90000,72000,0,0,0,0,0,1,2,432,432,0,-1,0,0,0,-1,0,0,0,-2,0,0,0
21403,100000,80000,0,0,0,0,0,0,2,28812,1500,27312,0,31134,2700,28434,0,30444,0,30444,2,32460,2400,30060
21404,210000,168000,0,0,0,0,0,0,0,107768,4500,103268,0,84505,3100,81405,0,81796,3016,78780,0,52453,2000,50453
21405,240000,192000,0,0,0,0,0,0,0,169882,6500,163382,0,173246,6183,167063,0,177112,6640,170472,0,187951,14000,173951
21406,140000,112000,0,0,0,1,1,1,0,6327,6327,0,-1,138485,135000,3485,0,140492,4700,135792,0,141006,5000,136006
21407,150000,120000,0,0,0,0,0,0,0,94196,3229,90967,0,91550,3150,88400,0,89586,3348,86238,0,88300,3244,85056
21408,90000,72000,0,1,1,1,1,1,2,90635,7500,83135,2,91745,3500,88245,2,87466,0,87466,2,85662,3300,82362
21409,120000,96000,0,0,0,0,0,0,2,316,316,0,-1,632,632,0,-1,316,0,316,0,316,316,0
21410,130000,104000,0,0,0,0,0,1,2,71933,3000,68933,2,70117,0,70117,2,72014,3000,69014,0,73759,3000,70759
21411,20000,16000,0,1,0,0,0,0,0,18890,2000,16890,0,11026,2000,9026,0,5863,1000,4863,0,3273,1000,2273
21412,50000,40000,1,1,0,0,0,0,0,56850,3000,53850,0,4359,1218,3141,0,816,0,816,2,766,1000,-234
21413,250000,200000,0,0,0,0,0,0,-1,3490,3490,0,-1,0,0,0,-1,4789,4789,0,-1,0,0,0
21414,20000,16000,0,0,0,0,0,0,0,14768,1300,13468,0,15518,1000,14518,0,16265,1000,15265,0,16706,711,15995
21415,230000,184000,0,0,0,0,0,0,0,54454,3000,51454,0,53457,2000,51457,0,55128,2500,52628,0,52788,2500,50288
21416,50000,40000,0,0,0,0,0,0,0,23268,1418,21850,0,23365,1295,22070,0,19602,677,18925,0,18462,669,17793
21417,30000,24000,0,1,1,1,0,0,0,29043,4021,25022,0,29419,2000,27419,0,29848,5000,24848,0,29306,6000,23306
21418,170000,136000,0,0,0,0,0,0,-1,321,324,-3,-1,0,0,0,-1,3857,3857,0,-1,0,0,0
21419,130000,104000,0,0,0,0,0,0,2,77795,3500,74295,2,78584,2700,75884,2,79736,2970,76766,2,78405,0,78405
21420,390000,312000,0,1,0,0,0,0,0,363787,30002,333785,0,291427,15052,276375,0,260026,10507,249519,0,178599,25001,153598
21421,50000,40000,0,1,1,1,1,0,0,48999,2357,46642,0,49388,1746,47642,0,48853,1628,47225,0,47765,1520,46245
21422,130000,104000,1,1,1,0,0,0,0,219970,6794,213176,0,221119,5315,215804,0,21904,2000,19904,0,22052,1000,21052
21423,50000,40000,0,1,0,0,0,0,0,52148,3014,49134,0,32718,1309,31409,0,32096,5009,27087,0,30563,2008,28555
21424,120000,96000,0,0,0,0,0,0,2,42200,42000,200,0,42000,200,41800,0,42000,0,42000,0,0,0,0
21425,80000,64000,0,0,0,0,0,0,-1,4820,1500,3320,0,867,867,0,-1,1154,1500,-346,-1,2473,1500,973
21426,150000,120000,0,0,0,0,0,0,-2,8958,8958,0,-2,780,780,0,-2,7500,7500,0,-2,0,0,0
21427,150000,120000,0,1,1,1,1,0,2,142163,27,142136,2,135075,4610,130465,0,135309,5000,130309,0,135165,5000,130165
21428,230000,184000,0,0,0,0,0,0,0,84297,4000,80297,0,49681,2029,47652,0,46224,2000,44224,0,44800,2500,42300
21429,50000,40000,0,1,1,0,0,0,2,47992,2500,45492,0,49278,3500,45778,0,28086,1000,27086,0,30196,3397,26799
21430,100000,80000,0,0,0,0,0,0,-2,0,0,0,-2,0,0,0,-2,551,551,0,-1,551,0,551
21431,180000,144000,0,0,0,0,0,0,-2,3681,3697,-16,-2,21325,21330,-5,-2,2228,2228,0,-2,856,1531,-675
21432,80000,64000,0,0,0,0,0,0,-2,0,0,0,-2,0,0,0,-2,0,0,0,-2,0,0,0
21433,20000,16000,0,1,1,0,0,1,-1,19499,1329,18170,0,19780,1000,18780,0,780,0,780,0,0,0,0
21434,20000,16000,0,0,1,0,0,1,3,17021,2277,14744,2,16461,0,16461,3,15901,0,15901,2,16294,800,15494
21435,20000,16000,1,1,1,1,1,1,2,20943,0,20943,3,20152,0,20152,2,19754,2,19752,0,19204,384,18820
21436,50000,40000,0,0,0,0,0,0,0,29604,13000,16604,0,27764,0,27764,2,28656,2000,26656,2,29087,1000,28087
21437,170000,136000,0,0,0,0,0,1,-1,199,199,0,-1,398,398,0,-1,199,0,199,0,199,199,0
21438,120000,96000,0,0,0,0,0,0,-1,0,0,0,-2,7304,7304,0,-1,7154,0,7154,2,9055,5000,4055
21439,160000,128000,0,0,0,0,0,0,0,66192,2268,63924,0,16905,16905,0,-1,0,0,0,-1,19789,19789,0
21440,50000,40000,0,0,0,0,0,0,0,5847,0,5847,2,4871,1000,3871,0,3007,0,3007,0,2136,993,1143
21441,100000,80000,0,1,1,1,1,0,0,98052,3500,94552,0,94423,3400,91023,0,96056,3500,92556,0,97320,5000,92320
21442,20000,16000,0,1,1,0,0,0,0,19681,1500,18181,0,19507,500,19007,0,14656,0,14656,0,756,756,0
21443,290000,232000,0,0,0,0,0,0,0,24872,8000,16872,0,20318,0,20318,0,26030,16000,10030,0,7258,7258,0
21444,230000,184000,0,0,0,0,0,0,2,27460,27446,14,0,22515,1400,21115,0,20109,0,20109,0,13700,274,13426
21445,200000,160000,0,0,0,0,0,0,0,4467,4467,0,-1,3285,1000,2285,0,0,0,0,0,0,0,0
21446,430000,344000,0,0,0,0,0,0,-1,44671,44671,0,-1,81979,82555,-576,-1,9120,9120,0,-1,85407,85407,0
21447,200000,160000,0,0,0,0,0,0,-2,29399,29404,-5,-2,15817,15825,-8,-2,6155,6155,0,-2,9955,9955,0
21448,230000,184000,0,0,0,0,0,0,-1,1156,1156,0,-1,316,316,0,-1,316,316,0,-1,316,316,0
21449,140000,112000,0,0,0,0,0,0,-1,1514,1522,-8,-1,2573,2580,-7,-1,495,496,-1,-1,1744,1749,-5
21450,30000,24000,0,0,1,1,0,0,0,26167,3102,23065,0,25413,1000,24413,2,25122,1015,24107,0,20448,700,19748
21451,50000,40000,0,0,0,0,0,0,3,390,0,390,2,2724,2724,0,-1,2183,0,2183,2,2638,1004,1634
21452,80000,64000,0,1,1,0,0,1,0,73327,2800,70527,0,69760,3038,66722,0,50642,2000,48642,0,48690,2000,46690
21453,50000,40000,0,1,1,1,1,1,0,47645,5000,42645,0,47552,3000,44552,0,48512,2000,46512,0,49622,2000,47622
21454,500000,400000,0,0,0,0,0,0,-1,18129,18129,0,-1,18934,18941,-7,-1,21687,16687,5000,0,16438,16438,0
21455,20000,16000,0,1,0,0,0,1,-2,20000,38,19962,-2,0,0,0,-2,0,0,0,-2,0,0,0
21456,80000,64000,0,0,0,0,0,0,-1,390,390,0,-1,780,0,780,2,780,1560,-780,-1,390,0,390
21457,200000,160000,0,0,0,0,0,0,0,140804,5090,135714,0,136437,5014,131423,0,135253,5009,130244,0,134629,4844,129785
21458,210000,168000,0,1,0,0,0,1,2,176634,6800,169834,0,128137,4900,123237,0,130500,4500,126000,2,128838,4700,124138
21459,80000,64000,0,0,0,0,0,1,-1,6837,6837,0,-1,7309,1000,6309,0,2568,2568,0,-1,2199,2199,0
21460,50000,40000,0,0,0,0,0,0,-2,0,0,0,-2,0,0,0,-2,0,0,0,-2,0,0,0
21461,280000,224000,0,0,0,0,0,0,0,151310,6867,144443,0,141937,5500,136437,0,144990,5500,139490,0,147911,5500,142411
21462,80000,64000,0,0,0,0,0,0,0,52319,1903,50416,0,58245,6800,51445,0,56728,0,56728,3,55691,0,55691
21463,140000,112000,0,0,0,0,0,0,0,62925,3000,59925,0,64280,3000,61280,0,67079,4000,63079,0,69802,4000,65802
21464,50000,40000,0,1,0,0,0,1,0,48479,2100,46379,0,18616,1000,17616,0,19196,1000,18196,0,17906,1000,16906
21465,60000,48000,0,0,0,0,0,0,0,29347,1219,28128,0,19544,1007,18537,0,11989,8,11981,0,9079,9381,-302
21466,500000,400000,0,0,0,0,0,0,0,0,0,0,-2,113904,113904,0,-1,116168,4130,112038,0,117375,4356,113019
21467,160000,128000,0,0,0,0,0,0,-2,0,0,0,-2,0,0,0,-2,0,0,0,-2,0,0,0
21468,550000,440000,0,0,0,0,0,0,-1,7451,7851,-400,-1,16111,19751,-3640,0,22819,29700,-6881,0,80846,80987,-141
21469,150000,120000,0,0,0,0,0,0,-1,1036,1036,0,-1,5022,5048,-26,-1,3938,3946,-8,-1,316,316,0
21470,50000,40000,0,0,0,1,0,1,2,40820,1973,38847,0,33545,1784,31761,0,46832,845,45987,0,24101,1750,22351
21471,20000,16000,0,0,0,1,1,1,2,15582,1500,14082,0,17809,2500,15309,0,17385,0,17385,2,18437,1500,16937
21472,110000,88000,0,0,0,0,0,0,0,20566,2000,18566,0,21158,783,20375,0,22141,3000,19141,0,22158,2000,20158
21473,20000,16000,0,1,1,1,1,0,0,19772,1596,18176,0,18940,664,18276,0,18587,838,17749,0,20352,2241,18111
21474,30000,24000,0,1,1,1,0,0,0,29643,1500,28143,0,29593,788,28805,0,27952,559,27393,0,0,0,0
21475,120000,96000,0,0,0,0,0,0,3,12056,0,12056,2,13958,2400,11558,2,13468,100,13368,3,6144,0,6144
21476,30000,24000,0,0,0,0,0,1,-1,0,0,0,-1,4810,4810,0,-1,2796,2796,0,-1,3245,3245,0
21477,220000,176000,0,1,0,0,0,1,0,214669,6889,207780,0,173187,6033,167154,0,176496,6247,170249,0,169649,6142,163507
21478,140000,112000,0,0,0,0,0,0,-2,518,518,0,-2,518,518,0,-2,518,518,0,-2,668,668,0
21479,180000,144000,0,1,0,0,0,0,0,175102,8199,166903,0,134494,4960,129534,0,135881,5404,130477,0,124651,4686,119965
21480,260000,208000,0,0,0,0,0,0,0,19270,3017,16253,0,11915,11915,0,-1,114479,114479,0,-1,24511,2000,22511
21481,190000,152000,0,1,0,0,0,0,0,174848,6099,168749,0,124776,4793,119983,0,92684,3684,89000,0,100151,12251,87900
21482,170000,136000,0,0,0,0,0,0,-1,13366,13366,0,-1,17446,20894,-3448,-1,17056,17056,0,-1,16666,16666,0
21483,200000,160000,0,0,0,0,0,0,-1,110059,0,110059,2,34125,34000,125,0,36031,2500,33531,0,31885,0,31885
21484,80000,64000,0,0,0,0,0,0,-2,988,988,0,-2,0,0,0,-2,0,0,0,-2,0,0,0
21485,80000,64000,0,1,1,1,0,0,0,79147,4000,75147,0,81159,4000,77159,0,69573,5000,64573,0,70306,8000,62306
21486,50000,40000,0,0,0,0,0,0,0,12521,0,12521,2,14308,2000,12308,0,14769,1000,13769,0,15925,1542,14383
21487,180000,144000,0,0,0,0,0,0,-2,-16,0,-16,-2,850,866,-16,-2,0,0,0,-2,0,0,0
21488,50000,40000,0,1,1,1,1,0,2,51450,2200,49250,2,47867,0,47867,2,51045,4300,46745,2,51118,2100,49018
21489,180000,144000,0,0,0,0,0,0,-2,16564,17266,-702,-2,15047,15053,-6,-2,17884,17884,0,-2,13630,13630,0
21490,60000,48000,0,0,0,0,0,0,-1,0,10785,-10785,-2,0,0,0,-2,0,0,0,-2,0,0,0
21491,50000,40000,0,1,1,0,0,0,0,48322,2320,46002,0,45353,1300,44053,0,19426,1000,18426,0,19857,700,19157
21492,500000,400000,0,0,0,0,0,0,-1,17058,10000,7058,-1,19858,3000,16858,-1,19974,10000,9974,0,22774,6000,16774
21493,120000,96000,0,0,0,0,0,0,-1,380,380,0,-1,380,380,0,-1,380,380,0,-1,380,380,0
21494,230000,184000,0,0,0,0,0,1,-1,2140,2140,0,-1,2360,2560,-200,-1,2620,2620,0,-1,0,0,0
21495,30000,24000,0,0,0,0,0,1,0,11710,1198,10512,0,13030,1518,11512,0,13776,1264,12512,0,13415,0,13415
21496,230000,184000,0,0,0,0,0,0,0,28121,1500,26621,0,33331,6000,27331,0,38459,6000,32459,0,42525,5000,37525
21497,300000,240000,0,0,0,0,0,0,0,38235,2691,35544,0,29944,2400,27544,0,26259,1000,25259,0,26288,1000,25288
21498,460000,368000,0,0,0,0,0,0,0,81812,5011,76801,0,82326,5047,77279,0,76055,4021,72034,0,74979,4071,70908
21499,80000,64000,0,0,0,0,0,0,0,25439,1299,24140,0,26140,1000,25140,0,28833,3000,25833,0,28459,981,27478
21500,150000,120000,0,0,1,0,1,1,2,124745,14779,109966,2,121249,0,121249,2,124237,5000,119237,0,132252,10000,122252
21501,200000,160000,0,0,0,0,0,0,-1,6309,6309,0,-1,385,385,0,-1,0,0,0,-1,0,0,0
21502,40000,32000,1,1,1,1,1,1,5,40114,0,40114,4,38797,0,38797,3,38244,0,38244,2,38478,871,37607
21503,80000,64000,0,1,1,0,0,1,2,82385,7600,74785,2,79795,5,79790,2,48999,2000,46999,0,48161,2000,46161
21504,50000,40000,0,1,1,0,0,1,0,50463,1988,48475,0,49407,1514,47893,0,29708,1041,28667,0,29308,1056,28252
21505,610000,488000,0,0,0,0,0,0,-1,7380,9710,-2330,-1,3755,3769,-14,-1,20515,20515,0,-1,11497,0,11497
21506,310000,248000,0,0,0,0,0,0,-2,6629,6629,0,-2,34342,17171,17171,-2,1900,3800,-1900,-2,5807,5807,0
21507,230000,184000,0,0,0,0,0,0,0,53457,2000,51457,0,55128,2500,52628,0,52788,2500,50288,0,53671,2000,51671
21508,130000,104000,0,0,0,0,0,0,0,50000,1000,49000,0,0,0,0,0,0,0,0,-2,0,0,0
21509,350000,280000,0,1,1,0,0,0,0,322806,15074,307732,0,328616,20353,308263,0,278858,10040,268818,0,281692,15000,266692
21510,200000,160000,0,1,1,1,1,0,0,180615,7912,172703,0,180127,6284,173843,0,166755,6313,160442,0,167416,6200,161216
21511,170000,136000,0,0,0,0,0,1,-1,3500,0,3500,2,7190,7190,0,-1,9000,9000,0,-1,0,0,0
21512,310000,248000,0,0,0,0,0,1,-2,65993,66008,-15,-2,8543,8543,0,-2,1695,1695,0,-2,750,750,0
21513,200000,160000,0,0,0,0,0,0,-2,0,0,0,-2,495,495,0,-2,0,0,0,-2,0,0,0
21514,160000,128000,0,0,0,0,0,0,2,106719,6000,100719,2,107485,4000,103485,2,108326,4100,104226,2,110635,4200,106435
21515,210000,168000,0,0,0,0,0,0,0,171506,7500,164006,0,133206,5503,127703,0,98885,4185,94700,0,88101,4500,83601
21516,100000,80000,0,0,0,0,0,0,0,45634,2000,43634,0,46576,2000,44576,0,47519,2000,45519,0,51404,5000,46404
21517,20000,16000,0,0,0,0,0,1,0,6554,2000,4554,0,6895,1032,5863,0,5844,155,5689,0,6079,1000,5079
21518,20000,16000,0,0,0,0,0,0,2,9907,1500,8407,2,9599,0,9599,2,14422,5000,9422,2,18885,5000,13885
21519,300000,240000,0,0,0,0,0,0,-1,77000,77000,0,-1,78718,3000,75718,0,80908,3500,77408,0,90495,11100,79395
21520,150000,120000,0,0,0,0,0,1,0,101996,4450,97546,0,56503,3243,53260,0,38650,2000,36650,0,28775,2000,26775
21521,280000,224000,0,0,0,0,0,0,-2,4245,4281,-36,-2,6969,6985,-16,-2,29236,29264,-28,-2,8865,8873,-8
21522,500000,400000,0,0,0,0,0,0,0,110340,30357,79983,0,122967,30000,92967,0,108834,20000,88834,0,70064,52183,17881
21523,110000,88000,1,1,1,1,0,1,2,114223,4000,110223,2,110876,0,110876,2,107710,4000,103710,0,90071,3700,86371
21524,50000,40000,0,1,0,0,0,1,0,44127,1804,42323,0,22053,2700,19353,0,20129,0,20129,2,19262,700,18562
21525,360000,288000,0,0,0,0,0,0,0,82455,3500,78955,0,83359,2500,80859,0,85171,2500,82671,0,87046,2600,84446
21526,390000,312000,0,0,0,0,0,0,-1,3273,3273,0,-1,6965,6965,0,-1,4893,4893,0,-1,7777,7777,0
21527,120000,96000,0,0,0,0,0,0,-2,0,0,0,-2,0,0,0,-2,0,0,0,-2,0,0,0
21528,50000,40000,0,0,0,0,0,0,0,18392,1700,16692,0,19170,1400,17770,0,20555,1689,18866,0,20102,0,20102
21529,160000,128000,0,0,0,0,0,1,-1,0,0,0,-1,450,450,0,-1,748,748,0,-1,5054,5054,0
21530,30000,24000,0,0,0,0,0,1,2,21103,0,21103,2,22939,2500,20439,2,22273,0,22273,2,22814,900,21914
21531,140000,112000,0,1,0,0,0,1,0,139414,4979,134435,0,97268,3715,93553,0,99960,4498,95462,0,86728,86728,0
21532,30000,24000,0,1,1,1,1,1,2,26589,0,26589,2,27050,1200,25850,0,29446,3000,26446,0,28825,0,28825
21533,410000,328000,0,0,0,0,0,0,-1,6566,7064,-498,-1,5206,430,4776,2,986,990,-4,-1,986,990,-4
21534,410000,328000,0,0,0,0,0,0,-1,2255,2266,-11,-1,2546,2558,-12,-1,2650,2663,-13,-1,6286,6303,-17
21535,300000,240000,0,0,0,0,0,0,0,151878,6163,145715,0,123417,4728,118689,0,104922,3811,101111,0,107005,3830,103175
21536,100000,80000,0,0,0,0,0,0,-1,52520,39033,13487,0,24550,524,24026,0,5973,18,5955,0,57200,57227,-27
21537,110000,88000,0,0,0,0,0,0,-1,2684,2684,0,-1,1149,4,1145,0,715,715,0,-1,1174,1174,0
21538,220000,176000,0,0,0,0,0,0,0,183838,12000,171838,0,157898,5852,152046,0,164860,10000,154860,0,168294,6610,161684
21539,230000,184000,0,0,0,0,0,0,0,27937,2200,25737,0,28774,2000,26774,0,29202,1100,28102,0,29683,1000,28683
21540,170000,136000,0,1,0,0,0,0,0,172307,7500,164807,0,35234,1200,34034,0,32869,1200,31669,0,33862,1500,32362
21541,360000,288000,0,0,0,0,0,0,0,262153,12500,249653,0,260025,12500,247525,0,169474,7000,162474,0,130705,5000,125705
21542,140000,112000,0,0,0,0,0,0,0,52238,2000,50238,0,53368,2000,51368,0,56488,4000,52488,0,58542,3000,55542
21543,50000,40000,0,0,0,0,0,0,0,16005,1600,14405,0,16472,1000,15472,0,18072,2000,16072,0,18405,618,17787
21544,350000,280000,0,0,0,0,0,0,-1,12149,12149,0,-1,14774,16928,-2154,-1,2154,0,2154,0,67081,67081,0
21545,200000,160000,0,0,0,0,0,0,0,9853,5033,4820,0,5334,3516,1818,0,5481,5497,-16,-1,11344,11378,-34
21546,50000,40000,0,0,0,0,0,0,-1,21206,1262,19944,0,20127,656,19471,0,19049,655,18394,0,19730,2433,17297
21547,170000,136000,0,1,0,0,0,0,0,171095,6154,164941,0,137986,15000,122986,0,141319,6000,135319,0,139463,7000,132463
21548,150000,120000,1,1,1,0,0,1,0,156201,3173,153028,0,149975,3749,146226,0,0,0,0,0,0,0,0
21549,50000,40000,0,0,0,0,0,0,0,36131,1789,34342,0,29374,1442,27932,0,27059,967,26092,0,27627,1003,26624
21550,120000,96000,0,0,0,0,0,1,-1,1914,1920,-6,-1,390,390,0,-1,0,0,0,-1,780,780,0
21551,500000,400000,0,0,0,0,0,0,-1,14148,14148,0,-1,28190,20000,8190,0,7423,0,7423,0,3588,0,3588
21552,340000,272000,0,0,0,0,0,0,-1,-2429,528,-2957,-1,10300,15303,-5003,-1,3630,13,3617,2,3577,3615,-38
21553,120000,96000,0,0,0,0,0,0,0,46247,3000,43247,0,45974,2000,43974,0,45854,2000,43854,0,45191,1500,43691
21554,240000,192000,0,0,0,0,0,1,0,2181,2185,-4,-1,1175,4,1171,2,-13,0,-13,2,2487,2500,-13
21555,270000,216000,0,0,0,0,0,0,0,90515,4000,86515,0,91903,3403,88500,0,93864,3200,90664,0,96118,3479,92639
21556,420000,336000,0,0,0,0,0,1,-2,2890,7898,-5008,-2,3391,3401,-10,-2,2409,2416,-7,-2,4270,4281,-11
21557,50000,40000,0,1,1,0,0,0,2,43454,1200,42254,0,44254,1000,43254,0,2150,2150,0,-1,1689,1689,0
21558,460000,368000,0,0,0,0,0,1,2,295114,12500,282614,2,299739,11000,288739,2,304319,11000,293319,2,299400,0,299400
21559,200000,160000,0,1,0,0,0,1,2,197185,3028,194157,2,146021,5169,140852,0,147473,5400,142073,0,147669,5306,142363
21560,110000,88000,0,1,1,1,1,1,0,111387,5000,106387,0,111631,4300,107331,0,111657,12700,98957,0,109756,0,109756
21561,40000,32000,0,0,0,0,0,0,8,25234,0,25234,7,24579,0,24579,6,23635,0,23635,5,22680,0,22680
21562,60000,48000,0,0,0,0,0,0,2,6772,1500,5272,2,6515,0,6515,2,7906,1500,6406,2,7487,0,7487
21563,100000,80000,0,0,0,0,0,0,0,14479,3005,11474,0,10775,0,10775,2,10998,700,10298,0,12655,2000,10655
21564,100000,80000,0,0,0,0,0,0,2,750,0,750,2,750,0,750,3,750,0,750,3,750,0,750
21565,70000,56000,0,0,0,0,0,0,0,10803,11000,-197,-1,15133,5000,10133,0,3148,3150,-2,-1,4699,2000,2699
21566,70000,56000,0,1,1,0,0,1,0,66646,3237,63409,0,69641,4938,64703,0,46458,1693,44765,0,50679,5000,45679
21567,160000,128000,0,0,0,0,0,0,-1,2562,2562,0,-1,8582,8582,0,-1,2758,2758,0,-1,0,0,0
21568,210000,168000,0,0,0,0,0,1,2,0,0,0,2,0,0,0,-2,0,0,0,-2,0,0,0
21569,100000,80000,0,0,0,0,0,0,-1,1977,1000,977,0,380,380,0,-1,380,380,0,-1,1253,1253,0
21570,400000,320000,0,0,0,0,0,0,2,19058,1510,17548,0,15146,1010,14136,0,15064,1000,14064,0,12774,2000,10774
21571,170000,136000,0,0,0,0,0,1,-2,0,0,0,-2,0,0,0,-2,0,0,0,-2,330,330,0
21572,50000,40000,0,0,0,0,0,1,2,26620,2000,24620,2,26889,1000,25889,2,26158,0,26158,2,27737,2000,25737
21573,260000,208000,0,0,0,0,0,0,0,84117,5018,79099,0,28683,10000,18683,0,3154,3154,0,-1,13603,13603,0
21574,220000,176000,0,0,0,0,0,0,0,152786,8000,144786,0,137946,6000,131946,0,118310,5000,113310,0,119147,5000,114147
21575,50000,40000,0,0,0,0,0,1,0,30455,1175,29280,0,2000,2000,0,-1,0,0,0,-1,0,0,0
21576,360000,288000,0,0,0,0,0,0,0,183154,10000,173154,0,143367,5500,137867,0,135751,5000,130751,0,138659,5100,133559
21577,230000,184000,0,1,0,0,0,0,-1,197630,0,197630,2,172058,7556,164502,0,174123,6219,167904,0,178052,6721,171331
21578,20000,16000,0,0,0,0,0,0,0,2576,1500,1076,0,1834,200,1634,0,1092,200,892,0,942,942,0
21579,50000,40000,0,1,0,0,0,1,2,50175,3056,47119,2,12790,0,12790,2,12743,2000,10743,0,17305,5000,12305
21580,360000,288000,0,0,0,0,0,0,0,0,0,0,-2,150,150,0,-1,205150,205000,150,0,0,0,0
21581,290000,232000,0,0,0,0,0,1,0,162007,6500,155507,0,143679,6100,137579,0,375499,235075,140424,0,222575,10047,212528
21582,20000,16000,0,0,0,0,0,0,0,16249,1381,14868,0,16478,1000,15478,0,10735,215,10520,0,3274,65,3209
21583,150000,120000,0,0,0,0,0,0,0,89006,10006,79000,0,89775,3266,86509,0,87725,4040,83685,0,40788,1698,39090
21584,30000,24000,0,1,1,1,1,0,3,29506,0,29506,2,29106,0,29106,0,29106,0,29106,0,29700,594,29106
21585,70000,56000,0,0,0,0,0,0,0,46189,3000,43189,0,39327,3000,36327,0,38618,2000,36618,0,38404,2000,36404
21586,50000,40000,0,1,0,0,0,0,2,48506,173,48333,2,18524,1000,17524,0,19239,1000,18239,0,19283,1000,18283
21587,230000,184000,0,1,1,1,1,1,2,227054,158,226896,2,196356,7100,189256,0,199525,7400,192125,0,201836,7500,194336
21588,140000,112000,0,0,0,0,0,0,-1,11639,11639,0,-1,14362,14362,0,-1,0,0,0,-1,46514,46514,0
21589,400000,320000,0,0,0,0,0,0,-2,664,667,-3,-2,1250,1256,-6,-2,-10,0,-10,-2,2174,2184,-10
21590,350000,280000,0,0,0,0,0,1,-1,17926,18018,-92,-1,17966,18058,-92,-1,30741,30897,-156,-1,31088,31244,-156
21591,110000,88000,0,0,0,0,0,1,0,62235,2300,59935,0,63499,2300,61199,0,64877,2400,62477,0,66230,2431,63799
21592,390000,312000,0,0,0,0,0,0,0,101211,84908,16303,0,96725,121081,-24356,-1,125810,80000,45810,0,182122,85000,97122
21593,170000,136000,0,0,0,0,0,0,0,38816,3000,35816,0,32475,1978,30497,0,24606,4700,19906,0,21988,1000,20988
21594,230000,184000,0,0,0,0,0,0,0,162143,8000,154143,0,165345,7000,158345,0,151047,10000,141047,0,147564,10000,137564
21595,140000,112000,0,0,0,0,0,0,0,26021,1337,24684,0,28684,3000,25684,0,29273,951,28322,0,30900,2000,28900
21596,50000,40000,0,0,0,0,0,0,0,0,0,0,-2,0,0,0,-2,0,0,0,-2,0,0,0
21597,420000,336000,0,0,0,0,0,0,0,38710,900,37810,0,38022,101,37921,2,20256,3000,17256,0,22743,3000,19743
21598,70000,56000,0,0,0,0,0,0,0,37725,2000,35725,0,38792,2000,36792,0,39447,1600,37847,0,40361,1700,38661
21599,50000,40000,0,0,0,0,0,0,0,40989,2024,38965,0,26695,3000,23695,0,18884,1000,17884,0,20131,5000,15131
21600,130000,104000,0,0,0,0,0,0,0,62963,3000,59963,0,58470,3000,55470,0,59069,2500,56569,0,51599,2000,49599
21601,160000,128000,0,0,0,0,0,0,-1,2323,3000,-677,-1,9032,9000,32,0,5630,0,5630,0,9141,9596,-455
21602,50000,40000,0,0,0,0,0,1,2,40307,2199,38108,0,17575,1000,16575,0,14691,5000,9691,0,14393,2000,12393
21603,80000,64000,0,1,1,0,0,1,2,77572,0,77572,2,77123,3500,73623,0,49823,2500,47323,0,50680,2000,48680
21604,290000,232000,0,0,0,0,0,0,0,29127,5000,24127,0,32901,5000,27901,0,36634,5000,31634,0,40460,5000,35460
21605,250000,200000,0,1,1,0,1,0,0,246357,11500,234857,0,250942,11000,239942,0,205081,7500,197581,0,209309,7500,201809
21606,20000,16000,0,0,0,0,0,0,0,0,0,0,0,0,0,0,-2,0,0,0,-2,0,0,0
21607,360000,288000,0,0,0,0,0,0,-1,759,759,0,-1,0,0,0,-1,0,0,0,-2,2318,2318,0
21608,60000,48000,0,0,0,0,0,0,0,35136,3000,32136,0,34163,5005,29158,0,27197,2000,25197,0,26528,4001,22527
21609,180000,144000,0,0,0,0,0,0,0,45172,2000,43172,0,46121,2000,44121,0,95432,2332,93100,0,50984,5000,45984
21610,80000,64000,0,0,0,0,0,1,2,51901,1883,50018,0,52959,1920,51039,0,54012,1931,52081,0,55147,2003,53144
21611,100000,80000,0,0,0,0,0,0,0,54477,2677,51800,0,56076,3076,53000,0,60100,5080,55020,0,59713,3000,56713
21612,50000,40000,0,1,0,0,0,0,0,50321,2059,48262,0,20141,666,19475,0,18039,1000,17039,0,19349,2008,17341
21613,180000,144000,0,0,0,0,0,0,0,6529,2000,4529,0,104327,100000,4327,0,105867,4500,101367,0,106806,5041,101765
21614,170000,136000,0,0,0,0,0,0,0,29253,1400,27853,0,29196,2500,26696,0,22400,0,22400,2,3605,3605,0
21615,200000,160000,0,0,0,0,0,1,2,63663,5000,58663,0,67596,5000,62596,0,66388,0,66388,2,71272,6000,65272
21616,50000,40000,0,1,0,0,0,0,0,49302,2500,46802,0,16522,1318,15204,0,15175,700,14475,0,16371,1600,14771
21617,70000,56000,0,0,0,0,0,0,0,16581,0,16581,2,14106,650,13456,0,14427,650,13777,0,11689,570,11119
21618,260000,208000,0,0,0,0,0,1,0,101023,6000,95023,0,93738,5000,88738,0,96218,4000,92218,0,102547,8000,94547
21619,20000,16000,0,1,1,1,1,0,0,19973,1300,18673,0,20081,700,19381,0,20292,800,19492,0,20289,1000,19289
21620,90000,72000,0,0,0,0,0,0,-1,0,0,0,-2,4220,4220,0,-1,1130,1130,0,-1,212,212,0
21621,70000,56000,0,1,1,1,1,0,0,70660,2532,68128,0,67975,2569,65406,0,65805,2324,63481,0,66058,2541,63517
21622,30000,24000,0,0,0,0,0,0,2,909,909,0,-1,390,390,0,-1,29570,29570,0,-1,940,940,0
21623,150000,120000,0,0,0,0,0,0,0,64432,3000,61432,0,54848,2000,52848,0,46098,2000,44098,0,47352,2000,45352
21624,30000,24000,0,0,0,0,0,1,2,2400,0,2400,2,2400,0,2400,7,2400,0,2400,7,2400,0,2400
21625,50000,40000,0,1,1,1,1,1,0,48854,0,48854,2,50901,3800,47101,2,50015,1890,48125,2,48179,0,48179
21626,60000,48000,0,0,0,0,0,1,0,21669,1664,20005,0,23005,2000,21005,0,22499,0,22499,2,22873,900,21973
21627,180000,144000,0,0,0,0,0,0,-2,0,0,0,-2,0,0,0,-2,2201,2201,0,-1,2201,0,2201
21628,10000,8000,0,0,0,0,0,0,-1,6470,1000,5470,0,390,390,0,-1,0,0,0,-1,780,780,0
21629,30000,24000,0,0,0,0,0,0,-2,7501,7501,0,-2,11216,11216,0,-2,14333,14387,-54,-2,0,0,0
21630,20000,16000,0,1,1,1,1,1,0,17954,1304,16650,0,18966,1316,17650,0,19404,754,18650,0,19962,931,19031
21631,250000,200000,0,0,0,0,0,0,-2,-11,0,-11,-2,-11,0,-11,-2,39618,39629,-11,-2,20380,20380,0
21632,250000,200000,0,0,0,0,0,0,-2,412,416,-4,-2,6264,6303,-39,-2,5880,5880,0,-2,0,0,0
21633,50000,40000,0,0,0,0,0,0,0,23807,2000,21807,0,17623,1293,16330,0,17974,644,17330,0,18350,666,17684
21634,150000,120000,0,1,1,1,1,1,2,143704,5000,138704,0,151572,9500,142072,0,149807,0,149807,2,153088,5005,148083
21635,410000,328000,0,0,0,0,0,0,2,190,190,0,-1,380,380,0,-1,190,0,190,0,1539,1539,0
21636,360000,288000,0,0,0,0,0,0,0,69552,20200,49352,0,38898,10063,28835,0,31222,1897,29325,0,55801,30278,25523
21637,100000,80000,0,0,0,0,0,0,-1,2781,0,2781,2,32231,32231,0,-1,2781,0,2781,0,21651,21651,0
21638,310000,248000,0,0,0,0,0,0,0,68131,10000,58131,0,68585,3018,65567,0,68657,4000,64657,0,55457,3000,52457
21639,70000,56000,0,0,0,0,0,0,0,54263,5040,49223,0,47562,2000,45562,0,43735,2000,41735,0,43509,12000,31509
21640,30000,24000,0,1,0,1,0,1,3,29928,0,29928,2,29498,31200,-1702,-1,27025,541,26484,0,0,0,0
21641,30000,24000,0,0,0,0,0,0,-1,5831,5842,-11,-1,2083,2088,-5,-2,2903,2903,0,-2,3874,3874,0
21642,280000,224000,0,0,0,0,0,0,-2,0,0,0,-2,17535,17535,0,-1,9119,9119,0,-1,18960,18960,0
21643,360000,288000,0,0,0,0,0,0,-1,177639,177671,-32,-1,174397,3508,170889,0,4852,4876,-24,-1,4125,4188,-63
21644,50000,40000,0,0,0,0,0,0,-2,2333,2440,-107,-2,1800,1807,-7,-2,1620,2204,-584,-2,0,0,0
21645,500000,400000,0,0,0,0,0,0,0,182274,6831,175443,0,185523,6500,179023,0,183530,6500,177030,0,187150,6500,180650
21646,150000,120000,0,0,0,0,0,0,-1,11848,11848,0,-1,7435,7435,0,-1,3685,0,3685,0,3545,3545,0
21647,280000,224000,0,0,0,0,0,0,-1,3968,3968,0,-1,3868,0,3868,0,0,0,0,0,0,0,0
21648,120000,96000,0,1,1,1,1,0,0,123155,6108,117047,0,120267,5831,114436,0,121471,4700,116771,0,118656,4486,114170
21649,500000,400000,0,0,0,0,0,0,-1,53170,53192,-22,-1,28622,28622,0,-1,19140,19140,0,-1,0,0,0
21650,200000,160000,0,0,0,0,0,0,2,61807,61807,0,-1,7849,7849,0,-1,14978,10000,4978,0,46333,35000,11333
21651,150000,120000,0,0,0,0,0,0,-2,596,596,0,-2,22131,22131,0,-2,0,1980,-1980,-2,1596,1596,0
21652,80000,64000,0,1,1,1,1,0,0,79887,5000,74887,0,76067,10000,66067,0,73077,6500,66577,0,76894,5000,71894
21653,190000,152000,0,0,0,0,0,1,0,87736,4000,83736,0,90373,5000,85373,0,91980,4000,87980,0,94502,4000,90502
21654,10000,8000,0,0,0,0,1,0,0,6673,1300,5373,0,7890,1500,6390,0,8628,1000,7628,0,9360,1000,8360
21655,20000,16000,1,1,1,1,0,0,3,20332,0,20332,2,19932,0,19932,0,19932,0,19932,0,7080,0,7080
21656,90000,72000,0,0,0,0,0,0,0,26711,1747,24964,0,27722,1758,25964,0,28116,1152,26964,0,28552,1038,27514
21657,30000,24000,0,0,0,0,0,1,-1,3016,3000,16,0,4504,3009,1495,0,5755,5767,-12,-1,3560,3566,-6
21658,700000,560000,0,0,0,0,0,0,0,224238,8500,215738,0,174189,7093,167096,0,121717,4500,117217,0,124040,4100,119940
21659,60000,48000,0,0,0,0,0,1,2,25086,4000,21086,2,24404,0,24404,2,25212,1500,23712,0,28147,3500,24647
21660,80000,64000,0,1,0,0,0,0,0,82150,3800,78350,0,0,0,0,0,0,0,0,-2,0,0,0
21661,180000,144000,0,0,0,0,0,0,0,73730,3504,70226,0,64600,3000,61600,0,2500,0,2500,0,0,0,0
21662,90000,72000,0,0,0,0,0,0,0,0,0,0,0,1700,1700,0,-1,1700,1700,0,-1,0,0,0
21663,270000,216000,0,0,0,0,0,0,-1,1152,1152,0,-1,56891,56891,0,-1,4866,4866,0,-1,9334,9533,-199
21664,310000,248000,0,0,0,0,0,0,0,18731,5000,13731,0,23078,5000,18078,0,27354,5000,22354,0,31725,5000,26725
21665,150000,120000,0,0,0,0,0,0,0,122175,122685,-510,-1,111847,3328,108519,0,76628,2230,74398,0,64200,2062,62138
21666,320000,256000,0,0,0,0,0,0,0,110569,5004,105565,0,106095,4086,102009,0,92573,5033,87540,0,89650,5020,84630
21667,20000,16000,0,0,0,0,0,1,2,9339,1000,8339,2,10029,1000,9029,0,10615,900,9715,0,11285,1000,10285
21668,60000,48000,0,0,0,0,0,0,0,37137,3429,33708,0,26015,2015,24000,0,18840,2000,16840,0,19183,2004,17179
21669,160000,128000,0,1,1,1,0,1,2,154957,0,154957,2,157788,7300,150488,0,160282,7000,153282,0,100213,4400,95813
21670,210000,168000,0,0,0,0,0,0,-1,1181,1181,0,-1,1031,1031,0,-1,1430,1430,0,-1,1031,1031,0
21671,50000,40000,0,0,0,0,0,0,0,33886,2004,31882,0,32929,1324,31605,0,34549,3768,30781,0,33458,1,33457
21672,130000,104000,0,0,0,0,0,1,2,44396,1500,42896,2,45365,2000,43365,2,46093,1600,44493,2,47185,2000,45185
21673,20000,16000,0,0,0,1,1,0,0,16544,1581,14963,0,17250,1287,15963,0,17604,641,16963,0,19993,2684,17309
21674,100000,80000,0,1,1,1,1,1,4,86256,0,86256,3,87150,3200,83950,2,85636,0,85636,2,91007,6803,84204
21675,120000,96000,0,0,0,0,0,1,-1,416,416,0,-1,416,416,0,-1,0,0,0,-1,832,832,0
21676,180000,144000,0,0,0,0,0,0,0,43847,10000,33847,0,50763,10000,40763,0,69026,23000,46026,0,32030,5000,27030
21677,430000,344000,0,0,0,0,0,0,0,18753,5002,13751,0,14734,1000,13734,0,17572,5000,12572,0,18784,5000,13784
21678,480000,384000,0,0,0,0,0,0,0,20885,5000,15885,0,19949,795,19154,0,23031,5000,18031,0,27176,5000,22176
21679,100000,80000,0,0,0,0,0,0,0,4470,1193,3277,0,1490,1000,490,0,542,0,542,0,679,400,279
21680,230000,184000,0,0,0,0,0,0,-1,3665,3665,0,-1,929,929,0,-1,4167,4167,0,-1,115126,115126,0
21681,220000,176000,0,0,0,0,0,0,2,156996,7600,149396,0,158717,5700,153017,0,162122,6000,156122,0,165399,6000,159399
21682,210000,168000,0,0,0,0,0,0,0,144415,5082,139333,0,148190,6000,142190,0,147993,5900,142093,0,131629,4544,127085
21683,80000,64000,0,0,0,0,0,0,0,20344,3379,16965,0,7311,0,7311,0,6100,0,6100,0,2160,0,2160
21684,140000,112000,0,0,0,0,0,0,-1,13125,0,13125,3,14600,2000,12600,2,16066,2000,14066,2,17521,2000,15521
21685,410000,328000,0,0,0,0,0,1,0,8484,3040,5444,0,15286,15362,-76,-1,17116,17133,-17,-1,18777,5076,13701
21686,170000,136000,0,0,0,0,0,0,-1,4336,4346,-10,-1,947,947,0,-1,316,316,0,-1,3797,3797,0
21687,180000,144000,0,0,0,0,0,0,-2,0,0,0,-2,0,0,0,-2,11855,11855,0,-1,2520,0,2520
21688,30000,24000,0,1,1,1,0,0,0,28503,1200,27303,0,27525,2,27523,0,27630,835,26795,0,0,0,0
21689,130000,104000,0,0,0,0,0,0,0,1330,1330,0,-1,0,0,0,-1,0,0,0,-2,0,0,0
21690,380000,304000,0,0,0,0,0,0,0,71599,11000,60599,0,80377,10000,70377,0,84113,5000,79113,0,86612,7000,79612
21691,80000,64000,0,1,1,0,0,1,0,76228,3470,72758,0,76841,3305,73536,0,9534,500,9034,0,7371,300,7071
21692,500000,400000,0,0,0,0,0,0,0,42392,10000,32392,0,36641,5132,31509,0,12149,12159,-10,-1,426518,426529,-11
21693,50000,40000,0,0,0,0,0,0,0,22110,1606,20504,0,19837,692,19145,0,19855,709,19146,0,20151,721,19430
21694,220000,176000,0,0,0,0,0,0,0,60360,3037,57323,0,61168,4000,57168,0,57287,4000,53287,0,62208,15000,47208
21695,50000,40000,0,1,1,1,0,1,2,45744,3400,42344,2,43123,0,43123,2,42343,1528,40815,0,43020,3038,39982
21696,280000,224000,0,0,0,0,0,0,0,96333,7066,89267,0,97475,10000,87475,0,100652,5000,95652,0,1823,1823,0
21697,190000,152000,0,0,0,0,0,0,0,129376,4696,124680,0,132016,4791,127225,0,134632,4811,129821,0,137470,5000,132470
21698,230000,184000,0,0,0,0,0,0,-1,72938,7064,65874,0,54105,4106,49999,0,18744,5075,13669,0,5148,1000,4148
21699,130000,104000,0,0,0,0,0,0,0,22760,2000,20760,0,23215,778,22437,0,23706,811,22895,0,21951,2000,19951
21700,200000,160000,0,0,0,0,0,0,0,126343,5203,121140,0,125700,4000,121700,0,126448,5000,121448,0,81008,3001,78007
21701,50000,40000,0,0,0,0,0,1,0,27905,1670,26235,0,17174,605,16569,0,17533,626,16907,0,17240,654,16586
21702,70000,56000,0,1,1,0,0,0,0,71867,3427,68440,0,64534,3100,61434,0,33683,1200,32483,0,32857,1700,31157
21703,420000,336000,0,0,0,0,0,0,-2,1133,1143,-10,-1,10415,10429,-14,-1,7792,194,7598,0,-3,556,-559
21704,130000,104000,0,0,0,0,0,0,0,0,0,0,0,0,0,0,-2,0,0,0,-2,0,0,0
21705,420000,336000,0,0,0,0,0,0,-2,18653,18728,-75,-2,36076,36430,-354,-2,27823,27906,-83,-2,0,0,0
21706,80000,64000,0,0,0,0,0,1,0,21268,1368,19900,0,23903,3003,20900,0,24367,1000,23367,0,24964,1000,23964
21707,290000,232000,0,0,0,0,0,0,-2,37392,37578,-186,-2,6106,6136,-30,-2,14839,14913,-74,-2,11209,11264,-55
21708,190000,152000,0,1,1,1,1,0,0,192058,8900,183158,0,185995,6700,179295,0,188649,6699,181950,0,190700,7400,183300
21709,100000,80000,0,0,0,0,0,0,-1,9217,9226,-9,-1,1845,1845,0,-1,41194,41194,0,-1,40325,2920,37405
21710,60000,48000,0,1,1,0,0,1,0,54007,2570,51437,0,52089,2202,49887,0,29397,1200,28197,0,29110,1100,28010
21711,210000,168000,0,0,0,0,0,1,2,161573,6800,154773,0,122362,3800,118562,0,116243,5134,111109,0,108414,4000,104414
21712,70000,56000,0,0,0,0,0,0,0,-2601,695,-3296,0,69823,73820,-3997,-1,30446,1042,29404,0,29585,1054,28531
21713,80000,64000,0,0,0,0,0,0,0,26855,27318,-463,-1,23287,1407,21880,0,20885,429,20456,0,17595,417,17178
21714,200000,160000,0,0,0,0,0,0,-1,287,1000,-713,-1,9471,9500,-29,-1,985,1000,-15,-1,4489,4500,-11
21715,50000,40000,0,0,0,0,0,1,0,38498,1754,36744,0,40644,2900,37744,0,39731,0,39731,2,35657,1265,34392
21716,200000,160000,0,0,0,0,0,0,-2,15191,15220,-29,-2,8991,8991,0,-2,8986,8986,0,-2,8609,8609,0
21717,90000,72000,0,0,0,0,0,0,-1,800,800,0,-1,0,0,0,-1,0,0,0,-2,0,0,0
21718,390000,312000,0,0,0,0,0,0,-1,278505,278505,0,-1,288000,15000,273000,0,264214,9310,254904,0,266704,10000,256704
21719,280000,224000,0,0,0,0,0,0,2,115223,4700,110523,2,116930,5100,111830,2,112607,0,112607,2,95949,4200,91749
21720,180000,144000,0,0,0,0,0,0,0,146396,7000,139396,0,136531,5000,131531,0,138502,5000,133502,0,136665,6000,130665
21721,160000,128000,0,0,0,0,0,0,-1,8404,8404,0,-1,8875,8875,0,-1,8509,8509,0,-1,4630,4630,0
21722,120000,96000,0,0,0,0,0,0,0,70864,2823,68041,0,64193,2514,61679,0,61733,1732,60001,0,59717,1756,57961
21723,200000,160000,0,0,0,0,0,0,0,11938,4938,7000,0,15972,5972,10000,0,17952,7952,10000,0,5925,2925,3000
21724,150000,120000,0,0,0,0,0,0,-1,0,0,0,-1,0,0,0,-2,0,0,0,-2,35752,35752,0
21725,20000,16000,0,0,0,0,0,1,0,9701,1161,8540,0,9894,354,9540,0,10102,367,9735,0,10534,600,9934
21726,20000,16000,0,0,0,0,0,0,-1,15586,1551,14035,0,12800,5060,7740,0,0,0,0,0,0,0,0
21727,150000,120000,0,0,0,0,0,0,-2,7542,7542,0,-2,1200,1200,0,-2,0,0,0,-2,0,0,0
21728,30000,24000,0,0,0,0,0,0,-1,0,1000,-1000,-1,0,0,0,-2,0,0,0,-2,0,0,0
21729,30000,24000,0,0,0,0,0,0,0,22352,2000,20352,0,23221,1500,21721,0,24339,4000,20339,0,25943,2000,23943
21730,490000,392000,0,0,0,0,0,0,2,227998,12000,215998,0,217660,12000,205660,0,194641,8000,186641,0,199344,8000,191344
21731,170000,136000,0,0,0,0,0,0,-2,326,326,0,-2,326,326,0,-2,326,326,0,-2,324,324,0
21732,170000,136000,0,0,0,0,0,0,0,22499,10000,12499,0,25015,25015,0,-1,34343,10000,24343,0,53403,20000,33403
21733,200000,160000,0,0,0,0,0,0,-2,0,0,0,-2,0,0,0,-2,0,0,0,-2,0,0,0
21734,140000,112000,0,0,0,0,0,0,0,38079,3400,34679,0,37167,0,37167,2,41146,4600,36546,2,40332,0,40332
21735,160000,128000,0,0,0,0,0,0,0,56214,3500,52714,0,57246,2500,54746,0,58443,2207,56236,0,59883,2500,57383
21736,50000,40000,0,0,0,0,0,0,0,15967,1700,14267,0,16599,1200,15399,0,17329,1000,16329,0,17888,1000,16888
21737,270000,216000,0,0,0,0,0,0,0,15016,2000,13016,0,14092,1000,13092,0,14315,2000,12315,0,111458,100000,11458
21738,50000,40000,0,0,0,0,0,1,3,25004,2600,22404,2,24315,0,24315,3,23626,0,23626,2,25370,2129,23241
21739,130000,104000,0,0,0,0,0,0,-1,98080,4368,93712,0,97224,3449,93775,0,97940,3713,94227,0,99170,3610,95560
21740,50000,40000,0,0,0,0,0,0,0,36467,1819,34648,0,18890,2664,16226,0,30288,31057,-769,-1,30003,1064,28939
21741,160000,128000,0,0,0,0,0,0,0,0,0,0,-2,972,972,0,-2,-1,1,-2,-2,-1,0,-1
21742,50000,40000,0,0,0,0,0,0,2,10726,1500,9226,0,10863,800,10063,0,11200,700,10500,0,11272,600,10672
21743,50000,40000,0,0,0,0,0,0,0,23228,1436,21792,0,21482,1162,20320,0,18029,2184,15845,0,18705,871,17834
21744,130000,104000,0,0,0,0,0,1,0,85424,3500,81924,0,82632,2956,79676,0,84522,3220,81302,0,86061,3100,82961
21745,50000,40000,0,1,0,0,0,0,0,49179,2300,46879,0,19747,1004,18743,0,19726,730,18996,0,20140,700,19440
21746,80000,64000,0,0,0,0,0,0,-2,0,3100,-3100,-2,0,0,0,-2,0,0,0,-2,0,0,0
21747,210000,168000,0,1,1,0,0,1,0,192717,7791,184926,0,195700,7000,188700,0,150525,5254,145271,0,137565,5400,132165
21748,220000,176000,0,1,0,0,0,1,0,225462,19254,206208,0,116915,0,116915,2,116021,8500,107521,2,114001,0,114001
21749,130000,104000,0,0,0,0,0,0,0,1349,1349,0,-1,1609,1609,0,-1,635,635,0,-1,849,849,0
21750,20000,16000,0,0,0,0,0,0,0,3347,5000,-1653,-1,4426,2000,2426,0,1906,0,1906,0,942,900,42
21751,210000,168000,0,0,0,0,0,1,-1,326,326,0,-1,326,326,0,-1,326,326,0,-1,326,326,0
21752,380000,304000,0,0,0,0,0,0,-1,21814,2200,19614,0,47964,48000,-36,-1,33405,0,33405,0,2981,2981,0
21753,400000,320000,0,0,0,0,0,0,0,7566,1213,6353,0,7716,363,7353,0,7722,219,7503,0,7890,234,7656
21754,30000,24000,0,1,1,1,1,0,0,30291,1512,28779,0,30616,1259,29357,0,30456,2500,27956,0,29818,0,29818
21755,80000,64000,0,0,0,0,0,0,0,24577,1233,23344,0,24788,882,23906,0,18522,633,17889,0,17873,842,17031
21756,30000,24000,0,0,1,1,1,0,2,25218,2579,22639,2,24514,0,24514,2,25030,909,24121,0,25557,944,24613
21757,180000,144000,0,0,0,0,0,0,-2,0,0,0,-2,0,0,0,-2,0,0,0,-2,0,0,0
21758,50000,40000,0,0,0,0,0,0,-1,3116,3116,0,-1,302,302,0,-1,0,0,0,-1,5778,5778,0
21759,120000,96000,0,1,1,1,1,0,0,113997,4200,109797,0,117085,5000,112085,0,117945,5000,112945,0,109855,4200,105655
21760,210000,168000,0,0,0,0,0,0,-1,2042,2042,0,-1,1646,0,1646,0,396,396,0,-1,396,396,0
21761,500000,400000,0,0,0,0,0,0,-2,504,625,-121,-2,24125,24246,-121,-2,19611,19709,-98,-2,3100,3117,-17
21762,100000,80000,0,0,0,0,0,0,0,66575,3000,63575,0,68499,3000,65499,0,69584,3000,66584,0,71247,3000,68247
21763,200000,160000,0,0,0,0,0,1,-1,1230,1230,0,-1,390,390,0,-1,390,390,0,-1,390,390,0
21764,80000,64000,0,0,0,0,0,0,-2,0,0,0,-2,0,0,0,-2,0,0,0,-2,0,0,0
21765,110000,88000,0,0,0,0,0,0,0,22760,1624,21136,0,23466,1330,22136,0,24085,949,23136,0,24584,976,23608
21766,140000,112000,0,0,0,0,0,0,0,61544,3000,58544,0,62925,3000,59925,0,64280,3000,61280,0,67079,4000,63079
21767,30000,24000,0,1,1,1,1,0,2,29953,0,29953,2,30332,1962,28370,0,29871,1395,28476,0,28977,1000,27977
21768,290000,232000,0,0,0,0,0,0,0,53841,1926,51915,0,54486,1931,52555,0,55198,1989,53209,0,55878,2002,53876
21769,130000,104000,0,0,0,0,0,0,0,7559,1000,6559,0,5198,2200,2998,0,5198,0,5198,0,5198,0,5198
21770,180000,144000,0,0,0,0,0,0,0,2125,2125,0,-1,0,0,0,-1,0,0,0,-2,0,0,0
21771,320000,256000,0,0,0,0,0,1,2,22035,0,22035,2,22015,2007,20008,0,21163,1000,20163,0,25806,5000,20806
21772,200000,160000,0,0,0,0,0,0,0,5535,12,5523,2,2513,50,2463,0,1828,300,1528,0,3731,3738,-7
21773,320000,256000,0,0,0,0,0,0,-1,54659,54726,-67,-1,35196,103,35093,0,71244,71404,-160,-1,35299,35448,-149
21774,440000,352000,0,0,0,0,0,0,0,24077,3000,21077,0,23241,2000,21241,0,24600,5000,19600,0,16344,0,16344
21775,10000,8000,0,0,0,0,0,0,0,5428,1000,4428,0,7928,2500,5428,0,6091,122,5969,0,0,0,0
21776,230000,184000,0,0,0,0,0,1,-2,2310,2310,0,-2,316,316,0,-2,316,316,0,-2,316,316,0
21777,140000,112000,0,0,0,0,0,1,2,41739,0,41739,2,43730,3000,40730,0,45687,3000,42687,0,46796,2000,44796
21778,50000,40000,0,0,0,0,0,1,0,30272,1640,28632,0,31080,1901,29179,0,15315,526,14789,0,15238,537,14701
21779,120000,96000,0,0,0,0,0,1,2,-116,0,-116,2,-442,0,-442,-2,732,1500,-768,-1,406,0,406
21780,40000,32000,0,0,0,0,0,0,-1,0,0,0,-2,0,0,0,-2,0,0,0,-2,0,0,0
21781,220000,176000,0,0,0,0,0,0,0,141917,5155,136762,0,144811,5258,139553,0,147685,5284,142401,0,150780,5473,145307
21782,180000,144000,0,0,0,0,0,0,-1,8834,8857,-23,-1,19565,19565,0,-1,14170,502,13668,0,9017,3000,6017
21783,190000,152000,0,0,0,0,0,0,0,9224,0,9224,2,10262,1200,9062,0,13083,3000,10083,0,13372,500,12872
21784,500000,400000,0,0,0,0,0,0,-2,-32,0,-32,-2,6443,6475,-32,-2,0,0,0,-2,265,265,0
21785,180000,144000,0,0,0,0,0,0,-1,326,326,0,-1,326,326,0,-1,326,326,0,-1,326,326,0
21786,80000,64000,0,0,0,0,0,1,0,0,0,0,-2,0,0,0,-2,0,0,0,-2,0,0,0
21787,120000,96000,0,0,0,0,0,0,-2,1990,1990,0,-1,0,0,0,-1,0,0,0,-2,0,0,0
21788,150000,120000,0,0,0,0,0,0,-2,190,190,0,-1,3173,3180,-7,-1,673,0,673,2,38100,38100,0
21789,150000,120000,0,0,0,0,0,0,-2,0,0,0,-2,0,0,0,-2,0,0,0,-2,9240,9240,0
21790,200000,160000,0,0,0,1,0,0,0,158486,8000,150486,0,160375,3500,156875,0,163444,3269,160175,0,0,0,0
21791,130000,104000,0,0,0,0,0,0,-1,0,817,-817,-1,1261,1261,0,-1,13161,13161,0,-1,390,390,0
21792,230000,184000,0,0,0,0,0,1,2,3004,3004,0,-1,4200,4200,0,-1,1400,0,1400,0,4222,4222,0
21793,200000,160000,0,0,0,0,0,1,2,90634,0,90634,2,95464,7260,88204,2,99894,6100,93794,2,98171,0,98171
21794,230000,184000,0,0,0,0,0,0,0,8967,1300,7667,0,8729,468,8261,0,10816,2816,8000,0,15893,5893,10000
21795,90000,72000,0,0,0,0,0,0,-1,9223,0,9223,3,8480,79,8401,2,2181,2181,0,-1,2983,2991,-8
21796,50000,40000,0,1,0,0,0,0,0,49966,1000,48966,0,523,523,0,0,18450,18868,-418,-1,18478,806,17672
21797,310000,248000,0,0,0,0,0,0,2,400,0,400,2,400,0,400,2,20334,20334,0,-1,19050,0,19050
21798,220000,176000,0,1,1,1,1,1,2,187220,6600,180620,0,199542,15200,184342,0,202036,7000,195036,2,200956,2000,198956
21799,290000,232000,0,0,0,0,0,0,-2,6401,6491,-90,-2,1864,1864,0,-2,5156,5157,-1,-2,3277,3277,0
21800,100000,80000,0,0,0,0,0,1,-2,0,0,0,-2,0,0,0,-2,0,0,0,-2,0,0,0
21801,220000,176000,0,0,0,0,0,1,-1,3572,2518,1054,0,7330,7409,-79,-1,0,0,0,-1,3995,3995,0
21802,210000,168000,0,0,0,0,0,0,-2,0,0,0,-2,0,0,0,-2,0,0,0,-2,0,0,0
21803,300000,240000,0,0,0,0,0,0,-1,14583,14583,0,-1,2506,2513,-7,-1,2996,2996,0,-1,370,370,0
21804,280000,224000,0,0,0,0,0,0,2,30529,0,30529,2,33562,3562,30000,0,34557,1557,33000,0,35600,1600,34000
21805,20000,16000,0,0,0,0,0,0,0,3948,3600,348,0,18838,20044,-1206,-1,-71,65,-136,-1,8929,9000,-71
21806,20000,16000,0,0,0,0,0,0,0,11260,0,11260,2,11260,0,11260,0,11260,0,11260,0,0,0,0
21807,370000,296000,0,0,0,0,0,0,0,256269,11295,244974,0,200761,8300,192461,0,125646,5000,120646,0,111185,4600,106585
21808,170000,136000,0,1,1,0,0,0,0,169829,6336,163493,0,162988,5205,157783,0,125969,4452,121517,0,127643,4592,123051
21809,60000,48000,0,1,1,1,1,0,2,55208,0,55208,2,59175,5000,54175,2,60218,2511,57707,2,55447,6,55441
21810,260000,208000,0,1,1,1,1,0,0,253218,9090,244128,0,249770,9034,240736,0,243277,8521,234756,0,240576,10067,230509
21811,230000,184000,0,0,0,0,0,0,0,63574,5000,58574,0,71941,10000,61941,0,75882,5000,70882,0,75619,5000,70619
21812,30000,24000,1,1,1,1,0,0,0,37685,2452,35233,0,33305,1072,32233,0,28305,1089,27216,0,20371,3101,17270
21813,500000,400000,0,0,0,0,0,0,-1,33823,34000,-177,-1,130689,100028,30661,0,77736,0,77736,0,151,151,0
21814,60000,48000,0,0,0,0,0,0,0,49351,3000,46351,0,28549,1500,27049,0,29063,1500,27563,0,28863,1100,27763
21815,90000,72000,0,0,0,0,0,0,0,25248,1500,23748,0,26386,1500,24886,0,24171,2000,22171,0,25607,2000,23607
21816,200000,160000,0,0,0,0,0,1,-1,0,200,-200,-2,12141,12141,0,-1,0,0,0,-1,0,0,0
21817,20000,16000,0,0,0,0,0,0,-1,11417,1000,10417,0,16449,6782,9667,0,6989,670,6319,0,2021,2021,0
21818,130000,104000,0,0,0,0,0,1,0,31247,0,31247,2,40047,9000,31047,0,12450,12450,0,-1,2294,2294,0
21819,500000,400000,0,0,0,0,0,0,-1,0,0,0,-1,51697,51697,0,-1,37511,37511,0,-1,1685,1685,0
21820,50000,40000,0,0,0,0,0,0,0,32287,1318,30969,0,34156,496,33660,0,14618,1076,13542,0,3648,708,2940
21821,500000,400000,0,0,0,0,0,0,-1,9933,10021,-88,-1,14557,14576,-19,-1,53328,53850,-522,-1,58052,58332,-280
21822,30000,24000,0,1,1,1,1,1,0,27525,1500,26025,0,28545,1500,27045,0,29388,1300,28088,0,30133,1200,28933
21823,300000,240000,0,0,0,0,0,1,-1,3391,3472,-81,-1,34282,47371,-13089,-1,12983,64,12919,0,0,0,0
21824,30000,24000,0,1,1,0,0,1,0,28045,1200,26845,0,27259,0,27259,0,0,0,0,0,0,0,0
21825,50000,40000,0,1,1,1,1,0,0,48172,4200,43972,0,46937,0,46937,2,48570,3000,45570,0,50144,3800,46344
21826,70000,56000,0,1,0,0,0,0,0,69744,2215,67529,0,50190,2000,48190,0,49603,1800,47803,0,49469,2000,47469
21827,260000,208000,0,0,0,0,0,0,0,215343,9150,206193,0,205576,7500,198076,0,207688,8000,199688,0,198955,7500,191455
21828,280000,224000,0,0,0,0,0,0,-2,182,183,-1,-2,4411,4429,-18,-1,976,981,-5,-1,4968,4992,-24
21829,80000,64000,0,0,0,0,0,0,-2,0,0,0,-2,0,0,0,-2,0,0,0,-2,0,0,0
21830,20000,16000,0,0,0,0,0,1,0,4165,1000,3165,0,6323,10488,-4165,-1,0,0,0,-1,0,0,0
21831,50000,40000,0,0,0,0,0,0,0,15371,15387,-16,-1,14163,1500,12663,0,15517,2000,13517,0,14685,1000,13685
21832,60000,48000,0,0,0,0,0,1,2,30027,2000,28027,2,28928,0,28928,2,29346,1500,27846,0,29717,1300,28417
21833,300000,240000,0,0,0,0,0,0,-1,5015,5459,-444,-1,2334,0,2334,2,3334,1000,2334,0,3350,16,3334
21834,220000,176000,0,0,0,0,0,0,-1,5572,5600,-28,-1,5572,5600,-28,-1,5774,5802,-28,-1,3264,3279,-15
21835,160000,128000,0,0,0,0,0,0,-1,1155,1155,0,-1,3334,3334,0,-1,1055,0,1055,0,8824,8824,0
21836,40000,32000,0,0,0,0,0,1,-1,11228,0,11228,2,2475,2475,0,-1,5341,5341,0,-1,6255,1500,4755
21837,230000,184000,0,0,0,0,0,1,-2,916,916,0,-2,0,0,0,-2,0,0,0,-2,8878,8878,0
21838,110000,88000,0,0,0,0,0,0,-2,0,0,0,-2,0,0,0,-2,0,0,0,-2,0,0,0
21839,230000,184000,0,0,0,0,0,0,-1,3733,3756,-23,-1,1443,1443,0,-1,1443,1443,0,-1,1435,1435,0
21840,260000,208000,0,0,0,0,0,0,-2,4328,4353,-25,-2,15711,17767,-2056,-2,0,23209,-23209,-2,127395,127395,0
21841,360000,288000,0,0,0,0,0,0,-1,300,300,0,-1,966,966,0,-1,1730,1730,0,-1,0,0,0
21842,90000,72000,0,0,0,0,0,1,-1,998,998,0,-1,0,0,0,-1,0,0,0,-2,0,0,0
21843,140000,112000,0,0,0,0,0,0,0,57668,2004,55664,0,55024,1941,53083,0,55883,2073,53810,0,55744,1909,53835
21844,400000,320000,0,0,0,0,0,0,0,120657,6624,114033,0,122338,5200,117138,0,124145,3826,120319,0,113477,3363,110114
21845,230000,184000,0,0,0,0,0,0,2,111819,0,111819,2,93007,3700,89307,0,92122,3986,88136,0,61583,2900,58683
21846,80000,64000,0,1,1,1,1,0,0,78366,3455,74911,0,78400,1960,76440,0,80000,2000,78000,0,80000,0,80000
21847,60000,48000,0,1,1,0,0,1,0,54851,2500,52351,0,55742,2500,53242,0,27333,1000,26333,0,27615,1100,26515
21848,630000,504000,0,0,0,0,0,0,0,6500,6500,0,-1,6500,6500,0,-1,6500,6500,0,-1,2870,2870,0
21849,10000,8000,0,0,0,0,1,0,0,7865,1260,6605,0,7105,1500,5605,0,8298,1470,6828,0,8020,0,8020
21850,340000,272000,0,0,0,0,0,0,0,146603,5333,141270,0,149519,5366,144153,0,151697,5550,146147,0,154499,7000,147499
21851,20000,16000,0,0,0,0,0,1,-1,732,732,0,-1,642,300,342,0,1252,1000,252,0,643,500,143
21852,30000,24000,0,1,1,0,0,0,0,29537,1539,27998,0,30087,1089,28998,0,17534,718,16816,0,15145,400,14745
21853,100000,80000,0,0,0,0,0,0,-1,4069,4069,0,-1,37069,33000,4069,0,20233,20000,233,0,22227,22227,0
21854,20000,16000,0,0,0,0,0,0,0,15468,1488,13980,0,11082,1172,9910,0,11303,393,10910,0,10768,415,10353
21855,240000,192000,0,0,0,0,0,1,0,16469,3002,13467,0,13737,5002,8735,0,9071,3009,6062,0,177268,177004,264
21856,50000,40000,0,1,1,1,1,0,0,49388,1746,47642,0,48853,1628,47225,0,47765,1520,46245,0,48145,2202,45943
21857,20000,16000,0,0,1,1,1,0,-1,17151,1300,15851,0,18161,1302,16859,0,18521,662,17859,0,18911,688,18223
21858,200000,160000,0,0,0,0,0,0,-2,6449,6454,-5,-1,14392,14392,0,-1,14792,600,14192,0,8016,164,7852
21859,240000,192000,0,1,1,1,1,1,0,206386,0,206386,2,219111,16007,203104,2,211373,7,211366,2,211215,8229,202986
21860,480000,384000,0,0,0,0,0,0,0,650,650,0,-1,1597,1597,0,-1,3750,3750,0,-1,9429,9429,0
21861,200000,160000,0,0,0,0,0,0,-2,2897,2902,-5,-2,1432,1432,0,-2,1200,1517,-317,-2,-41,0,-41
21862,280000,224000,0,0,0,0,0,0,0,195204,7200,188004,0,199091,8800,190291,0,201581,7300,194281,0,206054,7700,198354
21863,210000,168000,0,0,0,0,0,1,-2,0,0,0,-2,0,0,0,-2,0,0,0,-2,0,0,0
21864,340000,272000,0,0,0,0,0,0,0,7681,3000,4681,0,12519,5000,7519,0,15299,3000,12299,0,15905,1000,14905
21865,210000,168000,0,0,0,0,0,0,0,153056,6230,146826,0,140518,5696,134822,0,70901,2328,68573,0,72539,2567,69972
21866,100000,80000,0,0,0,0,0,1,-1,3079,3079,0,-1,6427,6427,0,-1,6558,131,6427,0,0,0,0
21867,50000,40000,0,0,0,0,0,0,0,0,0,0,-2,0,0,0,-2,0,0,0,-2,0,0,0
21868,170000,136000,0,0,0,0,0,0,2,17120,2000,15120,0,17836,1000,16836,0,18396,1000,17396,0,18935,1000,17935
21869,160000,128000,0,0,0,0,0,0,2,678,678,0,-1,0,0,0,-1,0,0,0,-2,678,678,0
21870,500000,400000,0,0,0,0,0,0,0,48060,3030,45030,0,51132,10022,41110,0,49348,3064,46284,0,40652,3022,37630
21871,420000,336000,0,1,0,0,0,0,0,426336,18691,407645,0,84732,5027,79705,0,64614,3000,61614,0,3068,3068,0
21872,150000,120000,0,0,0,0,0,0,-1,4590,4590,0,-1,2605,2605,0,-1,2605,2605,0,-1,3795,3795,0
21873,190000,152000,0,1,1,1,1,0,0,190411,8400,182011,0,190197,6486,183711,0,180392,6046,174346,0,163922,6069,157853
21874,230000,184000,0,0,0,0,0,0,0,6997,6997,0,-1,1386,1386,0,-1,5578,5578,0,-1,1386,1386,0
21875,280000,224000,0,0,0,0,0,0,0,109958,4654,105304,0,112850,4730,108120,0,115092,4119,110973,0,117496,4258,113238
21876,220000,176000,0,0,0,0,0,0,-1,5878,5892,-14,-1,6452,6463,-11,-1,5157,5163,-6,-1,4159,4169,-10
21877,150000,120000,0,1,1,1,1,0,0,137737,7000,130737,0,140047,6000,134047,0,144557,7000,137557,0,133716,5021,128695
21878,260000,208000,0,0,0,0,0,0,-1,4866,4866,0,-1,316,316,0,-1,316,316,0,-1,4843,4843,0
21879,290000,232000,0,0,0,0,0,0,0,14483,3000,11483,0,16589,3000,13589,0,18306,3000,15306,0,22204,5000,17204
21880,50000,40000,0,1,0,0,0,0,0,49483,2000,47483,0,40850,3000,37850,0,0,0,0,0,800,400,400
21881,310000,248000,0,0,0,0,0,0,0,12222,1187,11035,0,12468,433,12035,0,11809,428,11381,0,12044,431,11613
21882,150000,120000,1,1,1,1,0,0,0,247706,12370,235336,0,239805,6552,233253,0,242653,6936,235717,0,39496,395,39101
21883,180000,144000,0,0,0,0,0,0,0,13190,3000,10190,0,17676,8700,8976,0,14792,1500,13292,0,11210,600,10610
21884,20000,16000,0,0,0,0,0,0,-1,340,340,0,-1,-50,0,-50,-1,-830,0,-830,-2,-1660,0,-1660
21885,150000,120000,0,0,0,0,0,0,-1,1420,1426,-6,-1,1141,1141,0,-1,1067,1067,0,-1,1128,1200,-72
21886,20000,16000,0,0,0,0,0,0,0,12106,1172,10934,0,12349,415,11934,0,11420,404,11016,0,11641,400,11241
21887,130000,104000,0,1,0,0,0,0,0,108738,4148,104590,0,71835,2477,69358,0,62539,2346,60193,0,61906,2640,59266
21888,80000,64000,0,0,0,0,0,0,0,55685,3000,52685,0,58642,4500,54142,0,60533,3000,57533,0,61823,2300,59523
21889,260000,208000,0,0,0,0,0,0,0,12001,12173,-172,-1,20325,20619,-294,-1,43849,43968,-119,-1,22820,3014,19806
21890,140000,112000,0,0,0,0,0,1,2,104207,3600,100607,2,100326,0,100326,2,102740,4000,98740,0,103444,4000,99444
21891,210000,168000,0,0,0,0,0,0,-2,8173,8177,-4,-2,6855,6860,-5,-2,2200,2200,0,-2,1500,1500,0
21892,210000,168000,0,0,0,0,0,1,-1,978,978,0,-1,652,0,652,0,326,0,326,0,0,0,0
21893,200000,160000,0,0,0,0,0,0,0,97749,4949,92800,0,99168,4800,94368,0,58256,2256,56000,0,59313,2313,57000
21894,750000,600000,0,0,0,0,0,0,0,92767,2330,90437,0,75696,2705,72991,0,35485,50854,-15369,-1,4889,4913,-24
21895,50000,40000,0,1,1,0,0,0,0,46220,2261,43959,0,47459,2500,44959,0,27056,2000,25056,0,28452,2000,26452
21896,50000,40000,0,0,0,0,0,0,0,17823,1587,16236,0,18495,1259,17236,0,18266,765,17501,0,18631,773,17858
21897,140000,112000,0,0,0,0,0,0,0,30579,1600,28979,0,31227,2000,29227,0,34898,5000,29898,0,35528,2000,33528
21898,360000,288000,0,0,0,0,0,0,0,186961,10005,176956,0,201703,20117,181586,0,189455,15018,174437,0,194373,10027,184346
21899,170000,136000,1,1,1,0,0,1,0,189067,7509,181558,0,180389,5573,174816,0,137030,4309,132721,0,129222,4239,124983
21900,270000,216000,0,0,0,0,1,1,2,219829,15000,204829,2,214795,0,214795,2,228084,17000,211084,2,232680,8500,224180
21901,150000,120000,0,0,0,0,0,0,-2,1076,1084,-8,-2,0,0,0,-2,3113,3113,0,-2,0,0,0
21902,30000,24000,0,1,1,1,1,0,0,29068,2165,26903,0,29567,3002,26565,0,29144,1005,28139,0,29541,3000,26541
21903,50000,40000,0,0,0,0,0,0,0,22456,19776,2680,0,19776,1096,18680,0,9433,572,8861,0,7487,645,6842
21904,210000,168000,0,1,0,0,0,0,0,183774,7113,176661,0,152509,6011,146498,0,136376,4471,131905,0,131656,4513,127143
21905,200000,160000,0,0,0,0,0,0,-2,0,0,0,-2,0,0,0,-2,0,0,0,-2,0,0,0
21906,100000,80000,0,1,1,1,1,0,0,102093,5000,97093,0,97701,4000,93701,0,99322,3800,95522,0,98787,3710,95077
21907,80000,64000,0,0,0,0,0,0,2,24751,1500,23251,0,26493,2150,24343,0,25936,0,25936,2,26304,944,25360
21908,60000,48000,0,0,0,0,0,0,0,37861,5000,32861,0,60993,25500,35493,0,2343,3000,-657,-1,6707,6000,707
21909,50000,40000,0,0,0,1,1,1,0,40779,2000,38779,0,41793,2000,39793,0,42916,1800,41116,0,44199,2000,42199
21910,710000,568000,0,0,0,0,0,0,-2,0,0,0,-2,0,0,0,-2,0,0,0,-2,0,0,0
21911,390000,312000,0,0,0,0,0,0,2,258372,9500,248872,0,261498,30140,231358,0,213003,4235,208768,0,102423,1998,100425
21912,260000,208000,0,0,0,0,0,1,0,150188,6000,144188,0,138975,6000,132975,0,134225,5006,129219,0,128321,5006,123315
21913,150000,120000,0,0,0,0,0,0,0,57181,15043,42138,0,49453,5021,44432,0,86869,46034,40835,0,79150,5002,74148
21914,50000,40000,0,1,0,0,0,1,3,46543,5,46538,2,19359,661,18698,0,17850,770,17080,0,18203,800,17403
21915,80000,64000,0,1,1,1,1,0,0,76090,0,76090,2,75892,3000,72892,0,77310,4000,73310,0,80752,5000,75752
21916,280000,224000,0,0,0,0,0,0,-2,5737,5737,0,-2,922,922,0,-2,107,107,0,-2,980,980,0
21917,80000,64000,0,1,1,1,0,1,0,77738,4100,73638,0,77235,2000,75235,0,76835,0,76835,0,34751,0,34751
21918,100000,80000,0,0,1,1,1,0,2,83130,5001,78129,2,83961,3100,80861,2,85574,3100,82474,2,84039,0,84039
21919,60000,48000,1,1,1,1,1,0,0,67405,3000,64405,2,63559,3000,60559,0,60048,3000,57048,0,56458,2000,54458
21920,210000,168000,0,0,0,0,0,0,2,73634,2674,70960,0,75095,2687,72408,0,76886,3000,73886,0,78604,3000,75604
21921,10000,8000,0,0,0,1,1,0,0,8144,1283,6861,0,8861,1000,7861,0,10104,1535,8569,0,9803,0,9803
21922,50000,40000,0,1,0,0,0,0,0,44043,1566,42477,0,28557,983,27574,0,27903,1027,26876,0,29164,3000,26164
21923,450000,360000,0,0,0,0,0,1,-1,0,0,0,-2,0,0,0,-2,0,0,0,-2,0,0,0
21924,70000,56000,0,0,0,0,0,1,-1,40206,2500,37706,0,42184,2468,39716,0,43182,1466,41716,0,42674,1328,41346
21925,240000,192000,0,0,0,0,0,0,0,189190,7000,182190,0,193018,7000,186018,0,188593,6500,182093,0,179309,6600,172709
21926,50000,40000,0,1,0,0,0,0,0,48119,5000,43119,0,8257,1000,7257,0,8037,309,7728,0,9470,2000,7470
21927,100000,80000,1,1,1,0,0,1,-1,163665,6035,157630,0,170257,9410,160847,0,57747,1000,56747,0,16998,2000,14998
21928,50000,40000,0,0,0,0,0,0,0,29453,1755,27698,0,26660,1500,25160,0,26235,1101,25134,0,27647,2000,25647
21929,280000,224000,0,0,0,0,0,0,0,76835,3200,73635,0,70722,2500,68222,0,60694,2400,58294,0,62032,2500,59532
21930,90000,72000,0,1,1,1,1,1,2,86173,4008,82165,0,87942,4100,83842,0,92756,7200,85556,0,91146,0,91146
21931,180000,144000,0,0,0,0,0,1,0,7768,4739,3029,0,7156,2289,4867,0,6956,4289,2667,0,29402,26735,2667
21932,50000,40000,0,0,0,0,0,0,0,13008,1433,11575,0,12540,1465,11075,0,10746,0,10746,2,8482,500,7982
21933,230000,184000,0,0,0,0,0,0,-1,13827,13835,-8,-1,11686,11686,0,-1,46963,46963,0,-1,15962,15962,0
21934,240000,192000,0,0,0,0,0,1,-2,0,0,0,-2,0,0,0,-2,0,0,0,-2,0,0,0
21935,290000,232000,0,0,0,0,0,0,0,181392,9000,172392,0,173856,6500,167356,0,172835,7000,165835,0,176710,6800,169910
21936,150000,120000,0,0,0,0,0,0,-2,416,416,0,-2,416,416,0,-2,37911,37911,0,-1,38299,1400,36899
21937,30000,24000,0,0,0,0,0,0,0,24117,1500,22617,0,23917,0,23917,0,0,0,0,0,0,0,0
21938,50000,40000,0,0,0,0,0,0,-1,17820,17820,0,-1,3800,3800,0,-1,2241,2241,0,-1,12241,12500,-259
21939,20000,16000,0,0,1,0,1,1,2,16899,3132,13767,2,16335,0,16335,2,16509,742,15767,0,17590,1501,16089
21940,20000,16000,0,1,1,1,1,0,0,16926,0,16926,2,17368,1000,16368,0,17959,1000,16959,0,19023,3000,16023
21941,20000,16000,0,1,1,1,1,0,0,20223,1394,18829,0,19788,1159,18629,0,19927,678,19249,0,20045,793,19252
21942,240000,192000,0,0,0,0,0,0,-1,650,5000,-4350,-1,4770,5000,-230,-1,2515,0,2515,-1,37405,40000,-2595
21943,120000,96000,0,0,0,0,0,1,-1,780,780,0,-1,0,0,0,-1,0,0,0,-2,0,0,0
21944,50000,40000,0,0,0,0,0,1,2,38426,2050,36376,0,7816,500,7316,0,7859,500,7359,0,7979,400,7579
21945,50000,40000,0,0,0,0,0,0,0,15407,2280,13127,0,17127,2000,15127,0,17569,1000,16569,0,18162,1000,17162
21946,70000,56000,0,0,0,0,0,0,-1,6598,6598,0,-1,6405,227,6178,0,7248,1270,5978,0,8090,1296,6794
21947,90000,72000,0,0,0,0,0,0,-1,1712,1712,0,-1,5000,5000,0,-1,0,0,0,-1,4210,4210,0
21948,110000,88000,0,0,0,0,0,1,0,3861,1073,2788,0,4869,1081,3788,0,4966,178,4788,0,5070,184,4886
21949,130000,104000,0,0,0,0,0,0,0,1138,1138,0,-1,1138,0,1138,0,2478,2500,-22,-1,-3040,0,-3040
21950,730000,584000,0,0,0,0,0,0,0,351588,16500,335088,0,86927,3000,83927,0,66111,2000,64111,0,38491,2000,36491
21951,100000,80000,0,0,0,0,0,0,0,76109,3500,72609,0,77068,3300,73768,0,77868,3000,74868,0,75954,3000,72954
21952,50000,40000,0,0,0,0,0,0,0,24178,1401,22777,0,24659,882,23777,0,25175,913,24262,0,25832,1075,24757
21953,320000,256000,0,0,0,0,0,0,-1,86024,86466,-442,-1,232017,232242,-225,-1,15622,3199,12423,0,7463,7500,-37
21954,150000,120000,0,0,0,0,0,1,0,92441,5000,87441,0,102903,12000,90903,0,105240,4000,101240,0,109479,6000,103479
21955,100000,80000,0,0,0,0,0,0,2,11705,2500,9205,2,12919,1700,11219,2,12139,0,12139,4,11653,0,11653
21956,200000,160000,0,0,0,0,0,0,0,3665,1000,2665,0,4665,1000,3665,0,6665,2000,4665,0,150,150,0
21957,180000,144000,0,1,1,1,1,0,0,169278,6307,162971,0,171274,6300,164974,0,169691,6300,163391,0,173760,7000,166760
21958,240000,192000,0,0,0,0,0,0,-1,0,0,0,-2,0,0,0,-2,0,0,0,-2,0,0,0
21959,80000,64000,0,0,0,0,0,0,0,44989,1844,43145,0,41358,2009,39349,0,42379,5017,37362,0,38052,2000,36052
21960,50000,40000,0,0,0,0,0,0,0,24446,1800,22646,0,25535,1500,24035,0,26109,1000,25109,0,26689,1000,25689
21961,20000,16000,0,1,1,1,1,0,0,17609,1300,16309,0,17329,700,16629,0,17850,800,17050,0,18046,602,17444
21962,90000,72000,0,1,1,0,0,0,0,78646,3100,75546,0,79212,3116,76096,0,54659,2000,52659,0,55902,2100,53802
21963,70000,56000,0,1,1,1,1,1,2,65253,2500,62753,2,63609,0,63609,2,68397,6000,62397,2,69605,2500,67105
21964,150000,120000,0,0,0,0,0,0,-2,-286,0,-286,-2,-286,0,-286,-2,-286,0,-286,-2,-286,0,-286
21965,370000,296000,0,0,0,0,0,0,-1,0,0,0,-1,1539,1539,0,-1,1815,1815,0,-1,0,0,0
21966,20000,16000,0,0,0,0,0,1,-2,0,0,0,-2,0,0,0,-2,0,0,0,-2,8081,8081,0
21967,200000,160000,0,1,1,1,1,1,2,180484,16000,164484,2,176111,0,176111,2,184620,13000,171620,2,189518,8000,181518
21968,200000,160000,0,0,0,0,0,0,0,10972,2000,8972,0,12757,2003,10754,0,13069,1008,12061,0,13334,2029,11305
21969,50000,40000,0,0,0,0,0,0,-1,4050,4050,0,-1,3050,0,3050,0,1243,1243,0,-1,865,865,0
21970,280000,224000,0,1,1,1,0,0,2,283374,11143,272231,0,238039,7300,230739,0,234017,6024,227993,0,145132,6000,139132
21971,50000,40000,0,1,1,0,0,0,0,50633,1925,48708,0,48724,5006,43718,0,19208,2000,17208,0,19917,1016,18901
21972,430000,344000,0,0,0,0,0,0,-1,7719,7759,-40,-1,4437,4451,-14,-1,2912,2915,-3,-1,6368,6383,-15
21973,220000,176000,0,0,0,0,0,0,-2,0,0,0,-2,0,0,0,-2,0,0,0,-2,0,0,0
21974,70000,56000,0,0,0,0,0,0,0,31610,2000,29610,0,37209,7000,30209,0,40749,5000,35749,0,40541,1500,39041
21975,180000,144000,0,0,0,0,0,1,0,145992,5000,140992,0,124841,5935,118906,0,125596,4263,121333,0,113105,4200,108905
21976,260000,208000,1,1,1,0,0,0,0,295631,15000,280631,0,299692,8526,291166,0,164332,20000,144332,0,183033,20000,163033
21977,460000,368000,0,0,0,0,0,0,0,160223,7018,153205,0,160894,7000,153894,0,165246,7002,158244,0,169983,8007,161976
21978,140000,112000,0,1,1,0,0,1,0,139178,6703,132475,0,139900,6120,133780,0,109665,4015,105650,0,108129,4042,104087
21979,50000,40000,0,0,0,0,0,1,0,11670,0,11670,2,12167,1036,11131,0,2210,79,2131,0,2406,232,2174
21980,50000,40000,0,1,1,0,0,0,0,49993,2150,47843,0,50025,2118,47907,0,29562,1045,28517,0,29786,1077,28709
21981,200000,160000,0,0,0,0,0,1,-2,2348,2348,0,-1,1790,0,1790,2,1790,0,1790,0,350,350,0
21982,360000,288000,0,0,0,0,0,0,-1,0,0,0,-2,764,764,0,-1,0,0,0,-1,2844,2844,0
21983,240000,192000,0,0,0,0,0,1,3,45660,0,45660,2,48905,4000,44905,2,47993,0,47993,2,52015,5000,47015
21984,360000,288000,0,0,0,0,0,0,-1,960,982,-22,-2,6658,6858,-200,-2,0,0,0,-2,0,0,0
21985,240000,192000,0,0,0,0,0,0,0,133385,5000,128385,0,136654,5500,131154,0,136639,5500,131139,0,123951,5000,118951
21986,390000,312000,0,0,0,0,0,0,-2,8051,8091,-40,-2,-5,0,-5,-2,1965,990,975,-2,3088,3108,-20
21987,230000,184000,0,0,0,0,0,0,-1,5722,5955,-233,-2,10371,10371,0,-1,9998,0,9998,0,1328,1332,-4
21988,200000,160000,0,1,0,0,0,0,0,195622,8000,187622,0,126281,5000,121281,0,128702,5000,123702,0,131001,5000,126001
21989,170000,136000,0,0,0,0,0,0,0,91409,4456,86953,0,90720,2992,87728,0,83208,3000,80208,0,83956,3200,80756
21990,230000,184000,0,0,0,0,0,1,-1,3480,3480,0,-1,3555,3555,0,-1,1850,0,1850,0,1580,1580,0
21991,50000,40000,0,0,0,0,0,0,-1,1261,1261,0,-1,1261,1261,0,-1,2522,2522,0,-1,1261,0,1261
21992,360000,288000,0,0,0,0,0,1,-1,223,1,222,2,-166,1,-167,2,-555,1,-556,-2,-944,1,-945
21993,80000,64000,0,1,1,0,0,0,2,82698,6200,76498,2,81467,2139,79328,2,49150,0,49150,2,51303,4000,47303
21994,160000,128000,0,0,0,0,0,1,-1,7858,0,7858,2,0,0,0,2,0,0,0,-2,0,0,0
21995,20000,16000,0,0,0,0,0,0,0,0,0,0,-2,0,0,0,-2,0,0,0,-2,0,0,0
21996,70000,56000,0,1,0,1,1,0,0,57571,0,57571,2,57871,2250,55621,0,60872,4500,56372,0,59329,0,59329
21997,30000,24000,0,0,0,0,0,0,0,24233,1310,22923,0,22893,490,22403,0,3332,67,3265,0,3400,68,3332
21998,50000,40000,0,1,0,0,0,0,0,48647,2068,46579,0,26894,3048,23846,0,10875,418,10457,0,15878,12004,3874
21999,230000,184000,0,0,0,0,0,1,2,187521,6300,181221,2,182671,6200,176471,2,174794,500,174294,2,182160,12500,169660
22000,360000,288000,0,0,0,0,0,0,-2,6909,7039,-130,-1,5954,10,5944,0,4160,1,4159,0,1726,4,1722
22001,290000,232000,0,0,0,0,0,0,-1,108157,108168,-11,-1,35379,35811,-432,-1,18711,18711,0,-1,3110,0,3110
22002,360000,288000,0,0,0,0,0,0,-2,-5,0,-5,-2,-5,0,-5,-2,-5,0,-5,-2,-5,0,-5
22003,320000,256000,0,1,1,1,1,0,0,317847,13036,304811,0,313990,10072,303918,0,312070,9600,302470,0,319672,11056,308616
22004,220000,176000,0,0,0,0,0,0,-1,919,919,0,-1,47545,47545,0,-1,2398,2398,0,-1,3338,5178,-1840
22005,400000,320000,0,0,0,0,0,0,2,333,333,0,-1,4928,4928,0,-1,8235,8235,0,-1,3317,0,3317
22006,130000,104000,0,0,1,1,1,0,0,108842,6000,102842,0,110236,5000,105236,0,114763,6800,107963,0,118884,6500,112384
22007,40000,32000,0,0,0,0,0,1,3,24235,1400,22835,2,23557,0,23557,2,24025,850,23175,0,24528,880,23648
22008,470000,376000,0,0,0,0,0,0,-1,2272,11,2261,2,6040,6080,-40,-1,6655,6688,-33,-1,1200,1206,-6
22009,280000,224000,0,0,0,0,0,0,0,154940,6107,148833,0,136894,5000,131894,0,138467,5057,133410,0,128473,5005,123468
22010,240000,192000,0,0,0,0,0,0,0,85011,3181,81830,0,77329,3000,74329,0,50673,1500,49173,0,48723,3042,45681
22011,380000,304000,0,0,0,0,0,0,-1,2107,2107,0,-1,0,0,0,-1,1630,1630,0,-1,0,0,0
22012,50000,40000,0,0,0,0,0,1,0,9926,1313,8613,0,9970,357,9613,0,10339,530,9809,0,11009,1000,10009
22013,130000,104000,0,1,1,0,0,0,0,123746,5200,118546,0,123107,5012,118095,0,42897,2500,40397,0,39378,5000,34378
22014,280000,224000,0,0,0,0,0,0,-2,132,150,-18,-2,-20,0,-20,-2,-20,0,-20,-2,680,700,-20
22015,110000,88000,0,0,0,0,0,0,-1,1490,1490,0,-1,2490,2245,245,0,1245,0,1245,0,2675,2675,0
22016,250000,200000,0,0,0,0,0,0,-1,12327,12327,0,-1,10538,211,10327,0,8712,174,8538,0,3002,2228,774
22017,80000,64000,0,0,0,0,0,1,2,4140,1000,3140,2,3920,0,3920,2,0,0,0,2,0,0,0
22018,130000,104000,0,1,0,0,0,0,0,131862,6000,125862,0,101971,4000,97971,0,101689,4000,97689,0,101303,4000,97303
22019,50000,40000,0,1,1,0,0,0,0,48090,2000,46090,0,48125,1000,47125,0,4080,1000,3080,0,0,0,0
22020,130000,104000,0,0,0,0,0,0,0,5771,1000,4771,0,8659,3000,5659,0,10503,2000,8503,0,11329,1000,10329
22021,50000,40000,0,0,0,0,0,0,0,32668,5004,27664,0,25738,10000,15738,0,30192,5200,24992,0,27912,0,27912
22022,20000,16000,0,0,0,0,0,0,2,17233,1333,15900,0,7630,500,7130,0,1730,100,1630,0,0,0,0
22023,500000,400000,0,0,0,0,0,0,-2,37596,37596,0,-1,62845,31802,31043,0,80212,30615,49597,0,20494,21346,-852
22024,50000,40000,0,0,0,0,0,1,0,0,0,0,0,0,0,0,-2,0,0,0,-2,239,239,0
22025,30000,24000,0,0,0,0,0,0,0,22115,1400,20715,0,22158,443,21715,0,22610,452,22158,0,0,0,0
22026,20000,16000,0,0,0,0,0,0,2,0,0,0,2,0,0,0,-2,0,0,0,-2,0,0,0
22027,70000,56000,0,0,0,0,0,1,2,26574,4000,22574,2,25804,0,25804,2,27454,2000,25454,0,25447,1000,24447
22028,20000,16000,0,1,1,1,1,0,3,18663,0,18663,2,20394,2616,17778,2,19228,0,19228,3,19615,1400,18215
22029,330000,264000,0,1,0,0,0,0,0,391478,65042,326436,0,142842,12000,130842,0,143257,5000,138257,0,144783,6000,138783
22030,360000,288000,0,0,0,0,0,0,0,8217,2041,6176,0,2963,2980,-17,-1,15437,16038,-601,-1,15722,8032,7690
22031,120000,96000,0,0,0,0,0,0,0,67080,3000,64080,0,68660,3700,64960,0,69411,3500,65911,0,2855,1000,1855
22032,200000,160000,0,1,1,1,1,1,2,192803,8597,184206,0,304997,8583,296414,0,188504,6880,181624,0,189527,7235,182292
22033,150000,120000,0,0,0,0,0,0,-2,4876,4372,504,-2,9128,18853,-9725,-2,10460,10975,-515,-1,5157,5157,0
22034,50000,40000,0,0,0,0,0,0,0,32829,1677,31152,0,26811,900,25911,0,24477,1023,23454,0,24177,1024,23153
22035,200000,160000,0,0,0,0,0,0,0,3152,1046,2106,0,2732,1006,1726,0,1380,34,1346,0,1380,1386,-6
22036,30000,24000,0,1,1,1,1,0,0,25463,1435,24028,0,26453,1425,25028,0,26987,959,26028,0,28760,2201,26559
22037,130000,104000,0,0,0,0,0,0,2,4634,2946,1688,2,2946,0,2946,2,1473,0,1473,0,780,780,0
22038,110000,88000,0,1,0,0,0,0,0,99241,3680,95561,0,73151,2511,70640,0,64731,2350,62381,0,66025,2370,63655
22039,110000,88000,1,1,1,0,0,0,0,120439,5485,114954,0,113273,3396,109877,0,81261,2844,78417,0,76051,3005,73046
22040,150000,120000,1,1,1,1,0,0,0,193500,6500,187000,0,196000,4000,192000,0,200000,4000,196000,0,0,0,0
22041,20000,16000,0,1,1,1,1,0,0,18849,1500,17349,0,19917,1500,18417,0,19087,500,18587,0,19588,1380,18208
22042,130000,104000,0,1,0,1,1,0,2,107185,0,107185,2,108569,5399,103170,0,112541,8000,104541,0,114885,5000,109885
22043,70000,56000,0,1,0,0,0,0,2,59018,2200,56818,0,48033,2100,45933,0,48833,1900,46933,0,49736,1841,47895
22044,210000,168000,0,0,0,0,0,0,-1,987,987,0,-1,2467,2469,-2,-1,3319,3319,0,-1,5387,5387,0
22045,10000,8000,0,0,1,1,0,0,0,9259,1300,7959,0,9757,1000,8757,0,9887,206,9681,0,9987,2094,7893
22046,50000,40000,0,0,0,0,0,0,0,19610,1581,18029,0,17801,1000,16801,0,18078,900,17178,0,18137,700,17437
22047,220000,176000,0,0,0,0,0,0,2,396,396,0,-1,396,396,0,-1,396,396,0,-1,546,546,0
22048,30000,24000,0,0,0,0,0,1,0,13383,1225,12158,0,14699,1541,13158,0,14688,530,14158,0,16749,2302,14447
22049,210000,168000,0,0,0,0,0,1,-1,-200,0,-200,-1,-200,0,-200,-2,23560,23760,-200,-1,0,0,0
22050,130000,104000,0,0,0,0,0,0,-1,24175,1217,22958,0,15182,1000,14182,0,12805,3000,9805,0,14415,2000,12415
22051,150000,120000,0,0,0,0,0,1,2,91242,7400,83842,2,88399,0,88399,2,89629,3300,86329,0,94637,7000,87637
22052,320000,256000,0,0,0,0,0,0,0,204879,8335,196544,0,143976,5113,138863,0,143142,5062,138080,0,145070,5221,139849
22053,50000,40000,0,1,1,1,1,0,2,43327,2100,41227,2,42335,0,42335,2,43326,2000,41326,0,46256,3800,42456
22054,270000,216000,0,0,0,0,0,0,0,5718,1103,4615,0,6727,1112,5615,0,6861,246,6615,0,7005,255,6750
22055,200000,160000,0,0,0,0,0,0,-1,3421,3421,0,-1,301,301,0,-1,9585,10217,-632,-1,8374,0,8374
22056,320000,256000,0,0,0,0,0,1,0,0,0,0,-2,364,364,0,-1,16177,16177,0,-1,16706,800,15906
22057,230000,184000,0,0,0,0,0,1,-1,4988,5003,-15,-1,3528,3528,0,-1,3642,3642,0,-1,14073,14073,0
22058,70000,56000,0,0,0,0,0,1,0,70138,36500,33638,0,51781,2300,49481,0,29117,1500,27617,0,29264,2000,27264
22059,80000,64000,0,0,0,0,0,1,-1,199,199,0,-1,199,199,0,-1,0,0,0,-1,22109,22109,0
22060,50000,40000,0,0,0,1,1,0,0,40339,2000,38339,0,44377,5000,39377,0,48723,5000,43723,0,49841,2010,47831
22061,310000,248000,0,0,0,0,0,0,2,9445,9453,-8,-1,5202,5206,-4,-1,14589,14589,0,-1,11673,0,11673
22062,260000,208000,0,0,0,0,0,1,0,114531,7004,107527,0,111037,15,111022,2,95454,3000,92454,0,96370,3000,93370
22063,470000,376000,0,1,1,1,0,1,0,470617,19000,451617,0,398523,14000,384523,0,389927,13600,376327,0,381295,13600,367695
22064,330000,264000,0,0,0,0,0,0,0,160008,5591,154417,0,160084,5500,154584,0,159453,6000,153453,0,159354,6000,153354
22065,200000,160000,0,0,0,0,0,0,-1,14943,1528,13415,0,14692,500,14192,0,14733,528,14205,0,14820,655,14165
22066,360000,288000,0,0,0,0,0,0,-1,0,0,0,-2,0,0,0,-2,0,0,0,-2,860,860,0
22067,40000,32000,1,1,1,1,1,0,0,67203,2000,65203,0,39764,2014,37750,0,39583,2503,37080,0,39839,2103,37736
22068,170000,136000,0,0,0,0,0,0,0,38658,2165,36493,0,35458,2285,33173,0,30143,500,29643,0,42215,28500,13715
22069,80000,64000,0,0,0,0,0,0,0,3234,3917,-683,-1,1819,1819,0,-1,1909,2299,-390,-1,1909,1909,0
22070,50000,40000,0,0,0,0,0,0,2,19469,1700,17769,0,20412,1600,18812,0,19755,700,19055,0,20320,840,19480
22071,100000,80000,0,0,0,0,0,1,0,61898,3007,58891,0,53035,2300,50735,0,15785,200,15585,0,7762,290,7472
22072,90000,72000,0,0,0,0,0,0,0,20148,5000,15148,0,4708,500,4208,0,5000,5000,0,-1,5028,500,4528
22073,280000,224000,0,1,1,1,1,1,0,283680,10424,273256,0,273446,10047,263399,0,279458,10683,268775,0,269333,10073,259260
22074,200000,160000,0,0,0,0,0,1,-2,0,0,0,-2,1517,1517,0,-1,48669,48000,669,0,49635,1775,47860
22075,50000,40000,0,1,1,0,0,0,2,50284,2310,47974,0,50740,1766,48974,0,30175,1201,28974,0,30407,1232,29175
22076,50000,40000,0,0,0,0,0,1,-1,5592,5608,-16,-1,10676,11906,-1230,-1,671,673,-2,-1,9826,9855,-29
22077,140000,112000,0,1,1,1,1,0,0,136412,7000,129412,0,136481,7000,129481,0,135012,5500,129512,0,133324,6000,127324
22078,70000,56000,0,0,0,0,0,0,0,44115,4000,40115,0,41112,0,41112,2,39922,1500,38422,0,40150,3000,37150
22079,450000,360000,0,0,0,0,0,0,0,212496,205004,7492,0,51953,52000,-47,0,74870,74896,-26,-1,-2313,500,-2813
22080,50000,40000,0,0,0,0,0,0,0,11500,11615,-115,-1,2756,2756,0,-1,7000,7000,0,-1,12025,12025,0
22081,10000,8000,0,1,1,1,1,1,0,9252,1139,8113,0,9590,477,9113,0,10129,830,9299,0,8932,0,8932
22082,50000,40000,0,0,0,0,0,1,0,0,0,0,-2,0,0,0,-2,15239,15239,0,-1,14853,0,14853
22083,30000,24000,0,1,1,1,1,1,0,28820,3700,25120,0,28538,718,27820,2,28208,1500,26708,0,29326,1500,27826
22084,30000,24000,0,0,0,0,0,0,2,0,0,0,2,0,0,0,-2,0,0,0,-2,0,0,0
22085,460000,368000,0,0,0,0,0,0,0,16098,10000,6098,0,3316,3316,0,-1,3316,3316,0,-1,3316,3316,0
22086,20000,16000,0,0,0,0,0,0,2,10087,700,9387,2,9585,0,9585,2,10082,1000,9082,0,10965,1400,9565
22087,250000,200000,0,0,0,0,0,0,-2,2470,2661,-191,-1,3887,3887,0,-1,4731,1000,3731,0,8710,4000,4710
22088,170000,136000,0,0,1,0,0,0,0,160153,157541,2612,0,160823,8020,152803,0,128646,5260,123386,0,124547,5000,119547
22089,50000,40000,0,0,0,0,0,1,-1,3180,0,3180,2,1831,1831,0,-1,1868,37,1831,0,3300,3300,0
22090,240000,192000,0,1,0,0,0,0,0,243567,11005,232562,0,44351,8006,36345,0,193283,202000,-8717,-1,21682,8505,13177
22091,80000,64000,0,0,0,0,0,0,0,-478,0,-478,0,-1739,0,-1739,-2,1261,4261,-3000,-1,1261,1261,0
22092,180000,144000,0,0,0,0,0,0,0,0,0,0,0,0,0,0,-2,351,351,0,-1,1351,1000,351
22093,140000,112000,0,0,0,0,0,0,0,36823,3000,33823,0,36285,1580,34705,0,36683,1294,35389,0,37150,1355,35795
22094,140000,112000,0,0,0,0,0,0,-2,1117,1170,-53,-1,0,0,0,-1,0,0,0,-2,0,0,0
22095,500000,400000,0,0,0,0,0,0,0,40740,4135,36605,0,16316,3256,13060,0,10705,53,10652,0,-42,0,-42
22096,190000,152000,0,0,0,0,0,0,2,582,582,0,-1,291,0,291,2,582,582,0,-1,291,0,291
22097,20000,16000,0,1,1,1,1,1,0,18227,0,18227,2,19632,1720,17912,0,20298,1754,18544,0,20337,893,19444
22098,10000,8000,0,0,0,0,0,1,2,2300,0,2300,2,2300,0,2300,7,2300,0,2300,7,2300,0,2300
22099,90000,72000,0,0,0,0,0,0,0,25348,1176,24172,0,9580,1000,8580,0,0,0,0,0,0,0,0
22100,70000,56000,0,0,0,0,0,0,0,49674,2243,47431,0,44568,1467,43101,0,31156,1076,30080,0,30954,1096,29858
22101,50000,40000,0,0,0,0,0,0,0,390,390,0,-1,26898,26898,0,-1,26911,1000,25911,0,26926,1000,25926
22102,300000,240000,0,0,0,0,0,0,-2,900,902,-2,-2,11019,11117,-98,-2,3452,3462,-10,-2,57848,58418,-570
22103,220000,176000,0,0,0,0,0,0,0,61655,3000,58655,0,61855,3000,58855,0,64966,5000,59966,0,66942,3000,63942
22104,230000,184000,0,0,0,0,0,0,-2,10867,10880,-13,-1,10100,10125,-25,-1,3068,3076,-8,-2,21064,21162,-98
22105,400000,320000,0,1,0,0,0,0,0,375948,13595,362353,0,195991,6243,189748,0,152127,6007,146120,0,155182,6061,149121
22106,500000,400000,0,0,0,0,0,1,-2,1164,1164,0,-2,0,0,0,-2,0,0,0,-2,0,0,0
22107,480000,384000,0,0,0,0,0,0,-2,0,0,0,-2,0,0,0,-2,0,0,0,-2,0,0,0
22108,410000,328000,0,0,0,0,0,0,-2,17106,17106,0,-2,9600,9600,0,-2,2052,2052,0,-2,3829,3829,0
22109,50000,40000,0,0,0,0,0,0,0,0,0,0,0,31288,95000,-63712,-1,27335,1000,26335,0,30626,3700,26926
22110,80000,64000,0,0,0,0,0,0,0,61633,3000,58633,0,69160,9160,60000,0,26000,0,26000,2,25000,0,25000
22111,100000,80000,0,0,0,0,0,1,2,45983,4000,41983,2,46927,2000,44927,2,47759,1900,45859,2,46865,0,46865
22112,400000,320000,0,0,0,0,0,0,0,1453,1469,-16,-1,4944,4968,-24,-1,1896,1905,-9,-1,2486,2494,-8
22113,250000,200000,0,0,0,0,0,0,2,14669,1400,13269,0,14265,1090,13175,0,8887,246,8641,0,6679,402,6277
22114,90000,72000,0,0,0,0,0,0,-1,3734,3740,-6,-1,-45,38,-83,-1,1905,1950,-45,-1,22636,22636,0
22115,120000,96000,0,1,0,0,0,1,0,116797,10008,106789,0,92346,3051,89295,0,88542,3100,85442,0,80225,3052,77173
22116,460000,368000,0,0,0,0,0,0,-2,309622,580464,-270842,-1,297039,80017,217022,0,258056,31017,227039,0,188083,27,188056
22117,270000,216000,0,0,0,0,0,1,-1,123,123,0,-1,123,0,123,2,0,0,0,2,0,0,0
22118,140000,112000,0,1,1,0,0,0,0,131886,7000,124886,0,133105,5518,127587,0,78607,2933,75674,0,78773,3100,75673
22119,50000,40000,0,0,0,0,0,1,0,17744,2000,15744,0,19440,2000,17440,0,23089,4000,19089,0,24695,2000,22695
22120,120000,96000,0,0,0,0,0,0,-2,0,0,0,-2,600,600,0,-1,0,0,0,-1,0,0,0
22121,270000,216000,0,0,0,0,0,0,0,203867,7098,196769,0,188064,6179,181885,0,147915,5023,142892,0,139976,6090,133886
22122,140000,112000,0,0,0,0,0,0,0,87849,7124,80725,0,84455,2866,81589,0,87287,4033,83254,0,81423,5954,75469
22123,50000,40000,0,0,0,0,0,0,0,7783,1200,6583,0,8843,1200,7643,0,9209,500,8709,0,10070,1000,9070
22124,360000,288000,0,0,0,0,0,0,-2,0,0,0,-2,5950,5950,0,-1,6352,500,5852,0,6563,317,6246
22125,180000,144000,0,0,0,0,0,0,0,38547,3000,35547,0,63249,33000,30249,0,51437,2000,49437,0,45279,2000,43279
22126,140000,112000,0,0,0,0,0,0,-2,1404,1404,0,-2,540,540,0,-2,0,0,0,-2,0,0,0
22127,50000,40000,0,0,0,0,0,0,0,18814,1297,17517,0,19189,672,18517,0,19233,837,18396,0,19108,836,18272
22128,60000,48000,0,0,0,0,0,1,2,46549,2000,44549,2,32902,0,32902,2,30677,1059,29618,0,31318,1096,30222
22129,230000,184000,0,1,0,1,0,1,2,229553,0,229553,2,190525,6829,183696,0,192974,7300,185674,0,186407,7000,179407
22130,300000,240000,0,0,0,0,0,0,-2,0,0,0,-2,2208,2208,0,-2,2475,2475,0,-2,7580,7580,0
22131,450000,360000,0,0,0,0,0,1,-1,1173,1173,0,-1,0,0,0,-1,6265,6265,0,-1,2374,2374,0
22132,160000,128000,0,0,0,0,0,1,-1,8030,8030,0,-1,19069,19069,0,-1,15359,5359,10000,0,10846,377,10469
22133,180000,144000,0,0,0,0,0,0,0,62144,3500,58644,0,56728,1000,55728,0,52918,1420,51498,0,20856,1000,19856
22134,360000,288000,0,0,0,0,0,0,0,23912,13912,10000,0,9785,9785,0,-1,166,0,166,0,2142,2142,0
22135,60000,48000,0,1,1,1,1,0,2,59175,5000,54175,2,60218,2511,57707,2,55447,6,55441,2,55305,3000,52305
22136,120000,96000,0,0,0,0,0,1,2,17695,1600,16095,0,17901,800,17101,0,19608,2000,17608,0,19143,0,19143
22137,140000,112000,0,0,0,0,0,0,0,0,0,0,-2,0,0,0,-2,51571,51571,0,-1,55731,5001,50730
22138,230000,184000,0,0,0,0,0,0,-2,0,0,0,-2,790,790,0,-2,0,0,0,-2,2803,2803,0
22139,130000,104000,0,0,0,0,0,0,0,105252,6000,99252,0,103969,10000,93969,0,104254,10000,94254,0,99525,5000,94525
22140,60000,48000,0,1,1,1,1,0,0,53559,2000,51559,0,54716,2000,52716,0,54533,2000,52533,0,58085,6000,52085
22141,50000,40000,0,0,0,0,0,1,0,28103,1447,26656,0,28814,1158,27656,0,29261,1041,28220,0,29878,1082,28796
22142,30000,24000,0,1,1,1,1,0,0,27986,1500,26486,0,28580,1050,27530,0,28649,1100,27549,0,29147,1000,28147
22143,50000,40000,0,0,0,0,0,0,-1,32617,1095,31522,0,28814,2000,26814,0,16478,10000,6478,0,25349,13352,11997
22144,500000,400000,0,0,0,0,0,1,-2,0,0,0,-2,0,0,0,-2,0,0,0,-2,0,0,0
22145,80000,64000,0,0,0,0,0,0,-2,0,0,0,-2,5526,5526,0,-1,3292,3292,0,-1,12792,12807,-15
22146,50000,40000,0,0,0,0,0,1,3,23766,4000,19766,2,23114,0,23114,5,22173,0,22173,4,21521,0,21521
22147,260000,208000,0,1,1,1,1,0,0,263431,10020,253411,0,253596,9900,243696,0,258387,9331,249056,0,259118,9307,249811
22148,20000,16000,0,0,0,0,0,1,2,8240,1296,6944,0,9582,1638,7944,0,9279,0,9279,2,9971,844,9127
22149,240000,192000,0,0,0,0,0,0,-1,34351,35000,-649,-1,22241,8877,13364,0,8472,500,7972,0,500,0,500
22150,30000,24000,0,1,1,1,1,0,0,25880,1387,24493,0,25873,893,24980,0,26157,1000,25157,0,26918,1501,25417
22151,140000,112000,0,0,0,0,0,0,2,32485,0,32485,2,33142,1500,31642,0,35443,3000,32443,0,34724,0,34724
22152,360000,288000,0,0,0,0,0,0,-1,13062,13062,0,-1,41977,41977,0,-1,24354,0,24354,0,25948,25948,0
22153,140000,112000,0,0,0,0,0,0,0,37114,600,36514,2,38687,2400,36287,2,41338,3500,37838,2,40645,0,40645
22154,140000,112000,0,1,0,0,0,0,0,116858,4691,112167,0,105786,4000,101786,0,93273,4000,89273,0,91207,4000,87207
22155,310000,248000,0,1,1,1,1,0,0,269351,9775,259576,0,276873,12000,264873,0,281764,11000,270764,0,299161,22000,277161
22156,80000,64000,0,1,1,1,0,0,0,78173,3500,74673,0,79220,3000,76220,0,81351,3368,77983,0,48056,1023,47033
22157,30000,24000,0,0,0,0,0,0,-1,8557,8000,557,0,8400,43,8357,0,20966,20109,857,0,13638,222,13416
22158,50000,40000,0,0,0,0,0,0,0,36319,0,36319,2,22538,1000,21538,0,23013,1000,22013,0,23465,1000,22465
22159,50000,40000,0,1,1,1,0,1,0,46791,1400,45391,0,47922,3000,44922,0,49482,5000,44482,0,0,0,0
22160,90000,72000,0,1,1,1,1,1,3,84131,0,84131,2,85225,3400,81825,0,90347,6500,83847,0,85725,0,85725
22161,130000,104000,0,1,0,0,0,0,0,130128,5146,124982,0,101794,4000,97794,0,101826,4000,97826,0,101763,3866,97897
22162,20000,16000,0,0,0,0,0,1,2,10871,1000,9871,2,10402,0,10402,2,12077,2000,10077,2,11594,0,11594
22163,400000,320000,0,0,0,0,0,0,2,5299,5316,-17,-1,8841,8858,-17,-1,18612,18769,-157,-1,6115,6115,0
22164,350000,280000,0,0,0,0,0,0,-1,10857,10916,-59,-1,12688,12745,-57,-1,6344,6344,0,-1,5376,22,5354
22165,400000,320000,0,0,0,0,0,0,0,52366,17213,35153,0,29995,1000,28995,0,22722,1000,21722,0,24479,2100,22379
22166,100000,80000,0,0,0,0,0,0,-1,0,0,0,-2,50063,50063,0,-1,22767,900,21867,0,23399,1000,22399
22167,80000,64000,0,0,0,0,0,0,-2,0,0,0,-2,0,0,0,-2,13369,13369,0,-1,0,0,0
22168,180000,144000,0,0,0,0,0,1,2,125768,5000,120768,2,126202,4200,122002,0,127677,3000,124677,0,99764,5000,94764
22169,80000,64000,0,1,0,0,0,0,0,77456,2202,75254,0,21118,1500,19618,0,22260,1500,20760,0,23396,1500,21896
22170,40000,32000,0,0,0,0,0,1,2,24204,1600,22604,2,24510,1000,23510,2,24811,1000,23811,2,24274,0,24274
22171,130000,104000,0,1,0,0,0,0,0,107674,3500,104174,0,89780,3200,86580,0,90625,3200,87425,0,90492,3300,87192
22172,240000,192000,0,0,0,0,0,0,-1,326,326,0,-1,5676,5676,0,-1,476,476,0,-1,326,326,0
22173,30000,24000,0,1,1,1,1,1,2,29216,0,29216,2,29681,1200,28481,0,29321,1000,28321,0,28068,1046,27022
22174,80000,64000,0,0,0,0,0,1,-1,390,390,0,-1,390,390,0,-1,780,780,0,-1,390,0,390
22175,320000,256000,0,0,0,0,0,1,-1,84421,84440,-19,-1,886,886,0,-1,11741,11533,208,0,4317,4317,0
22176,310000,248000,0,1,1,0,0,1,0,307371,12500,294871,0,299501,11000,288501,0,217763,6600,211163,0,217659,7000,210659
22177,200000,160000,0,0,0,0,0,0,-2,-15,0,-15,-2,1753,1768,-15,-2,4717,6137,-1420,-1,1230,0,1230
22178,260000,208000,0,0,0,0,0,0,-1,326,326,0,-1,326,326,0,-1,476,476,0,-1,326,326,0
22179,100000,80000,0,0,0,0,0,0,-2,680,680,0,-1,837,837,0,-1,0,0,0,-1,0,0,0
22180,450000,360000,0,0,0,0,0,0,-2,-5738,1800,-7538,-2,-5738,0,-5738,-2,-5738,0,-5738,-2,-5738,0,-5738
22181,50000,40000,0,1,0,0,0,0,0,49366,1500,47866,0,29441,1024,28417,0,30061,1064,28997,0,28728,1029,27699
22182,260000,208000,0,0,0,0,0,0,-1,0,0,0,-1,202,202,0,-1,11990,11990,0,-1,3359,3359,0
22183,260000,208000,0,0,0,0,0,1,2,2500,0,2500,2,2500,0,2500,2,2500,0,2500,2,2500,0,2500
22184,270000,216000,0,0,0,0,0,0,0,8966,1000,7966,0,8294,8294,0,-1,3902,3902,0,-1,468,468,0
22185,250000,200000,0,0,0,0,0,0,-2,0,0,0,-2,0,0,0,-2,0,0,0,-2,0,0,0
22186,30000,24000,0,0,0,0,0,0,-2,0,0,0,-2,0,0,0,-2,0,0,0,-2,0,0,0
22187,150000,120000,0,0,0,0,0,0,-1,5290,5294,-4,-1,17205,17211,-6,-1,27130,14635,12495,0,3801,1,3800
22188,180000,144000,0,0,0,0,0,0,-2,139740,139770,-30,-1,15631,1000,14631,0,2777,2777,0,0,2160,2160,0
22189,20000,16000,0,1,1,1,1,0,0,19089,1323,17766,0,19658,1600,18058,0,19453,830,18623,0,19108,700,18408
22190,310000,248000,0,0,0,0,0,0,-1,10327,48,10279,2,17252,17337,-85,-1,9917,9965,-48,-1,33776,33826,-50
22191,420000,336000,0,0,0,0,0,0,0,9180,5000,4180,0,13965,5000,8965,0,10245,5000,5245,0,20199,10000,10199
22192,500000,400000,0,0,0,0,0,0,-1,18909,19001,-92,-1,31449,31603,-154,-1,8253,8289,-36,-1,25707,25832,-125
22193,360000,288000,0,0,0,0,0,0,0,119028,4816,114212,0,103046,2061,100985,0,15863,15863,0,-1,10503,21,10482
22194,180000,144000,0,0,0,0,0,0,0,114559,6000,108559,0,113759,6100,107659,0,94665,4000,90665,0,97134,4000,93134
22195,20000,16000,0,0,0,0,0,1,0,4144,3,4141,2,8168,5101,3067,0,6894,6,6888,0,11424,6530,4894
22196,50000,40000,0,1,0,0,0,1,0,50156,2225,47931,0,20186,1008,19178,0,17966,757,17209,0,19659,2601,17058
22197,180000,144000,0,1,1,0,0,0,0,176081,7000,169081,0,175540,7200,168340,0,142015,5018,136997,0,139162,5200,133962
22198,150000,120000,0,0,0,0,0,0,-1,1995,2340,-345,-1,285,0,285,0,4926,4970,-44,-1,5523,5527,-4
22199,50000,40000,0,1,1,1,1,1,2,41164,0,41164,2,43658,3500,40158,2,44644,2000,42644,2,43798,0,43798
22200,300000,240000,0,0,0,0,0,0,-2,2105,2109,-4,-2,835,835,0,-2,1761,1761,0,-2,2849,2853,-4
22201,300000,240000,1,1,1,1,1,1,0,313600,11380,302220,0,309670,11216,298454,0,305660,11069,294591,0,301693,11090,290603
22202,140000,112000,0,1,1,1,1,0,0,137110,6010,131100,0,139761,6000,133761,0,137215,5400,131815,0,133572,5000,128572
22203,280000,224000,0,0,0,0,0,0,0,237301,20000,217301,0,201226,10000,191226,0,207802,10000,197802,0,219281,15000,204281
22204,110000,88000,0,1,0,0,0,0,0,92114,3200,88914,0,70057,2500,67557,0,28492,1600,26892,0,107453,80000,27453
22205,340000,272000,0,0,0,0,0,1,0,73950,5000,68950,0,59324,2000,57324,0,156094,112000,44094,0,110234,4234,106000
22206,110000,88000,0,1,1,1,1,1,2,91803,2200,89603,2,94376,5000,89376,2,96409,3700,92709,2,98072,3400,94672
22207,260000,208000,0,0,0,0,0,1,2,86472,4300,82172,2,87157,3000,84157,2,88526,3700,84826,2,90355,3400,86955
22208,160000,128000,0,0,0,0,0,0,0,21380,1000,20380,0,283,283,0,-1,0,0,0,-1,-17149,0,-17149
22209,360000,288000,0,0,0,0,0,0,-2,0,0,0,-2,0,0,0,-2,0,0,0,-2,0,0,0
22210,100000,80000,0,1,1,1,1,0,0,102066,4516,97550,0,99186,3645,95541,0,97140,3649,93491,0,95123,3724,91399
22211,100000,80000,0,0,0,0,0,0,0,37882,20000,17882,0,40882,3000,37882,0,45683,5000,40683,0,5765,2000,3765
22212,10000,8000,0,0,0,0,0,0,-2,0,0,0,-2,-400,0,-400,-2,0,400,-400,-2,0,0,0
22213,130000,104000,0,0,0,0,0,0,-1,0,0,0,-1,0,0,0,-2,428,428,0,-1,150,150,0
22214,130000,104000,0,1,1,0,0,0,0,130870,6338,124532,0,132213,5530,126683,0,52755,1877,50878,0,53463,1937,51526
22215,30000,24000,0,0,0,0,0,0,0,22302,2000,20302,0,23208,1800,21408,0,21822,0,21822,2,16624,641,15983
22216,500000,400000,0,0,0,0,0,1,-1,1989,1989,0,-1,1200,1200,0,-1,1451,1451,0,-1,548,548,0
22217,100000,80000,0,0,0,0,0,0,0,11307,1124,10183,0,11139,495,10644,0,11361,500,10861,0,9816,758,9058
22218,370000,296000,0,0,0,0,0,0,-2,12939,12939,0,-2,11367,11380,-13,-2,17049,17049,0,-2,27337,27337,0
22219,210000,168000,0,0,0,0,0,0,-2,765,765,0,-2,0,0,0,-2,0,0,0,-2,0,0,0
22220,100000,80000,0,0,0,0,0,0,0,71635,3000,68635,0,72809,2743,70066,0,74100,3000,71100,0,75316,3000,72316
22221,300000,240000,0,0,0,0,0,0,-2,10610,10841,-231,-1,10520,0,10520,0,120,100,20,0,0,0,0
22222,50000,40000,0,1,1,0,0,1,0,49598,2200,47398,0,46363,1150,45213,0,9283,500,8783,0,9632,500,9132
22223,70000,56000,0,1,0,0,0,1,0,63352,2700,60652,0,28085,1732,26353,0,28487,1134,27353,0,27006,1128,25878
22224,260000,208000,0,0,0,0,0,0,0,188608,6486,182122,0,172722,5712,167010,0,159826,5647,154179,0,146891,5386,141505
22225,280000,224000,0,0,0,0,0,0,0,218043,8077,209966,0,196016,7171,188845,0,195307,8014,187293,0,168946,6235,162711
22226,460000,368000,0,0,0,0,0,0,0,79012,10027,68985,0,74349,3001,71348,0,77504,5004,72500,0,90032,15000,75032
22227,130000,104000,0,0,0,0,0,0,-1,2565,2572,-7,-1,8975,9010,-35,-1,43663,42739,924,0,23566,5583,17983
22228,50000,40000,0,0,0,0,0,0,0,26570,1000,25570,2,28085,2001,26084,0,27009,910,26099,0,28142,1510,26632
22229,190000,152000,0,0,0,0,0,0,-2,2251,2251,0,-1,2251,0,2251,0,497,600,-103,0,7681,9289,-1608
22230,50000,40000,0,0,0,0,0,0,-1,13032,13032,0,-1,14292,1500,12792,0,16698,3000,13698,0,15436,554,14882
22231,120000,96000,0,0,0,0,0,0,0,30893,1500,29393,0,32804,2401,30403,0,32213,1155,31058,0,31891,1460,30431
22232,150000,120000,0,0,0,0,0,0,0,37033,1783,35250,0,25032,1282,23750,0,12500,250,12250,0,12500,12500,0
22233,20000,16000,0,0,1,1,1,1,2,16646,1285,15361,0,17648,1287,16361,0,18819,1458,17361,0,17992,0,17992
22234,60000,48000,0,0,0,0,0,1,2,600,0,600,4,600,0,600,4,300,0,300,3,150,0,150
22235,70000,56000,0,0,0,0,0,0,0,31914,1700,30214,2,32394,1300,31094,2,31574,0,31574,2,34053,3000,31053
22236,20000,16000,0,0,0,0,0,0,0,9638,1000,8638,0,8878,1000,7878,0,6474,500,5974,0,2771,0,2771
22237,150000,120000,0,0,0,0,0,0,0,6640,1000,5640,0,5831,1070,4761,0,10514,6000,4514,0,5432,2432,3000
22238,150000,120000,0,0,0,0,0,0,-1,7672,7672,0,-1,1736,1736,0,-1,82188,82178,10,0,67578,5000,62578
22239,50000,40000,0,1,0,0,0,0,2,48869,136,48733,2,30115,1206,28909,0,29527,2002,27525,0,29998,2005,27993
22240,20000,16000,0,0,0,0,0,1,0,631,631,0,-1,4481,4481,0,-1,6481,2000,4481,0,3465,300,3165
22241,330000,264000,0,1,0,0,0,0,0,303679,10691,292988,0,271773,10373,261400,0,198604,7901,190703,0,149923,5328,144595
22242,450000,360000,0,0,0,0,0,0,0,156049,13641,142408,0,164076,12168,151908,0,170885,9650,161235,0,177483,9650,167833
22243,280000,224000,0,0,0,0,0,0,-1,2657,1422,1235,0,1416,7,1409,0,2706,2719,-13,-1,1229,1235,-6
22244,50000,40000,0,0,0,0,0,1,0,22571,1360,21211,0,23024,810,22214,0,25567,2900,22667,0,24463,0,24463
22245,50000,40000,0,0,0,0,0,0,0,22851,1000,21851,0,6699,0,6699,0,10060,3361,6699,0,7737,0,7737
22246,110000,88000,0,0,0,0,0,1,2,34090,11412,22678,0,24843,739,24104,0,18105,1560,16545,0,16952,0,16952
22247,180000,144000,0,0,0,0,0,0,-2,0,0,0,-2,0,0,0,-2,6017,6017,0,-2,0,0,0
22248,110000,88000,0,1,1,0,0,0,0,109501,5007,104494,0,105290,5290,100000,0,78812,8812,70000,0,78503,8503,70000
22249,140000,112000,0,1,1,0,0,0,0,143728,5829,137899,0,125158,6240,118918,0,93998,3500,90498,0,91229,3500,87729
22250,450000,360000,0,0,0,0,0,0,0,84033,3073,80960,0,72279,3000,69279,0,55757,2000,53757,0,37161,1500,35661
22251,170000,136000,0,0,0,0,0,0,-1,74152,74198,-46,-1,38579,38804,-225,-1,77819,66000,11819,0,47975,40970,7005
22252,70000,56000,0,0,0,0,0,0,0,47229,3600,43629,2,47956,1800,46156,2,47056,0,47056,2,49565,3308,46257
22253,40000,32000,0,0,0,0,0,1,3,6156,0,6156,2,7146,1100,6046,2,7384,500,6884,2,7117,0,7117
22254,270000,216000,0,0,0,0,0,0,0,16911,2500,14411,2,14692,0,14692,2,13907,1000,12907,2,10660,0,10660
22255,180000,144000,0,0,0,0,0,0,-2,0,0,0,-2,0,0,0,-2,0,0,0,-2,0,0,0
22256,140000,112000,0,0,0,0,0,0,0,51334,2411,48923,0,51533,2000,49533,0,52233,2041,50192,0,53826,3000,50826
22257,20000,16000,0,1,1,0,0,1,3,19661,25,19636,2,26158,2000,24158,0,13560,1000,12560,0,15324,2000,13324
22258,50000,40000,0,1,0,0,0,0,2,44069,3509,40560,2,37395,0,37395,2,32284,1302,30982,0,32805,1191,31614
22259,90000,72000,0,0,0,0,0,0,-1,0,0,0,-1,3000,3000,0,-1,3000,3000,0,-1,3000,3000,0
22260,80000,64000,0,0,0,0,0,0,2,3182,2000,1182,0,5124,2000,3124,0,4893,0,4893,2,5810,1000,4810
22261,310000,248000,0,0,0,0,0,1,-1,9794,9794,0,-1,15792,7004,8788,0,8944,1000,7944,0,88643,89137,-494
22262,300000,240000,0,0,0,0,0,0,-2,4541,4541,0,-2,5620,5620,0,-2,25,25,0,-2,25,0,25
22263,50000,40000,0,1,1,0,0,0,0,46210,2321,43889,0,46549,1660,44889,0,20084,3000,17084,0,20264,1004,19260
22264,130000,104000,0,0,0,0,0,0,-1,9840,0,9840,2,11671,2000,9671,0,11914,431,11483,0,12155,438,11717
22265,20000,16000,0,0,0,0,0,1,-1,390,0,390,2,0,0,0,2,780,780,0,-1,0,0,0
22266,180000,144000,1,1,1,1,1,0,0,279551,20000,259551,0,285045,12000,273045,0,298652,18000,280652,0,296036,0,296036
22267,50000,40000,0,1,1,1,1,0,0,50516,2000,48516,0,50987,2500,48487,0,48960,2000,46960,0,48691,1800,46891
22268,250000,200000,0,0,0,0,0,0,0,43497,3000,40497,0,13877,4500,9377,0,14395,3000,11395,0,14063,5000,9063
22269,60000,48000,0,1,0,0,0,0,0,52757,17,52740,2,29209,3106,26103,2,26403,0,26403,2,26969,1104,25865
22270,420000,336000,0,0,0,0,0,0,-2,11343,11353,-10,-2,5216,5255,-39,-2,23001,23001,0,-2,2439,2439,0
22271,90000,72000,0,1,1,1,1,0,0,90298,4100,86198,0,91343,3307,88036,0,90887,3405,87482,0,90858,3311,87547
22272,10000,8000,0,1,1,1,1,1,0,8826,0,8826,2,8849,318,8531,0,9567,862,8705,0,9265,0,9265
22273,30000,24000,0,0,0,0,0,0,0,18253,5000,13253,0,19646,5000,14646,0,21238,5000,16238,0,23843,5000,18843
22274,100000,80000,0,1,0,0,0,1,2,101600,4384,97216,0,17046,341,16705,0,1075,1075,0,-1,1442,1442,0
22275,100000,80000,0,0,0,0,0,0,0,64480,2782,61698,0,0,0,0,0,0,0,0,-2,1218,1218,0
22276,30000,24000,0,1,1,1,1,0,0,26901,1230,25671,0,27907,1236,26671,0,28469,798,27671,0,29058,822,28236
22277,110000,88000,0,1,1,1,1,1,0,102724,3800,98924,2,100188,0,100188,2,102110,3685,98425,0,107014,6580,100434
22278,60000,48000,0,0,0,0,0,0,0,31962,1900,30062,0,32444,1310,31134,0,32971,1200,31771,0,33721,1300,32421
22279,110000,88000,0,0,0,0,0,1,0,87748,4521,83227,0,99201,20000,79201,0,78281,2710,75571,0,77772,2800,74972
22280,120000,96000,0,0,0,0,0,0,0,32493,5000,27493,0,16258,7,16251,2,8871,0,8871,0,2000,2000,0
22281,110000,88000,0,0,0,0,0,0,2,279,0,279,3,279,0,279,3,129,0,129,2,179,200,-21
22282,250000,200000,0,0,0,0,0,0,-2,0,0,0,-2,1930,1930,0,-2,1643,1643,0,-2,1687,1687,0
22283,520000,416000,0,0,0,0,0,0,0,280101,10423,269678,0,184081,7215,176866,0,108330,4012,104318,0,89199,3017,86182
22284,100000,80000,0,0,0,0,0,0,-2,2926,2926,0,-1,60540,58801,1739,0,60929,2200,58729,0,64121,5000,59121
22285,210000,168000,0,0,0,0,0,0,-1,3702,3702,0,-1,3673,3673,0,-1,1883,0,1883,0,384,384,0
22286,10000,8000,0,0,0,0,0,0,-1,780,780,0,-1,390,0,390,0,780,31250,-30470,-1,390,0,390
22287,540000,432000,0,0,0,0,0,0,0,66513,3070,63443,0,67149,3100,64049,0,66880,2320,64560,0,67667,2796,64871
22288,340000,272000,0,0,0,0,0,1,0,65752,2406,63346,0,69639,5000,64639,0,80057,11610,68447,0,83713,5000,78713
22289,20000,16000,0,1,1,1,0,1,2,18592,0,18592,2,19431,1238,18193,0,19993,800,19193,0,-1000,0,-1000
22290,160000,128000,0,0,0,0,0,1,-1,0,0,0,-2,0,0,0,-2,0,0,0,-2,0,0,0
22291,180000,144000,0,0,0,0,0,0,0,73422,2708,70714,0,72687,3071,69616,0,68167,2500,65667,0,69746,2615,67131
22292,90000,72000,0,0,0,0,0,0,0,11195,1086,10109,0,8948,581,8367,0,9143,273,8870,0,6003,227,5776
22293,50000,40000,0,0,0,0,0,1,0,19641,1506,18135,0,15848,713,15135,0,16026,582,15444,0,16359,600,15759
22294,250000,200000,0,0,0,0,0,0,0,103675,94000,9675,0,91487,3000,88487,0,83374,7000,76374,0,67445,20006,47439
22295,160000,128000,0,0,0,0,0,0,-2,0,0,0,-2,0,0,0,-2,0,0,0,-2,0,0,0
22296,200000,160000,0,0,0,0,0,0,-1,3191,3191,0,-1,1873,0,1873,0,90687,90729,-42,-1,4577,0,4577
22297,230000,184000,0,0,0,0,0,0,0,17874,5000,12874,0,26743,10000,16743,0,26431,5000,21431,0,35153,10018,25135
22298,470000,376000,0,0,0,0,0,1,0,15270,1300,13970,0,15615,600,15015,0,16261,900,15361,0,16969,1000,15969
22299,200000,160000,0,0,0,0,0,0,2,29192,6,29186,2,28170,991,27179,0,28763,1032,27731,0,28453,1310,27143
22300,30000,24000,0,0,0,0,0,0,2,153,0,153,2,1495,1495,0,-1,955,0,955,2,1735,1170,565
22301,270000,216000,0,0,0,0,0,0,0,17555,1000,16555,0,17803,2054,15749,0,1852,1857,-5,-1,2044,2069,-25
22302,20000,16000,0,1,0,1,1,0,0,18142,1600,16542,0,17245,1600,15645,0,17657,1000,16657,0,18370,1000,17370
22303,620000,496000,0,0,0,0,0,0,-1,17206,17244,-38,-1,164582,154826,9756,0,75743,76300,-557,-1,54737,55012,-275
22304,140000,112000,0,1,1,1,1,1,0,137187,4975,132212,0,136807,4897,131910,0,136631,5029,131602,0,136080,4792,131288
22305,380000,304000,0,0,0,0,0,1,-2,0,0,0,-2,0,0,0,-2,0,0,0,-2,0,0,0
22306,30000,24000,0,1,1,1,1,1,0,30416,2000,28416,0,28165,2003,26162,0,28654,2000,26654,0,29083,1000,28083
22307,130000,104000,0,0,0,0,0,0,0,88093,3224,84869,0,89837,3236,86601,0,91625,3257,88368,0,92822,3509,89313
22308,200000,160000,0,0,0,0,0,0,0,131352,6579,124773,0,130884,4734,126150,0,132142,4368,127774,0,118084,4183,113901
22309,190000,152000,0,0,0,0,0,0,0,33142,1720,31422,0,33726,1300,32426,0,35758,2600,33158,0,35171,0,35171
22310,340000,272000,0,0,0,0,0,1,-2,0,0,0,-2,0,0,0,-2,0,0,0,-2,0,0,0
22311,360000,288000,0,0,0,0,0,0,-1,15687,15766,-79,-1,38750,38944,-194,-1,15802,15881,-79,-1,15730,15809,-79
22312,500000,400000,0,0,0,0,0,0,0,63488,2000,61488,0,32050,1285,30765,0,46393,15000,31393,0,35207,1520,33687
22313,60000,48000,0,0,0,0,0,0,-1,31632,32264,-632,-1,13264,12948,316,0,948,0,948,0,18002,17370,632
22314,50000,40000,0,0,0,0,0,0,0,11824,1500,10324,0,13018,1500,11518,0,12303,281,12022,0,18584,18584,0
22315,50000,40000,0,0,0,0,0,0,0,12950,7956,4994,0,11188,3188,8000,0,12167,2200,9967,0,14873,7000,7873
22316,300000,240000,0,1,1,1,1,0,0,295173,11067,284106,0,286885,10026,276859,0,287816,10500,277316,0,294383,11080,283303
22317,50000,40000,0,0,0,0,0,1,0,38984,4022,34962,0,23566,3034,20532,0,21652,5000,16652,0,3612,3700,-88
22318,50000,40000,0,0,0,0,0,0,0,7076,4000,3076,0,7729,2000,5729,0,9442,2000,7442,0,9887,1000,8887
22319,30000,24000,0,1,1,1,1,0,0,31105,1500,29605,2,30270,0,30270,2,29963,1050,28913,0,29661,1250,28411
22320,100000,80000,0,1,1,1,1,1,0,101863,3919,97944,0,101729,3986,97743,0,98103,3865,94238,0,99521,3760,95761
22321,400000,320000,0,0,0,0,0,0,-1,38915,39186,-271,-1,29926,30153,-227,-1,24383,12029,12354,0,45588,38220,7368
22322,50000,40000,0,0,0,0,0,1,2,1879,0,1879,2,889,0,889,0,2399,2500,-101,-1,1225,0,1225
22323,30000,24000,0,0,0,0,0,1,-1,8610,3000,5610,0,8402,299,8103,0,10878,3000,7878,0,10790,608,10182
22324,360000,288000,0,0,0,0,0,0,-2,0,0,0,-2,0,0,0,-2,0,0,0,-2,0,0,0
22325,20000,16000,0,1,1,1,1,1,0,19424,1600,17824,0,19208,384,18824,0,19600,392,19208,0,20000,400,19600
22326,10000,8000,0,0,0,0,0,0,-1,0,0,0,-1,780,780,0,-1,5018,5018,0,-1,5275,375,4900
22327,150000,120000,0,0,0,0,0,0,0,8000,8000,0,-1,0,2000,-2000,-1,10000,10000,0,-1,0,0,0
22328,100000,80000,0,0,0,0,0,0,-2,0,0,0,-2,0,0,0,-2,0,0,0,-2,0,0,0
22329,360000,288000,0,0,0,0,0,1,-2,0,0,0,-2,0,0,0,-2,0,0,0,-2,0,0,0
22330,40000,32000,0,0,0,0,0,0,-1,960,960,0,-1,960,960,0,-1,1383,1383,0,-1,960,960,0
22331,50000,40000,0,1,1,0,0,0,0,49397,4000,45397,0,50360,5000,45360,0,19971,3000,16971,0,19694,4500,15194
22332,20000,16000,0,1,1,0,0,0,0,18371,1206,17165,0,18400,2222,16178,0,0,0,0,0,0,0,0
22333,50000,40000,0,0,0,0,0,0,0,27774,1387,26387,0,28387,1000,27387,0,28982,980,28002,0,29599,1026,28573
22334,360000,288000,0,0,0,0,0,0,-1,19181,19286,-105,-1,16155,16243,-88,-1,5936,5966,-30,-1,15330,15407,-77
22335,100000,80000,0,0,0,0,0,0,-1,858,858,0,-1,429,0,429,0,429,429,0,-1,429,429,0
22336,210000,168000,0,0,0,1,1,0,0,17383,1400,15983,0,172065,155000,17065,0,181981,12700,169281,0,174744,0,174744
22337,20000,16000,0,1,1,1,1,0,0,19012,2000,17012,0,19959,1300,18659,0,19962,658,19304,0,19988,680,19308
22338,200000,160000,0,1,1,1,1,0,0,191098,7125,183973,0,194671,7333,187338,0,177096,6325,170771,0,180388,6522,173866
22339,30000,24000,0,0,0,0,0,1,2,16620,1600,15020,2,16056,0,16056,2,17386,1600,15786,2,16968,0,16968
22340,50000,40000,0,0,0,0,0,0,0,7315,1500,5815,0,9195,2000,7195,0,10624,1583,9041,0,10138,1100,9038
22341,120000,96000,0,0,0,0,0,0,-1,3011,3011,0,-1,1964,1964,0,-1,1883,1883,0,-1,1538,1538,0
22342,70000,56000,0,0,0,0,0,1,0,26744,1396,25348,0,28087,3000,25087,0,27393,980,26413,0,26646,955,25691
22343,20000,16000,0,0,1,1,0,0,-2,18354,21431,-3077,-1,19064,2300,16764,0,19422,558,18864,0,4390,4403,-13
22344,20000,16000,0,0,1,1,1,0,2,17174,1600,15574,3,16605,0,16605,2,17029,1000,16029,0,17305,700,16605
22345,500000,400000,0,0,0,0,0,0,-1,2287,3037,-750,-1,96501,96501,0,-1,12143,12500,-357,-1,50143,38000,12143
22346,200000,160000,0,1,1,1,1,1,0,194175,9000,185175,0,189457,8000,181457,0,187050,10000,177050,0,187082,8000,179082
22347,280000,224000,0,0,0,0,0,1,-1,-15,0,-15,-1,30943,30958,-15,-1,15631,15631,0,-1,17508,17508,0
22348,360000,288000,0,0,0,0,0,0,-1,33148,33148,0,-1,33829,1287,32542,0,16555,413,16142,0,7090,7127,-37
22349,140000,112000,0,1,1,0,0,0,0,142280,8000,134280,0,142002,6314,135688,0,89035,3200,85835,0,94006,6400,87606
22350,10000,8000,0,1,1,1,0,1,0,9412,1000,8412,0,9604,192,9412,0,9800,196,9604,0,0,0,0
22351,50000,40000,0,0,0,0,0,0,0,16980,2010,14970,0,16908,1500,15408,0,17327,1000,16327,0,17895,1000,16895
22352,240000,192000,0,0,0,0,0,0,0,86507,3000,83507,0,89138,3000,86138,0,91118,2500,88618,0,93229,2500,90729
22353,200000,160000,0,0,0,0,0,0,-1,0,0,0,-2,151,151,0,-2,0,0,0,-2,0,0,0
22354,260000,208000,0,0,0,0,0,1,-1,4865,4873,-8,-1,507,507,0,-1,3787,3787,0,-1,1443,1443,0
22355,50000,40000,0,0,0,0,0,0,-1,3106,3106,0,-1,0,0,0,-1,0,0,0,-2,1370,1370,0
22356,170000,136000,0,0,0,0,0,0,2,51184,0,51184,2,37938,0,37938,0,25292,0,25292,0,12646,0,12646
22357,130000,104000,0,0,0,0,0,0,-1,0,0,0,-2,0,0,0,-2,0,0,0,-2,0,0,0
22358,50000,40000,0,1,1,1,1,1,0,51109,4116,46993,0,51713,2000,49713,2,52738,1950,50788,2,48789,0,48789
22359,280000,224000,0,0,0,0,0,0,-1,3590,3607,-17,-1,274,275,-1,-1,5274,5275,-1,-1,8222,3223,4999
22360,20000,16000,0,0,0,0,0,0,0,9662,1020,8642,0,8091,2000,6091,0,0,0,0,0,0,0,0
22361,500000,400000,0,0,0,0,0,0,0,76088,30000,46088,0,110294,50000,60294,0,108964,5000,103964,0,103548,5000,98548
22362,10000,8000,0,0,1,1,1,0,0,8749,1165,7584,0,9413,1079,8334,0,10534,1200,9334,0,10210,754,9456
22363,420000,336000,0,0,0,0,0,0,2,2010,2010,0,-1,6058,6058,0,-1,160,160,0,-1,580,1000,-420
22364,180000,144000,0,0,0,0,0,0,0,31613,1501,30112,0,25220,1000,24220,0,8654,0,8654,0,4837,0,4837
22365,50000,40000,0,0,0,0,0,0,0,18059,1500,16559,0,18020,629,17391,0,18028,672,17356,0,17744,626,17118
22366,360000,288000,0,0,0,0,0,1,-1,2776,2776,0,-1,0,0,0,-1,44110,44110,0,-1,0,0,0
22367,50000,40000,0,0,0,0,0,0,0,16235,2000,14235,0,17035,2022,15013,0,15601,1000,14601,0,16349,1000,15349
22368,420000,336000,0,0,0,0,0,0,0,144169,5502,138667,0,122453,4193,118260,0,120509,5006,115503,0,119783,4503,115280
22369,240000,192000,0,0,0,0,0,0,-2,2486,2489,-3,-1,2500,2500,0,-1,580,580,0,-1,490,490,0
22370,50000,40000,0,0,0,0,0,0,0,27381,1251,26130,0,17930,1200,16730,0,18128,600,17528,0,18490,627,17863
22371,150000,120000,0,0,0,0,0,0,0,25592,1800,23792,0,24949,1100,23849,0,26846,2300,24546,0,26908,1000,25908
22372,150000,120000,0,0,0,0,0,0,-1,17991,19406,-1415,0,101553,102989,-1436,-1,95786,2608,93178,0,82645,7845,74800
22373,210000,168000,0,0,0,0,0,0,0,105875,6029,99846,0,97873,3000,94873,0,90872,3500,87372,0,72969,3000,69969
22374,80000,64000,0,0,0,0,0,0,0,0,0,0,0,0,0,0,-2,11457,45568,-34111,-1,6709,3000,3709
22375,120000,96000,0,0,0,0,0,0,-2,506,506,0,-2,2097,2097,0,-2,758,758,0,-2,2005,2005,0
22376,120000,96000,0,0,0,0,0,0,-1,250,252,-2,-1,1579,1579,0,-1,223,223,0,-1,421,421,0
22377,120000,96000,0,0,0,0,0,0,-1,326,326,0,-1,12055,12055,0,-1,11968,239,11729,0,12968,1000,11968
22378,260000,208000,0,0,0,0,0,0,-2,0,0,0,-2,0,0,0,-2,0,0,0,-2,0,0,0
22379,50000,40000,0,1,1,1,1,0,0,49115,2581,46534,0,48688,1900,46788,0,48927,1919,47008,0,49106,1887,47219
22380,80000,64000,0,0,0,0,0,0,0,36232,1005,35227,0,30200,31063,-863,-1,30326,1094,29232,0,30290,1109,29181
22381,230000,184000,0,0,0,0,0,0,-2,1636,1640,-4,-2,1149,1152,-3,-2,334,335,-1,-2,459,460,-1
22382,310000,248000,0,0,0,0,0,0,0,26024,3000,23024,0,26201,1500,24701,0,20896,500,20396,0,6579,6579,0
22383,210000,168000,0,0,0,0,0,0,-1,8024,8042,-18,-1,1292,1292,0,-1,1000,1000,0,-1,3340,3340,0
22384,20000,16000,0,0,0,0,0,1,-1,1192,1192,0,-1,7804,7807,-3,-1,6200,124,6076,0,3982,3982,0
22385,50000,40000,0,0,0,0,0,0,-2,0,0,0,-2,0,0,0,-2,0,0,0,-2,0,0,0
22386,310000,248000,0,0,0,0,0,0,-2,0,0,0,-2,0,0,0,-2,0,0,0,-2,0,0,0
22387,110000,88000,0,0,0,0,0,0,2,71866,3200,68666,2,72698,2600,70098,2,70930,0,70930,2,72439,2650,69789
22388,600000,480000,0,0,0,0,0,0,-2,1191,3000,-1809,-2,11390,11500,-110,-2,8680,8680,0,-2,38018,38020,-2
22389,110000,88000,0,0,0,0,0,0,0,56394,3500,52894,0,58341,3500,54841,0,60242,3000,57242,0,62234,3000,59234
22390,30000,24000,0,1,1,1,0,0,2,28427,2000,26427,0,28752,1000,27752,0,28447,1100,27347,0,24552,1500,23052
22391,150000,120000,0,0,0,0,0,0,0,52598,2424,50174,0,3218,3218,0,-1,0,0,0,-1,0,0,0
22392,220000,176000,0,0,0,0,0,0,0,130365,16000,114365,0,126780,0,126780,2,129570,5000,124570,0,133553,6300,127253
22393,130000,104000,0,0,0,0,0,0,0,34810,1872,32938,0,35194,1256,33938,0,35951,1500,34451,0,36703,1500,35203
22394,130000,104000,0,0,0,0,0,0,-1,0,0,0,-2,0,0,0,-2,0,0,0,-2,0,0,0
22395,70000,56000,0,0,0,0,0,0,0,49976,1362,48614,0,20882,1268,19614,0,16401,587,15814,0,16903,766,16137
22396,100000,80000,0,0,0,0,0,0,0,28503,1000,27503,0,6810,1039,5771,0,-3,12920,-12923,0,-3,0,-3
22397,50000,40000,0,0,0,0,0,0,0,20650,1650,19000,0,0,0,0,0,0,0,0,-2,0,0,0
22398,50000,40000,0,0,0,0,0,0,0,29177,1653,27524,0,29544,1400,28144,0,19863,0,19863,0,18812,0,18812
22399,70000,56000,0,0,0,0,0,0,0,35122,4500,30622,0,28633,1200,27433,2,28039,0,28039,2,28621,1200,27421
22400,330000,264000,0,0,0,0,0,0,0,137289,4989,132300,0,141844,6844,135000,0,143470,5470,138000,0,146596,5596,141000
22401,310000,248000,0,0,0,0,0,0,0,78380,6000,72380,0,77102,2559,74543,2,66828,45,66783,2,58520,3033,55487
22402,160000,128000,0,0,0,0,0,0,-1,435,435,0,-1,435,435,0,-1,435,435,0,-1,435,435,0
22403,200000,160000,0,0,0,0,0,0,-1,7428,1025,6403,0,10234,10249,-15,0,5380,5380,0,-1,7532,5000,2532
22404,270000,216000,0,0,0,0,0,0,0,17723,2000,15723,0,18634,1145,17489,0,19997,1508,18489,0,18948,900,18048
22405,210000,168000,0,0,0,0,0,0,-1,1821,2,1819,2,1683,1683,0,-1,0,0,0,-1,1986,1986,0
22406,310000,248000,0,0,0,0,0,0,0,34161,2000,32161,0,38689,5034,33655,0,32710,1045,31665,0,24343,776,23567
22407,180000,144000,0,0,0,0,0,0,0,5446,0,5446,2,4853,288,4565,0,3965,143,3822,0,3310,246,3064
22408,150000,120000,0,0,0,0,0,0,0,4880,4880,0,-1,0,0,0,-1,0,0,0,-2,2250,2250,0
22409,130000,104000,0,0,0,0,0,1,2,33740,1407,32333,0,17009,347,16662,0,11580,11,11569,0,0,0,0
22410,280000,224000,0,0,0,0,0,0,-1,4628,4660,-32,-1,2589,2601,-12,-1,3120,3135,-15,-1,4334,4354,-20
22411,20000,16000,0,0,0,1,0,0,0,17443,1500,15943,0,16216,1500,14716,0,18027,2000,16027,0,12364,0,12364
22412,180000,144000,0,0,0,0,0,0,0,128002,6007,121995,0,127286,4304,122982,0,119733,4241,115492,0,116705,4200,112505
22413,370000,296000,0,0,0,0,0,0,-2,4556,4578,-22,-2,4333,4354,-21,-2,2504,2516,-12,-2,3431,3438,-7
22414,230000,184000,0,0,0,0,0,1,-1,416,416,0,-1,416,416,0,-1,416,416,0,-1,416,416,0
22415,250000,200000,0,0,0,0,0,0,0,42090,12004,30086,0,61558,21558,40000,0,80894,20894,60000,0,93938,15000,78938
22416,30000,24000,0,0,0,0,0,0,0,8762,5,8757,2,6200,1062,5138,0,0,0,0,0,0,0,0
22417,60000,48000,0,1,0,0,0,1,0,60251,2500,57751,0,57251,31000,26251,0,27896,981,26915,0,28499,1035,27464
22418,50000,40000,0,0,0,0,0,1,-1,6093,4000,2093,-1,5850,0,5850,2,9558,4000,5558,0,15371,6000,9371
22419,200000,160000,0,0,0,0,0,0,0,20207,4007,16200,0,23858,5001,18857,0,33236,10020,23216,0,33337,5073,28264
22420,80000,64000,0,1,0,0,0,0,0,72868,0,72868,2,55780,2100,53680,0,53523,2100,51423,0,54679,2200,52479
22421,210000,168000,0,0,0,0,0,0,-1,6867,6867,0,-1,2271,2271,0,-1,1054,1054,0,-1,1197,1197,0
22422,180000,144000,0,0,0,0,0,0,2,0,0,0,2,0,0,0,-2,1245,1245,0,-1,546,0,546
22423,340000,272000,0,0,0,0,0,0,0,206485,10000,196485,0,196137,10000,186137,0,196447,8032,188415,0,195114,8000,187114
22424,240000,192000,0,0,0,0,0,0,-1,26832,26834,-2,-1,3518,3518,0,-1,1280,1280,0,-1,5900,5900,0
22425,300000,240000,0,0,0,0,0,0,-2,1109,1422,-313,-2,0,0,0,-2,474,474,0,-2,337,337,0
22426,50000,40000,0,1,0,0,0,0,2,49255,3000,46255,0,8838,1000,7838,0,9011,1000,8011,0,9872,1000,8872
22427,140000,112000,0,0,0,0,0,1,-1,446,446,0,-1,0,0,0,-1,0,0,0,-2,0,0,0
22428,410000,328000,0,1,1,0,0,0,0,383225,20000,363225,0,396283,20000,376283,0,274224,50000,224224,0,321787,30000,291787
22429,300000,240000,0,0,0,0,0,0,-2,0,0,0,-2,0,0,0,-2,0,0,0,-2,0,0,0
22430,140000,112000,0,1,0,0,0,0,0,131666,6200,125466,0,114989,4246,110743,0,81475,5000,76475,0,82812,3000,79812
22431,420000,336000,0,0,0,0,0,0,0,3360,2400,960,0,3343,100,3243,0,3091,62,3029,0,3578,1276,2302
22432,20000,16000,0,1,1,1,1,0,0,19573,1600,17973,0,19504,700,18804,0,19642,1000,18642,0,20128,1000,19128
22433,50000,40000,0,0,0,0,0,0,0,4533,2254,2279,0,4279,0,4279,2,4592,313,4279,0,0,0,0
22434,500000,400000,0,0,0,0,0,0,0,21803,21831,-28,-1,90182,90182,0,-1,79310,2500,76810,0,68380,2380,66000
22435,290000,232000,0,0,0,0,0,0,-1,0,0,0,-1,28974,28974,0,-1,7524,0,7524,0,0,0,0
22436,80000,64000,0,0,0,0,0,0,-1,825,0,825,2,825,825,0,-1,825,825,0,-1,825,825,0
22437,420000,336000,0,0,0,0,0,0,0,57706,3000,54706,0,55628,4000,51628,0,54797,2500,52297,0,52759,2000,50759
22438,140000,112000,0,0,0,0,0,0,0,18848,3000,15848,0,21209,3000,18209,0,25503,5000,20503,0,27918,3000,24918
22439,210000,168000,0,0,0,0,0,0,0,103733,3519,100214,0,102027,3442,98585,0,103453,3553,99900,0,103651,3625,100026
22440,300000,240000,0,0,0,0,0,0,0,18580,1000,17580,0,1400,1410,-10,-1,6297,6297,0,-1,977,0,977
22441,360000,288000,0,0,0,0,0,0,0,178030,9300,168730,0,117997,6000,111997,0,0,0,0,0,0,0,0
22442,300000,240000,0,0,0,0,0,1,3,390,1,389,2,769,769,0,-1,772,3,769,0,1722,1730,-8
22443,50000,40000,0,1,0,1,0,0,0,49348,2210,47138,0,28433,1946,26487,0,53718,983,52735,0,27084,1950,25134
22444,50000,40000,0,0,1,1,0,1,0,40893,1679,39214,0,81308,1640,79668,0,41463,1449,40014,0,40045,1454,38591
22445,100000,80000,0,0,0,0,0,0,0,46680,2000,44680,0,47926,2000,45926,0,49028,2001,47027,0,49561,2014,47547
22446,300000,240000,0,0,0,0,0,0,-2,8347,8361,-14,-2,10471,10490,-19,-2,9813,9828,-15,-2,10690,10698,-8
22447,20000,16000,0,0,0,0,0,1,-1,1170,1170,0,-1,780,0,780,0,0,0,0,0,0,0,0
22448,20000,16000,0,0,1,0,0,1,0,16739,1368,15371,0,17486,1115,16371,0,9392,301,9091,0,9587,310,9277
22449,80000,64000,0,0,0,0,0,0,0,39864,2500,37364,0,38934,2200,36734,0,38816,2000,36816,0,38850,2000,36850
22450,370000,296000,0,0,0,0,0,0,0,279467,10107,269360,0,262511,9410,253101,0,248101,8398,239703,0,243899,8464,235435
22451,80000,64000,0,0,0,0,0,1,0,18976,1316,17660,0,19660,1000,18660,0,20343,1000,19343,0,21003,1000,20003
22452,20000,16000,0,0,0,0,0,0,-1,8369,8369,0,-1,433,433,0,-1,1669,1669,0,-1,7800,7800,0
22453,170000,136000,0,0,0,0,0,0,0,59171,3000,56171,0,55888,2000,53888,0,53672,3000,50672,0,51461,3000,48461
22454,90000,72000,0,1,1,1,1,0,2,78252,3000,75252,2,78470,2100,76370,2,81056,4000,77056,2,82572,3001,79571
22455,230000,184000,0,0,0,0,0,1,-1,3465,3465,0,-1,0,0,0,-1,486,486,0,-1,634,634,0
22456,400000,320000,0,0,0,0,0,0,-1,13582,7276,6306,0,7272,7,7265,0,414,417,-3,-1,10799,10802,-3
22457,450000,360000,0,0,0,0,0,0,-1,6281,6281,0,-1,3446,3446,0,-1,6157,6157,0,-1,0,0,0
22458,310000,248000,0,0,0,0,0,0,-2,2109,2109,0,-2,14109,14109,0,-2,2109,2109,0,-2,2218,2218,0
22459,80000,64000,0,0,0,0,0,0,0,31026,2998,28028,2,31401,1183,30218,2,31986,1400,30586,2,32468,1139,31329
22460,350000,280000,0,0,0,0,0,0,-2,3015,3019,-4,-1,6980,4580,2400,0,8762,4000,4762,0,7532,284,7248
22461,30000,24000,0,1,1,1,1,1,2,26753,0,26753,2,30107,4100,26007,2,30614,900,29714,2,27190,0,27190
22462,580000,464000,0,0,0,0,0,0,0,255409,8842,246567,0,256321,7663,248658,0,250358,7814,242544,0,236608,7794,228814
22463,250000,200000,0,0,0,0,0,1,0,186166,10000,176166,0,189786,10000,179786,0,195130,10000,185130,0,198147,7300,190847
22464,170000,136000,1,1,0,0,0,0,0,180389,5573,174816,0,137030,4309,132721,0,129222,4239,124983,0,122229,5142,117087
22465,70000,56000,0,0,0,0,0,0,0,46581,4000,42581,0,47634,1829,45805,0,51305,4500,46805,0,52580,2100,50480
22466,220000,176000,0,1,1,0,0,1,3,198088,6000,192088,2,187000,0,187000,2,179703,14004,165699,2,174571,0,174571
22467,20000,16000,0,1,1,1,1,1,0,19368,0,19368,3,18759,0,18759,2,19131,683,18448,0,19533,709,18824
22468,50000,40000,0,0,0,0,0,0,2,28444,0,28444,2,28878,1100,27778,0,27655,1100,26555,0,24480,2000,22480
22469,50000,40000,0,0,0,0,0,0,0,17180,1500,15680,0,18811,2000,16811,0,18380,0,18380,2,19086,2000,17086
22470,200000,160000,0,0,0,0,0,0,0,136437,5014,131423,0,135253,5009,130244,0,134629,4844,129785,0,134309,5002,129307
22471,160000,128000,0,0,0,0,0,0,-1,7379,7379,0,-1,669,669,0,-1,21381,21581,-200,-1,200,0,200
22472,470000,376000,0,0,0,0,0,0,0,135683,5001,130682,0,128719,6010,122709,0,116173,4512,111661,0,104283,4012,100271
22473,30000,24000,0,0,0,0,0,0,0,17213,2002,15211,0,17723,1553,16170,0,17431,1002,16429,0,17882,2002,15880
22474,210000,168000,0,0,0,0,0,0,-1,291,291,0,-1,291,291,0,-1,441,441,0,-1,291,291,0
22475,170000,136000,0,0,0,0,0,1,-2,0,0,0,-2,0,0,0,-2,0,0,0,-2,0,0,0
22476,150000,120000,0,1,1,0,0,1,2,150963,6000,144963,0,152607,10000,142607,0,103113,4000,99113,0,96518,4000,92518
22477,240000,192000,0,0,0,0,0,1,-2,0,0,0,-2,0,0,0,-2,0,0,0,-2,0,0,0
22478,140000,112000,0,0,0,0,0,1,0,1934,5,1929,2,0,0,0,2,0,0,0,-2,0,0,0
22479,260000,208000,0,0,0,0,0,1,0,191813,9000,182813,0,193555,7100,186455,0,197090,7509,189581,0,200841,8000,192841
22480,60000,48000,0,0,0,0,0,1,0,18475,2100,16375,0,17919,0,17919,2,19167,1500,17667,2,18750,0,18750
22481,80000,64000,0,1,1,1,0,0,0,78748,3010,75738,0,76722,2700,74022,0,70370,2300,68070,0,64510,2500,62010
22482,50000,40000,0,1,0,0,0,1,0,46666,4050,42616,0,20162,676,19486,0,19864,730,19134,0,19680,866,18814
22483,270000,216000,0,0,0,0,0,0,-1,0,0,0,-2,1074,1074,0,-1,3292,3292,0,-1,2106,0,2106
22484,50000,40000,1,1,1,0,0,0,0,96860,2100,94760,0,48803,2600,46203,0,19324,1000,18324,0,19668,1000,18668
22485,60000,48000,0,0,0,0,0,0,-1,2175,2175,0,-1,3528,3528,0,-1,10260,10260,0,-1,6378,6378,0
22486,140000,112000,0,0,0,0,0,0,0,50768,2182,48586,0,50629,2041,48588,0,49974,1715,48259,0,49897,1982,47915
22487,50000,40000,0,0,0,0,0,0,0,38376,1323,37053,0,19595,840,18755,0,19851,713,19138,0,20256,727,19529
22488,50000,40000,0,0,0,0,0,0,2,400,0,400,2,400,0,400,4,400,0,400,4,400,0,400
22489,210000,168000,0,0,0,0,0,0,-1,106,106,0,-1,-10,0,-10,-1,-10,0,-10,-2,-10,0,-10
22490,50000,40000,0,0,0,0,0,0,0,3359,3359,0,-1,2158,1000,1158,0,2470,2470,0,-1,662,500,162
22491,20000,16000,0,0,0,0,0,1,2,-211,0,-211,2,1863,2253,-390,-1,390,0,390,0,390,390,0
22492,200000,160000,0,0,0,0,0,0,-2,4684,4687,-3,-2,2992,3051,-59,-2,7559,7559,0,-2,4967,4967,0
22493,50000,40000,0,1,0,0,0,0,0,50024,1712,48312,0,20281,705,19576,0,20285,759,19526,0,20066,748,19318
22494,100000,80000,0,1,1,0,0,0,0,99400,3803,95597,0,88037,3146,84891,0,59213,2514,56699,0,56651,3000,53651
22495,30000,24000,0,0,0,0,0,1,0,18146,5000,13146,0,0,0,0,0,0,0,0,-2,0,0,0
22496,180000,144000,0,0,0,0,0,0,-1,766,766,0,-1,316,316,0,-1,4356,4356,0,-1,316,316,0
22497,70000,56000,0,0,0,0,0,1,0,32017,1217,30800,0,17630,500,17130,0,9730,0,9730,0,6400,6400,0
22498,140000,112000,1,1,1,0,0,1,0,211542,7027,204515,0,132019,6032,125987,0,101731,4000,97731,0,108687,8700,99987
22499,500000,400000,0,0,0,0,0,0,-2,9390,9429,-39,-2,-3772,3423,-7195,-2,282777,291227,-8450,-1,288937,9011,279926
22500,260000,208000,0,0,0,0,0,0,0,161545,7503,154042,0,0,0,0,0,0,0,0,-2,0,0,0
22501,50000,40000,0,0,0,0,0,0,0,14774,3000,11774,0,14233,0,14233,2,14744,1000,13744,0,15252,1000,14252
22502,720000,576000,0,0,0,0,0,0,-2,1744,1744,0,-2,7323,7323,0,-2,711,711,0,-2,970,970,0
22503,80000,64000,0,0,0,0,0,0,0,38556,3000,35556,0,34345,3000,31345,0,36020,3000,33020,0,38420,3000,35420
22504,190000,152000,0,0,0,0,0,0,-2,0,0,0,-2,0,0,0,-2,0,0,0,-2,0,0,0
22505,100000,80000,0,1,1,1,1,1,4,95979,5900,90079,4,93580,0,93580,4,91181,0,91181,3,93563,4000,89563
22506,30000,24000,0,0,0,0,0,0,2,13785,1200,12585,2,13911,646,13265,2,13548,0,13548,2,14465,1300,13165
22507,80000,64000,0,0,0,0,0,0,0,49430,2113,47317,0,46864,3007,43857,0,46473,2000,44473,0,48191,3000,45191
22508,10000,8000,0,0,0,0,0,0,-1,4428,2000,2428,0,6368,2000,4368,0,9046,2780,6266,0,10000,2000,8000
22509,240000,192000,0,0,0,0,0,0,-1,0,0,0,-1,390,390,0,-1,780,780,0,-1,0,0,0
22510,130000,104000,0,0,0,0,0,1,-1,3738,3746,-8,-1,1396,1396,0,-1,13069,13069,0,-1,1285,1285,0
22511,190000,152000,0,1,1,0,0,0,2,185512,7791,177721,0,169728,4000,165728,0,143260,2865,140395,0,136901,40000,96901
22512,80000,64000,0,0,0,0,0,1,0,31875,1720,30155,0,18686,1002,17684,0,0,0,0,0,0,0,0
22513,70000,56000,0,1,1,1,1,1,0,61926,5000,56926,0,60332,0,60332,2,61658,2300,59358,0,65561,4950,60611
22514,200000,160000,0,0,0,0,0,0,0,72912,20000,52912,0,80819,10000,70819,0,84186,20000,64186,0,83710,10000,73710
22515,150000,120000,0,0,0,0,0,0,0,86565,5000,81565,0,85069,5003,80066,0,508,508,0,-1,0,0,0
22516,100000,80000,0,1,0,1,1,1,3,81265,0,81265,2,83012,3100,79912,0,84933,3300,81633,0,94362,11000,83362
22517,360000,288000,0,0,0,0,0,0,-1,2500,2500,0,-1,0,0,0,-1,0,0,0,-2,0,0,0
22518,180000,144000,0,0,0,0,0,0,-2,834,1200,-366,-1,-96,0,-96,-1,-96,0,-96,-2,-96,0,-96
22519,500000,400000,0,0,0,0,0,0,0,84741,43095,41646,0,72510,7522,64988,0,69053,9065,59988,0,64841,8841,56000
22520,60000,48000,0,0,0,0,0,1,0,6544,1111,5433,0,7093,660,6433,0,7973,1000,6973,0,9038,1200,7838
22521,500000,400000,0,0,0,0,0,0,-1,29944,29944,0,-1,10528,10528,0,-1,17907,17907,0,-1,3147,3147,0
22522,50000,40000,0,0,0,0,0,0,0,9816,1091,8725,0,9889,1000,8889,0,8765,1000,7765,0,9136,1000,8136
22523,20000,16000,0,0,0,0,0,0,0,7266,2100,5166,0,11282,1000,10282,0,3303,132,3171,0,2350,47,2303
22524,50000,40000,0,1,1,1,1,0,0,46331,2795,43536,0,47896,2750,45146,0,47266,1130,46136,0,48002,1314,46688
22525,290000,232000,0,0,0,0,0,0,0,106730,4539,102191,0,93882,3000,90882,0,91746,3500,88246,0,76547,3856,72691
22526,50000,40000,0,0,0,0,0,0,0,21751,1300,20451,0,20154,668,19486,0,16784,8000,8784,0,17352,1000,16352
22527,110000,88000,0,1,1,1,1,0,0,97307,5000,92307,0,99666,4000,95666,0,102082,4000,98082,0,105500,5000,100500
22528,140000,112000,0,0,0,0,0,0,-1,862,1075,-213,-1,1355,1355,0,-1,1130,1130,0,-1,21361,21361,0
22529,80000,64000,0,0,0,0,0,0,0,28783,2338,26445,0,30003,2000,28003,2,29385,0,29385,2,31401,2500,28901
22530,230000,184000,0,0,0,0,0,0,-2,0,0,0,-2,0,0,0,-2,596,596,0,-2,4870,4870,0
22531,240000,192000,0,0,0,0,0,0,3,192447,6000,186447,4,188156,0,188156,3,183299,0,183299,2,180090,9013,171077
22532,20000,16000,0,0,0,0,0,0,0,14561,1354,13207,0,15017,1200,13817,0,15119,302,14817,0,4077,82,3995
22533,30000,24000,0,0,0,0,0,0,-1,950,950,0,-1,0,0,0,-1,0,0,0,-2,0,0,0
22534,50000,40000,0,0,0,0,0,0,0,9273,1153,8120,0,9609,489,9120,0,9657,351,9306,0,9927,431,9496
22535,440000,352000,0,0,0,0,0,0,-2,0,0,0,-2,0,0,0,-2,0,0,0,-2,0,162000,-162000
22536,20000,16000,0,0,0,0,0,0,-1,12656,12656,0,-1,1693,1700,-7,-1,303,500,-197,-1,12303,12000,303
22537,260000,208000,0,0,0,0,0,0,0,39330,19342,19988,0,39880,15000,24880,0,78787,53787,25000,0,52790,22790,30000
22538,140000,112000,0,0,0,0,0,0,0,61998,10000,51998,0,63517,6500,57017,0,62463,3900,58563,0,62168,6700,55468
22539,340000,272000,0,0,0,0,0,1,0,203784,6618,197166,0,181490,5168,176322,0,154478,5014,149464,0,135259,5398,129861
22540,360000,288000,0,0,0,0,0,0,-2,0,0,0,-2,0,0,0,-2,0,0,0,-2,0,0,0
22541,80000,64000,0,0,0,0,0,1,2,29582,3500,26082,2,28852,0,28852,2,29464,1033,28431,0,28688,1502,27186
22542,80000,64000,0,0,0,0,0,0,0,49991,1920,48071,0,47681,2063,45618,0,46900,1543,45357,0,45161,1400,43761
22543,280000,224000,0,0,0,0,0,0,-2,0,0,0,-2,0,0,0,-2,710,710,0,-1,7611,7611,0
22544,70000,56000,0,0,0,0,0,0,0,60190,14494,45696,0,25126,6019,19107,0,24718,7010,17708,0,27726,8007,19719
22545,50000,40000,0,0,0,0,0,0,0,34789,2,34787,2,8671,500,8171,0,9550,1000,8550,0,8741,0,8741
22546,50000,40000,0,0,0,0,1,0,0,11151,3002,8149,0,-2897,1500,-4397,0,48211,52000,-3789,-1,48154,1900,46254
22547,170000,136000,0,0,0,0,0,0,-1,2200,2200,0,-1,7510,5510,2000,0,12510,5000,7510,0,19720,8100,11620
22548,150000,120000,0,0,0,0,0,0,0,35970,2049,33921,0,26727,0,26727,0,71112,63889,7223,0,63889,0,63889
22549,90000,72000,0,0,0,0,0,0,2,50781,1700,49081,2,51840,2200,49640,2,52607,1750,50857,2,53784,2200,51584
22550,160000,128000,0,1,1,1,1,0,0,139923,5000,134923,0,140815,5000,135815,0,139935,5000,134935,0,138912,5000,133912
22551,360000,288000,0,0,0,0,0,1,-2,0,0,0,-2,0,0,0,-2,0,0,0,-2,0,0,0
22552,210000,168000,0,1,1,0,0,0,0,207222,10646,196576,0,209189,8601,200588,0,106090,3601,102489,0,108300,3719,104581
22553,90000,72000,0,0,0,0,0,0,2,42520,2000,40520,2,42997,1800,41197,2,41698,0,41698,2,43976,3434,40542
22554,500000,400000,0,0,0,0,0,0,0,51006,6620,44386,0,44360,6015,38345,0,34229,10001,24228,0,37880,4137,33743
22555,180000,144000,0,0,0,0,0,1,-1,9199,9211,-12,-1,4745,4758,-13,-1,0,0,0,-1,0,0,0
22556,500000,400000,0,0,0,0,0,0,0,323101,19725,303376,0,296962,13091,283871,0,84615,5066,79549,0,267596,195829,71767
22557,90000,72000,0,0,0,0,0,0,0,48683,0,48683,2,44102,1312,42790,0,35577,1200,34377,0,28500,1070,27430
22558,100000,80000,0,0,0,0,0,0,0,81284,3439,77845,0,71748,2474,69274,0,67577,2400,65177,0,68217,2500,65717
22559,290000,232000,0,0,0,0,0,0,-2,123514,123514,0,-1,125973,4274,121699,0,128608,4426,124182,0,127976,4859,123117
22560,380000,304000,0,1,0,0,0,0,0,347667,13500,334167,0,304356,11000,293356,0,311458,12000,299458,0,299277,12000,287277
22561,450000,360000,0,0,0,0,0,0,-1,0,0,0,-2,0,0,0,-2,0,0,0,-2,0,0,0
22562,80000,64000,0,0,0,0,0,1,0,25443,3000,22443,0,28790,4000,24790,0,29929,1500,28429,0,23796,1000,22796
22563,60000,48000,0,0,0,0,0,0,0,35751,2015,33736,0,25824,2000,23824,0,25831,1000,24831,0,27393,2000,25393
22564,100000,80000,0,0,0,0,0,1,-2,0,0,0,-2,0,0,0,-2,0,0,0,-2,970,970,0
22565,60000,48000,0,0,0,0,0,0,0,27967,1500,26467,0,28526,1003,27523,0,28275,1500,26775,0,29151,1500,27651
22566,80000,64000,0,0,0,0,0,0,-1,12113,1000,11113,0,-33,33,-66,0,2748,2871,-123,-2,90,90,0
22567,350000,280000,0,0,0,0,0,0,0,119522,5900,113622,0,119947,5800,114147,0,117328,4100,113228,0,118400,4500,113900
22568,80000,64000,0,0,0,0,0,0,0,66725,2784,63941,0,21604,1882,19722,0,9352,1000,8352,0,9276,457,8819
22569,50000,40000,0,0,0,0,0,0,0,36103,5396,30707,0,29384,6,29378,2,29356,1003,28353,0,29089,1449,27640
22570,500000,400000,0,0,0,0,0,0,0,203537,15000,188537,0,167013,15000,152013,0,169395,15000,154395,0,171648,15000,156648
22571,30000,24000,0,1,1,1,1,0,2,29752,0,29752,2,27262,0,27262,0,27262,0,27262,0,24265,0,24265
22572,20000,16000,0,0,0,0,1,0,0,15683,3000,12683,0,16050,1000,15050,0,17401,2000,15401,0,17573,1000,16573
22573,50000,40000,0,0,0,0,0,0,-1,10057,2000,8057,0,9221,0,9221,0,8808,423,8385,0,3861,3861,0
22574,20000,16000,0,0,1,1,1,0,0,19980,19288,692,0,19983,681,19302,0,20066,917,19149,0,19855,1000,18855
22575,180000,144000,0,0,0,0,0,0,-2,0,0,0,-2,0,0,0,-2,7108,7108,0,-2,1300,1300,0
22576,20000,16000,0,1,1,1,1,0,0,21255,1600,19655,0,19105,1200,17905,0,19609,1000,18609,0,19283,900,18383
22577,70000,56000,0,1,0,0,0,0,0,68038,2518,65520,0,55193,1525,53668,0,27099,1000,26099,0,28298,2000,26298
22578,150000,120000,0,1,1,1,1,1,2,140830,8100,132730,2,146050,9000,137050,2,142241,0,142241,2,145559,5578,139981
22579,240000,192000,0,0,0,0,0,0,-2,1133,1133,0,-2,0,0,0,-2,39344,39344,0,-1,40264,1500,38764
22580,320000,256000,0,0,0,0,0,0,-2,1622,1622,0,-2,7728,7762,-34,-2,5781,5781,0,-2,3896,3896,0
22581,280000,224000,0,0,0,0,0,0,-2,0,0,0,-2,0,0,0,-2,0,0,0,-2,0,0,0
22582,260000,208000,0,0,0,0,0,0,0,214941,196000,18941,0,196242,6020,190222,0,193177,6330,186847,0,161731,6032,155699
22583,220000,176000,0,0,0,0,0,0,0,184198,15000,169198,0,171391,6000,165391,0,178742,10000,168742,0,164793,10000,154793
22584,100000,80000,0,1,1,0,0,0,0,95736,4000,91736,0,98679,5700,92979,0,67007,2507,64500,0,67485,2500,64985
22585,50000,40000,0,0,0,0,0,0,0,780,780,0,-1,0,0,0,-1,0,0,0,-2,0,0,0
22586,140000,112000,0,0,0,0,0,1,0,94370,3600,90770,0,95894,3258,92636,0,91600,3313,88287,0,93347,3258,90089
22587,320000,256000,0,0,0,0,0,0,-1,9433,9439,-6,-1,2490,2493,-3,-1,2655,2655,0,-1,1070,0,1070
22588,30000,24000,0,0,0,0,0,0,0,15461,1000,14461,2,16204,1000,15204,0,16642,700,15942,0,17067,700,16367
22589,250000,200000,0,0,0,0,0,0,0,169014,5945,163069,0,167776,5919,161857,0,168110,6000,162110,0,168505,6059,162446
22590,70000,56000,0,0,0,0,0,0,0,2330,1005,1325,0,1499,1002,497,0,1327,503,824,0,671,502,169
22591,170000,136000,0,0,0,0,0,0,0,89620,4400,85220,0,90797,3827,86970,0,47200,2200,45000,0,47707,2500,45207
22592,30000,24000,0,0,0,0,0,0,-1,630,630,0,-1,240,0,240,0,690,840,-150,-1,150,0,150
22593,20000,16000,0,0,1,1,1,1,2,17242,1400,15842,0,18448,1500,16948,0,19495,1500,17995,0,20026,1000,19026
22594,200000,160000,0,0,0,0,0,0,-2,1958,1968,-10,-2,-5,200,-205,-2,1013,1018,-5,-2,2350,2361,-11
22595,50000,40000,0,0,0,0,0,0,0,16816,1000,15816,0,602,602,0,-1,712,500,212,0,822,500,322
22596,50000,40000,0,0,0,0,0,1,0,19399,0,19399,2,19785,709,19076,0,20465,1000,19465,0,20877,750,20127
22597,90000,72000,0,0,0,0,0,0,0,63943,3489,60454,0,62327,1639,60688,0,55800,1136,54664,0,56800,1000,55800
22598,130000,104000,0,1,1,1,1,0,0,130745,8000,122745,0,127344,5000,122344,0,127809,4500,123309,0,119976,4500,115476
22599,110000,88000,0,0,0,0,0,0,-1,82293,2846,79447,0,78622,2755,75867,0,78430,2838,75592,0,78120,2808,75312
22600,200000,160000,0,0,0,0,0,0,-2,3410,3487,-77,-2,0,0,0,-2,0,0,0,-2,82150,85900,-3750
22601,160000,128000,0,0,0,0,0,0,-1,5030,5037,-7,-1,3181,3182,-1,-1,4998,5000,-2,-1,1250,1252,-2
22602,20000,16000,0,0,1,1,1,0,0,18428,15000,3428,0,19709,2000,17709,0,19833,1000,18833,0,19376,900,18476
22603,450000,360000,0,0,0,0,0,0,-1,0,0,0,-1,0,0,0,-2,0,0,0,-2,0,0,0
22604,20000,16000,0,1,1,0,0,0,0,18546,1463,17083,0,19283,1200,18083,0,14821,296,14525,0,0,0,0
22605,50000,40000,0,0,0,0,0,1,2,21204,6828,14376,2,21363,800,20563,2,20722,0,20722,2,22384,2000,20384
22606,470000,376000,0,0,0,0,0,0,-1,14509,14509,0,-1,21168,21168,0,-1,14501,0,14501,0,8726,1528,7198
22607,200000,160000,0,0,0,0,0,0,-2,17965,18000,-35,-2,9846,9900,-54,-2,13621,13650,-29,-2,10466,10500,-34
22608,200000,160000,0,0,0,0,0,0,-2,1452,1452,0,-2,6248,6248,0,-2,4112,4112,0,-2,0,0,0
22609,50000,40000,0,0,0,0,0,0,0,21081,1649,19432,0,21432,1000,20432,0,21933,1000,20933,0,22569,1000,21569
22610,50000,40000,0,1,1,1,1,0,0,44330,1800,42530,0,45404,1800,43604,0,46363,1700,44663,0,47630,2000,45630
22611,260000,208000,0,0,0,0,0,0,-1,0,0,0,-1,0,0,0,-2,0,0,0,-2,0,0,0
22612,230000,184000,0,0,0,0,0,1,-2,0,0,0,-2,0,0,0,-2,0,0,0,-2,0,0,0
22613,70000,56000,0,0,0,0,0,0,3,12114,1000,11114,2,13597,2000,11597,0,15060,2000,13060,0,16653,2000,14653
22614,220000,176000,0,0,0,0,0,0,0,141900,5160,136740,0,144764,5233,139531,0,147657,5278,142379,0,150749,5464,145285
22615,310000,248000,0,0,0,0,0,0,0,94484,5000,89484,0,95087,5000,90087,0,80331,6000,74331,0,66813,6000,60813
22616,80000,64000,0,0,0,0,0,0,-2,0,0,0,-2,19230,19230,0,-2,0,0,0,-2,0,0,0
22617,70000,56000,0,0,0,0,0,0,0,31179,5000,26179,0,28686,2000,26686,0,10806,3000,7806,0,11673,3000,8673
22618,50000,40000,0,0,1,1,1,0,2,43434,3900,39534,2,44316,1900,42416,2,45189,1900,43289,2,46214,1900,44314
22619,50000,40000,0,0,0,0,0,0,0,48751,10109,38642,0,37140,1514,35626,0,19535,1000,18535,0,19492,1000,18492
22620,100000,80000,0,0,0,0,0,0,0,38673,3000,35673,0,43014,5000,38014,0,48300,6000,42300,0,57497,10000,47497
22621,150000,120000,1,1,1,1,1,1,2,170405,14000,156405,2,176048,10048,166000,2,161874,0,161874,2,144124,5118,139006
22622,180000,144000,0,0,0,0,0,0,-1,3275,3284,-9,-1,2347,2354,-7,-1,3020,3029,-9,-1,2193,2199,-6
22623,100000,80000,0,0,0,0,0,1,0,33490,1564,31926,0,34926,2000,32926,0,35771,1426,34345,0,36366,1320,35046
22624,200000,160000,0,0,0,0,0,0,-1,29787,20000,9787,0,32040,3000,29040,0,7773,1000,6773,0,12681,5000,7681
22625,130000,104000,0,0,0,0,0,0,0,63766,3000,60766,0,65839,3000,62839,0,67908,3000,64908,0,63530,5000,58530
22626,220000,176000,0,0,0,0,0,1,-1,53895,54165,-270,-1,-105,0,-105,-1,20895,21000,-105,-1,20835,20940,-105
22627,60000,48000,0,1,1,0,0,0,0,60851,2317,58534,0,56113,2500,53613,0,30326,1100,29226,0,30038,1300,28738
22628,50000,40000,0,0,0,0,0,0,0,20718,1200,19518,0,24048,5000,19048,0,5017,5017,0,-1,3570,71,3499
22629,300000,240000,0,0,0,0,0,1,-2,4735,344467,-339732,-1,6186,6822,-636,-1,116,49,67,-1,14429,15000,-571
22630,120000,96000,0,0,0,0,0,0,0,19312,10000,9312,0,13262,5000,8262,0,16923,7000,9923,0,16903,5000,11903
22631,240000,192000,0,0,0,0,0,0,-1,651,651,0,-1,0,0,0,-1,127,127,0,-1,0,0,0
22632,90000,72000,0,0,0,0,0,1,2,64428,10000,54428,2,64767,2000,62767,2,65579,2000,63579,2,67328,3000,64328
22633,90000,72000,0,0,0,0,0,1,0,71536,3000,68536,0,72964,2411,70553,0,64487,2294,62193,0,65845,2383,63462
22634,150000,120000,0,0,0,0,0,0,-1,99,99,0,-1,45,45,0,-1,2928,2982,-54,-1,519,0,519
22635,200000,160000,0,0,0,0,0,0,-1,3165,3165,0,-1,0,0,0,-1,0,0,0,-2,0,0,0
22636,30000,24000,0,1,1,1,0,0,3,29634,4,29630,2,28174,1020,27154,0,27307,1110,26197,0,24449,989,23460
22637,140000,112000,0,1,0,0,0,0,0,122024,6723,115301,0,112367,4069,108298,0,67820,5000,62820,0,66595,3200,63395
22638,50000,40000,0,0,0,0,0,0,0,10240,2000,8240,0,170,170,0,-1,-220,0,-220,-1,390,1000,-610
22639,170000,136000,0,1,0,0,0,0,0,167008,7077,159931,0,131544,5000,126544,0,125652,5000,120652,0,127224,5000,122224
22640,180000,144000,0,0,0,0,0,0,0,125022,4525,120497,0,129079,6123,122956,0,130109,4644,125465,0,133714,5688,128026
22641,240000,192000,0,0,0,0,0,0,0,67528,2390,65138,0,64238,2311,61927,0,65521,2330,63191,0,65829,2392,63437
22642,100000,80000,0,0,0,0,0,1,2,123,0,123,2,7286,7286,0,-1,123,123,0,-1,123,123,0
22643,20000,16000,0,0,0,0,0,0,0,780,780,0,-1,780,0,780,0,0,0,0,0,0,0,0
22644,240000,192000,0,0,0,0,0,0,3,1291,10,1281,2,2740,2740,0,-1,2241,2241,0,-1,1060,0,1060
22645,450000,360000,0,0,0,0,0,0,0,23095,2012,21083,0,20776,1107,19669,0,6189,21,6168,0,2396,512,1884
22646,270000,216000,0,0,0,0,0,0,0,6511,3027,3484,0,49873,49935,-62,-1,44658,5021,39637,0,40703,2004,38699
22647,330000,264000,0,0,0,0,0,0,-1,0,0,0,-1,404,404,0,-1,404,0,404,2,24420,24420,0
22648,20000,16000,0,1,1,1,0,1,0,16473,0,16473,2,19004,3000,16004,0,19254,574,18680,0,16287,539,15748
22649,120000,96000,0,0,1,1,1,0,0,99051,4877,94174,0,99927,3625,96302,0,101541,3600,97941,0,103379,3751,99628
22650,50000,40000,0,0,0,0,0,0,0,20672,1600,19072,0,16336,1000,15336,0,16921,1000,15921,0,17489,1000,16489
22651,170000,136000,0,0,0,0,0,0,-1,15291,15291,0,-1,9085,182,8903,0,5801,116,5685,0,6603,6603,0
22652,60000,48000,0,1,1,0,0,0,0,61188,2464,58724,0,57459,1462,55997,0,26551,847,25704,0,24901,1007,23894
22653,80000,64000,0,0,0,0,0,0,2,3237,3237,0,-1,2760,2760,0,-1,914,914,0,-1,0,0,0
22654,10000,8000,0,0,0,0,0,0,-2,0,0,0,-2,0,0,0,-2,0,0,0,-2,0,0,0
22655,80000,64000,0,0,1,1,1,0,-1,68227,68227,0,-1,68040,2000,66040,0,69840,2000,67840,0,69840,0,69840
22656,360000,288000,0,0,0,0,0,0,-2,-31,0,-31,-2,-31,0,-31,-2,-31,0,-31,-2,-31,0,-31
22657,50000,40000,0,0,0,0,0,0,0,17403,5461,11942,0,17907,2872,15035,0,19000,1093,17907,0,18055,19055,-1000
22658,30000,24000,0,0,0,0,0,0,-1,821,821,0,-1,0,0,0,-1,0,0,0,-2,0,0,0
22659,120000,96000,0,0,0,0,0,0,0,85558,4000,81558,0,86491,3250,83241,0,88136,3195,84941,0,89886,3210,86676
22660,100000,80000,0,0,0,0,0,0,2,16432,0,16432,2,18019,2100,15919,2,17501,0,17501,2,18786,1500,17286
22661,100000,80000,0,0,0,0,0,0,0,36495,2905,33590,0,36910,1320,35590,0,37838,1522,36316,0,38457,1400,37057
22662,250000,200000,0,1,1,1,1,0,0,253610,9327,244283,0,234205,8362,225843,0,238892,9000,229892,0,252563,18244,234319
22663,430000,344000,0,0,0,0,0,1,-2,2320,2320,0,-2,0,0,0,-2,4139,4139,0,-2,0,1015,-1015
22664,200000,160000,0,0,0,0,0,1,-1,51040,0,51040,2,56205,6000,50205,2,54723,0,54723,2,58657,5000,53657
22665,140000,112000,0,0,0,0,0,0,-1,33788,33788,0,-1,-18,0,-18,-1,-18,0,-18,-2,-18,0,-18
22666,50000,40000,0,0,0,0,0,0,2,29261,3500,25761,2,28444,0,28444,2,28878,1100,27778,0,27655,1100,26555
22667,20000,16000,0,0,1,1,1,0,0,18210,2300,15910,0,19335,1721,17614,2,19715,1000,18715,2,20249,1000,19249
22668,70000,56000,0,0,0,0,0,1,2,38061,1649,36412,0,42545,5133,37412,0,43346,1800,41546,2,44105,1600,42505
22669,150000,120000,0,0,1,1,1,0,0,123087,4500,118587,0,124843,3700,121143,0,127431,3716,123715,0,130008,3768,126240
22670,300000,240000,0,0,0,0,0,0,-1,0,0,0,-2,0,0,0,-2,0,0,0,-2,0,0,0
22671,60000,48000,0,0,0,0,0,0,0,42025,8825,33200,0,41067,0,41067,3,40109,0,40109,2,42695,3400,39295
22672,160000,128000,0,0,0,0,0,0,-2,4200,4200,0,-2,2461,2461,0,-2,0,0,0,-2,0,0,0
22673,180000,144000,0,1,1,0,0,0,0,175867,6528,169339,0,159053,6500,152553,0,126688,5000,121688,0,122947,5000,117947
22674,170000,136000,0,0,0,0,0,0,0,64374,2430,61944,0,63936,2224,61712,0,60750,1957,58793,0,54248,1917,52331
22675,380000,304000,0,0,0,0,0,0,-1,3003,3012,-9,-1,69127,69294,-167,-1,33815,33827,-12,-1,115854,115860,-6
22676,50000,40000,0,0,0,0,0,0,0,26955,1447,25508,0,27647,1139,26508,0,28149,1100,27049,0,28940,1262,27678
22677,360000,288000,0,0,0,0,0,0,0,3501,1002,2499,0,328,328,0,-1,0,0,0,-1,770,770,0
22678,180000,144000,0,0,0,0,0,0,0,80269,5603,74666,0,66855,3,66852,2,67128,2504,64624,0,67257,2511,64746
22679,200000,160000,0,0,0,0,0,0,0,159513,15019,144494,0,150852,15000,135852,0,151996,15000,136996,0,147690,10000,137690
22680,30000,24000,0,0,0,0,0,0,-2,0,0,0,-2,0,0,0,-2,7463,7463,0,-2,6804,6804,0
22681,50000,40000,0,0,0,0,0,0,0,28709,3000,25709,0,28386,3548,24838,0,28361,2500,25861,0,28449,2000,26449
22682,380000,304000,0,0,0,0,0,0,0,226959,9500,217459,0,219918,8000,211918,0,203575,7200,196375,0,188774,6700,182074
22683,10000,8000,0,0,1,1,1,0,0,8830,1400,7430,0,9687,1162,8525,0,10025,500,9525,0,10400,600,9800
22684,30000,24000,0,1,1,1,1,1,2,29368,22,29346,2,27769,2000,25769,0,25999,1000,24999,0,26924,2000,24924
22685,200000,160000,0,1,0,0,0,0,0,190716,0,190716,2,132731,6000,126731,0,129960,40450,89510,0,66747,13000,53747
22686,150000,120000,0,0,0,0,0,0,-1,780,780,0,-1,7500,7500,0,-1,0,0,0,-1,0,0,0
22687,100000,80000,0,0,0,0,0,0,0,37813,2000,35813,0,38881,2001,36880,0,39634,1700,37934,0,40493,1650,38843
22688,450000,360000,0,0,0,0,0,0,0,0,0,0,-2,0,0,0,-2,0,0,0,-2,0,0,0
22689,20000,16000,0,0,0,0,0,0,0,13007,1827,11180,0,13590,1500,12090,0,13476,482,12994,0,15009,1750,13259
22690,50000,40000,0,0,0,0,0,0,0,8684,3109,5575,0,5983,2209,3774,0,4252,2000,2252,0,5034,2500,2534
22691,250000,200000,0,0,0,0,0,0,-1,3774,0,3774,2,4508,4508,0,-1,2916,2916,0,-1,4969,4969,0
22692,80000,64000,0,0,0,0,0,0,0,55875,2640,53235,0,7552,1056,6496,0,0,0,0,0,0,0,0
22693,100000,80000,0,0,0,0,0,1,0,56300,2825,53475,0,54288,5000,49288,0,25759,0,25759,2,25775,2000,23775
22694,30000,24000,0,0,0,0,0,1,0,12668,0,12668,2,15038,2905,12133,2,14502,0,14502,2,15501,1386,14115
22695,30000,24000,0,1,1,1,1,1,0,28920,1703,27217,0,27997,1001,26996,0,28378,1500,26878,0,29321,1845,27476
22696,70000,56000,0,0,0,0,0,0,0,38988,4000,34988,0,38192,1200,36992,0,28775,592,28183,0,16497,330,16167
22697,310000,248000,0,0,0,0,0,0,-1,10453,10453,0,-1,10115,202,9913,0,600,1098,-498,-1,1788,1788,0
22698,330000,264000,0,0,0,0,0,0,0,119672,4026,115646,0,95699,3507,92192,0,98424,5000,93424,0,101167,5000,96167
22699,30000,24000,0,0,0,0,0,1,2,10120,0,10120,2,11145,1200,9945,0,11368,408,10960,0,12186,1002,11184
22700,50000,40000,0,0,0,0,0,1,2,30827,2363,28464,2,31224,1200,30024,2,30587,0,30587,2,32763,2700,30063
22701,120000,96000,0,0,0,0,0,0,2,39247,0,39247,2,44412,9076,35336,0,23344,8788,14556,0,22892,1000,21892
22702,170000,136000,0,1,1,0,0,0,0,148362,6000,142362,0,142223,5012,137211,0,126060,5000,121060,0,123978,5000,118978
22703,210000,168000,0,0,0,0,0,1,-1,326,326,0,-1,326,326,0,-1,652,652,0,-1,326,0,326
22704,130000,104000,0,0,0,0,0,1,-1,2595,3000,-405,-1,1030,1000,30,-1,-1121,897,-2018,-1,-2452,0,-2452
22705,600000,480000,0,0,0,0,0,1,2,469703,18000,451703,0,447130,16000,431130,0,440982,16000,424982,0,434715,21000,413715
22706,180000,144000,0,0,0,0,0,0,0,48311,1734,46577,0,38221,1183,37038,0,33947,1174,32773,0,24731,1000,23731
22707,360000,288000,0,0,0,0,0,0,-1,20470,20470,0,-1,10357,207,10150,0,8540,0,8540,0,0,0,0
22708,400000,320000,0,0,0,0,0,0,-2,1290,1290,0,-1,1319,29,1290,0,694,0,694,0,697,3,694
22709,290000,232000,0,0,0,0,0,0,0,84836,3019,81817,0,82168,2818,79350,0,80299,3000,77299,0,77324,3199,74125
22710,80000,64000,0,0,0,0,0,0,-2,1151,1151,0,-2,10312,10312,0,-1,12238,12238,0,-1,8279,5000,3279
22711,70000,56000,0,0,0,0,0,1,0,50036,1794,48242,0,36908,2000,34908,0,29439,967,28472,0,19494,1000,18494
22712,210000,168000,0,0,0,0,0,0,-2,0,0,0,-2,0,0,0,-2,0,0,0,-2,8270,8270,0
22713,90000,72000,0,0,0,0,0,1,2,64288,2500,61788,2,65236,2600,62636,2,66639,2600,64039,2,67893,2500,65393
22714,70000,56000,0,1,0,0,0,1,0,80149,13489,66660,0,47735,7000,40735,0,48737,1771,46966,0,50225,2300,47925
22715,60000,48000,0,0,0,0,0,0,2,31123,3000,28123,0,34134,3638,30496,0,23552,0,23552,2,24020,1000,23020
22716,400000,320000,0,0,0,0,0,0,-1,2833,2833,0,-1,1162,1162,0,-1,325,325,0,-1,325,325,0
22717,210000,168000,0,0,0,0,0,1,-2,-163,0,-163,-2,-65167,5530,-70697,-2,-168,84332,-84500,-2,2999,21500,-18501
22718,30000,24000,1,1,1,1,1,1,7,33756,0,33756,6,32960,0,32960,5,31881,0,31881,4,31085,0,31085
22719,50000,40000,0,0,0,0,0,1,-1,390,390,0,-1,390,390,0,-1,390,390,0,-1,390,390,0
22720,210000,168000,0,0,0,0,0,1,-1,4056,4056,0,-1,65825,65825,0,-1,60803,1420,59383,0,56578,1132,55446
22721,300000,240000,0,0,0,0,0,0,-1,2263,2267,-4,-1,7412,7523,-111,-1,5113,5113,0,-1,4121,4121,0
22722,70000,56000,0,0,0,0,0,0,0,25922,0,25922,2,27177,2000,25177,0,28930,2200,26730,0,28329,0,28329
22723,50000,40000,0,1,1,1,1,0,2,43127,2000,41127,0,44210,1800,42410,0,45844,2500,43344,0,49869,5500,44369
22724,50000,40000,0,1,0,0,0,0,0,49225,2800,46425,0,18858,1610,17248,0,19166,918,18248,0,19834,1214,18620
22725,80000,64000,0,0,0,0,0,0,-1,1125,1125,0,-1,1613,1613,0,-1,0,0,0,-1,4811,4811,0
22726,60000,48000,0,0,0,0,0,1,-2,-2640,0,-2640,-2,1760,4400,-2640,-1,880,0,880,0,3110,3110,0
22727,50000,40000,0,0,0,0,0,0,0,41045,3030,38015,0,41532,2124,39408,0,18646,646,18000,0,19183,828,18355
22728,150000,120000,0,0,0,0,0,0,0,65366,20142,45224,0,62283,3759,58524,0,60942,7022,53920,0,55878,20000,35878
22729,190000,152000,0,0,0,0,0,0,-1,15571,15571,0,-1,14625,0,14625,0,28520,28520,0,-1,24920,0,24920
22730,230000,184000,0,0,0,0,0,0,-1,33151,20757,12394,0,0,0,0,0,0,0,0,-2,469,469,0
22731,50000,40000,0,1,0,0,0,0,2,48010,2000,46010,0,24331,1000,23331,0,25553,2000,23553,0,26733,2000,24733
22732,180000,144000,0,0,0,0,0,0,2,2400,0,2400,7,2400,0,2400,7,2400,0,2400,7,2400,0,2400
22733,130000,104000,0,0,0,0,0,0,-1,0,0,0,-1,631,631,0,-1,0,0,0,-1,427,427,0
22734,50000,40000,0,0,0,0,0,0,0,23177,1150,22027,0,8550,1200,7350,0,6373,1000,5373,0,5848,1000,4848
22735,70000,56000,0,0,0,0,0,1,2,22202,0,22202,2,24326,2500,21826,2,23636,0,23636,2,25350,2100,23250
22736,200000,160000,0,0,0,0,0,1,-1,0,0,0,-1,1115,1115,0,-1,1336,1336,0,-1,1878,1878,0
22737,90000,72000,0,0,0,0,0,1,0,14509,0,14509,2,15518,1555,13963,0,15563,600,14963,0,18289,3000,15289
22738,230000,184000,0,0,0,0,0,0,-2,0,0,0,-2,0,0,0,-2,0,0,0,-2,0,0,0
22739,20000,16000,0,1,1,1,1,0,2,18608,1502,17106,0,19138,822,18316,0,20690,2000,18690,0,20174,0,20174
22740,450000,360000,0,0,0,0,0,0,0,234421,90000,144421,0,240020,10517,229503,0,240016,8801,231215,0,223545,8265,215280
22741,210000,168000,0,0,0,0,0,0,-1,11305,11401,-96,-1,1368,1368,0,-1,2684,2684,0,-1,1397,1397,0
22742,50000,40000,0,0,0,0,0,0,0,29366,1442,27924,0,27737,982,26755,0,28318,1017,27301,0,28806,1277,27529
22743,250000,200000,0,0,0,0,0,1,2,32459,0,32459,2,34600,3000,31600,0,36539,2500,34039,0,38287,2500,35787
22744,110000,88000,0,0,0,0,0,0,-1,-153,0,-153,-1,6540,7009,-469,-1,632,632,0,-1,316,0,316
22745,50000,40000,0,1,0,0,0,1,0,42871,2001,40870,0,7606,500,7106,0,11267,4423,6844,0,14453,4000,10453
22746,50000,40000,0,0,0,0,0,0,0,8651,1143,7508,0,8824,316,8508,0,9008,326,8682,0,9187,328,8859
22747,30000,24000,0,0,0,0,0,0,0,8983,1079,7904,0,8141,239,7902,0,6422,209,6213,0,5187,206,4981
22748,190000,152000,0,0,0,0,0,1,0,155045,7000,148045,0,95145,3100,92045,0,86025,92101,-6076,-1,87836,3200,84636
22749,50000,40000,0,1,1,1,1,1,2,42838,1000,41838,3,43335,1500,41835,2,44220,1900,42320,2,45159,1800,43359
22750,30000,24000,0,0,0,0,0,0,-1,3530,3530,0,-1,0,0,0,-1,5960,5960,0,-1,0,0,0
22751,200000,160000,0,1,0,0,0,0,0,200662,10183,190479,0,-1528,1504,-3032,0,-1528,0,-1528,-2,-1504,24,-1528
22752,160000,128000,0,0,0,0,0,0,0,5711,3008,2703,0,6003,6023,-20,-1,3527,71,3456,0,127,0,127
22753,30000,24000,0,0,0,0,0,0,-1,1261,1261,0,-1,1261,1261,0,-1,1261,1261,0,-1,1261,1261,0
22754,20000,16000,0,0,0,0,0,1,0,4087,1748,2339,0,4339,500,3839,2,3288,0,3288,0,3288,0,3288
22755,90000,72000,0,0,0,0,0,0,0,21066,1494,19572,0,20422,600,19822,0,20327,1000,19327,0,13619,1000,12619
22756,190000,152000,0,1,1,1,1,1,2,172122,6100,166022,2,167858,0,167858,2,171192,6127,165065,0,174937,6503,168434
22757,200000,160000,0,0,0,0,0,0,-1,1170,780,390,2,780,0,780,0,0,0,0,0,390,390,0
22758,130000,104000,0,0,0,0,0,1,-2,0,0,0,-2,0,0,0,-2,0,0,0,-2,0,0,0
22759,20000,16000,0,1,1,1,1,0,0,19445,1274,18171,0,19831,660,19171,0,19473,752,18721,0,20009,906,19103
22760,20000,16000,0,0,0,0,0,0,2,390,0,390,2,780,780,0,-1,390,0,390,0,1735,1735,0
22761,100000,80000,0,0,0,0,0,1,-1,650,650,0,-1,325,0,325,0,647,647,0,-1,7706,7706,0
22762,500000,400000,0,0,0,0,0,0,-1,16205,16205,0,-1,21770,21976,-206,-1,60827,50000,10827,0,18524,7000,11524
22763,30000,24000,0,0,0,0,0,1,2,9988,0,9988,2,11708,1892,9816,2,11223,0,11223,2,12079,1042,11037
22764,190000,152000,0,0,0,0,0,0,0,106082,16027,90055,0,95645,9000,86645,0,89762,2919,86843,0,91835,3220,88615
22765,200000,160000,0,0,0,0,0,0,-1,11162,21162,-10000,-1,45607,45614,-7,-1,23359,23359,0,-1,25713,25713,0
22766,80000,64000,0,0,0,0,0,0,2,2336,0,2336,2,0,0,0,2,5471,5471,0,-1,5415,5415,0
22767,180000,144000,0,0,0,0,0,0,0,32552,1700,30852,0,34004,2000,32004,0,35792,2500,33292,0,36645,1600,35045
22768,180000,144000,0,0,0,0,0,0,0,23946,2000,21946,0,0,0,0,0,0,0,0,-2,0,0,0
22769,300000,240000,0,0,0,0,0,0,-2,7270,7286,-16,-2,2970,2978,-8,-2,2359,2369,-10,-2,8492,10011,-1519
22770,380000,304000,0,1,1,1,1,0,0,344460,0,344460,2,347754,12800,334954,0,334891,12500,322391,0,340728,12500,328228
22771,20000,16000,0,0,0,0,0,1,0,9618,2000,7618,0,10313,1000,9313,2,9863,0,9863,3,9558,0,9558
22772,30000,24000,0,0,0,0,0,0,0,20260,2000,18260,0,20626,1000,19626,0,21142,1000,20142,0,21790,1000,20790
22773,360000,288000,0,0,0,0,0,0,-1,1224,331,893,2,331,0,331,2,0,0,0,2,2757,2757,0
22774,40000,32000,0,0,0,0,0,1,0,13816,2013,11803,0,10291,319,9972,0,7441,415,7026,0,7435,266,7169
22775,20000,16000,1,1,1,1,1,1,4,21098,0,21098,3,20334,0,20334,2,19943,458,19485,0,19956,463,19493
22776,160000,128000,0,0,0,0,0,0,0,153258,29000,124258,0,29975,1200,28775,0,65683,69364,-3681,-1,53856,1600,52256
22777,360000,288000,0,0,0,0,0,1,-2,0,0,0,-2,0,0,0,-2,0,0,0,-2,0,0,0
22778,20000,16000,0,0,0,0,0,1,2,7678,500,7178,2,7318,0,7318,0,7458,500,6958,0,7598,500,7098
22779,250000,200000,0,1,1,1,1,0,0,223068,9000,214068,0,228051,9000,219051,0,233072,9000,224072,0,237879,9000,228879
22780,20000,16000,0,0,1,0,0,0,-1,19305,19305,0,-1,17748,355,17393,0,8269,0,8269,0,1074,1074,0
22781,60000,48000,0,0,0,0,0,0,0,7139,2420,4719,0,4254,0,4254,2,4855,800,4055,0,5355,1000,4355
22782,220000,176000,0,0,0,0,0,0,-1,11289,11289,0,-1,4887,4887,0,-1,3083,3083,0,-1,9401,10020,-619
22783,380000,304000,0,0,0,0,0,0,0,80080,5000,75080,0,81162,5000,76162,0,89571,10000,79571,0,96627,10000,86627
22784,10000,8000,0,0,1,1,1,1,0,8985,1149,7836,0,9164,328,8836,0,9356,340,9016,0,9593,393,9200
22785,80000,64000,0,0,0,0,0,0,-1,3446,3466,-20,-1,4969,4969,0,-1,0,0,0,-1,2650,2650,0
22786,210000,168000,0,0,0,0,0,0,0,65968,5000,60968,0,67307,2697,64610,0,46511,2000,44511,0,47583,2012,45571
22787,70000,56000,0,1,0,0,0,0,2,68607,2332,66275,0,27870,1751,26119,0,28219,1100,27119,0,28810,1034,27776
22788,150000,120000,0,0,0,0,0,0,-2,32702,32715,-13,-2,33459,33475,-16,-2,27800,27808,-8,-2,2261,2261,0
22789,150000,120000,0,0,0,0,0,0,0,141568,135332,6236,0,97990,2848,95142,0,96017,2330,93687,0,79743,2204,77539
22790,200000,160000,0,0,0,0,0,0,-1,18041,18090,-49,-1,4288,4288,0,-1,2270,2270,0,-1,467,467,0
22791,120000,96000,0,0,0,0,0,0,0,38472,2000,36472,0,39510,2000,37510,0,40873,2000,38873,0,42082,2000,40082
22792,50000,40000,0,0,0,0,0,1,2,1050,0,1050,3,1050,0,1050,3,1050,0,1050,3,1050,0,1050
22793,50000,40000,0,0,0,0,0,1,2,40686,1200,39486,0,7710,1000,6710,0,0,0,0,0,0,0,0
22794,80000,64000,0,0,0,0,0,0,-2,0,0,0,-2,0,0,0,-2,0,0,0,-2,2060,2060,0
22795,160000,128000,0,0,0,0,0,1,0,129237,4900,124337,0,90981,2807,88174,0,92580,2898,89682,0,77184,2713,74471
22796,80000,64000,0,1,1,0,0,0,0,72408,4573,67835,0,72832,3500,69332,0,46473,2000,44473,0,50329,5000,45329
22797,90000,72000,0,0,0,0,0,0,0,21836,30000,-8164,-1,11036,11036,0,-1,29836,19836,10000,0,986,986,0
22798,200000,160000,0,0,0,0,0,0,0,94564,18900,75664,0,95859,3000,92859,0,99593,4524,95069,0,101834,3084,98750
22799,310000,248000,0,0,0,0,0,0,0,87523,18088,69435,0,77902,5500,72402,0,82165,6300,75865,0,97298,17300,79998
22800,150000,120000,0,0,0,0,0,0,0,9243,3000,6243,0,10280,1500,8780,0,10637,527,10110,0,10916,600,10316
22801,180000,144000,0,0,0,0,0,0,0,119687,5018,114669,0,131725,21000,110725,0,134122,6000,128122,0,133961,6000,127961
22802,270000,216000,0,0,0,0,0,0,-1,0,0,0,-2,0,0,0,-2,3353,3353,0,-1,764,764,0
22803,100000,80000,0,0,0,0,0,0,-1,4714,4718,-4,-1,11642,11734,-92,-1,4897,4901,-4,-1,3722,3723,-1
22804,70000,56000,0,0,0,0,0,0,0,14259,3000,11259,0,15525,2000,13525,2,14772,0,14772,2,15380,1000,14380
22805,210000,168000,0,0,0,0,0,0,0,1230,1230,0,0,24531,24531,0,-1,24287,1003,23284,0,22683,479,22204
22806,50000,40000,0,0,0,0,0,0,-1,179,179,0,-1,10100,10100,0,-1,13285,13285,0,-1,5489,5489,0
22807,30000,24000,0,0,0,0,1,1,2,22043,0,22043,2,23367,2000,21367,0,24983,2000,22983,0,25437,1000,24437
22808,300000,240000,0,0,0,0,0,0,0,11915,6416,5499,0,8813,5800,3013,0,8292,6000,2292,0,13546,8900,4646
22809,100000,80000,0,0,0,0,0,0,-1,1967,1967,0,-1,5476,7142,-1666,-1,396,396,0,-1,811,811,0
22810,80000,64000,0,0,0,0,0,0,-1,6597,6597,0,-1,665,3465,-2800,-1,10117,10117,0,-1,0,0,0
22811,210000,168000,0,0,0,0,0,0,0,82810,5000,77810,0,78255,5000,73255,0,77816,5000,72816,0,81392,5000,76392
22812,200000,160000,0,0,0,0,0,0,0,158869,10000,148869,0,145723,7000,138723,0,139960,6000,133960,0,142193,5500,136693
22813,360000,288000,0,0,0,0,0,1,0,14250,3024,11226,0,13780,4004,9776,0,15077,4008,11069,0,14009,3008,11001
22814,210000,168000,0,0,0,0,0,0,-2,0,0,0,-2,4351,4351,0,-1,0,0,0,-1,6200,6200,0
22815,180000,144000,0,0,0,0,0,0,-1,8750,8750,0,-1,9931,9931,0,-1,0,0,0,-1,7760,7760,0
22816,20000,16000,0,1,1,1,1,1,2,19254,1298,17956,0,19456,1000,18456,0,19323,692,18631,0,19265,766,18499
22817,140000,112000,0,0,0,0,0,0,0,64072,5000,59072,2,62444,0,62444,2,67411,6000,61411,2,71144,5000,66144
22818,260000,208000,0,0,0,0,0,1,-2,0,0,0,-2,1930,1930,0,-1,4304,4304,0,-1,150,0,150
22819,30000,24000,0,0,0,0,1,0,-2,22015,22015,0,-1,22649,1000,21649,0,24583,2300,22283,0,25227,1200,24027
22820,370000,296000,0,0,0,0,0,0,-1,3788,100332,-96544,-1,9424,9456,-32,-1,2468,2468,0,-1,2468,2468,0
22821,20000,16000,0,0,0,0,0,0,-1,0,0,0,-1,228,228,0,-1,0,0,0,-1,0,0,0
22822,290000,232000,0,0,0,0,0,1,-1,1311,1317,-6,-1,1486,1493,-7,-1,1488,1495,-7,-1,1650,1657,-7
22823,150000,120000,0,0,0,0,0,0,0,62142,3000,59142,0,57777,2010,55767,0,51110,2000,49110,0,52284,2000,50284
22824,50000,40000,0,1,1,0,1,0,0,48868,1200,47668,0,49668,1000,48668,0,49780,40000,9780,0,49980,1000,48980
22825,200000,160000,0,0,0,0,0,0,-1,738,747,-9,-1,4152,4164,-12,-1,2866,2874,-8,-1,1414,1418,-4
22826,20000,16000,0,1,1,1,1,0,0,19431,1700,17731,0,20290,1500,18790,0,20293,700,19593,0,19665,750,18915
22827,180000,144000,0,0,0,0,0,0,-2,1540,1541,-1,-2,0,0,0,-2,0,0,0,-2,0,0,0
22828,50000,40000,0,0,0,0,0,0,-1,-42,0,-42,-1,13109,14109,-1000,-1,13266,1000,12266,0,13401,1000,12401
22829,320000,256000,0,0,0,0,0,0,-1,33968,34151,-183,-1,86024,86466,-442,-1,232017,232242,-225,-1,15622,3199,12423
22830,190000,152000,0,0,0,0,0,0,0,30144,1600,28544,0,31243,1600,29643,0,32719,2000,30719,0,33540,1500,32040
22831,30000,24000,1,1,1,1,1,0,2,36794,1820,34974,0,33991,1600,32391,0,30820,1012,29808,0,29323,2586,26737
22832,100000,80000,0,0,0,0,0,0,0,63028,2700,60328,0,43360,1712,41648,0,41906,1500,40406,0,42831,1600,41231
22833,290000,232000,0,0,0,0,0,0,-2,-582,0,-582,-2,-1164,0,-1164,-2,291,1455,-1164,-1,732,732,0
22834,150000,120000,0,0,0,0,0,0,0,2130,0,2130,2,2130,0,2130,0,32,0,32,0,-780,0,-780
22835,50000,40000,0,0,0,0,0,0,0,41728,2070,39658,0,41163,1505,39658,0,29408,1500,27908,0,30047,1242,28805
22836,250000,200000,0,0,0,0,0,0,0,70375,5023,65352,0,65085,5069,60016,0,54986,10037,44949,0,50848,5184,45664
22837,50000,40000,0,0,0,0,0,1,-1,0,0,0,-1,780,780,0,-1,0,0,0,-1,0,0,0
22838,20000,16000,0,0,1,1,1,0,0,18902,3000,15902,0,18768,663,18105,0,18650,676,17974,0,19175,834,18341
22839,350000,280000,0,0,0,0,0,0,-2,1440,1440,0,-2,27000,27000,0,-2,872,872,0,-2,12600,12600,0
22840,180000,144000,0,0,0,0,0,0,-2,0,0,0,-2,0,0,0,-2,0,0,0,-2,0,0,0
22841,30000,24000,0,0,0,0,0,0,-2,390,390,0,-2,390,390,0,-2,390,390,0,-2,0,0,0
22842,320000,256000,0,0,0,0,0,1,-1,500,0,500,2,0,0,0,2,0,0,0,-2,0,0,0
22843,20000,16000,0,0,0,0,0,0,-1,451,451,0,-1,-810,0,-810,-1,-420,780,-1200,-2,1320,2130,-810
22844,440000,352000,0,1,0,0,0,1,0,387948,14740,373208,0,354871,9655,345216,0,238196,6453,231743,0,200777,5478,195299
22845,50000,40000,0,0,0,0,0,0,0,29672,5000,24672,0,22365,1021,21344,0,12702,0,12702,0,4134,3000,1134
22846,200000,160000,0,0,0,0,0,0,-2,390,390,0,-2,390,390,0,-2,390,390,0,-2,390,390,0
22847,100000,80000,0,0,0,0,0,0,0,42351,1200,41151,0,43011,860,42151,0,43011,0,43011,0,28947,579,28368
22848,300000,240000,0,0,0,0,0,0,-2,0,694,-694,-2,0,0,0,-2,694,694,0,-1,394,0,394
22849,260000,208000,0,0,0,0,0,0,-1,85,85,0,-1,105,105,0,-1,80,80,0,-1,95,95,0
22850,50000,40000,0,0,0,0,0,1,0,29913,2000,27913,0,32417,3000,29417,0,31597,0,31597,2,33575,2500,31075
22851,70000,56000,0,0,0,0,0,0,0,25282,1819,23463,0,21858,509,21349,0,19171,539,18632,0,8443,2000,6443
22852,60000,48000,0,0,0,0,0,1,2,24404,0,24404,2,25212,1500,23712,0,28147,3500,24647,0,30152,2600,27552
22853,310000,248000,0,0,0,0,0,0,0,208505,100000,108505,0,150380,7000,143380,0,38551,10000,28551,0,42901,5000,37901
22854,20000,16000,0,1,1,1,1,0,4,18048,0,18048,3,18553,1000,17553,2,19465,1400,18065,3,16523,0,16523
22855,20000,16000,0,0,0,0,0,0,0,3259,1132,2127,0,2969,2000,969,0,0,0,0,0,0,0,0
22856,50000,40000,0,0,0,0,0,1,0,5420,0,5420,2,4104,1596,2508,0,1596,0,1596,0,1594,1594,0
22857,280000,224000,0,0,0,0,0,0,-1,832,832,0,-1,0,0,0,-1,832,832,0,-1,416,416,0
22858,30000,24000,0,1,0,0,0,1,2,29412,1331,28081,0,18587,49,18538,0,1558,5,1553,0,4681,5363,-682
22859,20000,16000,0,0,0,0,0,0,0,12999,0,12999,2,14456,1686,12770,0,16313,2089,14224,0,15766,0,15766
22860,150000,120000,0,1,1,1,1,1,0,125502,5000,120502,0,129589,6163,123426,0,133145,7200,125945,0,139322,10500,128822
22861,50000,40000,0,0,0,0,0,0,-1,493,493,0,-1,493,493,0,-1,493,493,0,-1,493,493,0
22862,340000,272000,0,0,0,0,0,0,0,274467,11019,263448,0,275341,9502,265839,0,280913,9579,271334,0,270448,9026,261422
22863,50000,40000,0,0,0,0,0,0,0,39336,2000,37336,0,10142,462,9680,0,10174,736,9438,0,9904,0,9904
22864,250000,200000,0,0,0,0,0,0,-1,1155,1155,0,-1,3582,3582,0,-1,580,580,0,-1,1398,1398,0
22865,20000,16000,0,0,0,0,0,0,2,1050,0,1050,3,1050,0,1050,3,1050,0,1050,3,1050,0,1050
22866,70000,56000,0,0,0,0,0,1,0,45492,2030,43462,0,45482,1800,43682,0,46371,2000,44371,0,47603,2000,45603
22867,50000,40000,0,0,0,0,0,0,0,32856,1660,31196,0,27438,1600,25838,0,4786,624,4162,0,768,768,0
22868,80000,64000,0,1,1,1,1,0,2,80300,6000,74300,2,75724,0,75724,2,77504,3000,74504,0,79715,3500,76215
22869,210000,168000,0,0,0,0,0,0,0,125469,7000,118469,0,103409,5000,98409,0,75498,4000,71498,0,72020,2447,69573
22870,50000,40000,0,0,0,0,0,1,-1,0,0,0,-1,0,0,0,-2,0,0,0,-2,0,0,0
22871,20000,16000,0,0,0,0,0,0,-1,390,390,0,-1,390,390,0,-1,390,390,0,-1,930,930,0
22872,220000,176000,0,0,0,0,0,0,2,158994,6300,152694,2,154506,0,154506,2,126399,5000,121399,0,129357,5000,124357
22873,20000,16000,0,1,1,1,1,1,3,21556,3700,17856,2,22824,1900,20924,4,22192,0,22192,5,21271,0,21271
22874,170000,136000,0,0,0,0,0,0,0,132615,5012,127603,0,131213,5000,126213,0,129293,4516,124777,0,128379,5000,123379
22875,80000,64000,0,1,1,0,0,0,0,78321,5001,73320,0,73731,2092,71639,0,39643,1218,38425,0,39457,1445,38012
22876,80000,64000,0,0,0,0,0,0,-1,1872,1872,0,-1,746,746,0,-1,746,0,746,0,4424,4424,0
22877,360000,288000,0,0,0,0,0,0,-1,1261,1261,0,-1,1261,1261,0,-1,1261,1261,0,-1,1261,1261,0
22878,200000,160000,0,0,0,0,0,0,-1,390,390,0,-1,390,390,0,-1,540,540,0,-1,770,770,0
22879,260000,208000,0,0,0,0,0,0,0,0,0,0,-2,0,0,0,-2,0,0,0,-2,0,0,0
22880,230000,184000,0,0,0,0,0,1,2,1100,1100,0,-1,0,0,0,-1,2119,2119,0,-1,0,0,0
22881,230000,184000,0,0,0,0,0,0,0,94489,4500,89989,0,93143,4114,89029,0,87654,3500,84154,0,90172,4000,86172
22882,10000,8000,0,0,0,0,1,1,0,0,1600,-1600,0,1170,1170,0,-1,9956,9956,0,-1,9992,282,9710
22883,230000,184000,0,0,0,0,0,1,-1,32450,20013,12437,0,17285,346,16939,0,9766,5000,4766,0,9981,8000,1981
22884,60000,48000,0,0,0,0,0,0,0,30389,1403,28986,0,24914,1500,23414,0,25408,908,24500,0,25941,941,25000
22885,100000,80000,0,1,1,1,1,1,0,97565,3500,94065,0,98561,3800,94761,0,103039,7500,95539,0,95803,0,95803
22886,260000,208000,0,0,0,0,0,0,-1,0,0,0,-1,0,0,0,-2,0,0,0,-2,0,0,0
22887,200000,160000,0,0,0,0,0,1,0,55285,3000,52285,0,57370,3000,54370,0,59454,3000,56454,0,63461,5000,58461
22888,20000,16000,0,0,0,0,0,0,-2,0,0,0,-2,0,0,0,-2,0,0,0,-2,0,0,0
22889,50000,40000,0,0,0,0,0,0,0,19306,1234,18072,0,19857,785,19072,0,20361,900,19461,0,20051,2800,17251
22890,100000,80000,0,0,0,0,0,1,2,35572,3200,32372,2,34700,0,34700,2,36942,2800,34142,2,36196,0,36196
22891,180000,144000,0,0,0,0,0,0,0,13093,2000,11093,0,14874,2000,12874,0,14339,0,14339,2,19068,5000,14068
22892,150000,120000,0,0,0,0,0,0,-1,3280,3280,0,-1,11167,11167,0,-1,15915,10000,5915,0,16268,686,15582
22893,60000,48000,0,0,0,0,0,0,0,40861,1718,39143,0,35638,3800,31838,0,32147,2000,30147,0,19796,2386,17410
22894,200000,160000,0,0,0,0,0,0,-1,9552,9588,-36,-1,4215,5135,-920,-1,3400,3487,-87,-1,3286,3295,-9
22895,160000,128000,0,0,0,0,0,0,0,17671,7804,9867,0,22121,7730,14391,0,40835,67296,-26461,-1,37471,1340,36131
22896,50000,40000,0,0,0,0,0,1,-2,400,400,0,-1,0,0,0,-1,600,600,0,-1,600,0,600
22897,30000,24000,0,0,0,0,0,0,0,14371,2000,12371,2,13843,0,13843,2,15611,2000,13611,2,15221,0,15221
22898,280000,224000,0,1,0,0,0,1,0,283396,17003,266393,0,213294,7657,205637,0,213384,7750,205634,0,213604,7861,205743
22899,30000,24000,0,1,1,1,1,1,0,28080,1844,26236,0,28836,1600,27236,0,28812,576,28236,0,29400,588,28812
22900,30000,24000,0,1,1,1,1,0,0,29327,1800,27527,0,27836,1136,26700,0,28423,1178,27245,0,29813,2430,27383
22901,360000,288000,0,1,0,0,0,0,0,315730,13738,301992,0,113412,5053,108359,0,2500,2500,0,-1,0,0,0
22902,20000,16000,0,0,0,1,1,1,2,5865,2000,3865,0,17935,13500,4435,0,19353,2500,16853,0,20094,2000,18094
22903,150000,120000,0,0,0,0,0,0,-1,1672,1672,0,-1,453,453,0,-1,2129,2129,0,-1,1414,1414,0
22904,70000,56000,1,1,1,0,0,1,0,70050,0,70050,2,70415,3000,67415,0,48405,1000,47405,0,46514,1500,45014
22905,120000,96000,0,0,0,0,0,1,-1,538,538,0,-1,3160,3160,0,-1,2928,100,2828,-1,2596,0,2596
22906,380000,304000,0,0,0,0,0,0,0,28749,2071,26678,0,14258,29,14229,0,7594,72,7522,0,190628,190710,-82
22907,50000,40000,0,0,0,0,0,0,0,36549,5016,31533,0,32665,4000,28665,0,20246,2000,18246,0,19968,2000,17968
22908,30000,24000,0,0,0,0,0,0,2,9528,1800,7728,2,9725,500,9225,2,9427,0,9427,2,10118,1000,9118
22909,50000,40000,0,0,0,0,0,0,0,0,0,0,0,0,0,0,-2,0,0,0,-2,0,0,0
22910,360000,288000,0,0,0,0,0,0,-2,77,77,0,-1,0,0,0,-1,0,0,0,-2,0,0,0
22911,130000,104000,0,1,0,0,0,0,0,132969,6000,126969,0,45584,1291,44293,0,46516,1319,45197,0,47455,1336,46119
22912,210000,168000,0,0,0,0,0,0,0,101393,10023,91370,0,89894,3047,86847,0,75652,2007,73645,0,54329,2086,52243
22913,280000,224000,0,0,0,0,0,0,0,145127,6918,138209,0,145571,7100,138471,0,115765,4388,111377,0,118190,4500,113690
22914,40000,32000,0,1,1,1,1,0,0,39951,2000,37951,0,40552,1526,39026,0,38935,1500,37435,0,40187,1900,38287
22915,100000,80000,0,1,1,1,1,0,-1,88498,4000,84498,0,90289,2600,87689,0,92485,3000,89485,0,95630,4000,91630
22916,340000,272000,0,0,0,0,0,0,-2,0,0,0,-2,0,0,0,-2,0,0,0,-2,0,0,0
22917,320000,256000,0,0,0,0,0,0,-1,15591,0,15591,2,39240,39424,-184,-1,28424,0,28424,2,25120,25120,0
22918,110000,88000,0,0,0,0,0,1,0,26549,0,26549,2,34222,9000,25222,0,44062,10700,33362,0,45036,1700,43336
22919,310000,248000,0,0,0,0,0,0,-2,3959,3964,-5,-2,205,205,0,-2,3199,3209,-10,-2,5104,5109,-5
22920,50000,40000,0,0,0,0,0,0,2,4273,1000,3273,0,0,0,0,0,6805,6805,0,-1,5554,2000,3554
22921,280000,224000,0,0,0,0,0,0,-1,176823,176823,0,-1,117686,117686,0,-1,36708,36708,0,-1,18126,363,17763
22922,180000,144000,0,0,0,0,0,0,-2,-10,0,-10,-2,5650,5660,-10,-1,-10,0,-10,-1,-10,0,-10
22923,50000,40000,0,0,0,0,0,0,0,26868,1800,25068,0,27059,1400,25659,0,27503,1000,26503,0,27045,1000,26045
22924,240000,192000,0,0,0,0,0,0,0,28480,3500,24980,0,30247,3000,27247,0,30122,982,29140,0,27437,3437,24000
22925,350000,280000,0,0,0,0,0,0,-1,5571,5594,-23,-1,10978,11024,-46,-1,9326,9317,9,0,13255,13321,-66
22926,500000,400000,0,0,0,0,0,0,-1,141204,25012,116192,0,160275,40022,120253,0,138067,3024,135043,0,117049,0,117049
22927,180000,144000,0,0,0,0,0,0,-1,16285,16370,-85,-1,9632,9676,-44,-1,15025,15098,-73,-1,53941,54207,-266
22928,170000,136000,0,0,0,0,0,0,0,54592,2104,52488,0,56128,3208,52920,0,57469,2998,54471,0,59669,3000,56669
22929,200000,160000,0,0,0,0,0,0,-1,86800,86804,-4,-1,84144,1820,82324,0,83699,29000,54699,0,121930,71439,50491
22930,290000,232000,0,0,0,0,0,0,0,34491,1200,33291,0,29657,593,29064,0,9134,200,8934,0,2383,5637,-3254
22931,20000,16000,0,0,0,0,0,1,-2,780,780,0,-1,780,0,780,2,0,0,0,2,0,0,0
22932,30000,24000,0,1,1,1,1,1,2,30428,1500,28928,0,30485,2700,27785,0,31012,1300,29712,2,30402,0,30402
22933,150000,120000,0,0,0,0,0,0,0,0,0,0,0,0,0,0,-2,0,0,0,-2,217,217,0
22934,70000,56000,0,0,0,0,0,0,-1,-1000,0,-1000,-1,11019,12019,-1000,-1,11632,1000,10632,0,7864,157,7707
22935,220000,176000,0,0,0,0,0,0,0,168041,7461,160580,0,163783,5809,157974,0,160806,5608,155198,0,158866,6500,152366
22936,320000,256000,0,0,0,0,0,0,0,151365,6000,145365,0,154025,5671,148354,0,157082,5700,151382,0,160217,5741,154476
22937,210000,168000,0,0,0,0,0,1,0,0,0,0,-2,0,0,0,-2,0,0,0,-2,0,0,0
22938,70000,56000,0,0,0,0,0,0,2,22496,1703,20793,0,22070,1000,21070,0,22101,1800,20301,0,20724,0,20724
22939,80000,64000,0,0,0,0,0,0,2,11254,2000,9254,2,10777,0,10777,2,12096,1500,10596,0,13895,2000,11895
22940,300000,240000,0,0,0,0,0,1,-2,0,0,0,-2,0,0,0,-2,0,0,0,-2,0,0,0
22941,150000,120000,0,0,0,0,0,0,-1,7002,6000,1002,0,0,0,0,0,0,0,0,-2,0,0,0
22942,180000,144000,0,0,0,0,0,0,-1,187,187,0,-1,176,180,-4,-1,188,200,-12,-1,187,187,0
22943,50000,40000,0,1,1,1,1,0,5,56623,10000,46623,4,55815,0,55815,8,55033,0,55033,7,53625,0,53625
22944,50000,40000,0,0,1,1,1,1,2,46295,42000,4295,2,46885,1600,45285,2,47535,1500,46035,2,45994,2000,43994
22945,150000,120000,0,0,0,0,0,0,-2,3260,3260,0,-2,0,0,0,-2,0,0,0,-2,1081,1081,0
22946,420000,336000,0,0,0,0,0,0,0,117835,4013,113822,0,112705,3822,108883,0,111357,4086,107271,0,108306,3800,104506
22947,20000,16000,0,0,0,0,0,1,2,1650,0,1650,4,1650,0,1650,4,1650,0,1650,4,1650,0,1650
22948,410000,328000,0,0,0,0,0,0,-2,11912,11912,0,-2,4922,4922,0,-2,766,766,0,-2,640,640,0
22949,150000,120000,0,0,0,0,0,0,-1,9809,3000,6809,0,8000,8100,-100,-1,800,800,0,-1,1072,2524,-1452
22950,500000,400000,0,0,0,0,0,0,0,49722,10000,39722,0,67909,20025,47884,0,61613,10000,51613,0,16932,20000,-3068
22951,60000,48000,0,0,0,0,1,0,3,249,0,249,2,0,0,0,2,58628,115800,-57172,-1,59550,2141,57409
22952,200000,160000,0,1,1,1,1,0,0,202381,7851,194530,0,172574,6400,166174,0,171795,6500,165295,0,170960,6537,164423
22953,70000,56000,0,0,0,0,0,0,0,17548,1355,16193,0,15864,1203,14661,0,14937,516,14421,0,12841,500,12341
22954,70000,56000,0,0,0,0,0,0,-2,45078,2000,43078,-2,6823,1000,5823,-1,28989,30848,-1859,-1,29059,975,28084
22955,50000,40000,0,0,0,0,0,0,2,41464,1970,39494,0,35334,1827,33507,0,26875,1044,25831,0,23338,993,22345
22956,60000,48000,0,0,0,0,0,0,0,18571,1500,17071,0,18118,1295,16823,0,16179,3655,12524,0,12919,330,12589
22957,280000,224000,0,0,0,0,0,0,-2,0,0,0,-2,0,0,0,-2,0,0,0,-2,0,0,0
22958,80000,64000,0,1,1,0,0,1,0,78713,3300,75413,0,80684,3600,77084,0,50400,1568,48832,0,50058,1625,48433
22959,50000,40000,0,0,0,0,0,0,0,27553,1445,26108,0,28101,993,27108,0,28690,1029,27661,0,28467,1054,27413
22960,240000,192000,0,0,0,0,0,0,-1,4578,1150,3428,0,5928,5928,0,-1,5619,3619,2000,0,13227,13227,0
22961,170000,136000,0,0,0,0,0,1,-1,1804,1804,0,-1,1804,1804,0,-1,3608,3608,0,-1,1804,0,1804
22962,130000,104000,0,0,0,0,0,0,0,68158,3500,64658,0,69208,3000,66208,0,54677,3000,51677,0,59601,10000,49601
22963,180000,144000,0,0,0,0,0,0,-2,3647,3653,-6,-2,1593,32,1561,-2,1228,0,1228,-2,1006,1006,0
22964,10000,8000,0,0,0,0,0,0,3,6744,500,6244,3,6977,500,6477,2,6593,242,6351,0,7481,1000,6481
22965,50000,40000,0,0,0,0,0,0,0,33967,1421,32546,0,28115,4295,23820,0,27529,0,27529,2,29896,3000,26896
22966,200000,160000,0,0,0,0,0,1,2,20838,3000,17838,2,20217,0,20217,2,22896,3000,19896,2,22400,0,22400
22967,230000,184000,0,0,0,0,0,0,0,43286,2500,40786,2,39215,0,39215,2,39814,3000,36814,0,40437,3000,37437
22968,390000,312000,0,0,0,0,0,0,-2,0,0,0,-2,609,609,0,-2,0,0,0,-2,0,0,0
22969,70000,56000,0,0,0,0,0,1,0,19346,1237,18109,0,15754,545,15209,0,15855,726,15129,0,15011,353,14658
22970,100000,80000,0,1,1,0,0,1,0,101023,3700,97323,0,93514,4148,89366,0,79361,6000,73361,0,77373,0,77373
22971,490000,392000,0,0,0,0,0,0,0,201666,7143,194523,0,205798,7306,198492,0,196698,6303,190395,0,190306,6429,183877
22972,30000,24000,0,0,0,0,0,1,2,18631,1312,17319,0,21319,3000,18319,0,20692,0,20692,3,21201,1000,20201
22973,50000,40000,0,1,0,0,0,0,2,48689,2000,46689,0,19773,900,18873,0,19931,900,19031,0,19237,1000,18237
22974,90000,72000,0,0,0,0,0,1,-1,390,390,0,-1,390,390,0,-1,390,390,0,-1,390,390,0
22975,30000,24000,0,0,0,0,0,1,0,18443,3000,15443,0,7138,1000,6138,0,7638,500,7138,0,5884,5884,0
22976,70000,56000,0,0,0,0,0,0,0,58486,3199,55287,0,29171,1267,27904,0,17725,642,17083,0,17693,651,17042
22977,10000,8000,0,0,1,1,1,0,0,9356,2680,6676,0,9533,477,9056,2,9233,0,9233,2,9295,360,8935
22978,360000,288000,0,0,0,0,0,0,-1,2011,2011,0,-1,1116,1116,0,-1,0,0,0,-1,0,0,0
22979,230000,184000,0,0,0,0,0,0,0,180639,10000,170639,0,180117,5000,175117,0,179717,0,179717,0,124117,5000,119117
22980,30000,24000,0,1,1,1,1,0,2,27332,0,27332,3,26597,0,26597,2,27512,1500,26012,0,57002,1600,55402
22981,20000,16000,0,0,0,0,0,0,0,10102,1200,8902,0,10452,500,9952,0,10907,1000,9907,0,10400,600,9800
22982,310000,248000,0,0,0,0,0,0,0,102306,5197,97109,0,93929,4000,89929,0,87681,5000,82681,0,73479,3980,69499
22983,170000,136000,0,0,0,0,0,0,2,0,0,0,2,0,0,0,-2,3955,3955,0,-1,1278,1278,0
22984,170000,136000,0,1,1,0,0,0,0,161445,7334,154111,0,152549,6699,145850,0,122948,4315,118633,0,120277,4410,115867
22985,250000,200000,0,0,0,0,0,1,-2,316,316,0,-2,316,316,0,-2,316,316,0,-2,316,316,0
22986,50000,40000,0,0,0,0,0,1,-1,0,0,0,-1,0,0,0,-2,0,0,0,-2,0,0,0
22987,20000,16000,1,1,1,1,1,0,0,21197,0,21197,3,20400,0,20400,2,20000,0,20000,0,20000,0,20000
22988,170000,136000,0,0,0,0,0,0,0,11779,2009,9770,0,79862,78417,1445,0,39617,8000,31617,0,34091,3000,31091
22989,440000,352000,0,0,0,0,0,0,-1,87426,87426,0,-1,171244,130007,41237,0,150897,3018,147879,0,117870,15000,102870
22990,290000,232000,0,0,0,0,0,0,0,190012,10295,179717,0,36223,2082,34141,0,-4724,4724,-9448,0,225276,230000,-4724
22991,80000,64000,0,0,0,0,0,0,0,56949,4000,52949,0,35684,3000,32684,0,10400,1000,9400,0,0,0,0
22992,50000,40000,0,0,0,0,0,1,0,7909,0,7909,2,9767,2000,7767,2,9466,0,9466,2,11300,2000,9300
22993,310000,248000,0,0,0,0,0,0,-1,56527,1306,55221,0,560,560,0,-1,300,300,0,-1,2381,2387,-6
22994,50000,40000,0,1,0,0,0,0,0,47368,1672,45696,0,9515,500,9015,0,9483,500,8983,0,9292,355,8937
22995,120000,96000,0,0,0,0,0,0,0,44742,5069,39673,0,33231,2805,30426,0,-1320,0,-1320,0,-660,0,-660
22996,120000,96000,0,1,1,1,0,0,0,104378,5200,99178,0,106651,5500,101151,0,108362,5000,103362,0,96168,5000,91168
22997,120000,96000,0,0,0,0,0,0,-1,246,246,0,-1,246,246,0,-1,246,246,0,-1,884,884,0
22998,380000,304000,0,0,0,0,0,0,0,303016,11095,291921,0,290019,11007,279012,0,294689,11000,283689,0,301491,12006,289485
22999,500000,400000,0,0,0,0,0,0,-2,98,98,0,-2,522,522,0,-2,285,285,0,-2,950,950,0
23000,500000,400000,0,0,0,0,0,0,-1,9957,49,9908,2,2253,2270,-17,-1,4402,4422,-20,-1,10340,10360,-20
23001,50000,40000,0,0,1,1,1,0,0,41590,1700,39890,0,42419,1519,40900,0,43307,1572,41735,0,44167,1580,42587
23002,110000,88000,0,0,0,0,0,0,-2,0,0,0,-2,0,0,0,-2,0,0,0,-2,0,0,0
23003,50000,40000,0,1,0,0,0,1,0,45090,1972,43118,0,19031,672,18359,0,19534,800,18734,0,19301,700,18601
23004,220000,176000,0,0,0,0,0,1,-1,5484,5511,-27,-1,5342,5368,-26,-1,5618,5646,-28,-1,5236,5262,-26
23005,80000,64000,0,0,0,0,0,1,0,45257,1722,43535,0,45981,1619,44362,0,46032,1665,44367,0,46192,1700,44492
23006,210000,168000,0,0,0,0,0,0,-1,17162,17213,-51,-1,12949,6015,6934,0,12023,2083,9940,0,7324,7360,-36
23007,50000,40000,0,1,1,0,0,0,0,49528,2005,47523,0,44768,1312,43456,0,40295,1614,38681,0,33088,1706,31382
23008,130000,104000,0,0,0,0,0,0,0,99001,4700,94301,0,88214,3200,85014,0,90167,3403,86764,0,90682,3300,87382
23009,150000,120000,0,0,0,0,0,1,0,119043,3868,115175,0,112072,2808,109264,0,113932,3037,110895,0,105706,2583,103123
23010,260000,208000,0,0,0,0,0,0,0,27086,5000,22086,0,27821,1137,26684,0,30767,5000,25767,0,29890,1085,28805
23011,210000,168000,0,0,0,0,0,0,-1,7838,7862,-24,-1,7139,7146,-7,-1,-320,0,-320,-1,-320,0,-320
23012,240000,192000,0,1,1,0,0,0,0,231284,8500,222784,0,239410,12036,227374,0,184094,8300,175794,0,101776,5000,96776
23013,120000,96000,0,0,0,0,0,0,-1,3938,3938,0,-1,1110,1110,0,-1,9848,9848,0,-1,3301,3301,0
23014,180000,144000,0,0,0,0,0,0,-2,0,0,0,-2,0,0,0,-2,0,0,0,-2,0,0,0
23015,70000,56000,0,0,0,0,0,0,-1,13155,4000,9155,0,3929,4000,-71,-1,1953,0,1953,2,967,1000,-33
23016,240000,192000,0,0,0,0,0,0,0,82907,4000,78907,0,84832,4000,80832,0,87123,4000,83123,0,85363,3000,82363
23017,140000,112000,0,0,0,0,0,0,-1,2281,2290,-9,-1,437,437,0,-1,1320,1320,0,-1,300,300,0
23018,50000,40000,0,0,0,0,0,1,2,26591,2700,23891,2,25865,0,25865,2,27667,2225,25442,2,28264,1200,27064
23019,500000,400000,0,0,0,0,0,0,0,43875,1800,42075,0,34003,1500,32503,0,33079,1500,31579,0,28257,2000,26257
23020,500000,400000,0,0,0,0,0,0,1,63010,20012,42998,1,64178,10036,54142,1,64992,15000,49992,0,50722,10000,40722
23021,20000,16000,0,1,1,1,1,0,0,20858,3215,17643,0,20202,0,20202,2,18950,780,18170,0,17709,640,17069
23022,50000,40000,0,0,0,0,0,0,-2,0,0,0,-2,0,0,0,-2,0,0,0,-2,0,0,0
23023,190000,152000,0,0,0,0,0,0,3,750,0,750,2,14724,14724,0,-1,919,0,919,-1,-3899,0,-3899
23024,120000,96000,0,0,0,0,0,0,-2,0,0,0,-2,0,0,0,-2,0,0,0,-2,0,0,0
23025,200000,160000,0,0,0,0,0,0,-2,500,500,0,-2,0,0,0,-2,0,0,0,-2,300,300,0
23026,80000,64000,0,0,0,0,1,1,0,65581,2333,63248,0,63939,2288,61651,0,65278,2369,62909,0,66578,2385,64193
23027,320000,256000,0,0,0,0,0,0,-1,13217,13289,-72,-1,17967,18064,-97,-1,-13,0,-13,-1,-13,0,-13
23028,50000,40000,0,1,1,1,1,0,0,43132,1653,41479,0,43995,1516,42479,0,43230,1530,41700,0,43334,2139,41195
23029,470000,376000,0,0,0,0,0,0,0,80388,4019,76369,0,75631,2019,73612,0,71464,2120,69344,0,65915,2096,63819
23030,80000,64000,0,0,0,0,0,0,0,47740,3300,44440,0,50100,6267,43833,0,0,0,0,0,0,0,0
23031,20000,16000,0,0,0,0,0,0,0,13659,1524,12135,0,13635,500,13135,0,13922,507,13415,0,14689,1000,13689
23032,450000,360000,0,0,0,0,0,0,0,56033,1500,54533,0,31126,2109,29017,0,18345,5000,13345,0,12836,1000,11836
23033,50000,40000,0,1,0,0,1,0,0,48675,2000,46675,0,40059,1436,38623,0,41411,2000,39411,0,42722,2000,40722
23034,170000,136000,0,0,0,0,0,0,0,57061,5050,52011,0,49734,6000,43734,0,14285,3561,10724,0,136394,139898,-3504
23035,210000,168000,0,0,0,0,0,0,-1,-12,0,-12,-1,-12,0,-12,-2,5884,5896,-12,-1,0,0,0
23036,30000,24000,0,1,1,1,1,1,0,30485,2700,27785,0,31012,1300,29712,2,30402,0,30402,2,30195,1117,29078
23037,170000,136000,0,0,0,0,0,0,0,133090,5090,128000,0,130937,4937,126000,0,134043,5043,129000,0,137023,5023,132000
23038,150000,120000,0,0,0,0,0,0,0,59202,2730,56472,0,60304,2680,57624,0,61650,2850,58800,0,0,0,0
23039,30000,24000,0,1,1,0,0,0,0,29480,1400,28080,0,29679,599,29080,0,16451,0,16451,0,0,0,0
23040,530000,424000,0,1,1,1,1,1,0,537543,25022,512521,0,541019,21003,520016,0,468571,18003,450568,0,478034,20000,458034
23041,50000,40000,0,0,0,0,0,1,-1,25600,0,25600,2,-400,0,-400,2,40000,20400,19600,-1,0,0,0
23042,70000,56000,0,1,0,0,0,0,0,66937,2501,64436,0,38521,1417,37104,0,34149,1500,32649,0,38819,5050,33769
23043,340000,272000,0,0,0,0,0,0,0,154170,14000,140170,0,135951,0,135951,2,123353,4000,119353,0,110723,4000,106723
23044,140000,112000,0,0,0,0,0,0,0,54760,24000,30760,0,55568,11200,44368,0,27922,10000,17922,0,46108,34762,11346
23045,80000,64000,0,0,0,0,0,0,0,36060,1740,34320,0,30470,1200,29270,0,18306,366,17940,0,7432,7432,0
23046,140000,112000,0,0,0,0,0,0,-1,11579,1154,10425,0,10165,1000,9165,0,13067,3067,10000,0,92743,80000,12743
23047,180000,144000,0,0,0,0,0,0,0,82809,2891,79918,0,81755,3755,78000,0,81316,2941,78375,0,81206,3206,78000
23048,200000,160000,0,0,0,0,0,0,0,73624,3304,70320,0,73928,3815,70113,0,72060,3004,69056,0,72393,3006,69387
23049,130000,104000,0,0,0,0,0,1,2,300,0,300,2,300,0,300,3,300,0,300,3,150,0,150
23050,450000,360000,0,0,0,0,0,0,-2,1158,1273,-115,-2,1103,1109,-6,-2,110,0,110,-2,187,187,0
23051,80000,64000,0,0,0,0,0,0,0,65771,3500,62271,0,28690,900,27790,0,29137,700,28437,0,29569,700,28869
23052,80000,64000,0,0,0,0,0,0,-1,13454,13454,0,-1,1807,1807,0,-1,3560,3560,0,-1,3337,3337,0
23053,230000,184000,0,0,0,0,0,0,-2,0,0,0,-2,0,0,0,-2,0,0,0,-2,0,0,0
23054,120000,96000,0,0,0,0,0,0,-1,316,316,0,-1,316,316,0,-1,632,632,0,-1,316,0,316
23055,270000,216000,0,0,0,0,0,0,-1,9842,9896,-54,-1,7931,7977,-46,-1,3412,17,3395,0,1035,1040,-5
23056,260000,208000,0,0,0,0,0,0,0,206742,10000,196742,0,255079,65500,189579,0,208755,10000,198755,0,196701,8000,188701
23057,120000,96000,0,0,0,0,0,0,-1,10863,10863,0,-1,1601,0,1601,0,1126,1126,0,-1,4802,4802,0
23058,360000,288000,0,0,0,0,0,1,-2,0,0,0,-2,0,0,0,-2,0,0,0,-2,0,0,0
23059,500000,400000,0,0,0,0,0,0,0,359522,13464,346058,0,362412,12821,349591,0,362550,15033,347517,0,359481,12788,346693
23060,230000,184000,0,0,0,0,0,0,-1,0,0,0,-2,4135,4135,0,-1,814,0,814,0,2294,2294,0
23061,350000,280000,0,0,0,0,0,0,0,30900,2000,28900,0,0,0,0,0,223,223,0,-1,223,223,0
23062,50000,40000,0,0,0,0,0,0,0,16997,1194,15803,0,13150,379,12771,0,8866,281,8585,0,7899,321,7578
23063,50000,40000,0,0,0,0,0,0,0,18664,0,18664,2,18416,368,18048,0,416,416,0,-1,416,416,0
23064,180000,144000,0,0,0,0,0,1,-2,0,0,0,-2,0,0,0,-2,0,0,0,-2,0,0,0
23065,100000,80000,0,1,1,1,1,1,2,102623,10000,92623,2,100090,0,100090,2,101511,4000,97511,0,103503,7816,95687
23066,400000,320000,0,0,0,0,0,0,-1,591,591,0,-1,13654,13662,-8,-1,45363,45363,0,-1,2640,2640,0
23067,360000,288000,0,0,0,0,0,0,-2,0,0,0,-2,0,0,0,-2,5640,5640,0,-1,0,0,0
23068,100000,80000,0,1,1,1,1,0,0,101670,3700,97970,2,98047,0,98047,2,101891,7500,94391,2,98173,0,98173
23069,50000,40000,1,1,0,0,0,1,0,60032,2018,58014,0,25443,1500,23943,0,19600,1000,18600,0,19405,1500,17905
23070,160000,128000,0,0,0,0,0,0,-1,396,396,0,-1,0,0,0,-1,792,793,-1,-1,1220,1220,0
23071,410000,328000,0,0,0,0,0,0,-1,6557,6645,-88,-1,16128,16141,-13,-1,7539,0,7539,0,5300,5300,0
23072,200000,160000,0,0,0,0,0,1,-1,4091,5029,-938,0,5463,5463,0,-1,4978,100,4878,0,975,975,0
23073,140000,112000,0,0,0,0,0,0,0,90165,5000,85165,0,91318,2000,89318,0,94847,4000,90847,0,35773,5000,30773
23074,240000,192000,0,0,0,0,0,1,-1,6649,15,6634,2,5149,0,5149,0,13750,7013,6737,-1,5777,0,5777
23075,230000,184000,0,0,0,0,0,0,-1,3433,3447,-14,-1,11449,11449,0,-1,2433,2433,0,-2,23832,23832,0
23076,50000,40000,0,1,0,1,1,1,0,42472,1948,40524,0,44810,11746,33064,0,45699,1635,44064,0,46675,1712,44963
23077,320000,256000,0,0,0,0,0,0,-1,46163,46185,-22,-1,1373,1387,-14,-1,6064,6094,-30,-1,2145,2155,-10
23078,230000,184000,0,0,0,0,0,0,-2,0,0,0,-2,0,0,0,-2,299,299,0,-2,338,338,0
23079,200000,160000,0,0,0,0,0,0,0,16304,1200,15104,0,14973,300,14673,0,20542,7000,13542,0,15810,8000,7810
23080,210000,168000,0,0,0,0,0,0,-1,5570,5570,0,-1,2285,2285,0,-2,0,0,0,-2,0,0,0
23081,340000,272000,0,0,0,0,0,0,-1,9452,9461,-9,-1,22630,22676,-46,-1,8819,8007,812,0,9327,9336,-9
23082,160000,128000,0,0,0,0,0,0,-2,706,1096,-390,-2,706,706,0,-2,316,316,0,-2,1096,1096,0
23083,410000,328000,0,0,0,0,0,0,0,40881,2616,38265,0,39008,2617,36391,0,47638,20000,27638,0,27519,1012,26507
23084,270000,216000,0,0,0,0,0,1,-1,1191,1191,0,-1,3691,3691,0,-1,3445,3445,0,-1,56264,56264,0
23085,80000,64000,0,1,1,1,1,1,2,71389,3100,68289,2,73788,4204,69584,2,74463,2790,71673,2,72834,0,72834
23086,100000,80000,0,0,0,0,0,0,-1,0,0,0,-1,780,780,0,-1,0,0,0,-1,0,0,0
23087,210000,168000,0,0,0,0,0,0,0,23204,1777,21427,0,19709,1577,18132,0,14418,0,14418,2,13366,1366,12000
23088,420000,336000,0,1,0,0,0,1,2,382620,15,382605,2,333210,13175,320035,0,324487,11700,312787,0,327615,11900,315715
23089,150000,120000,0,0,0,0,0,0,-1,839,839,0,-1,693,0,693,0,0,0,0,0,3975,3975,0
23090,290000,232000,0,0,0,0,0,0,0,153092,7521,145571,0,3804,3804,0,-1,155233,160897,-5664,-1,148003,5198,142805
23091,460000,368000,0,0,0,0,0,0,-1,2978,2978,0,-1,11402,11402,0,-1,12072,12802,-730,-1,7090,7090,0
23092,50000,40000,0,0,0,0,0,1,-2,0,0,0,-2,0,0,0,-2,0,0,0,-2,0,0,0
23093,190000,152000,0,0,0,0,0,0,0,10060,2000,8060,0,10633,1000,9633,2,11197,1000,10197,0,11907,1000,10907
23094,80000,64000,0,1,0,0,0,0,0,77700,4176,73524,0,58025,4000,54025,0,59527,3000,56527,0,60778,2141,58637
23095,170000,136000,0,0,0,0,0,0,0,31450,1789,29661,0,28229,652,27577,0,26422,798,25624,0,15081,1081,14000
23096,30000,24000,0,0,1,0,1,0,0,25098,1450,23648,0,26209,1500,24709,0,25325,1500,23825,0,26400,1500,24900
23097,130000,104000,0,0,0,0,0,1,2,87587,4200,83387,2,85428,0,85428,2,86251,3000,83251,0,88094,3100,84994
23098,150000,120000,0,0,0,0,0,0,0,37775,3473,34302,0,36390,1000,35390,0,390,390,0,-1,390,390,0
23099,200000,160000,0,0,0,0,0,0,2,110000,10000,100000,2,115000,5000,110000,2,120000,5000,115000,3,127640,7661,119979
23100,10000,8000,0,0,1,1,0,0,0,9106,1400,7706,0,9719,1000,8719,0,9917,198,9719,0,0,0,0
23101,60000,48000,0,0,0,0,0,0,0,39689,1900,37789,0,27736,962,26774,0,28420,1100,27320,0,29002,1023,27979
23102,190000,152000,0,0,0,0,0,0,-2,306,306,0,-1,306,0,306,0,306,0,306,0,0,0,0
23103,70000,56000,0,0,0,1,0,0,0,53109,2520,50589,0,53630,2000,51630,0,108596,2000,106596,0,55886,4058,51828
23104,120000,96000,0,0,0,0,0,0,-1,60702,2299,58403,0,58677,1919,56758,0,51549,1838,49711,0,46552,2200,44352
23105,80000,64000,0,0,0,0,0,0,2,24253,1100,23153,2,24562,1000,23562,2,25126,1100,24026,2,25476,906,24570
23106,210000,168000,0,0,0,0,0,0,0,6200,1000,5200,0,0,0,0,0,0,0,0,-2,0,0,0
23107,320000,256000,0,0,0,0,0,0,0,28637,8081,20556,0,24385,5072,19313,0,8559,6591,1968,0,3207,1223,1984
23108,100000,80000,0,0,0,0,0,0,2,25762,1700,24062,0,27848,3000,24848,0,66537,40000,26537,0,57506,2500,55006
23109,360000,288000,0,0,0,0,0,1,-2,590,593,-3,-1,-10,0,-10,-1,2162,2172,-10,-1,3528,3545,-17
23110,20000,16000,0,0,1,1,0,0,0,17160,1400,15760,0,16760,0,16760,0,16760,0,16760,0,0,0,0
23111,110000,88000,0,0,0,0,0,1,0,64477,0,64477,3,65413,2600,62813,2,66520,2300,64220,2,68270,3000,65270
23112,130000,104000,0,0,0,0,0,0,0,396,792,-396,-1,1552,1552,0,-1,776,0,776,0,776,776,0
23113,80000,64000,0,1,0,0,0,0,0,75814,7704,68110,0,49784,8700,41084,0,51408,3000,48408,0,48587,12900,35687
23114,60000,48000,0,0,0,0,0,0,-1,5784,5784,0,-1,5246,5246,0,-1,3760,3760,0,-1,11411,11411,0
23115,150000,120000,0,0,0,0,0,1,2,75239,3700,71539,2,71245,0,71245,2,69214,2000,67214,2,24036,0,24036
23116,60000,48000,0,0,0,0,0,1,0,37220,2000,35220,0,38253,2000,36253,0,39369,2000,37369,0,36592,1400,35192
23117,20000,16000,0,1,1,1,0,1,3,18849,1200,17649,2,17724,0,17724,2,17524,0,17524,0,0,0,0
23118,410000,328000,0,1,1,0,0,0,2,384242,15282,368960,2,343283,15164,328119,2,320407,12005,308402,0,328827,15000,313827
23119,150000,120000,0,0,0,0,0,0,-1,0,0,0,-1,0,0,0,-2,0,0,0,-2,0,0,0
23120,200000,160000,0,0,0,0,0,0,0,121893,30039,91854,0,109647,15019,94628,0,56157,10000,46157,0,37293,10000,27293
23121,360000,288000,0,0,0,0,0,0,-1,692,692,0,-1,41301,41303,-2,-1,10889,10893,-4,-1,2017,2017,0
23122,20000,16000,0,0,0,0,0,1,2,7891,1800,6091,2,8913,1300,7613,2,8624,0,8624,2,9628,1300,8328
23123,60000,48000,0,1,1,1,1,1,2,55887,0,55887,2,70562,20783,49779,2,71322,2500,68822,2,58821,0,58821
23124,90000,72000,0,0,0,0,0,0,-1,2135,2150,-15,-1,316,316,0,-1,3491,3491,0,-1,1716,1716,0
23125,70000,56000,0,0,0,0,0,0,-1,5284,2284,3000,0,5950,3000,2950,0,5296,5296,0,-1,5713,2000,3713
23126,50000,40000,0,0,0,0,0,0,0,28528,1900,26628,0,28102,1050,27052,0,25574,1000,24574,0,26524,2000,24524
23127,340000,272000,0,0,0,0,0,0,0,276519,10143,266376,0,251815,7190,244625,0,218706,6283,212423,0,165666,5208,160458
23128,500000,400000,1,1,1,1,1,1,2,519267,0,519267,2,518741,19000,499741,0,516139,19000,497139,0,514975,18000,496975
23129,170000,136000,0,0,0,0,0,0,-1,7912,3000,4912,0,12517,5000,7517,0,14151,3020,11131,0,12157,5000,7157
23130,50000,40000,0,1,0,0,0,0,0,40371,0,40371,2,19522,805,18717,0,19140,818,18322,0,17912,1000,16912
23131,180000,144000,0,0,0,0,0,0,0,36696,2000,34696,0,35813,1128,34685,0,37893,2500,35393,0,34661,0,34661
23132,200000,160000,0,1,0,0,0,0,0,176720,5870,170850,0,164729,5009,159720,0,162097,5543,156554,0,154016,6037,147979
23133,200000,160000,0,0,0,0,0,1,2,102663,0,102663,2,97090,3500,93590,0,98045,3500,94545,0,105253,9000,96253
23134,200000,160000,0,0,0,0,0,0,2,69167,2943,66224,0,69289,2301,66988,0,70333,2374,67959,0,70610,2500,68110
23135,140000,112000,0,1,1,1,1,0,0,147204,16000,131204,0,139896,0,139896,2,136922,5341,131581,0,130098,4830,125268
23136,180000,144000,0,0,0,0,0,0,0,82451,3900,78551,0,83201,3400,79801,0,77081,5600,71481,0,74441,0,74441
23137,90000,72000,0,0,0,0,0,0,-2,59483,59483,0,-2,3065,26665,-23600,-2,854,854,0,-2,2328,2334,-6
23138,50000,40000,0,0,0,0,0,1,0,21899,2100,19799,0,20895,2000,18895,0,11241,1000,10241,0,-861,0,-861
23139,390000,312000,0,0,0,0,0,0,0,157388,10054,147334,0,123706,4242,119464,0,115813,4346,111467,0,112143,5000,107143
23140,400000,320000,0,0,0,0,0,0,-1,2026,2026,0,-1,8686,8686,0,-1,8526,8526,0,-1,4041,4041,0
23141,80000,64000,0,1,0,0,0,0,0,74908,3200,71708,0,41646,2230,39416,0,29297,1300,27997,0,30057,1410,28647
23142,360000,288000,0,0,0,0,0,0,-1,0,0,0,-1,742,742,0,-1,0,0,0,-1,0,0,0
23143,80000,64000,0,0,0,0,0,0,-1,60,0,60,2,5182,5182,0,-1,2792,0,2792,0,189,0,189
23144,150000,120000,0,1,1,1,1,0,0,147624,7500,140124,0,138636,10600,128036,0,146609,11200,135409,0,149438,5400,144038
23145,150000,120000,0,0,0,0,0,0,2,990,990,0,-1,990,990,0,-1,990,990,0,-1,1980,1980,0
23146,210000,168000,0,0,0,0,0,0,-1,63527,63000,527,0,32088,20000,12088,0,16731,5000,11731,0,62561,52343,10218
23147,180000,144000,0,0,0,0,0,0,0,85805,4100,81705,0,87462,4010,83452,0,89162,4000,85162,0,91609,4000,87609
23148,210000,168000,0,0,0,0,0,0,0,173694,7798,165896,0,163481,12246,151235,0,128216,5268,122948,0,113292,5000,108292
23149,50000,40000,0,0,0,0,0,0,0,14125,2000,12125,0,18025,4000,14025,0,9063,2000,7063,0,10747,2000,8747
23150,60000,48000,0,0,0,0,0,0,0,29219,1760,27459,0,29036,1200,27836,0,29493,1500,27993,0,29776,1367,28409
23151,160000,128000,0,0,0,0,0,0,0,135778,12501,123277,0,132505,4700,127805,2,124622,0,124622,2,127646,9500,118146
23152,200000,160000,0,0,0,0,0,0,2,200,200,0,2,200,0,200,-2,18370,18370,0,-2,53276,53276,0
23153,20000,16000,0,1,0,0,0,0,0,18421,1000,17421,0,7032,7200,-168,-1,0,0,0,-1,1000,1000,0
23154,50000,40000,0,0,0,0,0,0,-1,5140,1000,4140,0,5140,5140,0,-1,5140,5140,0,-1,5140,5140,0
23155,150000,120000,0,0,0,0,0,0,-2,0,0,0,-2,0,0,0,-2,0,0,0,-2,0,0,0
23156,50000,40000,0,0,0,0,0,0,-2,0,0,0,-2,1000,1000,0,-1,0,0,0,-1,0,0,0
23157,150000,120000,0,0,0,0,0,0,0,7408,1284,6124,0,8147,1271,6876,0,8054,426,7628,0,7819,283,7536
23158,300000,240000,0,0,0,0,0,0,-1,1049,1057,-8,-2,-25,0,-25,-2,-25,0,-25,-2,-25,0,-25
23159,30000,24000,0,0,0,0,0,0,-1,11428,11500,-72,-1,2462,2462,0,-1,3605,1559,2046,-1,1559,0,1559
23160,110000,88000,0,0,0,0,0,1,2,416,0,416,2,416,416,0,-1,416,416,0,-1,416,416,0
23161,50000,40000,0,0,0,0,0,0,0,26775,1800,24975,0,0,0,0,0,0,0,0,-2,0,0,0
23162,120000,96000,0,0,0,0,0,0,-2,0,0,0,-2,0,0,0,-2,9310,9310,0,-1,0,0,0
23163,50000,40000,0,0,0,0,0,1,-1,3787,0,3787,2,3246,1000,2246,0,1473,0,1473,0,390,390,0
23164,130000,104000,0,0,0,0,0,0,0,4950,1012,3938,0,-2490,0,-2490,0,-37594,0,-37594,-2,-21295,0,-21295
23165,150000,120000,0,0,0,0,0,0,0,105266,4030,101236,0,51456,1500,49956,0,35288,706,34582,0,29818,1000,28818
23166,10000,8000,0,1,1,1,1,1,2,9654,0,9654,2,10348,1000,9348,2,10044,0,10044,2,10009,515,9494
23167,280000,224000,0,0,0,0,0,0,0,0,0,0,0,0,0,0,-2,0,0,0,-2,1047,1047,0
23168,180000,144000,0,0,0,0,0,0,0,42128,6000,36128,0,39654,10000,29654,0,42954,15000,27954,0,22543,23000,-457
23169,60000,48000,0,1,0,0,0,0,2,58748,0,58748,2,49375,2100,47275,0,38433,1600,36833,0,38378,1600,36778
23170,200000,160000,0,0,0,0,0,0,0,139978,8039,131939,0,126213,5112,121101,0,93788,5000,88788,0,94875,5008,89867
23171,200000,160000,0,0,0,0,0,1,0,98897,4300,94597,0,94943,3300,91643,0,96967,3361,93606,0,99016,3500,95516
23172,280000,224000,0,0,0,0,0,0,-2,2057,2707,-650,-1,650,3,647,2,3072,3072,0,2,3330,3330,0
23173,20000,16000,0,0,1,1,0,0,0,18206,3124,15082,0,17482,0,17482,2,34862,349,34513,0,14860,297,14563
23174,30000,24000,0,1,1,1,1,1,2,25682,0,25682,2,26155,1200,24955,0,27972,2400,25572,0,27374,0,27374
23175,180000,144000,0,0,0,0,0,0,0,59932,3010,56922,0,52382,2010,50372,0,40661,1200,39461,0,32385,1000,31385
23176,180000,144000,0,0,0,0,0,0,-1,0,0,0,-2,1012,1012,0,-1,0,0,0,-1,669,669,0
23177,50000,40000,0,0,0,0,0,0,0,4390,1000,3390,0,19206,19206,0,-1,20486,1500,18986,-1,15252,0,15252
23178,150000,120000,0,0,0,0,0,1,-2,0,0,0,-2,0,0,0,-2,0,0,0,-2,0,0,0
23179,150000,120000,0,0,0,0,0,0,-1,0,0,0,-2,0,0,0,-2,0,0,0,-2,11694,11694,0
23180,150000,120000,0,0,0,0,0,0,0,21332,1700,19632,0,22371,1700,20671,0,22700,1000,21700,0,23184,1000,22184
23181,450000,360000,0,0,0,0,0,0,-2,907,911,-4,-2,882,886,-4,-2,968,972,-4,-2,1243,1249,-6
23182,20000,16000,0,1,1,1,0,1,0,20434,1200,19234,2,19874,1000,18874,2,19546,400,19146,0,0,0,0
23183,320000,256000,0,0,0,0,0,0,0,96574,11550,85024,0,104795,11688,93107,0,113156,12122,101034,0,121465,12156,109309
23184,140000,112000,0,0,0,0,0,0,-1,17685,17725,-40,-1,36603,36621,-18,-1,27886,0,27886,0,7659,7847,-188
23185,70000,56000,1,1,1,1,1,0,2,71489,0,71489,3,68981,0,68981,2,66577,2500,64077,0,71013,5500,65513
23186,200000,160000,1,1,1,1,1,0,2,210315,8000,202315,0,206563,9000,197563,0,202896,8000,194896,0,173111,7000,166111
23187,20000,16000,0,1,1,1,1,0,0,18374,1700,16674,0,19222,1500,17722,0,18014,1000,17014,0,18627,1000,17627
23188,120000,96000,0,0,0,0,0,1,2,60584,0,60584,3,63871,4900,58971,2,62251,0,62251,3,63443,2500,60943
23189,150000,120000,0,0,0,0,0,1,2,76652,0,76652,2,77688,2800,74888,0,79440,3000,76440,0,81126,3000,78126
23190,50000,40000,0,0,0,0,0,0,0,11656,1542,10114,0,5435,1100,4335,0,6337,1000,5337,0,7227,1000,6227
23191,200000,160000,0,0,0,0,0,0,-2,-433,0,-433,-2,8567,9000,-433,-1,17363,17363,0,-1,0,0,0
23192,80000,64000,0,1,1,1,1,1,0,76649,0,76649,2,81845,7500,74345,2,80021,0,80021,2,82334,4200,78134
23193,120000,96000,0,1,1,1,0,1,2,119820,0,119820,2,124755,8500,116255,2,99423,0,99423,2,101718,11345,90373
23194,150000,120000,0,0,0,0,0,0,0,107782,5081,102701,0,84743,6041,78702,0,78804,3023,75781,0,76584,4049,72535
23195,280000,224000,0,0,0,0,0,0,-2,4734,4734,0,-2,0,0,0,-2,1420,1420,0,-2,2705,2705,0
23196,100000,80000,0,1,1,0,0,0,0,97051,0,97051,2,98342,4100,94242,0,56639,3000,53639,0,57388,2500,54888
23197,40000,32000,0,0,1,0,0,1,0,34610,3000,31610,0,35326,1500,33826,2,23489,0,23489,2,11762,1000,10762
23198,260000,208000,0,0,0,0,0,0,-1,3953,3953,0,-1,3953,3953,0,-1,16466,16466,0,-1,14246,2000,12246
23199,220000,176000,0,0,0,0,0,0,0,44179,2500,41679,0,44704,2000,42704,0,44997,2000,42997,0,45199,3000,42199
23200,70000,56000,0,0,0,0,0,0,-1,603,603,0,-1,2288,2288,0,-1,1380,1380,0,-1,2028,2028,0
23201,440000,352000,0,0,0,0,0,0,0,169622,6323,163299,0,169140,5700,163440,0,152404,4800,147604,0,138447,4000,134447
23202,240000,192000,0,0,0,0,0,0,0,185654,7722,177932,0,181350,9000,172350,0,186501,8000,178501,0,187457,7000,180457
23203,200000,160000,0,0,0,0,0,0,-2,1540,1540,0,-1,0,0,0,-1,3045,3045,0,-1,0,0,0
23204,320000,256000,0,0,0,0,0,0,-1,1021,1026,-5,-1,953,957,-4,-1,868,868,0,-1,872,4,868
23205,130000,104000,0,1,0,0,0,1,0,118536,3572,114964,0,34394,3153,31241,0,66701,69200,-2499,-1,58437,2500,55937
23206,80000,64000,0,0,0,0,0,1,2,326,326,0,-1,326,326,0,-1,326,326,0,-1,326,326,0
23207,20000,16000,0,0,0,0,0,1,-1,0,0,0,-2,0,0,0,-2,0,0,0,-2,0,0,0
23208,20000,16000,0,0,0,0,0,0,0,11557,1500,10057,0,12546,1500,11046,0,9900,800,9100,0,1000,1500,-500
23209,30000,24000,0,1,1,1,1,1,2,27504,3000,24504,2,26987,1000,25987,2,26927,1300,25627,2,25553,0,25553
23210,50000,40000,0,0,0,0,0,0,-1,0,0,0,-2,0,0,0,-2,0,0,0,-2,0,0,0
23211,220000,176000,0,0,0,0,0,0,0,174680,7500,167180,0,61523,2369,59154,0,61415,2000,59415,0,61982,2078,59904
23212,90000,72000,0,0,0,0,0,0,-1,6190,6246,-56,-1,307,307,0,-1,2870,2870,0,-1,670,670,0
23213,200000,160000,0,0,0,0,0,0,0,152601,6700,145901,0,105588,5500,100088,0,73886,4500,69386,0,198487,127600,70887
23214,100000,80000,0,0,0,0,0,0,0,65302,3200,62102,0,73056,10000,63056,0,74034,10000,64034,0,44825,10000,34825
23215,230000,184000,0,0,0,0,0,0,0,142377,7000,135377,0,143828,5356,138472,0,143698,5400,138298,0,143342,5200,138142
23216,280000,224000,0,0,0,0,0,0,-1,5525,5549,-24,-1,0,0,0,-1,21339,21339,0,-1,607,607,0
23217,40000,32000,0,0,0,0,0,0,0,32680,2000,30680,0,23472,1000,22472,0,25436,3000,22436,0,34309,10000,24309
23218,340000,272000,0,0,0,0,0,0,0,5129,1129,4000,0,3142,1052,2090,0,3210,120,3090,0,4153,1000,3153
23219,220000,176000,0,0,0,0,0,0,-2,3054,3054,0,-2,4701,4701,0,-2,2869,2869,0,-2,3654,3654,0
23220,60000,48000,1,1,1,1,1,0,0,180162,5162,175000,0,190202,10202,180000,0,209923,19923,190000,0,55491,1591,53900
23221,330000,264000,0,0,0,0,0,0,0,63646,3300,60346,0,39894,3195,36699,0,39860,3000,36860,0,39392,1120,38272
23222,20000,16000,0,0,0,0,0,0,0,12643,1290,11353,0,13447,1094,12353,0,8199,1000,7199,0,8416,316,8100
23223,390000,312000,0,0,0,0,0,0,-2,1630,1630,0,-1,1871,1871,0,-1,2400,2400,0,-1,3480,3480,0
23224,80000,64000,0,1,1,1,1,0,0,82036,3725,78311,0,82031,3722,78309,0,81535,3228,78307,0,81586,3281,78305
23225,50000,40000,0,0,0,0,0,0,0,19722,1532,18190,0,19644,1002,18642,0,18687,1006,17681,0,18033,2004,16029
23226,120000,96000,0,1,0,0,0,0,0,102228,4474,97754,0,75558,2647,72911,0,47536,1367,46169,0,44749,1322,43427
23227,420000,336000,0,0,0,0,0,0,-1,28690,28824,-134,-1,13310,13367,-57,-1,3539,3547,-8,-1,2926,2936,-10
23228,490000,392000,0,0,0,0,0,0,-2,1610,1618,-8,-2,1231,1237,-6,-2,1419,1426,-7,-2,14143,14214,-71
23229,100000,80000,0,0,0,0,0,0,0,71053,3169,67884,0,70405,3002,67403,0,71109,2022,69087,0,73905,3907,69998
23230,50000,40000,0,0,0,0,0,0,0,20401,1600,18801,0,17510,600,16910,0,18038,771,17267,0,16145,1000,15145
23231,50000,40000,0,0,0,0,0,0,2,35365,2077,33288,0,15426,2000,13426,0,17157,2000,15157,0,21842,5000,16842
23232,50000,40000,0,0,0,0,0,0,0,16118,1243,14875,0,14237,1492,12745,0,14381,636,13745,0,16026,2000,14026
23233,200000,160000,0,1,1,0,0,0,0,174199,5443,168756,0,173102,6000,167102,0,152178,5500,146678,0,129082,5000,124082
23234,30000,24000,0,1,1,1,1,0,0,28151,2000,26151,0,28827,1500,27327,0,29412,1000,28412,0,26199,1000,25199
23235,250000,200000,0,0,0,0,0,0,0,0,0,0,-2,0,0,0,-2,0,0,0,-2,0,0,0
23236,160000,128000,0,0,0,0,0,1,0,-183,0,-183,0,-218,0,-218,-2,-218,0,-218,-2,-218,0,-218
23237,230000,184000,0,0,0,0,0,0,0,15221,3000,12221,0,16501,3000,13501,0,10283,1000,9283,0,9086,1000,8086
23238,300000,240000,0,0,0,0,0,0,-2,0,0,0,-2,0,0,0,-2,6536,6536,0,-1,1400,1400,0
23239,80000,64000,0,0,0,0,0,0,0,5958,1000,4958,0,11341,11360,-19,-1,5259,486,4773,0,4278,478,3800
23240,130000,104000,0,0,0,0,0,1,2,95477,4500,90977,0,95334,3500,91834,0,96066,3400,92666,0,97413,4000,93413
23241,210000,168000,0,0,0,0,0,0,-1,316,316,0,-1,316,316,0,-1,316,316,0,-1,876,876,0
23242,50000,40000,0,0,0,0,0,0,0,9714,1000,8714,2,9047,0,9047,2,8983,1000,7983,0,9289,1000,8289
23243,40000,32000,0,1,1,1,1,0,0,37089,0,37089,2,39464,3000,36464,2,38698,0,38698,2,40051,2000,38051
23244,50000,40000,1,1,1,0,0,0,0,53164,2176,50988,0,46575,2064,44511,0,26609,1098,25511,0,27178,2134,25044
23245,180000,144000,0,0,0,0,0,0,-1,27315,27392,-77,-1,13315,13315,0,-1,8194,9000,-806,-1,12800,12800,0
23246,20000,16000,0,0,0,0,0,0,0,10510,1149,9361,0,10472,501,9971,0,10140,356,9784,0,10101,507,9594
23247,100000,80000,0,0,0,0,0,0,0,32498,4652,27846,0,0,0,0,0,0,0,0,-2,21648,21648,0
23248,470000,376000,0,0,0,0,0,0,-2,5603,5910,-307,-2,11685,13380,-1695,-2,5093,5093,0,-2,2791,2791,0
23249,280000,224000,0,0,0,0,0,0,-1,1504,1504,0,-1,0,0,0,-1,0,0,0,-2,2949,2949,0
23250,20000,16000,0,0,0,0,0,0,-1,390,390,0,-1,390,390,0,-1,540,540,0,-1,930,780,150
23251,340000,272000,0,0,0,0,0,0,0,256908,11750,245158,0,260462,9325,251137,0,265927,9665,256262,0,271766,10274,261492
23252,30000,24000,0,1,1,1,1,1,2,27474,3400,24074,2,27926,1200,26726,2,27189,0,27189,2,28604,2500,26104
23253,20000,16000,0,1,1,1,1,1,0,18384,1314,17070,0,18976,1296,17680,0,18955,665,18290,0,18983,710,18273
23254,80000,64000,0,1,0,0,0,0,0,71977,2502,69475,0,56023,2205,53818,0,47582,1702,45880,0,48039,1800,46239
23255,110000,88000,0,0,0,0,0,0,0,6144,2000,4144,0,7628,2000,5628,0,7111,1000,6111,0,7981,2000,5981
23256,70000,56000,0,0,0,0,0,0,0,29705,1595,28110,0,29012,775,28237,0,28355,1000,27355,0,16579,600,15979
23257,200000,160000,0,0,0,0,0,0,0,18556,2000,16556,0,19247,1000,18247,0,19935,1000,18935,0,21098,1500,19598
23258,20000,16000,0,0,0,0,0,0,-1,3042,3042,0,-1,0,0,0,-1,8402,8402,0,-1,6204,0,6204
23259,210000,168000,0,0,0,0,0,0,-1,1220,1220,0,-1,5357,5357,0,-1,4160,4160,0,-1,0,0,0
23260,170000,136000,0,0,0,0,0,0,0,84897,3111,81786,0,82608,3000,79608,0,84388,3100,81288,0,86096,3101,82995
23261,500000,400000,0,0,0,0,0,0,0,44277,2200,42077,0,46605,3500,43105,0,35766,0,35766,2,26175,1100,25075
23262,110000,88000,0,0,0,0,0,0,0,8164,2000,6164,0,10895,3000,7895,0,13503,3000,10503,0,16227,3000,13227
23263,250000,200000,0,0,0,0,0,0,0,90937,3317,87620,0,87445,3023,84422,0,84268,2937,81331,0,80762,2931,77831
23264,20000,16000,0,1,1,1,1,0,0,18163,1400,16763,0,19146,1300,17846,0,18331,700,17631,0,18736,700,18036
23265,350000,280000,0,0,0,0,0,0,0,36578,9000,27578,0,37717,10000,27717,0,58311,30000,28311,0,58467,9000,49467
23266,80000,64000,0,0,0,0,0,0,-2,0,0,0,-2,0,0,0,-2,0,0,0,-2,0,0,0
23267,80000,64000,0,0,0,0,0,0,-2,390,780,-390,-2,390,390,0,-2,740,740,0,-2,552,552,0
23268,300000,240000,0,0,0,0,0,0,-1,179,179,0,-1,1576,1579,-3,-1,497,1,496,0,-3,0,-3
23269,200000,160000,0,0,0,0,0,0,0,136183,8500,127683,0,127438,3500,123938,0,124816,3000,121816,0,92037,25000,67037
23270,210000,168000,0,0,0,0,0,0,-1,10347,11188,-841,-1,20198,20564,-366,-1,2960,3486,-526,-1,976,976,0
23271,10000,8000,0,0,0,1,1,0,0,7479,1272,6207,0,8489,1282,7207,0,9007,800,8207,0,9227,500,8727
23272,480000,384000,0,0,0,0,0,0,-2,67306,20496,46810,-1,19895,34,19861,-1,23650,23682,-32,-1,12616,29,12587
23273,190000,152000,0,0,0,0,0,0,-1,15951,15990,-39,-1,332,332,0,-1,0,0,0,-1,0,0,0
23274,10000,8000,0,0,0,0,0,0,0,8810,1172,7638,0,7637,1000,6637,0,6307,500,5807,0,4877,400,4477
23275,390000,312000,0,0,0,0,0,0,-1,0,0,0,-1,0,0,0,-2,123,123,0,-1,0,0,0
23276,360000,288000,0,0,0,0,0,1,-2,1935,1952,-17,-2,1205,1219,-14,-2,1320,1326,-6,-2,1068,1073,-5
23277,90000,72000,0,0,0,0,0,0,-1,421,0,421,2,2754,2833,-79,-1,309,1000,-691,-1,159,0,159
23278,200000,160000,0,0,0,0,0,0,-1,2868,0,2868,2,9470,9470,0,-1,5816,5834,-18,-1,7809,7809,0
23279,330000,264000,0,0,0,0,0,0,0,211831,7507,204324,0,153841,6000,147841,0,156866,6171,150695,0,155679,6000,149679
23280,100000,80000,0,0,0,0,0,0,0,-5000,0,-5000,0,-5000,0,-5000,-2,-5000,0,-5000,-2,-5000,0,-5000
23281,230000,184000,0,0,0,0,0,0,-1,1836,1836,0,-1,2274,2283,-9,-1,0,0,0,-1,21166,21166,0
23282,200000,160000,0,0,0,0,0,0,2,15463,3027,12436,0,17314,6223,11091,0,14245,0,14245,0,0,0,0
23283,180000,144000,0,0,0,0,0,0,0,40213,2000,38213,0,41702,2000,39702,0,43687,2500,41187,0,44982,2000,42982
23284,160000,128000,0,0,0,0,0,0,-1,4888,4890,-2,-1,4187,1010,3177,0,8995,8998,-3,-1,9731,2005,7726
23285,50000,40000,0,1,0,0,1,0,0,44530,2006,42524,0,40206,1632,38574,0,46538,7177,39361,0,47311,1701,45610
23286,10000,8000,0,0,1,0,0,0,-1,8589,1224,7365,0,9365,1000,8365,0,7740,175,7565,0,1000,0,1000
23287,400000,320000,0,0,0,0,0,0,0,26717,26862,-145,-1,25434,3000,22434,0,6973,2000,4973,0,9899,3000,6899
23288,350000,280000,0,0,0,0,0,0,-2,147437,6000,141437,-1,135043,5000,130043,0,137980,4000,133980,0,138908,4017,134891
23289,470000,376000,0,0,0,0,0,0,0,82718,3500,79218,0,85334,4000,81334,0,87948,4000,83948,0,90479,4000,86479
23290,100000,80000,0,0,0,0,0,0,0,75428,3100,72328,0,76450,3050,73400,0,77503,3000,74503,0,64119,2300,61819
23291,240000,192000,0,0,0,0,0,0,-1,2135,0,2135,2,3305,3305,0,-1,0,0,0,-1,5370,5370,0
23292,70000,56000,0,0,0,0,0,0,0,23755,1508,22247,0,23835,588,23247,0,25221,1500,23721,0,25780,700,25080
23293,110000,88000,0,0,0,0,0,0,0,250,450,-200,-1,3100,3100,0,-1,0,0,0,-1,0,0,0
23294,20000,16000,0,0,0,0,0,1,2,1200,0,1200,2,1200,0,1200,5,1200,0,1200,5,600,0,600
23295,20000,16000,0,1,0,1,0,0,0,18175,2000,16175,0,19000,3005,15995,0,20000,2000,18000,0,0,0,0
23296,90000,72000,0,0,0,0,0,0,-1,1613,1617,-4,-1,993,996,-3,-1,7881,7904,-23,-1,1516,1521,-5
23297,60000,48000,0,1,0,0,0,0,0,56106,3015,53091,0,29270,5000,24270,0,29412,2000,27412,0,29798,3000,26798
23298,240000,192000,0,0,0,0,0,0,-2,2396,2613,-217,-1,4657,5076,-419,-1,2452,2464,-12,-1,2418,2428,-10
23299,70000,56000,0,0,0,0,0,0,0,25323,2000,23323,0,25829,2000,23829,0,26589,1500,25089,0,16776,1000,15776
23300,360000,288000,0,0,0,0,0,0,0,6722,2000,4722,0,8605,4000,4605,0,28405,20000,8405,0,-105,5000,-5105
23301,240000,192000,0,0,0,0,0,0,0,142909,5206,137703,0,143531,5008,138523,0,144893,6011,138882,0,144121,5250,138871
23302,80000,64000,0,1,0,0,0,1,2,76776,1,76775,2,61884,3000,58884,0,55501,2504,52997,0,54840,2000,52840
23303,290000,232000,0,0,0,0,0,1,-2,97606,3400,94206,-2,76053,2588,73465,-2,53994,1696,52298,-2,31812,1113,30699
23304,400000,320000,0,0,0,0,0,0,0,247813,7395,240418,0,253726,7506,246220,0,258120,6000,252120,0,10002,2000,8002
23305,50000,40000,0,0,0,0,0,0,2,19330,1573,17757,0,19561,804,18757,0,19815,675,19140,0,18574,738,17836
23306,20000,16000,0,0,1,1,1,0,0,17218,1600,15618,0,18630,2000,16630,0,19029,1000,18029,0,19579,1000,18579
23307,70000,56000,0,0,0,0,0,0,0,23834,2000,21834,0,25353,2000,23353,0,27075,2000,25075,0,28092,3000,25092
23308,50000,40000,0,1,1,1,0,0,0,47080,0,47080,2,45833,1200,44633,0,45310,1000,44310,0,6313,126,6187
23309,20000,16000,0,1,1,1,1,0,0,19374,3300,16074,0,18766,0,18766,2,20859,2700,18159,2,20247,0,20247
23310,210000,168000,0,1,1,0,0,0,2,216703,9400,207303,0,206635,5000,201635,0,96240,2000,94240,0,88040,1800,86240
23311,50000,40000,0,0,0,0,0,1,0,30699,1641,29058,0,30038,1000,29038,0,29224,934,28290,0,29346,1109,28237
23312,80000,64000,0,0,0,0,0,0,0,51047,1711,49336,0,48260,1584,46676,0,46198,1576,44622,0,43253,1690,41563
23313,150000,120000,0,0,0,0,1,1,2,123379,6000,117379,2,122881,3000,119881,2,123954,4600,119354,0,131543,9800,121743
23314,30000,24000,0,0,0,0,0,1,0,10282,1451,8831,0,10180,349,9831,0,10394,362,10032,0,9614,343,9271
23315,240000,192000,0,0,0,0,0,0,0,10605,1000,9605,0,10765,1000,9765,0,11765,1000,10765,0,4311,1000,3311
23316,180000,144000,0,0,0,0,0,0,-1,9673,9673,0,-1,2861,3260,-399,-1,12338,13959,-1621,-1,9124,3000,6124
23317,30000,24000,0,0,0,0,0,1,2,21488,3433,18055,2,20847,0,20847,2,21162,800,20362,0,21809,1000,20809
23318,20000,16000,0,0,0,0,0,1,0,7839,0,7839,2,7999,160,7839,0,0,0,0,0,0,0,0
23319,100000,80000,0,0,0,0,0,0,0,60536,2700,57836,0,55708,2000,53708,0,51724,1900,49824,0,48671,1700,46971
23320,70000,56000,0,0,0,0,0,0,0,22630,1400,21230,0,14573,291,14282,0,15127,1500,13627,0,12596,5000,7596
23321,150000,120000,0,1,0,0,0,0,0,131798,10104,121694,0,115350,10017,105333,0,105770,4000,101770,0,111850,15000,96850
23322,350000,280000,0,0,0,0,0,0,0,88719,5006,83713,0,87968,4014,83954,0,84596,3010,81586,0,82785,3043,79742
23323,150000,120000,0,0,0,0,0,0,-1,330,0,330,2,330,330,0,-1,330,330,0,-1,740,740,0
23324,390000,312000,0,0,0,0,0,0,-2,6757,6757,0,-1,0,0,0,-1,3339,3339,0,-1,3339,0,3339
23325,60000,48000,0,0,0,0,0,0,0,36246,1762,34484,0,29831,1044,28787,0,29667,1065,28602,0,30062,1266,28796
23326,210000,168000,0,0,0,0,0,0,-2,0,0,0,-2,0,0,0,-2,0,0,0,-2,0,0,0
23327,110000,88000,0,1,1,0,0,0,0,96998,4200,92798,2,94480,0,94480,2,90860,3000,87860,0,85529,3140,82389
23328,260000,208000,0,0,0,0,0,0,-1,2268,0,2268,2,1732,1732,0,-1,718,718,0,-1,165,165,0
23329,80000,64000,0,0,0,0,0,0,-1,1125,1125,0,-1,4380,4401,-21,-1,2210,2210,0,-1,1150,1150,0
23330,130000,104000,0,0,0,0,0,0,0,0,0,0,-2,0,0,0,-2,0,0,0,-2,0,0,0
23331,120000,96000,0,0,0,0,0,0,0,61943,3419,58524,0,58744,5026,53718,0,-36156,15651,-51807,0,-36156,0,-36156
23332,50000,40000,0,1,1,0,0,0,0,49362,3264,46098,0,47907,1400,46507,0,18145,3000,15145,0,17495,350,17145
23333,20000,16000,0,0,0,0,0,0,-1,1973,1973,0,-1,17711,17711,0,-1,13747,2000,11747,0,13901,5000,8901
23334,120000,96000,1,1,1,1,0,1,3,127516,0,127516,2,124530,6000,118530,0,120937,5067,115870,0,67711,1548,66163
23335,50000,40000,0,0,0,0,0,0,0,0,0,0,0,0,0,0,-2,318,318,0,-1,0,0,0
23336,80000,64000,0,0,0,0,0,0,0,44878,1906,42972,0,42108,2000,40108,0,28316,2000,26316,0,29523,2000,27523
23337,230000,184000,0,0,0,0,0,0,0,41719,1689,40030,0,38072,1046,37026,0,33802,1025,32777,0,30435,928,29507
23338,120000,96000,0,1,1,0,1,0,0,116082,6000,110082,0,118405,6000,112405,0,99081,4000,95081,0,106300,9000,97300
23339,180000,144000,0,0,0,0,0,0,-1,-2811,0,-2811,-2,126884,131453,-4569,-1,129020,4209,124811,0,131708,4350,127358
23340,80000,64000,0,0,0,0,0,1,0,22843,1500,21343,0,20578,1000,19578,0,19049,779,18270,0,16221,545,15676
23341,220000,176000,0,0,0,0,0,0,-2,2598,2598,0,-1,640,790,-150,-1,168,168,0,-1,1579,1579,0
23342,20000,16000,0,0,0,0,0,0,-1,4033,4033,0,-1,897,1136,-239,-1,2147,2147,0,-1,1359,407,952
23343,310000,248000,0,0,0,0,0,0,-2,12497,12497,0,-2,8568,8580,-12,-2,1787,1787,0,-2,498,498,0
23344,260000,208000,0,0,0,0,0,0,0,26299,3000,23299,0,27804,3000,24804,0,25809,2500,23309,0,27052,2500,24552
23345,150000,120000,0,0,0,0,0,0,-1,4639,4639,0,-1,100940,100000,940,0,3284,3284,0,-1,2090,2576,-486
23346,30000,24000,0,1,0,1,1,1,0,29739,1459,28280,0,24950,1373,23577,0,25248,871,24377,0,25109,890,24219
23347,180000,144000,0,0,0,0,0,0,0,46325,1771,44554,0,47354,1800,45554,0,48323,1750,46573,0,49416,1893,47523
23348,60000,48000,0,1,1,1,1,1,0,57781,2130,55651,0,62309,7050,55259,0,60435,0,60435,2,55468,3190,52278
23349,30000,24000,0,1,1,1,1,0,0,30454,1455,28999,0,29227,1028,28199,0,28929,1044,27885,0,29484,1420,28064
23350,50000,40000,0,0,0,0,0,0,-2,530,530,0,-1,26530,26000,530,0,26574,951,25623,0,26289,943,25346
23351,260000,208000,0,0,0,0,0,0,0,69429,40000,29429,0,167640,100000,67640,0,169446,5720,163726,0,172989,5922,167067
23352,100000,80000,0,1,1,1,1,0,0,100750,3838,96912,0,98953,3563,95390,0,99114,3563,95551,0,101501,4000,97501
23353,140000,112000,0,0,0,0,0,0,-1,1872,1872,0,-1,1453,1453,0,-1,1453,1453,0,-1,1034,1034,0
23354,60000,48000,0,1,1,1,1,0,0,55993,2047,53946,0,56675,2024,54651,0,57550,2180,55370,0,57545,2321,55224
23355,160000,128000,0,0,0,0,0,1,-1,1000,1000,0,-1,0,0,0,-1,0,0,0,-2,0,0,0
23356,100000,80000,0,0,0,0,0,0,-2,0,0,0,-2,0,0,0,-2,0,0,0,-2,18149,18149,0
23357,50000,40000,0,0,0,0,0,0,0,34027,1807,32220,0,9568,1000,8568,0,9913,500,9413,0,10132,400,9732
23358,30000,24000,0,0,0,0,0,1,-2,0,0,0,-2,0,0,0,-2,0,0,0,-2,0,0,0
23359,50000,40000,0,0,0,0,0,1,3,28668,2000,26668,2,29191,1300,27891,2,35551,7000,28551,2,34420,0,34420
23360,90000,72000,0,0,0,0,0,0,0,51400,2400,49000,0,0,0,0,0,0,0,0,-2,0,0,0
23361,260000,208000,0,0,0,0,0,0,-2,2280,2280,0,-2,746,746,0,-2,1989,1989,0,-1,1668,1668,0
23362,10000,8000,1,1,1,1,1,1,2,10425,0,10425,3,9919,0,9919,2,9825,400,9425,0,10581,1100,9481
23363,200000,160000,0,1,1,1,1,1,3,182657,7000,175657,2,174547,0,174547,2,181454,13300,168154,2,177141,0,177141
23364,450000,360000,0,0,0,0,0,0,-1,0,0,0,-2,390,390,0,2,390,390,0,-1,390,390,0
23365,50000,40000,0,0,0,0,0,0,0,7241,1129,6112,0,8249,1137,7112,0,8414,302,8112,0,8590,312,8278
23366,70000,56000,0,0,0,0,0,0,0,59389,3800,55589,0,54064,1200,52864,0,58891,5000,53891,0,58347,4000,54347
23367,70000,56000,0,0,0,0,0,1,0,32054,3000,29054,0,31239,0,31239,2,31935,1200,30735,0,32602,1200,31402
23368,500000,400000,0,0,0,0,0,0,0,211508,10000,201508,0,223660,23660,200000,0,228014,20000,208014,0,223940,13940,210000
23369,280000,224000,0,1,1,1,1,0,0,277620,10470,267150,0,275495,10002,265493,0,270350,9948,260402,0,260554,9475,251079
23370,140000,112000,0,0,0,0,0,0,0,80037,4000,76037,0,53055,4000,49055,0,102587,98000,4587,0,98251,4000,94251
23371,280000,224000,0,0,0,0,0,0,2,0,0,0,2,0,0,0,-2,1000,1000,0,-1,0,0,0
23372,120000,96000,0,1,1,0,1,0,0,109786,5059,104727,0,104000,4000,100000,0,121427,120203,1224,0,116652,5000,111652
23373,180000,144000,0,0,0,0,0,0,0,6837,1500,5337,0,9367,2989,6378,0,8758,0,8758,2,8800,500,8300
23374,120000,96000,0,0,0,0,0,0,-1,70,70,0,-1,220,220,0,-1,220,220,0,-1,220,220,0
23375,500000,400000,0,0,0,0,0,0,0,64130,2332,61798,0,45766,1219,44547,0,45324,5000,40324,0,55011,54000,1011
23376,20000,16000,0,0,0,0,0,1,2,0,0,0,2,0,0,0,-2,0,0,0,-2,0,0,0
23377,30000,24000,0,0,0,0,0,0,0,18388,2309,16079,0,12992,0,12992,2,7736,1000,6736,0,8032,2000,6032
23378,80000,64000,0,0,0,0,0,0,-2,1958,2020,-62,-2,-101,0,-101,-2,15932,16033,-101,-2,950,11220,-10270
23379,580000,464000,0,1,1,1,1,0,0,485511,20036,465475,0,488800,20000,468800,0,500723,20000,480723,0,511905,20056,491849
23380,100000,80000,0,0,0,0,0,0,0,69674,2600,67074,0,71097,2582,68515,0,72913,3000,69913,0,74738,3000,71738
23381,360000,288000,0,0,0,0,0,0,-1,11704,11767,-63,-1,19036,20036,-1000,-1,41147,22207,18940,0,53733,54981,-1248
23382,20000,16000,0,1,1,1,1,1,0,19862,1600,18262,2,19245,0,19245,2,20532,1600,18932,2,19953,209,19744
23383,250000,200000,0,0,0,0,0,0,0,43214,2000,41214,0,36847,1048,35799,0,23230,1006,22224,0,21139,1507,19632
23384,20000,16000,0,1,1,1,1,0,0,20269,1500,18769,0,18268,1290,16978,0,19478,1500,17978,0,19885,704,19181
23385,50000,40000,0,1,1,1,1,0,0,47855,1797,46058,0,48894,1836,47058,0,50258,2200,48058,0,48276,2000,46276
23386,120000,96000,0,0,0,0,0,0,0,5257,5272,-15,-1,13781,13832,-51,-1,8636,8661,-25,-1,5698,5715,-17
23387,180000,144000,0,0,0,0,0,0,-2,0,0,0,-2,0,0,0,-2,0,0,0,-2,0,0,0
23388,230000,184000,0,0,0,0,0,0,-2,1024,1024,0,-2,0,0,0,-2,0,0,0,-2,0,0,0
23389,140000,112000,0,0,0,0,0,0,-1,264,528,-264,-1,1024,1024,0,-1,264,264,0,-1,264,264,0
23390,180000,144000,0,0,0,0,0,1,-1,0,0,0,-1,1752,1752,0,-1,70000,70000,0,-1,10552,10552,0
23391,200000,160000,0,0,0,0,0,0,-1,6952,6952,0,-1,827,827,0,-1,1426,1426,0,-1,763,763,0
23392,240000,192000,0,1,0,0,1,0,0,221051,8163,212888,0,191997,6753,185244,0,196221,7197,189024,0,200058,7176,192882
23393,80000,64000,0,0,0,0,0,1,0,48461,1500,46961,2,45943,1500,44443,2,46660,1742,44918,0,46118,1800,44318
23394,200000,160000,0,0,0,0,0,0,-1,8916,8983,-67,-1,12868,12908,-40,-1,7818,7834,-16,-1,12910,12919,-9
23395,280000,224000,0,0,0,0,0,0,0,116879,5000,111879,0,117912,4300,113612,0,118998,3729,115269,0,116067,3800,112267
23396,140000,112000,0,0,0,0,0,0,0,7609,3855,3754,0,4991,4991,0,-1,3400,3600,-200,-1,3745,5500,-1755
23397,180000,144000,0,0,0,0,0,0,-1,396,396,0,-1,396,396,0,-1,396,396,0,-1,396,396,0
23398,20000,16000,0,0,1,0,0,0,0,18829,5000,13829,0,18401,400,18001,0,3000,200,2800,0,0,0,0
23399,80000,64000,0,0,0,0,0,0,-1,5395,5395,0,-1,1182,1182,0,-1,266,266,0,-1,366,233,133
23400,200000,160000,0,0,0,0,0,1,0,67240,11000,56240,0,69798,5000,64798,0,72243,5000,67243,0,75277,5000,70277
23401,90000,72000,0,0,0,0,0,0,0,24100,1600,22500,0,25000,1500,23500,0,25000,0,25000,0,26254,1254,25000
23402,360000,288000,0,0,0,0,0,1,-2,0,0,0,-2,0,0,0,-2,0,0,0,-2,0,0,0
23403,180000,144000,0,0,0,0,0,0,0,93000,0,93000,2,93526,2340,91186,0,66726,1850,64876,0,42668,4000,38668
23404,50000,40000,0,0,0,0,0,0,2,39863,4500,35363,2,38924,0,38924,2,39744,1600,38144,0,40533,1600,38933
23405,230000,184000,0,0,0,0,0,0,-1,665,665,0,-1,582,582,0,-1,472,472,0,-1,746,746,0
23406,50000,40000,0,0,0,0,0,1,0,0,0,0,0,0,0,0,-2,0,0,0,-2,0,0,0
23407,10000,8000,0,1,1,1,0,1,2,10385,1000,9385,2,9987,0,9987,2,9987,0,9987,0,0,0,0
23408,50000,40000,0,0,0,0,0,0,-1,326,0,326,2,978,978,0,-1,652,0,652,0,326,0,326
23409,160000,128000,0,0,0,0,0,0,2,68939,3400,65539,2,72267,5100,67167,2,73602,2800,70802,2,75133,2900,72233
23410,200000,160000,0,0,0,0,0,0,-2,0,0,0,-2,0,0,0,-2,0,0,0,-2,0,0,0
23411,440000,352000,0,0,0,0,0,0,-1,5945,5945,0,-1,17165,17165,0,-1,1176,0,1176,0,18377,18377,0
23412,210000,168000,0,0,0,0,0,0,-1,0,0,0,-1,0,0,0,-2,0,0,0,-2,478,478,0
23413,100000,80000,0,0,0,0,0,0,-1,9690,9690,0,-1,5286,6916,-1630,-1,8191,8191,0,-1,11272,6412,4860
23414,150000,120000,0,0,0,0,0,0,0,135883,50001,85882,0,95806,3569,92237,0,97648,3529,94119,0,99737,3697,96040
23415,120000,96000,0,1,0,0,0,0,0,104754,3384,101370,0,79227,2589,76638,0,77751,3000,74751,0,69889,2460,67429
23416,150000,120000,0,0,0,0,0,0,-2,0,0,0,-2,0,0,0,-2,0,0,0,-2,0,0,0
23417,20000,16000,0,1,0,1,1,1,0,18577,1700,16877,0,18111,3500,14611,0,19114,2000,17114,0,17038,1000,16038
23418,210000,168000,0,0,0,0,0,0,0,111335,4100,107235,0,114037,4547,109490,0,67224,2500,64724,0,69177,3000,66177
23419,230000,184000,0,0,0,0,0,1,-2,0,0,0,-2,0,0,0,-2,0,0,0,-2,0,0,0
23420,70000,56000,0,0,0,0,0,0,-1,25510,3010,22500,-1,24726,0,24726,2,25377,875,24502,0,24818,600,24218
23421,50000,40000,0,0,0,0,0,0,0,18894,1500,17394,0,18512,1000,17512,0,16853,1000,15853,0,18401,2000,16401
23422,170000,136000,0,0,0,0,0,0,-1,7315,7352,-37,-1,10730,10730,0,-1,1686,1686,0,-1,9445,9445,0
23423,50000,40000,0,1,0,0,0,1,0,42672,2500,40172,0,23665,5946,17719,0,20085,3000,17085,0,20263,7000,13263
23424,20000,16000,0,0,0,0,0,1,0,10419,1015,9404,0,780,780,0,-1,0,0,0,-1,0,0,0
23425,200000,160000,0,0,0,0,0,1,-2,-2113,0,-2113,-2,-2113,0,-2113,-2,-2113,0,-2113,-2,-2113,0,-2113
23426,70000,56000,0,1,1,0,0,0,0,67344,2594,64750,0,62083,4512,57571,0,29914,0,29914,2,29406,1070,28336
23427,50000,40000,0,1,1,1,1,1,3,45718,0,45718,4,44696,0,44696,3,43848,0,43848,2,44718,1600,43118
23428,10000,8000,0,0,0,0,0,0,3,6247,0,6247,2,7975,2000,5975,2,7701,0,7701,2,7787,359,7428
23429,150000,120000,0,1,1,1,1,0,0,137320,5022,132298,0,138016,5100,132916,0,144084,10500,133584,0,136604,0,136604
23430,160000,128000,0,0,0,0,0,0,-2,196,196,0,-2,7730,7741,-11,-2,3113,3113,0,-2,3484,3484,0
23431,260000,208000,0,0,0,0,0,0,0,155081,7514,147567,0,156138,6756,149382,0,145251,5176,140075,0,139784,5200,134584
23432,400000,320000,0,0,0,0,0,0,0,3417,1000,2417,0,3267,1200,2067,0,186,186,0,-1,1200,1200,0
23433,60000,48000,1,1,1,1,1,0,0,63553,3000,60553,0,59633,2125,57508,0,55689,2007,53682,0,52778,3000,49778
23434,60000,48000,0,1,1,0,0,0,0,59690,2922,56768,0,59513,1586,57927,0,28494,570,27924,0,29149,31110,-1961
23435,20000,16000,0,0,0,0,0,0,-1,0,0,0,-2,0,0,0,-2,0,0,0,-2,0,0,0
23436,130000,104000,0,0,0,0,0,0,-2,740,740,0,-1,740,0,740,2,73758,73758,0,-1,72800,0,72800
23437,20000,16000,0,0,0,0,0,0,-1,0,0,0,-2,0,2000,-2000,-2,0,0,0,-2,0,0,0
23438,190000,152000,0,0,0,0,0,0,0,83530,5000,78530,0,87126,6000,81126,2,84165,0,84165,2,89017,6500,82517
23439,420000,336000,0,0,0,0,0,0,0,140011,7000,133011,0,141695,5500,136195,0,144839,5500,139339,0,147954,5600,142354
23440,230000,184000,0,0,0,0,0,0,-2,600,600,0,-2,0,0,0,-2,0,0,0,-2,0,0,0
23441,500000,400000,0,0,0,0,0,0,0,52210,23016,29194,0,27843,566,27277,0,28926,22323,6603,0,11931,11931,0
23442,130000,104000,0,1,1,0,0,0,0,129388,6000,123388,0,127628,5161,122467,0,64345,2239,62106,0,62373,3000,59373
23443,100000,80000,0,1,1,1,1,1,3,96461,1300,95161,3,96975,3000,93975,2,101280,5450,95830,2,101935,2000,99935
23444,70000,56000,0,0,1,1,1,1,2,57550,2600,54950,2,58008,2000,56008,2,58957,2500,56457,2,60367,2500,57867
23445,120000,96000,0,0,0,0,0,0,-1,0,0,0,-2,10446,10446,0,-1,0,0,0,-1,0,0,0
23446,120000,96000,0,1,1,1,1,0,0,115918,4172,111746,0,116918,4168,112750,0,118698,4770,113928,0,121372,5119,116253
23447,170000,136000,0,0,0,0,0,0,0,2800,2800,0,-1,21881,21881,0,-1,0,0,0,-1,6780,6780,0
23448,80000,64000,0,1,0,0,0,0,3,80146,2000,78146,2,61392,0,61392,2,60325,3091,57234,0,60469,2400,58069
23449,150000,120000,0,0,0,0,0,0,-1,6484,6484,0,-1,12287,12306,-19,-1,21888,21888,0,-1,19960,0,19960
23450,110000,88000,0,0,0,0,0,1,0,79889,3008,76881,0,70062,3200,66862,0,70901,2600,68301,0,72754,3000,69754
23451,240000,192000,0,0,0,1,0,0,0,189615,6002,183613,0,197092,10002,187090,0,201528,7030,194498,0,197155,6275,190880
23452,380000,304000,0,0,0,0,0,0,0,6697,2000,4697,0,2700,0,2700,2,1218,1218,0,-1,1533,700,833
23453,240000,192000,0,1,1,0,0,0,0,229622,10200,219422,0,202296,8366,193930,0,165639,6070,159569,0,159245,10000,149245
23454,20000,16000,0,1,1,0,0,0,0,18679,1340,17339,0,18275,1207,17068,0,7953,300,7653,0,8323,500,7823
23455,20000,16000,0,0,0,0,0,0,-1,6597,6597,0,-1,9333,5000,4333,0,4133,4431,-298,-1,8456,8500,-44
23456,260000,208000,0,0,0,0,0,0,0,89485,4153,85332,0,85906,2913,82993,0,83619,3012,80607,0,81260,3088,78172
23457,20000,16000,1,1,0,0,0,1,0,34964,1208,33756,0,9376,1276,8100,0,9620,520,9100,0,780,1560,-780
23458,140000,112000,0,0,0,0,0,1,2,33961,3500,30461,2,33250,0,33250,2,34524,2000,32524,0,38098,4000,34098
23459,260000,208000,0,0,0,0,0,0,0,28592,10000,18592,0,16869,3000,13869,0,12713,12713,0,-1,10420,10420,0
23460,200000,160000,0,1,0,0,0,0,0,194265,7673,186592,0,139360,5000,134360,0,82750,5000,77750,0,0,0,0
23461,140000,112000,0,0,0,0,0,0,0,96667,3600,93067,0,98883,3900,94983,0,79972,3000,76972,0,81642,3000,78642
23462,400000,320000,0,0,0,0,0,0,-1,1783,0,1783,2,129,129,0,-1,3170,3170,0,-1,657,657,0
23463,140000,112000,0,0,0,0,0,0,0,51980,2760,49220,0,54606,3386,51220,0,55220,2000,53220,0,56527,2082,54445
23464,60000,48000,0,1,0,1,1,1,2,48736,0,48736,2,49525,1900,47625,0,57564,8900,48664,0,56517,0,56517
23465,60000,48000,0,0,0,0,0,1,2,42117,1685,40432,2,41140,0,41140,2,42110,1655,40455,0,42988,1707,41281
23466,80000,64000,0,0,0,1,1,0,0,63905,2500,61405,0,67943,5100,62843,0,68811,2100,66711,2,70526,3000,67526
23467,30000,24000,0,0,0,0,0,0,0,13565,1000,12565,2,13055,0,13055,2,13525,1000,12525,2,0,2000,-2000
23468,180000,144000,0,0,0,0,0,0,-1,1247,1247,0,-1,0,0,0,-1,0,0,0,-2,0,0,0
23469,150000,120000,0,0,0,0,0,0,-1,780,780,0,-1,0,0,0,-1,0,0,0,-2,0,0,0
23470,150000,120000,0,0,0,0,0,0,0,40653,2000,38653,0,41249,1500,39749,0,42356,1700,40656,0,43278,1700,41578
23471,30000,24000,0,0,1,1,1,0,0,24943,1500,23443,0,27507,3000,24507,0,30767,3722,27045,0,29762,0,29762
23472,190000,152000,0,0,0,0,0,0,0,126944,5000,121944,0,130606,6171,124435,0,131120,4536,126584,0,133774,5150,128624
23473,240000,192000,0,1,1,1,0,0,0,236914,11000,225914,0,241351,11000,230351,0,244202,10000,234202,0,115036,5000,110036
23474,90000,72000,0,0,0,0,0,0,-2,1000,1000,0,-2,1000,1000,0,-2,1052,1052,0,-1,69237,71062,-1825
23475,310000,248000,0,1,1,0,0,0,0,312567,12124,300443,0,291153,10300,280853,0,159545,8168,151377,0,97438,5500,91938
23476,60000,48000,0,0,0,0,0,0,2,26578,1750,24828,0,27828,2000,25828,0,28271,1200,27071,0,28868,1200,27668
23477,160000,128000,0,0,0,0,0,0,0,97589,4500,93089,0,78487,3000,75487,0,78592,3000,75592,0,81326,4000,77326
23478,420000,336000,0,0,0,0,0,0,0,46932,2010,44922,0,45546,1700,43846,0,46369,1622,44747,0,42651,1520,41131
23479,200000,160000,0,0,0,0,0,0,0,67675,2646,65029,0,56519,2208,54311,0,11884,12503,-619,-1,14343,14869,-526
23480,200000,160000,0,0,0,0,0,0,-1,298,0,298,2,13764,13764,0,-1,5290,0,5290,0,924,924,0
23481,50000,40000,0,0,0,0,0,1,2,11738,1158,10580,0,11011,373,10638,0,9888,365,9523,0,10076,359,9717
23482,390000,312000,0,0,0,0,0,0,0,121854,5000,116854,0,90634,4000,86634,0,84353,5000,79353,0,57677,10000,47677
23483,60000,48000,0,0,0,0,0,0,0,49576,2384,47192,0,50802,3000,47802,0,11110,2000,9110,0,12543,2000,10543
23484,380000,304000,0,0,0,0,0,0,-1,15134,15138,-4,-1,32018,24677,7341,-1,11849,11851,-2,-1,11873,11875,-2
23485,200000,160000,0,0,0,0,0,0,-1,0,0,0,-1,0,0,0,-2,171,171,0,-1,1557,1386,171
23486,150000,120000,0,0,0,0,0,0,0,82169,2730,79439,0,67958,2468,65490,0,69310,2483,66827,0,70819,2628,68191
23487,300000,240000,0,0,0,0,0,0,-1,396,396,0,-1,0,0,0,-1,792,792,0,-1,68095,68095,0
23488,20000,16000,0,1,1,0,0,1,0,20110,1500,18610,0,19584,593,18991,0,16539,2701,13838,0,19466,4261,15205
23489,30000,24000,0,1,1,1,1,1,0,34804,5550,29254,0,33808,1238,32570,2,31740,0,31740,2,31135,1515,29620
23490,90000,72000,0,0,0,0,0,0,-1,0,0,0,-2,0,0,0,-2,0,0,0,-2,0,0,0
23491,60000,48000,0,0,0,0,0,1,0,31938,0,31938,2,1236,1236,0,-1,720,720,0,-1,16884,17000,-116
23492,50000,40000,0,1,0,0,0,0,0,50150,2040,48110,0,9658,330,9328,0,10011,492,9519,0,9345,332,9013
23493,120000,96000,0,0,0,0,0,0,-1,7752,7772,-20,-1,4447,4447,0,-1,8495,8495,0,-1,0,0,0
23494,180000,144000,0,1,1,1,1,0,0,158437,5741,152696,0,161664,5852,155812,0,164873,5881,158992,0,168344,7607,160737
23495,140000,112000,0,1,1,1,1,0,0,140254,6500,133754,0,139679,5100,134579,0,141748,5300,136448,0,142174,6000,136174
23496,270000,216000,0,0,0,0,0,0,0,33898,2000,31898,0,35272,2000,33272,0,37201,2408,34793,0,31447,1500,29947
23497,130000,104000,0,0,0,0,0,0,0,15709,1010,14699,0,13209,1003,12206,0,14166,2040,12126,0,14025,2000,12025
23498,360000,288000,0,0,0,0,0,0,-1,3225,0,3225,2,4230,4230,0,-1,6113,6113,0,-1,8745,8745,0
23499,200000,160000,0,0,0,0,0,1,-1,2523,2531,-8,-1,2327,2327,0,-1,2308,2308,0,-1,0,0,0
23500,10000,8000,0,0,0,0,0,0,2,6101,1500,4601,0,6711,2000,4711,0,7258,2000,5258,0,7777,2000,5777
23501,20000,16000,0,0,0,1,0,0,0,14382,0,14382,2,16820,3000,13820,2,16411,0,16411,2,17287,1304,15983
23502,130000,104000,0,0,0,0,0,1,0,78411,6500,71911,0,79725,3200,76525,2,81311,3500,77811,2,83048,3200,79848
23503,290000,232000,0,0,0,0,0,0,-2,0,0,0,-2,0,0,0,-2,0,0,0,-2,0,0,0
23504,80000,64000,0,1,0,0,0,0,0,79545,3714,75831,0,55119,1500,53619,0,45630,1000,44630,0,45630,0,45630
23505,320000,256000,0,0,0,0,0,0,0,232645,7216,225429,0,212184,10050,202134,0,204791,6313,198478,0,125974,4075,121899
23506,220000,176000,0,0,0,0,0,0,-1,375,0,375,2,375,375,0,-1,750,750,0,-1,375,0,375
23507,240000,192000,0,1,1,1,1,0,0,245657,8700,236957,2,240040,0,240040,2,231790,8207,223583,0,221683,9000,212683
23508,340000,272000,0,0,0,0,0,0,-2,0,0,0,-2,150,150,0,-1,920,920,0,-1,0,0,0
23509,500000,400000,0,0,0,0,0,0,0,137786,12063,125723,0,129575,8031,121544,0,135483,16114,119369,0,118851,10091,108760
23510,20000,16000,0,0,0,1,1,0,0,15571,1262,14309,0,16584,1275,15309,0,17067,758,16309,0,34262,638,33624
23511,230000,184000,0,0,0,0,0,0,-2,326,326,0,-2,326,326,0,-2,326,326,0,-2,326,326,0
23512,80000,64000,0,0,0,0,0,0,0,0,0,0,0,0,0,0,-2,0,0,0,-2,0,0,0
23513,340000,272000,0,0,0,0,0,0,-1,4105,4105,0,-1,2895,0,2895,0,2895,0,2895,0,2360,2360,0
23514,60000,48000,0,0,0,0,0,0,0,47329,5000,42329,0,35587,5000,30587,0,36193,5000,31193,0,29978,5000,24978
23515,100000,80000,0,1,1,1,1,0,0,94925,2688,92237,0,96837,2718,94119,0,98894,2854,96040,0,100500,2500,98000
23516,200000,160000,0,0,0,0,0,0,-2,-40,0,-40,-2,-40,0,-40,-2,-40,0,-40,-2,-40,0,-40
23517,150000,120000,0,0,0,0,0,0,0,81085,40104,40981,0,75300,10013,65287,0,77276,5083,72193,0,64065,1819,62246
23518,320000,256000,0,0,0,0,0,0,-2,0,0,0,-2,370,370,0,-1,9301,9301,0,-1,0,0,0
23519,100000,80000,0,0,0,0,0,0,-1,370,370,0,-1,-20,0,-20,-1,780,800,-20,-1,0,0,0
23520,10000,8000,0,0,1,1,1,0,2,9481,1632,7849,2,9180,0,9180,2,10052,1022,9030,2,10091,350,9741
23521,500000,400000,0,0,0,0,0,0,-1,9342,9342,0,-1,3518,3518,0,-1,5597,5597,0,-1,717,717,0
23522,480000,384000,0,0,0,0,0,0,-2,0,0,0,-2,15620,15620,0,-2,5200,5200,0,-2,1355,1355,0
23523,500000,400000,0,0,0,0,0,0,0,258310,10106,248204,0,221792,9021,212771,0,201215,7029,194186,0,183739,9093,174646
23524,280000,224000,0,0,0,0,0,0,-1,1843,1843,0,-1,1663,0,1663,2,-147,0,-147,2,-147,0,-147
23525,180000,144000,0,0,0,0,0,0,-1,1503,1512,-9,-1,1379,1379,0,-1,1216,1216,0,-1,1440,1440,0
23526,100000,80000,0,0,0,0,0,0,0,83898,7121,76777,0,77260,94,77166,2,68173,2408,65765,0,66682,2513,64169
23527,200000,160000,0,0,0,0,0,0,-2,-5,0,-5,-2,2999,3004,-5,-1,4804,4804,0,-1,4402,5008,-606
23528,110000,88000,0,0,0,0,0,1,2,58792,2300,56492,2,59620,2400,57220,2,60819,2300,58519,2,62069,2400,59669
23529,80000,64000,0,0,0,0,0,1,-1,0,0,0,-1,0,0,0,-2,0,0,0,-2,0,0,0
23530,320000,256000,0,0,0,0,0,0,-2,2913,2927,-14,-2,-27,0,-27,-2,-27,0,-27,-2,5399,5426,-27
23531,200000,160000,0,0,0,0,0,0,0,4794,1024,3770,0,11720,11726,-6,-1,12293,2608,9685,0,10798,344,10454
23532,280000,224000,0,0,0,0,0,0,0,23359,1389,21970,0,23647,1175,22472,0,-1353,0,-1353,0,93696,95049,-1353
23533,150000,120000,1,1,0,0,0,0,0,300000,17000,283000,-2,0,0,0,-2,0,0,0,-2,0,0,0
23534,500000,400000,0,0,0,0,0,0,0,214481,10815,203666,0,112222,5874,106348,0,33958,2729,31229,0,9684,9784,-100
23535,140000,112000,0,0,0,0,0,0,2,97448,10000,87448,0,105795,10000,95795,0,103988,0,103988,2,110769,8500,102269
23536,180000,144000,0,0,0,0,0,1,-1,2297,2308,-11,-1,4428,4446,-18,-1,985,987,-2,-1,4028,4040,-12
23537,210000,168000,0,0,0,0,0,0,0,99865,4000,95865,0,77754,3018,74736,0,49529,2000,47529,0,30683,3000,27683
23538,400000,320000,0,0,0,0,0,0,-1,42176,42386,-210,-1,75513,75865,-352,-1,57104,57379,-275,-1,53542,53787,-245
23539,20000,16000,0,0,0,1,0,0,0,8492,1145,7347,0,9547,1200,8347,0,20766,2000,18766,0,12197,3000,9197
23540,260000,208000,0,0,0,0,0,1,0,152724,5950,146774,0,153527,4000,149527,0,153375,3000,150375,0,105491,6000,99491
23541,430000,344000,0,0,0,0,0,0,-2,52983,52983,0,-1,70672,35002,35670,0,52378,10203,42175,0,56360,7500,48860
23542,140000,112000,0,0,0,0,0,0,0,96753,4034,92719,0,94310,5050,89260,0,92182,6034,86148,0,88818,3202,85616
23543,230000,184000,0,0,0,0,0,0,0,46987,1769,45218,0,45669,1635,44034,0,44510,1660,42850,0,43084,1544,41540
23544,200000,160000,0,0,0,0,0,0,2,3049,3049,0,-1,700,700,0,-1,2423,2423,0,-1,2210,2210,0
23545,70000,56000,0,0,0,0,0,1,0,51238,2100,49138,0,52196,2000,50196,0,53747,2000,51747,0,47695,2100,45595
23546,10000,8000,0,0,1,0,0,1,0,8518,1000,7518,0,8628,500,8128,0,9293,1500,7793,0,5033,0,5033
23547,200000,160000,0,0,0,0,0,1,-1,1946,1950,-4,-1,11900,11921,-21,-1,6344,4,6340,0,4747,3,4744
23548,50000,40000,0,0,0,0,0,0,0,19597,1519,18078,0,17830,1000,16830,0,18397,1000,17397,0,19064,1000,18064
23549,20000,16000,0,0,0,0,0,1,0,0,0,0,0,0,0,0,-2,0,0,0,-2,0,0,0
23550,230000,184000,0,0,0,0,0,0,0,189966,6100,183866,0,142377,7000,135377,0,143828,5356,138472,0,143698,5400,138298
23551,110000,88000,0,1,0,0,0,0,0,108803,3600,105203,0,82231,4138,78093,0,25687,1000,24687,0,27266,2000,25266
23552,50000,40000,0,0,0,0,0,0,0,21266,1286,19980,0,19418,666,18752,0,19315,680,18635,0,18559,816,17743
23553,30000,24000,0,0,0,0,0,0,3,21736,0,21736,2,23192,1800,21392,2,22701,0,22701,2,22954,1000,21954
23554,50000,40000,0,0,0,0,0,0,0,3047,1051,1996,0,3606,1000,2606,0,2390,50,2340,0,1655,10050,-8395
23555,230000,184000,0,0,0,0,0,0,-1,1144,1149,-5,-1,1346,1352,-6,-1,1024,1029,-5,-1,-4,0,-4
23556,160000,128000,0,0,0,0,0,0,0,13484,5017,8467,0,6714,5000,1714,0,-319,0,-319,0,3583,6774,-3191
23557,130000,104000,0,1,0,0,0,0,0,127102,7328,119774,0,65517,5000,60517,0,66925,2500,64425,0,68344,2500,65844
23558,150000,120000,0,1,1,0,0,1,2,130622,30,130592,2,126063,5050,121013,0,118836,5025,113811,0,116865,5000,111865
23559,200000,160000,0,0,0,0,0,0,0,37893,2000,35893,0,39266,2000,37266,0,40120,1500,38620,0,40961,1479,39482
23560,20000,16000,0,0,0,0,0,0,-1,-380,0,-380,-1,-380,0,-380,-2,-380,0,-380,-2,-380,0,-380
23561,300000,240000,0,0,0,0,0,0,-2,0,0,0,-2,0,0,0,-2,0,0,0,-2,0,0,0
23562,430000,344000,0,0,0,0,0,0,0,277823,11000,266823,0,251443,11000,240443,0,236975,10000,226975,0,203526,8000,195526
23563,80000,64000,0,0,0,0,0,0,0,21002,1424,19578,0,19478,576,18902,0,17882,1000,16882,0,5120,102,5018
23564,60000,48000,0,0,0,0,0,0,0,21736,1400,20336,0,23172,1800,21372,0,22661,0,22661,2,24087,1800,22287
23565,20000,16000,1,1,1,1,1,1,0,69521,2579,66942,0,16970,606,16364,0,17326,628,16698,0,17688,649,17039
23566,200000,160000,0,1,1,1,1,0,2,193731,8300,185431,2,189136,0,189136,2,191335,6800,184535,0,202780,14500,188280
23567,30000,24000,0,0,0,0,0,1,0,21034,1350,19684,0,22050,1366,20684,0,22490,806,21684,0,22961,834,22127
23568,90000,72000,0,0,0,0,0,0,-2,0,0,0,-2,0,0,0,-2,0,0,0,-2,0,0,0
23569,180000,144000,0,0,0,0,0,0,0,33700,1500,32200,0,0,0,0,0,0,0,0,-2,0,0,0
23570,200000,160000,0,0,0,0,0,1,-1,396,396,0,-1,792,792,0,-1,0,0,0,-1,396,396,0
23571,30000,24000,0,0,0,0,0,0,-2,0,0,0,-2,0,0,0,-2,0,0,0,-2,0,0,0
23572,220000,176000,0,0,0,0,0,0,-1,85897,4000,81897,0,90106,5000,85106,0,94129,5000,89129,0,101037,8000,93037
23573,300000,240000,0,0,0,0,0,0,0,0,0,0,-2,0,0,0,-2,0,0,0,-2,0,0,0
23574,290000,232000,0,0,0,0,0,0,-1,679,679,0,-1,3390,3390,0,-1,5784,5784,0,-1,5784,0,5784
23575,300000,240000,0,0,0,0,0,0,-2,142,142,0,-2,656,656,0,-2,620,620,0,-2,502,502,0
23576,50000,40000,0,0,0,0,0,0,0,20979,1294,19685,0,19894,682,19212,0,18811,680,18131,0,18805,694,18111
23577,170000,136000,0,0,0,0,0,0,0,114535,6000,108535,0,115448,4106,111342,0,117426,4312,113114,0,115675,5097,110578
23578,360000,288000,0,0,0,0,0,0,-1,17170,17173,-3,-1,11152,1000,10152,0,6000,1000,5000,0,0,0,0
23579,30000,24000,0,0,0,0,1,1,-1,28883,28883,0,-1,24291,1710,22581,0,27503,6000,21503,0,28142,1200,26942
23580,290000,232000,0,0,0,0,0,0,0,225000,25000,200000,0,16635,16635,0,-1,15000,15000,0,-1,47143,47143,0
23581,160000,128000,0,0,0,0,0,0,0,89902,4400,85502,0,90983,3000,87983,0,82255,2400,79855,0,83988,2500,81488
23582,240000,192000,0,0,0,0,0,0,-2,1522,1522,0,-1,2141,2141,0,-1,590,590,0,-1,176,176,0
23583,200000,160000,0,0,0,0,0,0,-1,21698,21698,0,-1,12657,12657,0,-1,11349,569,10780,0,9006,3000,6006
23584,200000,160000,0,0,0,0,0,0,-1,4864,5748,-884,-1,1958,1958,0,2,805,805,0,-1,3046,3100,-54
23585,50000,40000,0,0,0,0,0,0,0,36679,2021,34658,0,16707,650,16057,0,17057,619,16438,0,17423,650,16773
23586,210000,168000,0,0,0,0,0,0,0,108857,6053,102804,0,103789,10036,93753,0,96250,6027,90223,0,95788,10028,85760
23587,210000,168000,0,0,0,0,0,0,-1,30853,1371,29482,0,13774,1000,12774,0,3988,11197,-7209,-1,0,0,0
23588,80000,64000,0,0,0,0,0,0,0,68502,10092,58410,0,27160,966,26194,0,27712,2000,25712,0,29245,2000,27245
23589,80000,64000,0,1,0,0,0,0,0,69200,5000,64200,0,44651,2000,42651,0,45185,2000,43185,0,45674,2000,43674
23590,480000,384000,0,0,0,0,0,1,0,400000,302000,98000,0,66270,66270,0,-1,80274,15000,65274,0,82160,3044,79116
23591,220000,176000,0,0,0,0,0,0,-1,5707,5738,-31,-1,2021,2041,-20,-1,15441,15516,-75,-1,7661,7697,-36
23592,290000,232000,0,0,0,0,0,0,0,36129,5017,31112,0,20369,509,19860,0,29521,29526,-5,-1,59219,35000,24219
23593,100000,80000,0,1,1,0,0,0,0,92297,4068,88229,0,184134,2037,182097,0,70400,1408,68992,0,0,0,0
23594,30000,24000,0,1,1,1,1,0,0,30300,1730,28570,0,29463,1154,28309,0,29531,1034,28497,0,29901,1212,28689
23595,200000,160000,0,0,0,0,0,1,2,0,0,0,2,560,560,0,-1,558,558,0,-1,558,0,558
23596,20000,16000,0,0,0,1,0,0,2,13536,2072,11464,0,17623,15000,2623,0,18662,1500,17162,0,10243,0,10243
23597,280000,224000,0,0,0,0,0,0,-2,8467,8467,0,-2,2510,2510,0,-2,591,591,0,-2,14994,14994,0
23598,130000,104000,0,0,0,0,0,0,2,7924,6210,1714,2,6210,0,6210,2,2560,0,2560,0,7380,7380,0
23599,130000,104000,0,0,0,0,0,0,0,23245,2000,21245,0,27410,5000,22410,0,12085,3000,9085,0,9535,6000,3535
23600,50000,40000,0,0,0,0,0,1,0,36025,2025,34000,0,0,0,0,0,0,0,0,-2,0,0,0
23601,310000,248000,0,0,0,0,0,0,0,62992,20000,42992,0,62473,2500,59973,0,69837,11056,58781,0,69898,3000,66898
23602,210000,168000,0,0,0,0,0,0,0,40236,40252,-16,-1,19011,19011,0,-1,-1031,0,-1031,-1,-4873,0,-4873
23603,220000,176000,0,0,0,0,0,0,-1,11086,11134,-48,-1,4564,4578,-14,-1,6549,6593,-44,-1,6413,6440,-27
23604,210000,168000,0,0,0,0,0,0,0,65847,2824,63023,0,46992,1757,45235,0,47073,1674,45399,0,47283,1717,45566
23605,170000,136000,0,0,0,0,0,0,0,39914,2000,37914,0,40559,1610,38949,0,41953,2200,39753,0,42210,1600,40610
23606,50000,40000,0,1,0,0,0,0,-2,51400,2400,49000,-2,9463,9463,0,-1,9661,350,9311,0,9854,353,9501
23607,50000,40000,0,0,0,0,0,0,-2,0,0,0,-2,0,0,0,-2,0,0,0,-2,0,0,0
23608,60000,48000,0,0,0,0,0,1,2,150,0,150,2,150,0,150,2,150,0,150,2,150,150,0
23609,210000,168000,0,1,0,0,0,0,0,209189,8601,200588,0,106090,3601,102489,0,108300,3719,104581,0,87404,3300,84104
23610,190000,152000,0,0,0,0,0,0,0,114791,9844,104947,0,106414,3283,103131,2,96980,24,96956,2,90700,3297,87403
23611,220000,176000,0,0,0,0,0,0,0,32355,2000,30355,0,31573,2000,29573,0,51279,30000,21279,0,53590,3000,50590
23612,210000,168000,0,0,0,0,0,0,-2,-200,0,-200,-2,0,200,-200,-2,2000,2000,0,-2,0,0,0
23613,310000,248000,0,0,0,0,0,0,-2,5641,5648,-7,-2,0,0,0,-2,0,0,0,-2,0,0,0
23614,500000,400000,0,0,0,0,0,0,0,73558,3200,70358,0,71055,1946,69109,0,61248,1734,59514,0,40737,2000,38737
23615,360000,288000,0,0,0,0,0,0,0,0,0,0,0,0,0,0,-2,0,0,0,-2,0,0,0
23616,110000,88000,0,0,0,0,0,0,0,73596,42000,31596,0,76938,5091,71847,0,47942,2026,45916,0,40963,3033,37930
23617,30000,24000,0,0,0,1,0,1,2,24424,1000,23424,2,24627,900,23727,2,24093,0,24093,2,24785,1094,23691
23618,90000,72000,0,1,0,0,0,0,0,78994,2602,76392,0,50095,2000,48095,0,48987,3000,45987,0,49519,2000,47519
23619,150000,120000,0,0,0,0,0,0,-1,381,0,381,2,-35,0,-35,2,1015,1050,-35,-1,33,0,33
23620,50000,40000,1,1,0,0,0,0,0,83908,3320,80588,0,18801,2000,16801,0,16494,1000,15494,0,19191,3000,16191
23621,120000,96000,0,0,0,0,0,0,-1,490,490,0,-1,1433,1433,0,-1,0,0,0,-1,1096,1096,0
23622,90000,72000,0,0,0,0,0,1,0,13349,1221,12128,0,14276,1148,13128,0,13904,0,13904,2,14184,510,13674
23623,50000,40000,0,0,0,0,0,0,0,40928,2104,38824,0,29367,990,28377,0,29156,1200,27956,0,27337,1654,25683
23624,180000,144000,0,0,0,0,0,1,-2,-18,0,-18,-2,-18,0,-18,-2,-18,0,-18,-2,-18,0,-18
23625,220000,176000,0,0,0,0,0,0,0,30490,3008,27482,0,44071,20000,24071,0,55405,20004,35401,0,63422,20000,43422
23626,350000,280000,0,0,0,0,0,0,0,82329,3300,79029,0,85252,4089,81163,0,76222,3000,73222,0,67243,2400,64843
23627,360000,288000,0,0,0,0,0,0,-2,0,0,0,-2,0,0,0,-2,1499,1499,0,-2,4001,4001,0
23628,30000,24000,0,1,1,1,0,0,0,27999,0,27999,2,28097,1000,27097,0,28670,573,28097,0,7770,1000,6770
23629,70000,56000,0,0,0,0,0,0,0,14692,1000,13692,2,14784,1000,13784,0,15175,1000,14175,0,16360,2000,14360
23630,50000,40000,0,0,0,0,0,0,0,15414,1300,14114,0,16349,2000,14349,0,15800,600,15200,0,14719,1000,13719
23631,140000,112000,0,0,0,0,0,0,-2,700,700,0,-2,3105,3105,0,-2,1259,1259,0,-2,700,700,0
23632,460000,368000,0,0,0,0,0,1,-1,289,290,-1,-1,44517,44558,-41,-1,36065,101,35964,0,6591,6621,-30
23633,50000,40000,0,1,1,1,1,0,0,49453,2110,47343,0,49827,2324,47503,0,48930,2000,46930,0,48748,1920,46828
23634,200000,160000,0,0,0,0,0,0,0,142735,8011,134724,0,149574,10800,138774,2,151108,5411,145697,2,142190,0,142190
23635,50000,40000,0,0,0,0,0,0,0,21604,1286,20318,0,14772,1200,13572,0,9238,332,8906,0,9588,500,9088
23636,50000,40000,0,1,0,0,0,0,2,48866,2400,46466,0,4372,1000,3372,0,-1203,0,-1203,0,49830,51830,-2000
23637,240000,192000,0,0,0,0,0,0,-2,3124,3124,0,-2,3162,3200,-38,-2,3162,3162,0,-2,3162,3162,0
23638,360000,288000,0,0,0,0,0,0,0,-229,0,-229,0,10527,10756,-229,-1,9564,5035,4529,0,0,0,0
23639,20000,16000,0,0,0,0,0,1,2,16856,1200,15656,0,16875,1000,15875,0,13454,0,13454,2,10104,1000,9104
23640,20000,16000,0,1,1,1,1,0,0,20546,1598,18948,0,20250,692,19558,0,19754,697,19057,0,19833,777,19056
23641,310000,248000,0,0,0,0,0,0,0,83632,2782,80850,0,81133,4013,77120,0,75499,2688,72811,0,73540,2651,70889
23642,240000,192000,0,0,0,0,0,0,-1,386,386,0,-1,579,386,193,2,386,0,386,0,193,0,193
23643,230000,184000,0,0,0,0,0,0,-1,669,669,0,-1,656,656,0,-1,827,827,0,-1,2360,2376,-16
23644,80000,64000,0,1,0,0,0,0,0,68579,2398,66181,0,50312,2000,48312,0,44277,2000,42277,0,44488,1700,42788
23645,50000,40000,1,1,0,0,0,1,3,50307,0,50307,2,27707,0,27707,0,28479,974,27505,0,28979,31100,-2121
23646,50000,40000,0,0,0,0,0,0,0,28754,1200,27554,0,29137,583,28554,0,-711,711,-1422,0,29578,30289,-711
23647,70000,56000,0,0,0,0,0,0,0,22437,1378,21059,0,23448,1389,22059,0,23914,855,23059,0,24415,885,23530
23648,50000,40000,0,1,0,0,0,0,0,45206,4656,40550,0,35892,25,35867,2,22989,2869,20120,2,22483,0,22483
23649,50000,40000,0,1,0,0,0,0,0,42162,2102,40060,0,6765,255,6510,0,19286,3000,16286,0,9558,191,9367
23650,10000,8000,0,0,0,0,0,0,0,6743,2000,4743,0,8544,2000,6544,0,9858,2000,7858,0,1303,1000,303
23651,300000,240000,0,0,0,0,0,0,-1,316,316,0,-1,17597,17597,0,-1,15257,2000,13257,0,9482,2690,6792
23652,100000,80000,0,0,0,0,0,0,-1,0,0,0,-1,6272,6272,0,-1,10135,4000,6135,0,11958,2000,9958
23653,110000,88000,0,1,1,1,1,0,0,108727,5507,103220,0,107381,4500,102881,0,106831,4502,102329,0,108305,4200,104105
23654,110000,88000,0,0,0,0,0,0,0,49156,1601,47555,0,46426,1500,44926,0,43765,1696,42069,0,41295,1658,39637
23655,130000,104000,0,0,0,0,0,1,2,68345,0,68345,2,72487,5900,66587,2,73591,2900,70691,2,75161,2900,72261
23656,410000,328000,0,0,0,0,0,0,-1,16813,16865,-52,-1,11080,11100,-20,-1,16595,16615,-20,-1,15843,15866,-23
23657,200000,160000,0,0,0,0,0,0,-1,16556,16556,0,-1,0,0,0,-1,0,0,0,-2,47140,47140,0
23658,110000,88000,0,1,0,0,0,1,0,100093,3680,96413,0,90437,3030,87407,0,75701,2701,73000,0,77013,2674,74339
23659,250000,200000,0,0,0,0,0,0,-1,29381,29403,-22,-1,56372,56692,-320,-1,34020,34055,-35,-1,4575,4575,0
23660,50000,40000,0,0,0,0,0,0,0,27862,2000,25862,0,21229,2000,19229,0,20178,1000,19178,0,19275,1000,18275
23661,120000,96000,0,0,0,0,0,0,-1,6531,6900,-369,-1,6313,5037,1276,0,1100,1100,0,-1,1330,1330,0
23662,160000,128000,0,0,0,0,0,0,0,1194,1202,-8,0,694,694,0,-2,1800,1800,0,-2,186,186,0
23663,180000,144000,0,0,0,0,0,0,-2,37424,37433,-9,-1,0,0,0,-1,5758,5758,0,-1,18091,18000,91
23664,30000,24000,0,0,0,0,0,0,0,3737,3836,-99,-1,0,0,0,-1,0,0,0,-2,22525,22525,0
23665,190000,152000,0,0,0,0,0,0,0,5869,3869,2000,0,29223,25128,4095,0,19616,10115,9501,0,148482,148482,0
23666,230000,184000,0,0,0,0,0,0,-2,0,0,0,-2,0,0,0,-2,0,0,0,-2,0,0,0
23667,180000,144000,0,0,0,0,0,0,-2,2611,2618,-7,-2,8710,8736,-26,-2,5127,5142,-15,-2,8758,8766,-8
23668,20000,16000,0,0,1,1,0,0,0,20215,20000,215,0,19298,1612,17686,0,19807,1121,18686,0,12294,702,11592
23669,200000,160000,0,0,0,0,0,0,-2,0,0,0,-2,0,0,0,-2,0,0,0,-2,0,0,0
23670,300000,240000,0,0,0,0,0,1,-2,0,0,0,-2,0,0,0,-2,0,0,0,-2,0,0,0
23671,290000,232000,0,0,0,0,0,0,0,167930,5600,162330,0,171146,5500,165646,0,174889,5500,169389,0,179149,6000,173149
23672,300000,240000,0,0,0,0,0,0,-1,290,290,0,-1,707,1209,-502,-1,161,0,161,2,7705,7705,0
23673,20000,16000,0,1,1,1,1,1,0,18335,1600,16735,0,18935,1200,17735,0,20624,2600,18024,0,20702,700,20002
23674,30000,24000,0,1,1,1,0,0,0,29002,2500,26502,0,26806,1500,25306,0,25948,1000,24948,0,22162,2000,20162
23675,80000,64000,0,1,1,1,1,0,0,76408,3400,73008,0,77435,2900,74535,0,79187,3045,76142,0,79696,6000,73696
23676,150000,120000,0,0,0,0,0,0,-2,11317,11322,-5,-2,14037,14042,-5,-2,12030,12030,0,-2,10738,10738,0
23677,140000,112000,0,0,0,0,0,1,-1,1251,1251,0,-1,0,0,0,-1,2106,2106,0,-1,652,652,0
23678,300000,240000,0,0,0,0,0,0,-2,0,0,0,-2,0,0,0,-2,0,0,0,-2,0,0,0
23679,50000,40000,0,1,0,0,0,1,0,48038,1310,46728,0,8760,1000,7760,0,9646,1000,8646,0,7747,277,7470
23680,200000,160000,0,0,0,0,0,0,0,64610,5000,59610,0,60567,2509,58058,0,52122,2000,50122,0,50610,2000,48610
23681,70000,56000,0,0,0,0,0,1,0,27484,2000,25484,0,28526,2000,26526,0,30053,2000,28053,0,30379,2000,28379
23682,220000,176000,0,0,0,0,0,0,-2,6189,6203,-14,-1,1850,1850,0,-1,6938,6938,0,-1,5034,101,4933
23683,20000,16000,0,0,0,0,0,0,-1,0,0,0,-1,780,780,0,-1,0,0,0,-1,0,0,0
23684,50000,40000,0,0,0,0,0,0,0,30361,2000,28361,0,22266,5000,17266,0,18469,6560,11909,0,21551,10000,11551
23685,140000,112000,0,0,0,0,0,1,2,31785,5000,26785,2,30980,0,30980,2,33162,3000,30162,2,32497,0,32497
23686,120000,96000,0,0,0,0,0,0,2,1350,1350,0,-1,900,0,900,0,450,0,450,0,0,0,0
23687,160000,128000,0,1,0,0,0,0,0,143564,6882,136682,0,130860,6307,124553,0,122188,4730,117458,0,79360,2874,76486
23688,50000,40000,0,0,0,0,0,0,0,16002,1033,14969,0,6120,122,5998,0,3910,78,3832,0,299,299,0
23689,240000,192000,0,0,0,0,0,1,0,62848,34,62814,2,60645,4400,56245,2,57554,0,57554,2,57375,2000,55375
23690,300000,240000,0,0,0,0,0,0,0,9728,1010,8718,0,28960,42348,-13388,-1,26589,0,26589,0,18171,0,18171
23691,20000,16000,0,0,0,0,0,0,0,2935,2938,-3,-1,5909,6039,-130,-1,0,0,0,-1,0,0,0
23692,120000,96000,0,0,0,0,0,0,0,89657,3103,86554,0,41720,1800,39920,0,29022,2381,26641,0,28422,0,28422
23693,200000,160000,0,0,0,0,0,0,-2,505,505,0,-2,0,0,0,-2,0,0,0,-2,0,0,0
23694,290000,232000,0,0,0,0,0,0,0,18231,1303,16928,0,18593,665,17928,0,18986,692,18294,0,19967,1300,18667
23695,210000,168000,0,0,0,0,0,0,-1,0,0,0,-2,0,0,0,-2,0,0,0,-2,0,0,0
23696,300000,240000,0,0,0,0,0,0,0,5045,5045,0,-1,10288,10288,0,-1,12565,5000,7565,0,6947,5000,1947
23697,80000,64000,0,0,0,0,0,0,0,62779,3000,59779,0,634,1000,-366,-1,892,1000,-108,-1,412,412,0
23698,50000,40000,0,0,0,0,0,0,0,3469,1200,2269,0,2121,1000,1121,0,821,0,821,0,3821,3000,821
23699,90000,72000,0,0,0,0,0,0,0,18496,1300,17196,0,11716,2000,9716,0,3163,67,3096,0,30483,30483,0
23700,60000,48000,0,0,0,0,0,0,0,15177,2000,13177,0,16610,2000,14610,0,16821,628,16193,0,20048,3525,16523
23701,20000,16000,0,0,0,0,0,0,0,-202,202,-404,0,-202,0,-202,-2,950,1152,-202,-2,0,0,0
23702,170000,136000,0,0,0,0,0,1,-1,-103,0,-103,-2,-103,0,-103,-2,-103,0,-103,-2,2297,2400,-103
23703,210000,168000,0,0,0,0,0,0,0,113725,6000,107725,0,113779,5000,108779,0,114594,4000,110594,0,103205,4000,99205
23704,590000,472000,0,0,0,0,0,1,-2,0,0,0,-2,1387,1387,0,-1,2206,1000,1206,0,3014,1000,2014
23705,500000,400000,0,0,0,0,0,1,-1,15091,15091,0,-1,1587,1587,0,-1,61385,61385,0,-1,56252,0,56252
23706,400000,320000,0,0,0,0,0,0,-1,20192,20192,0,-1,17337,17337,0,-1,5396,0,5396,0,516,516,0
23707,100000,80000,0,0,0,0,0,0,0,33049,2000,31049,0,33112,1300,31812,0,0,0,0,0,715,715,0
23708,80000,64000,0,0,0,0,0,0,0,57030,3010,54020,0,56576,4000,52576,0,53819,5000,48819,0,48604,3000,45604
23709,260000,208000,0,0,0,0,0,1,-1,2287,2287,0,-1,1050,0,1050,2,1050,1050,0,-1,1050,1050,0
23710,170000,136000,0,0,0,0,0,0,-1,49771,50026,-255,-1,30929,31023,-94,-1,31429,20157,11272,0,14170,14233,-63
23711,440000,352000,0,0,0,0,0,1,2,226731,10000,216731,0,231456,10000,221456,0,237707,10000,227707,0,243555,10000,233555
23712,150000,120000,1,1,0,0,0,1,0,164830,7103,157727,0,95000,3000,92000,0,98000,3000,95000,0,100000,2000,98000
23713,20000,16000,0,0,0,0,0,1,2,13109,2716,10393,2,12602,0,12602,2,13093,700,12393,0,13433,700,12733
23714,260000,208000,0,0,0,0,0,1,-2,0,0,0,-2,0,0,0,-2,0,0,0,-2,0,0,0
23715,30000,24000,0,0,0,0,0,0,-1,390,390,0,-1,390,390,0,-1,0,0,0,-1,780,780,0
23716,220000,176000,0,0,0,0,0,0,0,140391,7000,133391,0,140549,5006,135543,0,140303,6000,134303,0,140737,6312,134425
23717,200000,160000,0,0,0,0,0,0,0,22869,22946,-77,-1,30268,30684,-416,-1,54466,54589,-123,-1,37127,37208,-81
23718,50000,40000,0,0,0,0,0,1,0,14015,1300,12715,0,14293,511,13782,0,14763,700,14063,0,14968,600,14368
23719,80000,64000,0,0,0,0,0,0,-1,600,500,100,0,1438,1000,438,0,1919,500,1419,0,5380,3500,1880
23720,10000,8000,0,0,0,0,0,1,2,6946,0,6946,2,5863,450,5413,2,4180,0,4180,2,4322,600,3722
23721,150000,120000,0,0,0,0,0,0,-1,49200,49200,0,-1,50000,1000,49000,0,0,0,0,0,50000,50000,0
23722,280000,224000,0,0,0,0,0,0,0,2173,10,2163,2,-9,0,-9,2,-9,0,-9,-2,3617,3626,-9
23723,30000,24000,0,0,0,0,0,0,-1,9000,9000,0,-1,0,0,0,-1,0,0,0,-2,5394,5394,0
23724,290000,232000,0,0,0,0,0,0,0,174184,6900,167284,0,163792,6733,157059,0,120754,5632,115122,0,236402,235024,1378
23725,50000,40000,0,0,0,0,0,0,0,0,300,-300,0,0,0,0,-2,0,0,0,-2,0,0,0
23726,200000,160000,0,0,0,0,0,0,-2,389,390,-1,-2,389,390,-1,-2,389,390,-1,-2,389,390,-1
23727,20000,16000,0,1,1,1,0,0,3,19400,0,19400,2,20000,1000,19000,0,20000,0,20000,0,0,0,0
23728,350000,280000,0,0,0,0,0,0,0,48631,1989,46642,0,48351,1591,46760,0,47939,1466,46473,0,33827,2000,31827
23729,20000,16000,0,0,0,1,0,1,0,14654,1246,13408,0,16712,2304,14408,0,16149,0,16149,2,18112,2390,15722
23730,120000,96000,0,0,0,0,0,0,0,-1843,1843,-3686,0,45041,46884,-1843,-2,45453,1296,44157,-2,42065,7000,35065
23731,110000,88000,1,1,1,1,1,0,0,125852,4400,121452,0,118254,4300,113954,0,120537,4205,116332,0,112021,4500,107521
23732,80000,64000,0,0,0,0,0,0,2,59587,2400,57187,2,60997,3000,57997,0,62856,3000,59856,0,66897,5100,61797
23733,140000,112000,0,0,0,0,0,1,-1,3074,3668,-594,-1,594,0,594,0,0,0,0,0,0,0,0
23734,130000,104000,0,1,0,0,0,0,0,122267,5088,117179,0,96800,4180,92620,0,58170,2035,56135,0,57483,3009,54474
23735,240000,192000,0,0,0,0,0,0,-1,21790,21817,-27,-1,17102,1120,15982,0,13367,13434,-67,-1,22659,22772,-113
23736,50000,40000,1,1,0,0,0,1,0,56266,3032,53234,0,39545,1668,37877,0,19856,1500,18356,0,19765,1805,17960
23737,60000,48000,0,0,0,0,0,0,2,41140,0,41140,2,42110,1655,40455,0,42988,1707,41281,0,43841,1718,42123
23738,120000,96000,0,0,0,0,0,1,-1,639,0,639,2,621,621,0,-1,-18,0,-18,-1,-18,0,-18
23739,200000,160000,0,0,0,0,0,1,2,1891,1891,0,-1,0,0,0,-1,1908,1908,0,-1,290,290,0
23740,330000,264000,0,0,0,0,0,0,0,138277,4723,133554,0,141453,5500,135953,0,112633,4000,108633,0,121242,10700,110542
23741,30000,24000,0,0,0,0,0,1,3,12408,500,11908,2,11912,0,11912,2,13707,2000,11707,2,14328,1000,13328
23742,380000,304000,0,0,0,0,0,0,-1,4686,4700,-14,-1,2363,2382,-19,-1,2416,2423,-7,-1,4718,4732,-14
23743,20000,16000,0,0,0,0,0,0,0,9867,1174,8693,0,11929,2236,9693,0,12091,500,11591,2,12245,500,11745
23744,150000,120000,0,0,0,0,0,0,-2,4724,4724,0,-2,5749,5749,0,-2,345,345,0,-2,349,349,0
23745,50000,40000,0,0,0,0,0,1,2,9572,1800,7772,2,9281,0,9281,2,8835,400,8435,0,9038,350,8688
23746,30000,24000,0,0,1,1,1,0,2,25647,3128,22519,2,24937,0,24937,2,26938,2419,24519,2,26374,0,26374
23747,30000,24000,0,0,0,0,0,1,3,20424,1000,19424,4,20601,786,19815,4,19992,0,19992,4,19392,0,19392
23748,50000,40000,0,0,0,0,0,1,3,22740,0,22740,2,2314,0,2314,0,1823,1823,0,-1,18839,18839,0
23749,20000,16000,0,0,0,0,0,0,0,11608,1500,10108,0,12313,1000,11313,0,12848,1500,11348,0,800,800,0
23750,50000,40000,0,1,0,0,0,0,0,43238,1811,41427,0,17253,594,16659,0,16307,587,15720,0,16651,1000,15651
23751,50000,40000,0,0,0,0,0,0,0,26999,3000,23999,0,27748,1500,26248,0,28351,1200,27151,0,28864,1136,27728
23752,100000,80000,0,1,1,1,1,0,0,101879,4000,97879,0,100999,4000,96999,0,101188,4000,97188,0,99328,4000,95328
23753,20000,16000,0,0,0,0,0,0,-2,1568,1568,0,-1,1398,1000,398,0,920,302,618,0,0,0,0
23754,200000,160000,0,0,0,0,0,0,-1,1520,1520,0,-1,413,413,0,-1,150,300,-150,-1,150,0,150
23755,90000,72000,0,1,0,0,0,1,2,90719,4183,86536,0,39902,1600,38302,0,39200,1280,37920,0,38531,1310,37221
23756,90000,72000,0,0,0,0,0,1,0,55426,2597,52829,0,56544,2637,53907,0,57048,2041,55007,0,58421,2291,56130
23757,350000,280000,0,0,0,0,0,0,-1,291,291,0,-1,291,291,0,-1,291,291,0,-1,291,291,0
23758,180000,144000,0,1,1,1,1,0,0,180439,6573,173866,0,182958,6506,176452,0,181287,6581,174706,0,179734,6801,172933
23759,80000,64000,0,0,0,0,0,0,0,34038,1200,32838,0,33231,0,33231,0,33440,816,32624,0,5513,365,5148
23760,200000,160000,0,0,0,0,0,0,-1,0,0,0,-2,0,0,0,-2,0,0,0,-2,11700,11700,0
23761,200000,160000,0,0,0,0,0,0,-2,0,0,0,-2,932,932,0,-2,2469,2487,-18,-1,0,0,0
23762,50000,40000,0,0,0,0,0,1,2,14242,0,14242,2,13968,426,13542,0,14319,501,13818,0,2614,2614,0
23763,490000,392000,0,0,0,0,0,0,-2,0,0,0,-2,0,0,0,-2,163,163,0,-2,1256,1256,0
23764,70000,56000,0,1,1,1,1,0,0,71442,3504,67938,0,68144,2620,65524,0,68671,2791,65880,0,68863,2639,66224
23765,360000,288000,0,0,0,0,0,0,-1,19703,19764,-61,-1,7474,37,7437,0,2741,2752,-11,-1,9526,9573,-47
23766,300000,240000,0,0,0,0,0,0,0,44508,6000,38508,0,67484,30000,37484,0,500,500,0,-1,7391,7391,0
23767,130000,104000,0,0,0,0,0,0,0,66370,3000,63370,0,43882,2500,41382,0,41063,4100,36963,0,29215,0,29215
23768,140000,112000,0,0,0,0,0,0,0,76098,2169,73929,0,50419,1651,48768,0,47202,2122,45080,0,43946,3006,40940
23769,50000,40000,0,1,0,0,0,0,0,50380,2500,47880,0,19144,644,18500,0,17625,628,16997,0,17246,642,16604
23770,140000,112000,0,1,0,0,0,0,0,137635,5200,132435,0,97928,3100,94828,0,99634,3200,96434,0,101020,3400,97620
23771,210000,168000,0,0,0,0,0,0,0,-9,0,-9,-2,3231,3240,-9,-1,125140,125009,131,0,124880,5009,119871
23772,90000,72000,0,0,0,0,0,0,0,0,0,0,0,0,0,0,-2,2522,2522,0,-1,2575,94,2481
23773,130000,104000,0,0,0,0,0,0,0,41324,1700,39624,0,25629,2000,23629,0,26961,2000,24961,0,28360,1500,26860
23774,100000,80000,0,0,0,0,0,1,2,3000,3000,0,-1,2000,0,2000,0,1000,0,1000,0,1150,1150,0
23775,360000,288000,0,0,0,0,0,0,-2,2317,2322,-5,-2,2482,2482,0,-2,1415,1417,-2,-2,2095,2095,0
23776,180000,144000,0,1,0,0,0,0,0,180382,6208,174174,0,132104,3749,128355,0,129772,4365,125407,0,124734,4517,120217
23777,260000,208000,0,0,0,0,0,0,-1,1497,1501,-4,-1,-3,0,-3,-1,2138,2141,-3,-1,900,902,-2
23778,30000,24000,0,1,1,0,0,1,2,24441,0,24441,2,24441,0,24441,0,11255,0,11255,0,0,0,0
23779,50000,40000,0,0,0,0,0,0,-1,-639,0,-639,-1,1559,3000,-1441,-1,-205,0,-205,-1,613,2000,-1387
23780,70000,56000,0,1,1,1,0,0,0,65443,3224,62219,0,65169,1680,63489,0,64370,3000,61370,0,15082,142,14940
23781,20000,16000,0,0,0,0,0,0,2,1716,0,1716,2,929,0,929,0,978,978,0,-1,0,0,0
23782,150000,120000,0,0,0,0,0,0,-2,0,0,0,-2,0,0,0,-2,0,0,0,-2,0,0,0
23783,100000,80000,0,0,0,0,0,0,0,81293,3000,78293,0,66435,3000,63435,0,64975,3000,61975,0,66951,3000,63951
23784,390000,312000,0,0,0,0,0,0,-1,0,0,0,-1,0,0,0,-2,0,0,0,-2,100000,100000,0
23785,130000,104000,0,0,0,0,0,0,0,57122,3000,54122,0,56003,4000,52003,0,57992,4000,53992,0,61049,4000,57049
23786,220000,176000,0,1,1,1,0,0,0,217461,8200,209261,0,212995,7039,205956,0,182534,6528,176006,0,169250,6100,163150
23787,180000,144000,0,0,0,0,0,0,0,134817,6000,128817,0,52629,1900,50729,0,51543,1680,49863,0,52781,1900,50881
23788,50000,40000,0,0,0,0,0,0,-2,3754,3754,0,-2,11985,12053,-68,-2,19332,19332,0,-2,0,0,0
23789,70000,56000,0,0,0,0,0,0,2,21868,1379,20489,0,13514,1500,12014,0,14303,1000,13303,0,14211,1000,13211
23790,200000,160000,0,0,0,0,0,0,-1,1898,3796,-1898,-1,849,849,0,-1,-171,0,-171,-1,14686,14857,-171
23791,180000,144000,0,0,0,0,0,0,0,6930,3000,3930,0,6090,2018,4072,0,2435,1200,1235,0,2074,1500,574
23792,30000,24000,0,0,0,0,0,0,2,13861,5000,8861,2,13344,0,13344,2,13972,1000,12972,0,18735,5000,13735
23793,190000,152000,0,1,0,0,0,0,0,166982,6000,160982,0,155621,6000,149621,0,142439,10000,132439,0,133742,5000,128742
23794,70000,56000,0,0,0,0,0,0,0,27874,2000,25874,0,28439,955,27484,0,26590,3000,23590,0,29043,3000,26043
23795,210000,168000,0,0,0,0,0,0,0,29883,1509,28374,0,30447,1469,28978,0,30803,1221,29582,0,29820,1100,28720
23796,60000,48000,0,0,0,0,0,0,0,23027,1206,21821,0,12947,259,12688,0,390,390,0,-1,700,700,0
23797,80000,64000,0,1,0,0,0,0,0,76792,3000,73792,0,61435,3000,58435,0,26516,1500,25016,0,27215,1500,25715
23798,130000,104000,0,0,0,0,0,0,0,46405,3005,43400,0,44342,1603,42739,0,45641,3022,42619,0,40945,1005,39940
23799,200000,160000,0,0,0,0,0,0,-2,0,0,0,-2,0,0,0,-2,0,0,0,-2,0,0,0
23800,420000,336000,0,0,0,0,0,0,0,25056,1407,23649,0,24751,1332,23419,0,24984,963,24021,0,24983,877,24106
23801,200000,160000,0,0,0,0,0,1,-2,0,0,0,-2,0,0,0,-2,0,0,0,-2,0,0,0
23802,80000,64000,0,0,0,0,0,0,0,5097,3000,2097,0,6107,1500,4607,0,7141,1500,5641,0,7355,700,6655
23803,140000,112000,0,1,1,1,1,1,2,135309,7000,128309,2,131671,0,131671,2,138771,10800,127971,2,141146,4800,136346
23804,30000,24000,0,0,0,0,0,1,0,21867,1800,20067,0,24291,3100,21191,0,23766,0,23766,2,23696,565,23131
23805,80000,64000,0,0,0,0,0,0,0,46685,3000,43685,0,35760,5000,30760,0,33853,5000,28853,0,35708,3000,32708
23806,200000,160000,0,1,1,1,1,0,2,175281,7500,167781,2,177895,7000,170895,2,180078,6600,173478,2,184048,7000,177048
23807,60000,48000,0,0,0,0,0,0,-1,390,390,0,-1,150,150,0,-1,1320,1560,-240,-1,780,0,780
23808,500000,400000,0,0,0,0,0,0,-2,9350,9350,0,-2,6972,6972,0,-2,11879,11879,0,-2,15574,15574,0
23809,20000,16000,0,1,1,1,1,0,0,18825,1416,17409,0,19876,1467,18409,0,20040,631,19409,0,17755,730,17025
23810,20000,16000,0,0,0,0,0,0,0,5831,5831,0,-1,14784,14784,0,-1,961,961,0,-1,311,0,311
23811,180000,144000,0,0,0,0,0,1,2,36322,0,36322,2,38808,3405,35403,2,39474,1600,37874,2,40297,1600,38697
23812,160000,128000,0,0,0,0,0,1,0,79594,3000,76594,0,49777,1000,48777,0,327,0,327,0,222,222,0
23813,150000,120000,0,0,0,0,0,0,-2,4975,4975,0,-2,3960,5017,-1057,-2,2914,2914,0,-2,1068,1250,-182
23814,180000,144000,0,0,0,0,0,0,2,0,0,0,2,0,0,0,-2,0,0,0,-2,0,0,0
23815,320000,256000,0,0,0,0,0,1,-1,3479,3479,0,-1,12610,12610,0,-1,23942,15000,8942,0,34183,14184,19999
23816,50000,40000,0,1,0,0,0,0,0,49736,1161,48575,0,17599,510,17089,0,16753,503,16250,0,10582,500,10082
23817,260000,208000,0,0,0,0,0,0,-1,4134,7388,-3254,-1,792,792,0,-1,1309,1312,-3,-1,2557,2564,-7
23818,110000,88000,0,0,0,0,0,0,0,42867,0,42867,2,43875,2000,41875,0,45036,2000,43036,0,46319,2180,44139
23819,60000,48000,0,0,0,0,0,0,-2,0,0,0,-2,619,619,0,-1,39224,39224,0,-1,34881,1500,33381
23820,100000,80000,0,0,0,0,0,0,-1,291,291,0,-1,291,291,0,-1,291,291,0,-1,502,502,0
23821,180000,144000,0,0,0,0,0,0,0,135592,7000,128592,0,107315,5200,102115,0,56274,2000,54274,0,57608,2060,55548
23822,10000,8000,0,0,0,0,0,1,-1,12,0,12,-1,12,0,12,-1,12,0,12,-1,12,0,12
23823,230000,184000,0,0,0,0,0,0,0,135520,10084,125436,0,102518,5091,97427,0,129195,70063,59132,0,101717,4037,97680
23824,30000,24000,0,0,0,0,0,0,0,5540,1128,4412,0,4605,1000,3605,0,2880,58,2822,0,2516,2516,0
23825,60000,48000,0,0,0,0,0,0,2,6770,1000,5770,0,6880,1000,5880,0,5021,2000,3021,0,4952,2000,2952
23826,120000,96000,0,1,0,1,1,0,0,118405,6000,112405,0,99081,4000,95081,0,106300,9000,97300,0,104433,0,104433
23827,240000,192000,0,0,0,0,0,0,-2,0,0,0,-2,0,0,0,-2,0,0,0,-2,0,0,0
23828,20000,16000,0,0,0,0,0,0,-1,137,137,0,-1,1714,5199,-3485,2,17694,17694,0,-1,12237,575,11662
23829,20000,16000,0,0,0,0,0,0,0,10860,2600,8260,0,12380,2000,10380,2,11400,0,11400,2,0,0,0
23830,250000,200000,0,0,0,0,0,0,-1,440,441,-1,-1,440,440,0,-1,880,880,0,-1,440,0,440
23831,120000,96000,0,1,1,1,1,0,2,113662,11000,102662,2,110349,0,110349,2,112036,5000,107036,0,114584,4332,110252
23832,80000,64000,0,0,0,0,0,0,0,64814,4000,60814,0,66796,4000,62796,0,41622,2000,39622,0,46002,5000,41002
23833,160000,128000,0,0,0,0,0,1,2,97251,4385,92866,0,98010,3639,94371,0,99669,3762,95907,0,101664,3800,97864
23834,200000,160000,0,0,0,0,0,1,0,116355,6000,110355,0,117802,5000,112802,0,116296,6000,110296,0,60792,3000,57792
23835,200000,160000,0,0,0,0,0,0,0,141821,6000,135821,0,145144,6000,139144,0,148268,6000,142268,0,151604,6000,145604
23836,200000,160000,0,1,0,0,0,0,0,200912,9000,191912,0,145658,6000,139658,0,146351,6000,140351,0,149667,6000,143667
23837,340000,272000,0,0,0,0,0,0,-2,0,0,0,-2,1888,1888,0,-1,4777,4777,0,-1,4752,4752,0
23838,180000,144000,0,0,0,0,0,0,-1,21073,21100,-27,-1,12159,0,12159,0,8418,0,8418,0,6896,6896,0
23839,450000,360000,0,0,0,0,0,0,-2,326,326,0,-2,4007,4007,0,-2,0,0,0,-2,0,0,0
23840,150000,120000,0,0,0,0,0,0,-1,4044,4156,-112,-1,594,600,-6,-2,0,0,0,-2,0,0,0
23841,230000,184000,0,0,0,0,0,0,0,-26,0,-26,-2,90624,90650,-26,-2,92624,2000,90624,-2,-89,89,-178
23842,70000,56000,0,0,0,1,1,0,0,55961,5000,50961,0,63341,10000,53341,0,64694,3000,61694,0,67905,5000,62905
23843,100000,80000,0,0,0,0,0,0,0,856,1000,-144,-1,-1267,0,-1267,-1,-363,5100,-5463,-2,-2389,0,-2389
23844,240000,192000,0,0,0,0,0,0,0,17833,1000,16833,0,194043,194043,0,-1,194991,6530,188461,0,192800,7000,185800
23845,60000,48000,0,0,0,0,0,0,0,27420,1500,25920,0,27965,1001,26964,0,28552,1038,27514,0,29276,1200,28076
23846,160000,128000,0,0,0,0,0,0,0,7035,1000,6035,0,4596,500,4096,0,4635,1000,3635,0,2744,1000,1744
23847,240000,192000,0,0,0,0,0,0,-2,3227,3236,-9,-2,4039,4051,-12,-2,1776,1781,-5,-2,1513,1517,-4
23848,50000,40000,0,0,0,0,0,0,0,10527,1500,9027,0,10679,1000,9679,0,10734,1000,9734,0,11550,1000,10550
23849,160000,128000,0,0,0,0,0,0,-2,-18,0,-18,-2,-18,0,-18,-2,-18,0,-18,-2,-18,0,-18
23850,180000,144000,0,0,0,0,0,0,-2,6572,6583,-11,-2,3179,3179,0,-2,11875,18462,-6587,-2,7633,7633,0
23851,70000,56000,0,1,1,0,0,0,0,72227,3800,68427,0,71078,3200,67878,0,50777,1950,48827,0,50841,2000,48841
23852,370000,296000,0,0,0,0,0,0,0,15840,5000,10840,0,20542,5000,15542,0,25255,5000,20255,0,30034,5000,25034
23853,150000,120000,0,0,0,0,0,0,-2,1793,1801,-8,-2,0,0,0,-2,0,0,0,-2,0,0,0
23854,30000,24000,0,0,0,0,0,0,0,12906,1215,11691,0,13162,471,12691,0,13438,488,12950,0,13705,491,13214
23855,180000,144000,0,0,0,0,0,0,-1,550,550,0,-1,99,99,0,-1,0,0,0,-1,0,0,0
23856,450000,360000,0,0,0,0,0,0,-1,2370,0,2370,2,2823,2243,580,0,2243,0,2243,0,4322,4322,0
23857,360000,288000,0,0,0,0,0,0,-1,2277,2282,-5,-2,500,500,0,-2,3586,3586,0,-2,7399,7399,0
23858,50000,40000,0,0,0,0,0,1,2,300,0,300,2,300,0,300,7,300,0,300,7,300,0,300
23859,280000,224000,0,0,0,0,0,0,0,98301,4033,94268,0,74624,3000,71624,0,75173,3300,71873,0,77419,3500,73919
23860,40000,32000,0,1,1,1,1,1,0,39706,1601,38105,0,36431,1587,34844,0,37154,1310,35844,0,37306,1510,35796
23861,110000,88000,0,1,1,1,1,1,2,105676,3800,101876,2,106506,4000,102506,2,103591,0,103591,2,109276,8800,100476
23862,380000,304000,0,0,0,0,0,0,-1,2956,2982,-26,-1,316,316,0,-1,316,316,0,-2,312,312,0
23863,100000,80000,0,0,0,0,0,1,2,-2106,0,-2106,2,8538,10644,-2106,-1,390,0,390,0,150,150,0
23864,290000,232000,0,0,0,0,0,0,-1,2948,2980,-32,-1,-6097,2777,-8874,-1,11037,17941,-6904,-1,17834,10002,7832
23865,80000,64000,0,0,0,0,0,0,0,19100,1200,17900,0,14600,0,14600,0,9000,0,9000,0,2000,2000,0
23866,160000,128000,0,0,0,0,0,0,-1,390,390,0,-1,390,390,0,-1,390,390,0,-1,390,390,0
23867,250000,200000,0,1,1,0,0,0,0,249882,10866,239016,0,248013,5592,242421,0,99071,2212,96859,0,98928,2565,96363
23868,250000,200000,0,0,0,0,0,0,-1,2200,2200,0,-1,3772,3772,0,-1,8650,8650,0,-1,17650,10000,7650
23869,330000,264000,0,0,0,0,0,0,0,24164,1522,22642,0,25042,1400,23642,0,25665,1000,24665,0,24059,820,23239
23870,390000,312000,0,1,0,0,0,1,0,373181,16525,356656,0,252195,8893,243302,0,257496,9229,248267,0,263018,10000,253018
23871,160000,128000,0,0,0,0,0,0,-1,8632,8641,-9,-1,25234,20012,5222,0,21234,62,21172,0,567,1,566
23872,80000,64000,0,1,1,0,0,0,0,72883,2727,70156,0,67337,3170,64167,0,60807,1940,58867,0,59088,2200,56888
23873,200000,160000,0,1,1,1,1,0,0,178604,6501,172103,0,181878,6500,175378,0,182444,6504,175940,0,185250,7008,178242
23874,220000,176000,0,0,0,0,0,1,0,31387,1534,29853,0,32559,1700,30859,0,35019,3000,32019,0,37422,3000,34422
23875,80000,64000,0,0,0,0,0,0,-2,390,390,0,-2,390,390,0,-2,390,390,0,-2,930,930,0
23876,50000,40000,0,0,0,0,0,0,0,11312,2700,8612,0,13112,2000,11112,0,13394,500,12894,0,14176,1000,13176
23877,160000,128000,0,0,0,0,0,0,-2,369,369,0,-1,0,0,0,-1,522,522,0,-1,0,0,0
23878,210000,168000,0,0,0,0,0,0,-1,0,0,0,-2,0,0,0,-2,0,0,0,-2,14202,14202,0
23879,70000,56000,0,1,0,0,0,0,0,69520,3500,66020,0,51605,2000,49605,0,50311,2000,48311,0,50729,2500,48229
23880,360000,288000,0,0,0,0,0,1,-2,0,0,0,-2,0,0,0,-2,0,0,0,-2,0,0,0
23881,250000,200000,0,0,0,0,0,0,0,15450,16000,-550,-1,1867,0,1867,0,-1,1,-2,0,-1,0,-1
23882,500000,400000,0,0,0,0,0,1,0,334227,11000,323227,0,145482,4500,140982,0,125936,4000,121936,0,91382,4000,87382
23883,390000,312000,0,0,0,0,0,0,0,15428,1500,13928,0,13465,1000,12465,0,40736,30000,10736,0,39532,2000,37532
23884,220000,176000,0,1,1,0,0,0,0,222830,18000,204830,0,195121,7000,188121,0,169396,6000,163396,0,173875,7000,166875
23885,160000,128000,0,0,0,0,0,0,-1,1672,1672,0,-1,836,0,836,0,836,836,0,-1,836,836,0
23886,20000,16000,0,1,1,0,0,1,0,19933,1300,18633,0,17331,390,16941,0,12822,388,12434,0,19924,10000,9924
23887,90000,72000,0,0,0,0,0,0,0,11227,16926,-5699,-1,4000,4000,0,-1,5000,6000,-1000,-1,10327,10327,0
23888,60000,48000,0,1,0,0,0,0,2,56473,0,56473,2,28603,1135,27468,0,22191,1822,20369,0,20750,1500,19250
23889,70000,56000,0,1,1,0,0,1,0,70012,3239,66773,0,66541,3405,63136,0,31609,1085,30524,0,31259,1102,30157
23890,380000,304000,0,0,0,0,0,0,-1,4090,4090,0,-1,9471,9476,-5,-1,1993,1993,0,-1,1164,1164,0
23891,50000,40000,0,0,0,0,0,1,3,38838,1700,37138,2,39598,1700,37898,2,40313,1500,38813,2,41293,1800,39493
23892,180000,144000,0,0,0,0,0,0,-1,759,759,0,-1,1042,1000,42,0,796,796,0,-1,547,0,547
23893,140000,112000,0,0,0,0,0,1,0,59571,2200,57371,0,60793,2200,58593,0,62797,3000,59797,0,64298,2500,61798
23894,360000,288000,0,0,0,0,0,0,-2,0,0,0,-2,0,0,0,-2,0,0,0,-2,0,0,0
23895,350000,280000,0,0,0,0,0,0,-1,12952,12991,-39,-1,39274,39278,-4,-1,5474,6000,-526,-1,14837,14837,0
23896,330000,264000,0,1,1,1,1,1,0,323182,13120,310062,0,325197,12833,312364,0,327750,14344,313406,2,321936,8567,313369
23897,50000,40000,0,0,0,0,0,0,-2,10188,10294,-106,-2,2277,2284,-7,-2,18488,18546,-58,-2,10263,11294,-1031
23898,120000,96000,0,0,0,0,0,1,-1,240,240,0,-1,240,240,0,-1,240,240,0,-1,240,240,0
23899,360000,288000,0,0,0,0,0,1,-1,-27,0,-27,-2,-27,0,-27,-2,-27,0,-27,-2,-27,0,-27
23900,50000,40000,0,0,0,0,0,0,0,24488,1488,23000,0,25775,1775,24000,0,1080,1080,0,-1,540,0,540
23901,310000,248000,0,0,0,0,0,0,-1,3050,3072,-22,-1,9080,9100,-20,-1,4990,23,4967,0,4940,4964,-24
23902,30000,24000,0,0,0,1,0,0,0,23557,2000,21557,0,24764,2000,22764,0,25234,1000,24234,0,14852,1000,13852
23903,230000,184000,0,0,0,0,0,0,-1,998,1000,-2,-1,-1,0,-1,-1,999,1000,-1,-1,0,0,0
23904,170000,136000,0,0,0,0,0,0,0,103021,3632,99389,0,99219,3494,95725,0,99179,3620,95559,0,99902,3800,96102
23905,360000,288000,0,0,0,0,0,0,0,0,0,0,0,0,0,0,-2,0,0,0,-2,0,0,0
23906,50000,40000,0,0,0,0,0,0,0,25226,1424,23802,0,26238,1436,24802,0,26760,958,25802,0,27318,989,26329
23907,190000,152000,0,1,1,1,1,1,2,163684,8150,155534,2,166163,6500,159663,2,168592,6500,162092,2,171923,6000,165923
23908,20000,16000,0,1,1,1,1,1,2,20018,1000,19018,2,20427,1000,19427,0,19377,1500,17877,0,19386,900,18486
23909,210000,168000,0,0,0,0,0,0,0,8792,1500,7292,0,9189,1000,8189,0,4404,500,3904,0,5708,2000,3708
23910,240000,192000,0,1,1,0,0,0,0,230666,10000,220666,0,219162,8000,211162,0,189589,10000,179589,0,193546,6531,187015
23911,50000,40000,0,0,0,0,0,0,2,4167,2000,2167,0,5438,1500,3938,0,6193,1000,5193,0,6939,1000,5939
23912,50000,40000,0,1,0,0,0,1,2,47884,2354,45530,0,29506,1410,28096,0,3672,1500,2172,0,8346,4900,3446
23913,110000,88000,0,0,0,0,0,0,0,85761,5000,80761,0,87336,4000,83336,0,39025,3700,35325,0,40242,2000,38242
23914,90000,72000,0,1,0,0,0,1,0,86302,3500,82802,0,67592,3000,64592,0,69518,3000,66518,0,68228,3000,65228
23915,210000,168000,0,0,0,0,0,0,-1,46884,46915,-31,-1,80514,80871,-357,-1,391,391,0,-1,1487,1497,-10
23916,130000,104000,0,0,0,0,0,0,0,70947,2575,68372,0,72367,2600,69767,0,73875,2674,71201,0,75355,2701,72654
23917,30000,24000,0,0,0,0,0,1,2,0,0,0,2,1919,1919,0,-1,2658,2000,658,0,2497,1100,1397
23918,410000,328000,0,0,0,0,0,0,-1,630,5,625,2,-736,266,-1002,2,-1591,266,-1857,-2,-2303,253,-2556
23919,120000,96000,0,0,0,0,0,0,-1,214,219,-5,-1,4479,4484,-5,-1,980,980,0,-1,690,690,0
23920,60000,48000,0,1,1,0,0,0,0,56449,2900,53549,0,56273,2034,54239,0,28316,2000,26316,0,30763,3000,27763
23921,260000,208000,0,0,0,0,0,0,0,67107,2005,65102,0,28081,3036,25045,0,12767,5000,7767,0,4200,2200,2000
23922,50000,40000,0,0,0,0,0,0,0,9981,3000,6981,0,10442,1000,9442,0,10496,600,9896,0,10933,1000,9933
23923,220000,176000,0,0,0,0,0,0,-1,23031,23031,0,-1,7229,7234,-5,-1,3942,3942,0,-1,2132,2132,0
23924,40000,32000,0,1,1,1,1,0,0,38744,4950,33794,0,38807,1400,37407,2,39933,2000,37933,0,38646,1400,37246
23925,50000,40000,1,1,1,0,0,0,0,78937,4695,74242,0,50205,2300,47905,0,30506,2500,28006,0,29860,2000,27860
23926,440000,352000,0,0,0,0,0,0,-1,0,0,0,-1,26549,26549,0,-1,0,0,0,-1,1000,1000,0
23927,170000,136000,0,0,0,0,0,0,0,134502,4514,129988,0,122186,4376,117810,0,122506,4432,118074,0,117121,4142,112979
23928,170000,136000,0,0,0,0,0,1,-1,2260,2260,0,-1,5053,5053,0,-1,0,0,0,-1,0,0,0
23929,50000,40000,0,1,0,0,0,0,0,47608,1000,46608,0,3990,3600,390,0,390,390,0,-1,0,0,0
23930,240000,192000,0,0,0,0,0,0,-1,-9032,1000,-10032,-1,13756,23724,-9968,-1,0,0,0,-1,3138,3138,0
23931,120000,96000,0,0,0,0,0,0,-1,499,499,0,-1,499,499,0,-1,499,499,0,-1,1148,1148,0
23932,350000,280000,0,0,0,0,0,0,0,40375,2000,38375,0,37959,2000,35959,0,36416,1200,35216,0,34875,1200,33675
23933,250000,200000,0,0,0,0,0,0,-2,0,0,0,-2,0,0,0,-2,0,0,0,-2,0,0,0
23934,200000,160000,0,0,0,0,0,0,-2,33442,33448,-6,-2,2140,2140,0,-2,964,964,0,-2,2075,2075,0
23935,380000,304000,0,0,0,0,0,1,-2,0,0,0,-2,0,0,0,-2,0,0,0,-2,0,0,0
23936,20000,16000,1,1,0,0,0,0,0,25816,2302,23514,0,12957,2400,10557,0,9602,0,9602,2,9357,2000,7357
23937,30000,24000,0,0,0,0,0,0,-2,1220,1220,0,-2,480,480,0,-2,0,0,0,-2,174,174,0
23938,20000,16000,0,0,0,0,0,0,2,390,390,0,-1,390,390,0,-1,390,390,0,-1,0,0,0
23939,300000,240000,0,0,0,0,0,0,-1,0,0,0,-1,4340,4340,0,-1,2672,2672,0,-1,800,800,0
23940,320000,256000,0,0,0,0,0,0,-1,15610,15610,0,-1,10556,10556,0,-1,11863,8000,3863,0,5619,5600,19
23941,150000,120000,0,0,0,0,0,0,2,110405,4800,105605,2,106317,0,106317,2,30906,1240,29666,0,31457,1200,30257
23942,230000,184000,0,0,0,0,0,0,0,66131,10000,56131,0,58430,10000,48430,0,72617,20145,52472,0,66787,11745,55042
23943,200000,160000,0,1,1,0,0,0,0,200170,9200,190970,0,202965,8000,194965,0,155579,7000,148579,0,124488,5000,119488
23944,140000,112000,0,0,0,0,0,0,-2,28336,18002,10334,-2,30281,3001,27280,-2,38339,9004,29335,-2,80792,45117,35675
23945,50000,40000,0,1,1,0,0,0,-1,48731,0,48731,2,46882,2102,44780,0,500,0,500,0,0,0,0
23946,240000,192000,0,0,0,0,0,0,-1,20367,20469,-102,-1,6997,7032,-35,-1,15607,15685,-78,-1,44412,44513,-101
23947,140000,112000,0,0,0,0,0,0,0,31119,1522,29597,0,32597,2000,30597,0,33257,1500,31757,0,35061,2500,32561
23948,150000,120000,0,0,0,0,0,0,-1,3359,3461,-102,-1,2924,261,2663,0,0,0,0,0,0,0,0
23949,240000,192000,0,0,0,0,0,0,-1,0,0,0,-2,0,0,0,-2,2500,2500,0,-2,0,0,0
23950,80000,64000,0,0,0,0,0,1,-1,390,390,0,-1,1936,1936,0,-1,390,390,0,-1,390,390,0
23951,50000,40000,0,1,1,0,0,0,0,49027,3000,46027,0,49564,2503,47061,0,28609,1500,27109,0,28302,1204,27098
23952,50000,40000,0,1,0,0,0,1,0,49764,1800,47964,0,36535,1430,35105,0,32428,1000,31428,0,15313,1000,14313
23953,80000,64000,0,1,1,1,1,0,0,76696,5800,70896,0,79659,4800,74859,2,80079,1800,78279,2,79657,1000,78657
23954,20000,16000,0,1,1,1,1,0,0,19390,1400,17990,0,19464,1000,18464,0,18126,700,17426,0,18827,1600,17227
23955,150000,120000,0,0,0,0,0,0,-1,1203,1203,0,-1,2064,2064,0,-1,2847,2847,0,-1,0,0,0
23956,90000,72000,0,0,0,0,0,0,0,19461,1384,18077,0,16181,407,15774,0,14669,673,13996,0,14422,0,14422
23957,620000,496000,0,0,0,0,0,1,2,160440,6200,154240,0,163781,6000,157781,0,167159,6000,161159,0,170894,6500,164394
23958,170000,136000,0,0,0,0,0,0,-1,0,0,0,-1,0,0,0,-2,0,0,0,-2,275,275,0
23959,500000,400000,0,0,0,0,0,1,-1,6290,6290,0,-1,11604,6000,5604,0,24679,14000,10679,0,8642,8642,0
23960,50000,40000,0,0,0,0,0,1,2,17807,1003,16804,2,17430,1000,16430,0,18262,1014,17248,0,14224,1004,13220
23961,20000,16000,0,0,0,0,0,0,0,0,0,0,0,-1953,18047,-20000,-2,5985,7985,-2000,-1,6893,1000,5893
23962,110000,88000,0,0,0,0,0,0,0,90705,3818,86887,0,40086,1426,38660,0,41449,2000,39449,0,42260,2000,40260
23963,110000,88000,0,0,1,1,0,0,2,93436,9000,84436,2,91075,0,91075,3,88714,0,88714,2,94316,7062,87254
23964,50000,40000,0,1,1,0,0,0,0,50760,1905,48855,0,49535,1811,47724,0,30358,1100,29258,0,30302,1100,29202
23965,280000,224000,0,0,0,0,0,1,-1,325,325,0,-1,898,898,0,-1,325,325,0,-1,-339603,0,-339603
23966,230000,184000,0,0,0,0,0,0,-1,2923,3000,-77,-1,25916,25916,0,-1,4219,2219,2000,0,7903,4000,3903
23967,500000,400000,0,0,0,0,0,0,-1,36511,36575,-64,-1,18323,18323,0,-1,7865,13445,-5580,-1,7960,9016,-1056
23968,10000,8000,0,0,1,1,1,1,0,8717,2580,6137,0,8431,0,8431,2,9079,942,8137,2,9110,321,8789
23969,110000,88000,0,0,0,0,0,0,0,30379,1706,28673,0,84257,55000,29257,0,84762,3200,81562,0,86139,3300,82839
23970,360000,288000,0,0,0,0,0,0,-1,3924,3924,0,-1,43900,43900,0,-1,88865,50000,38865,0,12104,12104,0
23971,50000,40000,0,1,1,1,1,1,4,49097,0,49097,3,50036,2000,48036,2,49145,0,49145,2,47639,1900,45739
23972,30000,24000,0,1,1,0,0,1,2,29047,1687,27360,0,29507,1147,28360,0,11609,524,11085,0,11711,400,11311
23973,260000,208000,0,0,0,0,0,0,-1,4948,7256,-2308,-1,13100,13100,0,-1,10854,10854,0,-1,7537,7537,0
23974,240000,192000,0,0,0,0,0,1,-2,1129,1129,0,-1,1129,0,1129,2,1971,1000,971,0,2059,496,1563
23975,200000,160000,0,0,0,0,0,0,-1,2780,2795,-15,-1,3107,3117,-10,-1,6687,6700,-13,-1,24524,24538,-14
23976,180000,144000,0,0,0,0,0,0,-1,16277,16277,0,-1,0,0,0,-1,28743,28743,0,-1,8210,8210,0
23977,50000,40000,0,0,0,0,0,0,0,6529,1000,5529,0,7533,1004,6529,0,7857,3004,4853,0,4424,1005,3419
23978,200000,160000,0,0,0,0,0,0,-1,316,316,0,-1,1076,1076,0,-1,316,316,0,-1,1226,1226,0
23979,30000,24000,0,1,1,1,0,1,2,28391,1500,26891,0,26156,1000,25156,0,25377,1000,24377,0,27422,3800,23622
23980,200000,160000,0,0,0,0,0,0,-1,675,675,0,-1,0,0,0,-1,0,0,0,-2,0,0,0
23981,160000,128000,0,1,1,0,0,0,0,156778,7054,149724,0,148292,6511,141781,0,115841,4500,111341,0,116972,4500,112472
23982,150000,120000,0,0,0,0,0,0,0,0,0,0,-2,0,0,0,-2,0,0,0,-2,0,0,0
23983,160000,128000,0,0,0,0,0,0,0,21159,1459,19700,0,20018,2018,18000,0,15761,1761,14000,0,12643,1643,11000
23984,170000,136000,0,0,0,0,0,0,-2,905,905,0,-2,0,0,0,-2,0,0,0,-2,0,0,0
23985,120000,96000,0,0,0,0,0,0,-2,0,0,0,-2,0,0,0,-2,0,0,0,-2,0,0,0
23986,50000,40000,0,1,0,0,0,0,2,49025,2080,46945,0,38697,1600,37097,0,18561,657,17904,0,18952,683,18269
23987,360000,288000,0,0,0,0,0,0,0,90216,10055,80161,0,86410,10000,76410,0,94668,10049,84619,0,93275,10053,83222
23988,260000,208000,0,0,0,0,0,1,-1,399,399,0,-1,399,399,0,-1,399,399,0,-1,399,399,0
23989,420000,336000,0,0,0,0,0,0,-2,277510,277510,0,-1,279493,10000,269493,0,285447,10000,275447,0,291183,10000,281183
23990,30000,24000,0,0,0,0,0,1,2,8165,1200,6965,0,8529,500,8029,0,8743,500,8243,0,8949,500,8449
23991,50000,40000,0,1,0,0,0,0,0,47991,1018,46973,0,0,0,0,0,0,0,0,-2,0,0,0
23992,10000,8000,0,1,0,0,1,0,0,9000,0,9000,2,0,1000,-1000,2,10500,10500,0,-1,10674,368,10306
23993,560000,448000,0,0,0,0,0,0,-1,23445,23560,-115,-1,105199,109726,-4527,-1,47519,48237,-718,-1,73537,74014,-477
23994,330000,264000,0,0,0,0,0,0,0,40786,2600,38186,0,41767,1500,40267,0,42501,1400,41101,0,43359,1400,41959
23995,500000,400000,0,0,0,0,0,0,0,1697,1697,0,-1,-107,0,-107,-1,2693,2800,-107,-1,5393,5400,-7
23996,50000,40000,1,1,1,0,0,0,0,89215,5000,84215,0,93908,5000,88908,0,14308,1000,13308,0,14808,500,14308
23997,300000,240000,0,0,0,0,0,1,-2,4576,4599,-23,-2,3567,3585,-18,-2,2180,2180,0,-2,644,644,0
23998,60000,48000,0,0,0,0,0,0,0,22243,7243,15000,0,20938,5000,15938,0,22486,5000,17486,0,21394,5394,16000
